chrom	geneName	splicedExonStart	splicedExonEnd	splicedExonReadCount(rc)	splicedExonLength(sl)	othersExonsReadCount(RC)	othersExonsLength(L)	RC - rc	L - sl	splicedExonAverageReadCoverage(n)	otherExonsAverageReadCoverage(N)
chr1	LINC01409	804775	804840	0	66	32806	6771	32806	6705	0.0	4.892766592095451
chr1	LINC01409	807216	807323	0	108	32806	6771	32806	6663	0.0	4.923607984391415
chr1	LINC01409	803566	803667	329	102	32806	6771	32477	6669	3.2254901960784315	4.869845554056081
chr1	LINC01409	783110	783363	6520	254	32806	6771	26286	6517	25.669291338582678	4.033450974374713
chr1	LINC01409	792881	793041	399	161	32806	6771	32407	6610	2.4782608695652173	4.902723146747353
chr1	LINC01128	852670	852766	0	97	56879	13620	56879	13523	0.0	4.206093322487614
chr1	LINC01128	829002	829104	0	103	56879	13620	56879	13517	0.0	4.2079603462306725
chr1	LINC01128	841199	844498	12235	3300	56879	13620	44644	10320	3.7075757575757575	4.325968992248062
chr1	LINC01128	849483	849602	138	120	56879	13620	56741	13500	1.15	4.203037037037037
chr1	LINC01128	847653	847806	1098	154	56879	13620	55781	13466	7.12987012987013	4.142358532600624
chr1	LINC01128	850180	850351	2187	172	56879	13620	54692	13448	12.715116279069768	4.066924449732302
chr1	LINC01128	841199	841373	918	175	56879	13620	55961	13445	5.2457142857142856	4.1622164373373005
chr1	LINC01128	850177	850351	2187	175	56879	13620	54692	13445	12.497142857142856	4.067831907772406
chr1	SAMD11	931038	931089	0	52	29500	4083	29500	4031	0.0	7.31828330439097
chr1	SAMD11	939274	939460	969	187	29500	4083	28531	3896	5.181818181818182	7.323151950718686
chr1	SAMD11	941143	941306	80	164	29500	4083	29420	3919	0.4878048780487805	7.50701709619801
chr1	SAMD11	939274	939412	880	139	29500	4083	28620	3944	6.330935251798561	7.256592292089249
chr1	SAMD11	941143	941230	33	88	29500	4083	29467	3995	0.375	7.375969962453066
chr1	SAMD11	939271	939460	969	190	29500	4083	28531	3893	5.1	7.328795273567942
chr1	PLEKHN1	973185	973326	204	142	5882	3466	5678	3324	1.4366197183098592	1.7081829121540313
chr1	AGRN	1051031	1051043	0	13	113519	9349	113519	9336	0.0	12.159275921165381
chr1	AL390719.1	1061019	1061117	0	99	51	2217	51	2118	0.0	0.024079320113314446
chr1	TTLL10	1196385	1196488	2783	104	17704	4015	14921	3911	26.759615384615383	3.815136793658911
chr1	SCNN1D	1285570	1285664	0	95	51188	3430	51188	3335	0.0	15.34872563718141
chr1	PUSL1	1308914	1308972	0	59	219609	1468	219609	1409	0.0	155.86160397444996
chr1	CPTP	1326835	1327032	116668	198	744389	2559	627721	2361	589.2323232323232	265.87081745023295
chr1	ATAD3C	1454344	1454500	4004	157	178770	3768	174766	3611	25.503184713375795	48.39822763777347
chr1	ATAD3B	1487862	1487914	1006	53	250861	6839	249855	6786	18.9811320754717	36.81918656056587
chr1	ATAD3A	1520547	1520617	0	71	145596	3362	145596	3291	0.0	44.24065633546034
chr1	ATAD3A	1519491	1519571	76	81	145596	3362	145520	3281	0.9382716049382716	44.35233160621762
chr1	ATAD3A	1527160	1527238	0	79	145596	3362	145596	3283	0.0	44.34846177276881
chr1	MIB2	1624990	1625185	680	196	67209	7887	66529	7691	3.4693877551020407	8.650240540891952
chr1	MIB2	1625557	1625653	1826	97	67209	7887	65383	7790	18.824742268041238	8.393196405648267
chr1	MIB2	1626649	1626754	323	106	67209	7887	66886	7781	3.047169811320755	8.596067343529109
chr1	MIB2	1629384	1629566	0	183	67209	7887	67209	7704	0.0	8.723909657320872
chr1	MIB2	1625545	1625653	1994	109	67209	7887	65215	7778	18.293577981651374	8.38454615582412
chr1	MIB2	1626366	1626754	1632	389	67209	7887	65577	7498	4.195372750642673	8.745932248599626
chr1	MMP23B	1632980	1633120	606	141	110201	2013	109595	1872	4.297872340425532	58.54433760683761
chr1	CALML6	1915684	1915735	0	52	102	1239	102	1187	0.0	0.08593091828138164
chr1	CALML6	1916440	1916615	0	176	102	1239	102	1063	0.0	0.09595484477892756
chr1	GABRD	2029110	2029266	0	157	51	4393	51	4236	0.0	0.012039660056657223
chr1	GABRD	2023796	2023890	0	95	51	4393	51	4298	0.0	0.011865984178687762
chr1	GABRD	2029110	2029408	0	299	51	4393	51	4094	0.0	0.012457254518808011
chr1	PRKCZ	2056483	2056573	0	91	31496	7604	31496	7513	0.0	4.192200186343671
chr1	PRKCZ	2146026	2146108	0	83	31496	7604	31496	7521	0.0	4.187740991889377
chr1	PRKCZ	2098346	2098555	357	210	31496	7604	31139	7394	1.7	4.211387611576955
chr1	PRKCZ	2145337	2145511	97	175	31496	7604	31399	7429	0.5542857142857143	4.226544622425629
chr1	PRKCZ	2145388	2145511	49	124	31496	7604	31447	7480	0.3951612903225806	4.204144385026738
chr1	PRKCZ	2181831	2181914	248	84	31496	7604	31248	7520	2.9523809523809526	4.1553191489361705
chr1	AL590822.3	2317610	2317729	808	120	60378	5798	59570	5678	6.733333333333333	10.49137020077492
chr1	RER1	2399414	2399514	0	101	0	3838	0	3737	0.0	0.0
chr1	RER1	2395607	2395648	0	42	0	3838	0	3796	0.0	0.0
chr1	PLCH2	2497501	2497609	0	109	16039	6815	16039	6706	0.0	2.391738741425589
chr1	PLCH2	2503616	2503643	18	28	16039	6815	16021	6787	0.6428571428571429	2.3605422130543685
chr1	PRXL2B	2588549	2588625	0	77	0	3060	0	2983	0.0	0.0
chr1	PRXL2B	2588529	2588625	0	97	0	3060	0	2963	0.0	0.0
chr1	PRDM16	3431965	3432140	83553	176	692674	9787	609121	9611	474.73295454545456	63.37748413276454
chr1	TPRG1L	3625712	3625889	0	178	0	2406	0	2228	0.0	0.0
chr1	TP73	3729999	3730148	0	150	151484	6783	151484	6633	0.0	22.837931554349463
chr1	TP73	3731462	3731556	7019	95	151484	6783	144465	6688	73.88421052631578	21.60062799043062
chr1	TP73	3730926	3731065	16632	140	151484	6783	134852	6643	118.8	20.2998645190426
chr1	DFFB	3873013	3873137	0	125	0	3880	0	3755	0.0	0.0
chr1	DFFB	3866283	3866398	0	116	0	3880	0	3764	0.0	0.0
chr1	DFFB	3860419	3860506	0	88	0	3880	0	3792	0.0	0.0
chr1	LINC01777	4423053	4423187	0	135	102	2582	102	2447	0.0	0.04168369431957499
chr1	LINC01777	4423347	4423448	0	102	102	2582	102	2480	0.0	0.04112903225806452
chr1	LINC01777	4422759	4423187	0	429	102	2582	102	2153	0.0	0.04737575476079889
chr1	LINC01777	4422875	4423187	0	313	102	2582	102	2269	0.0	0.04495372410753636
chr1	LINC01646	4572469	4572592	0	124	0	3336	0	3212	0.0	0.0
chr1	LINC01646	4575321	4575450	0	130	0	3336	0	3206	0.0	0.0
chr1	LINC01646	4582276	4582574	0	299	0	3336	0	3037	0.0	0.0
chr1	KCNAB2	6041830	6041872	0	43	42121	13510	42121	13467	0.0	3.12771961090072
chr1	KCNAB2	6040516	6040645	0	130	42121	13510	42121	13380	0.0	3.1480568011958145
chr1	KCNAB2	6018634	6018835	0	202	42121	13510	42121	13308	0.0	3.165088668470093
chr1	KCNAB2	6051510	6051754	2600	245	42121	13510	39521	13265	10.612244897959183	2.979344138710893
chr1	KCNAB2	5995862	5996084	82	223	42121	13510	42039	13287	0.36771300448430494	3.1639196206818694
chr1	KCNAB2	6085739	6085793	0	55	42121	13510	42121	13455	0.0	3.130509104422148
chr1	KCNAB2	6097516	6097555	0	40	42121	13510	42121	13470	0.0	3.1270230141054194
chr1	KCNAB2	6091262	6091307	0	46	42121	13510	42121	13464	0.0	3.1284165181224006
chr1	KCNAB2	6073353	6073384	80	32	42121	13510	42041	13478	2.5	3.1192313399614187
chr1	KCNAB2	6027355	6027459	7940	105	42121	13510	34181	13405	75.61904761904762	2.549869451697128
chr1	KCNAB2	6095938	6096204	0	267	42121	13510	42121	13243	0.0	3.1806237257419014
chr1	ESPN	6448892	6449091	32	200	10054	6800	10022	6600	0.16	1.5184848484848485
chr1	ESPN	6450443	6450470	0	28	10054	6800	10054	6772	0.0	1.484642646190195
chr1	TAS1R1	6574630	6575392	0	763	671	2770	671	2007	0.0	0.33432984554060785
chr1	ZBTB48	6580540	6581299	195	760	213031	3499	212836	2739	0.2565789473684211	77.70573201898503
chr1	THAP3	6628498	6628691	0	194	408	4079	408	3885	0.0	0.10501930501930502
chr1	THAP3	6629642	6629724	0	83	408	4079	408	3996	0.0	0.1021021021021021
chr1	LINC01672	6727432	6727612	2	181	5326	2191	5324	2010	0.011049723756906077	2.6487562189054725
chr1	CAMTA1	6820180	6820250	0	71	5988	9933	5988	9862	0.0	0.607179071182316
chr1	CAMTA1	7755637	7755668	0	32	5988	9933	5988	9901	0.0	0.6047873952126048
chr1	CAMTA1	6871756	6871840	0	85	5988	9933	5988	9848	0.0	0.6080422420796101
chr1	CAMTA1	6806982	6807088	0	107	5988	9933	5988	9826	0.0	0.6094036230409119
chr1	CAMTA1	6886239	6886346	0	108	5988	9933	5988	9825	0.0	0.6094656488549618
chr1	CAMTA1	7749770	7749791	0	22	5988	9933	5988	9911	0.0	0.6041771768741802
chr1	PER3	7808892	7808998	0	107	22788	7397	22788	7290	0.0	3.1259259259259258
chr1	PARK7	7969344	7969404	0	61	102	2378	102	2317	0.0	0.0440224428139836
chr1	LINC01714	8214624	8214678	0	55	0	1007	0	952	0.0	0.0
chr1	CA6	8949262	8949442	0	181	3223	2672	3223	2491	0.0	1.2938578883982337
chr1	CA6	8957136	8957285	0	150	3223	2672	3223	2522	0.0	1.2779540047581284
chr1	LNCTAM34A	9191039	9191124	0	86	1062	2148	1062	2062	0.0	0.5150339476236664
chr1	LNCTAM34A	9187535	9187789	306	255	1062	2148	756	1893	1.2	0.3993660855784469
chr1	TMEM201	9609839	9609911	0	73	13847	6994	13847	6921	0.0	2.0007224389539084
chr1	TMEM201	9611014	9611073	0	60	13847	6994	13847	6934	0.0	1.9969714450533602
chr1	RBP7	10004092	10004307	133	216	1011	867	878	651	0.6157407407407407	1.348694316436252
chr1	UBE4B	10130499	10130616	0	118	24272	9087	24272	8969	0.0	2.7062102798528263
chr1	UBE4B	10137066	10137205	0	140	24272	9087	24272	8947	0.0	2.712864647367833
chr1	UBE4B	10107221	10107374	280	154	24272	9087	23992	8933	1.8181818181818181	2.685771857158849
chr1	UBE4B	10106196	10106583	510	388	24272	9087	23762	8699	1.3144329896907216	2.7315783423382
chr1	UBE4B	10166243	10166342	2400	100	24272	9087	21872	8987	24.0	2.433737621008123
chr1	KIF1B	10273013	10273031	0	19	63579	17608	63579	17589	0.0	3.614702370799932
chr1	KIF1B	10279096	10279138	45	43	63579	17608	63534	17565	1.0465116279069768	3.6170794192997437
chr1	KIF1B	10355369	10355396	0	28	63579	17608	63579	17580	0.0	3.6165529010238906
chr1	PGD	10403070	10403136	0	67	3569	3347	3569	3280	0.0	1.088109756097561
chr1	CENPS-CORT	10440346	10440413	1679	68	9056	2251	7377	2183	24.691176470588236	3.379294548786074
chr1	CENPS-CORT	10442264	10442441	0	178	9056	2251	9056	2073	0.0	4.368547998070429
chr1	CENPS-CORT	10433841	10433965	230	125	9056	2251	8826	2126	1.84	4.151458137347131
chr1	CENPS-CORT	10434656	10434690	68	35	9056	2251	8988	2216	1.9428571428571428	4.055956678700361
chr1	TARDBP	11016843	11017007	0	165	153	4648	153	4483	0.0	0.03412893151907205
chr1	TARDBP	11020428	11020599	0	172	153	4648	153	4476	0.0	0.03418230563002681
chr1	TARDBP	11015523	11015646	0	124	153	4648	153	4524	0.0	0.033819628647214856
chr1	TARDBP	11016122	11016254	0	133	153	4648	153	4515	0.0	0.03388704318936877
chr1	TARDBP	11024063	11024335	0	273	153	4648	153	4375	0.0	0.03497142857142857
chr1	TARDBP	11024301	11024335	0	35	153	4648	153	4613	0.0	0.03316713635378279
chr1	AL109811.3	11029686	11029781	0	96	224	2216	224	2120	0.0	0.10566037735849057
chr1	UBIAD1	11285643	11285732	0	90	39082	5095	39082	5005	0.0	7.8085914085914085
chr1	FBXO44	11655327	11655699	0	373	0	3061	0	2688	0.0	0.0
chr1	FBXO44	11658532	11658628	0	97	0	3061	0	2964	0.0	0.0
chr1	FBXO44	11655669	11655699	0	31	0	3061	0	3030	0.0	0.0
chr1	FBXO6	11671927	11672023	0	97	0	1742	0	1645	0.0	0.0
chr1	AGTRAP	11745987	11746223	867	237	247528	2351	246661	2114	3.6582278481012658	116.67975402081362
chr1	AGTRAP	11746126	11746223	646	98	247528	2351	246882	2253	6.591836734693878	109.5792276964048
chr1	AGTRAP	11745802	11745837	0	36	247528	2351	247528	2315	0.0	106.92354211663067
chr1	AGTRAP	11747439	11747545	0	107	247528	2351	247528	2244	0.0	110.3065953654189
chr1	AGTRAP	11744532	11744568	0	37	247528	2351	247528	2314	0.0	106.96974935177182
chr1	CLCN6	11828457	11828624	0	168	33752	7557	33752	7389	0.0	4.567871159832183
chr1	CLCN6	11815845	11815911	0	67	33752	7557	33752	7490	0.0	4.506275033377837
chr1	AL021155.4	11911506	11911589	0	84	4232	3074	4232	2990	0.0	1.4153846153846155
chr1	PLOD1	11944521	11944662	0	142	4467	5069	4467	4927	0.0	0.9066368987213315
chr1	MFN2	11982066	11982114	805	49	419893	10140	419088	10091	16.428571428571427	41.530869091269444
chr1	MFN2	11981969	11982114	1088	146	419893	10140	418805	9994	7.4520547945205475	41.90564338603162
chr1	MFN2	12003757	12003889	45	133	419893	10140	419848	10007	0.3383458646616541	41.955431198161286
chr1	MFN2	11982522	11982590	2926	69	419893	10140	416967	10071	42.405797101449274	41.40274054215073
chr1	MFN2	11981973	11982114	1080	142	419893	10140	418813	9998	7.605633802816901	41.889677935587116
chr1	MFN2	11988426	11988516	0	91	419893	10140	419893	10049	0.0	41.78455567718181
chr1	MFN2	11988721	11988843	0	123	419893	10140	419893	10017	0.0	41.91803933313367
chr1	MFN2	11981809	11981853	126	45	419893	10140	419767	10095	2.8	41.58167409608717
chr1	MFN2	11992278	11992463	0	186	419893	10140	419893	9954	0.0	42.18334337954591
chr1	MFN2	11988781	11988843	0	63	419893	10140	419893	10077	0.0	41.66845291257319
chr1	MFN2	11981809	11982114	2801	306	419893	10140	417092	9834	9.15359477124183	42.4132601179581
chr1	MIIP	12021644	12021840	76	197	2390	2492	2314	2295	0.38578680203045684	1.0082788671023966
chr1	TNFRSF8	12084463	12084551	797	89	1460	3827	663	3738	8.955056179775282	0.17736757624398075
chr1	TNFRSF8	12138228	12138436	0	209	1460	3827	1460	3618	0.0	0.4035378662244334
chr1	TNFRSF8	12138231	12138436	0	206	1460	3827	1460	3621	0.0	0.4032035349351008
chr1	TNFRSF1B	12188795	12188895	0	101	0	3788	0	3687	0.0	0.0
chr1	VPS13D	12338230	12338305	0	76	25627	20657	25627	20581	0.0	1.2451775909819736
chr1	VPS13D	12358458	12358601	0	144	25627	20657	25627	20513	0.0	1.2493053185784624
chr1	VPS13D	12453838	12453899	0	62	25627	20657	25627	20595	0.0	1.244331148336975
chr1	VPS13D	12402567	12402702	0	136	25627	20657	25627	20521	0.0	1.2488182837093709
chr1	AADACL3	12719474	12719691	0	218	51	4059	51	3841	0.0	0.01327779224160375
chr1	C1ORF158	12755699	12755813	0	115	0	4138	0	4023	0.0	0.0
chr1	PDPN	13610386	13610516	0	131	0	3705	0	3574	0.0	0.0
chr1	PDPN	13595826	13595984	0	159	0	3705	0	3546	0.0	0.0
chr1	PRDM2	13732778	13732855	0	78	486	10938	486	10860	0.0	0.044751381215469614
chr1	PRDM2	13732778	13732882	0	105	486	10938	486	10833	0.0	0.04486291885904182
chr1	PRDM2	13778417	13782831	204	4415	486	10938	282	6523	0.04620611551528879	0.04323164188256937
chr1	PRDM2	13769117	13769173	0	57	486	10938	486	10881	0.0	0.04466501240694789
chr1	PRDM2	13769038	13769173	0	136	486	10938	486	10802	0.0	0.044991668209590815
chr1	PRDM2	13773077	13773188	0	112	486	10938	486	10826	0.0	0.04489192684278589
chr1	TMEM51	15210489	15210562	0	74	0	2243	0	2169	0.0	0.0
chr1	FHAD1	15272322	15272529	0	208	5626	11501	5626	11293	0.0	0.49818471619587357
chr1	FHAD1	15324451	15324559	0	109	5626	11501	5626	11392	0.0	0.4938553370786517
chr1	FHAD1	15349041	15349149	0	109	5626	11501	5626	11392	0.0	0.4938553370786517
chr1	FHAD1	15317823	15317928	0	106	5626	11501	5626	11395	0.0	0.49372531812198334
chr1	FHAD1	15383155	15383402	56	248	5626	11501	5570	11253	0.22580645161290322	0.49497911667999644
chr1	FHAD1	15391209	15391263	0	55	5626	11501	5626	11446	0.0	0.4915254237288136
chr1	FHAD1	15383806	15383930	414	125	5626	11501	5212	11376	3.312	0.4581575246132208
chr1	FHAD1	15388345	15388422	0	78	5626	11501	5626	11423	0.0	0.492515101111792
chr1	FHAD1	15383158	15383280	0	123	5626	11501	5626	11378	0.0	0.4944629987695553
chr1	EFHD2	15427897	15428009	0	113	0	2539	0	2426	0.0	0.0
chr1	CTRC	15444605	15444751	0	147	105	3491	105	3344	0.0	0.031399521531100476
chr1	CELA2B	15481644	15481749	0	106	0	1460	0	1354	0.0	0.0
chr1	DNAJC16	15529087	15529272	340	186	2105	7125	1765	6939	1.8279569892473118	0.2543594177835423
chr1	DDI2	15638306	15638434	0	129	152	11761	152	11632	0.0	0.013067400275103164
chr1	DDI2	15633797	15633879	0	83	152	11761	152	11678	0.0	0.01301592738482617
chr1	PLEKHM2	15716706	15716816	0	111	1533	4154	1533	4043	0.0	0.3791738807815978
chr1	PLEKHM2	15721328	15721388	0	61	1533	4154	1533	4093	0.0	0.3745419008062546
chr1	TMEM82	15742834	15742907	0	74	1734	1449	1734	1375	0.0	1.261090909090909
chr1	CLCNKA	16024858	16024891	0	34	2938	3502	2938	3468	0.0	0.8471741637831603
chr1	CLCNKA	16024762	16024891	14	130	2938	3502	2924	3372	0.1076923076923077	0.867141162514828
chr1	SZRD1	16391374	16391424	0	51	102	4752	102	4701	0.0	0.02169751116783663
chr1	SZRD1	16387501	16387794	0	294	102	4752	102	4458	0.0	0.02288021534320323
chr1	NECAP2	16455817	16455893	1852	77	1967543	4594	1965691	4517	24.051948051948052	435.1762231569626
chr1	NECAP2	16448059	16448141	0	83	1967543	4594	1967543	4511	0.0	436.1655952117047
chr1	NECAP2	16443631	16443732	0	102	1967543	4594	1967543	4492	0.0	438.01046304541404
chr1	NECAP2	16447869	16447974	189	106	1967543	4594	1967354	4488	1.7830188679245282	438.35873440285206
chr1	NECAP2	16450124	16450241	23	118	1967543	4594	1967520	4476	0.19491525423728814	439.5710455764075
chr1	CROCC	16938399	16938483	51	85	160695	8914	160644	8829	0.6	18.19503907577302
chr1	CROCC	16924324	16924479	125	156	160695	8914	160570	8758	0.8012820512820513	18.334094542132906
chr1	CROCC	16931290	16931397	473	108	160695	8914	160222	8806	4.37962962962963	18.19464001816943
chr1	CROCC	16936636	16936873	594	238	160695	8914	160101	8676	2.495798319327731	18.453319502074688
chr1	CROCC	16939893	16940093	4672	201	160695	8914	156023	8713	23.243781094527364	17.90692069321703
chr1	ARHGEF10L	17613057	17613174	0	118	5711	7987	5711	7869	0.0	0.7257593086796289
chr1	ARHGEF10L	17634547	17634562	0	16	5711	7987	5711	7971	0.0	0.7164722117676577
chr1	ARHGEF10L	17691119	17691192	0	74	5711	7987	5711	7913	0.0	0.7217237457348666
chr1	SLC66A1	19317599	19317841	0	243	0	2695	0	2452	0.0	0.0
chr1	MICOS10	19622099	19622147	1084	49	87618	5490	86534	5441	22.122448979591837	15.904061753354163
chr1	PLA2G5	20066023	20066129	0	107	11625	3257	11625	3150	0.0	3.6904761904761907
chr1	PLA2G5	20063483	20063602	0	120	11625	3257	11625	3137	0.0	3.705769843799809
chr1	PLA2G5	20070293	20070465	984	173	11625	3257	10641	3084	5.687861271676301	3.450389105058366
chr1	LINC01757	20243387	20243544	0	158	0	649	0	491	0.0	0.0
chr1	VWA5B1	20350155	20350230	0	76	81	6402	81	6326	0.0	0.012804299715460007
chr1	VWA5B1	20349097	20349298	0	202	81	6402	81	6200	0.0	0.013064516129032259
chr1	CDA	20613841	20613899	0	59	0	824	0	765	0.0	0.0
chr1	AL592309.2	21416971	21417121	1140	151	1140	765	0	614	7.549668874172186	0.0
chr1	NBPF3	21468687	21468897	0	211	8259	6838	8259	6627	0.0	1.2462652784065187
chr1	ALPL	21561096	21561212	510	117	100506	2994	99996	2877	4.358974358974359	34.7570385818561
chr1	ALPL	21553977	21554142	0	166	100506	2994	100506	2828	0.0	35.539603960396036
chr1	ALPL	21573664	21573799	56508	136	100506	2994	43998	2858	415.5	15.394681595521343
chr1	AL590556.3	22006877	22007014	570	138	14866	1620	14296	1482	4.130434782608695	9.64642375168691
chr1	AL590556.3	22010137	22010185	0	49	14866	1620	14866	1571	0.0	9.462762571610439
chr1	LINC00339	22027413	22027534	0	122	15847	3569	15847	3447	0.0	4.597331012474616
chr1	LINC00339	22027681	22027780	47	100	15847	3569	15800	3469	0.47	4.554626693571635
chr1	LINC00339	22028527	22028660	0	134	15847	3569	15847	3435	0.0	4.613391557496361
chr1	CDC42	22074093	22074219	0	127	21611	13175	21611	13048	0.0	1.6562691600245247
chr1	CDC42	22078705	22078881	0	177	21611	13175	21611	12998	0.0	1.662640406216341
chr1	CDC42	22069220	22069318	0	99	21611	13175	21611	13076	0.0	1.652722545120832
chr1	CDC42	22078746	22078881	0	136	21611	13175	21611	13039	0.0	1.6574123782498658
chr1	ZBTB40	22452658	22452946	0	289	5372	9189	5372	8900	0.0	0.6035955056179775
chr1	C1QB	22654007	22654160	0	154	0	1497	0	1343	0.0	0.0
chr1	KDM1A	23044426	23044486	0	61	0	3430	0	3369	0.0	0.0
chr1	KDM1A	23066059	23066071	0	13	0	3430	0	3417	0.0	0.0
chr1	MDS2	23627780	23627998	2651	219	4627	2151	1976	1932	12.105022831050228	1.0227743271221532
chr1	MDS2	23639108	23639251	735	144	4627	2151	3892	2007	5.104166666666667	1.939212755356253
chr1	LYPLA2	23793007	23793039	231	33	790	1850	559	1817	7.0	0.3076499724821134
chr1	LYPLA2	23793859	23793930	0	72	790	1850	790	1778	0.0	0.44431946006749157
chr1	LYPLA2	23794062	23794136	0	75	790	1850	790	1775	0.0	0.4450704225352113
chr1	GRHL3	24334644	24334706	0	63	1172	3924	1172	3861	0.0	0.30354830354830353
chr1	GRHL3	24339667	24339762	0	96	1172	3924	1172	3828	0.0	0.30616509926854757
chr1	GRHL3	24331425	24331612	0	188	1172	3924	1172	3736	0.0	0.31370449678800855
chr1	NIPAL3	24433103	24433213	0	111	566	7530	566	7419	0.0	0.07629060520285753
chr1	NIPAL3	24457733	24457833	0	101	566	7530	566	7429	0.0	0.07618791223583254
chr1	RCAN3	24514313	24514567	0	255	838	6672	838	6417	0.0	0.13059061866916005
chr1	RCAN3	24531217	24531391	224	175	838	6672	614	6497	1.28	0.09450515622595043
chr1	RCAN3	24533082	24533254	0	173	838	6672	838	6499	0.0	0.12894291429450686
chr1	RCAN3	24533112	24533254	0	143	838	6672	838	6529	0.0	0.1283504365140144
chr1	SRRM1	24648023	24648166	0	144	8136	5651	8136	5507	0.0	1.4773924096604323
chr1	SRRM1	24663182	24663224	472	43	8136	5651	7664	5608	10.976744186046512	1.3666191155492153
chr1	SRRM1	24647078	24647208	0	131	8136	5651	8136	5520	0.0	1.4739130434782608
chr1	RHD	25316999	25317079	0	81	0	3324	0	3243	0.0	0.0
chr1	RHD	25321888	25321962	0	75	0	3324	0	3249	0.0	0.0
chr1	RHD	25307646	25307816	0	171	0	3324	0	3153	0.0	0.0
chr1	RHD	25306595	25306729	0	135	0	3324	0	3189	0.0	0.0
chr1	TMEM50A	25340473	25340579	0	107	0	3018	0	2911	0.0	0.0
chr1	TMEM50A	25352881	25352974	0	94	0	3018	0	2924	0.0	0.0
chr1	TMEM50A	25342960	25343073	0	114	0	3018	0	2904	0.0	0.0
chr1	MACO1	25456652	25456831	0	180	0	3990	0	3810	0.0	0.0
chr1	MAN1C1	25780939	25781112	221	174	110213	8819	109992	8645	1.2701149425287357	12.723192596876807
chr1	MAN1C1	25654241	25654366	432	126	110213	8819	109781	8693	3.4285714285714284	12.628666743356725
chr1	SELENON	25802015	25802117	0	103	90714	4378	90714	4275	0.0	21.219649122807017
chr1	MTFR1L	25826614	25826826	5421	213	22094	4825	16673	4612	25.450704225352112	3.615134431916739
chr1	MTFR1L	25823239	25823439	357	201	22094	4825	21737	4624	1.7761194029850746	4.70090830449827
chr1	MTFR1L	25822995	25823128	171	134	22094	4825	21923	4691	1.2761194029850746	4.673417181837562
chr1	MTFR1L	25823018	25823128	123	111	22094	4825	21971	4714	1.1081081081081081	4.66079762409843
chr1	MTFR1L	25823345	25823439	357	95	22094	4825	21737	4730	3.7578947368421054	4.595560253699788
chr1	MTFR1L	25823237	25823323	0	87	22094	4825	22094	4738	0.0	4.6631490080202616
chr1	MTFR1L	25826301	25826411	4823	111	22094	4825	17271	4714	43.450450450450454	3.6637675010606703
chr1	EXTL1	26029599	26029707	0	109	0	4359	0	4250	0.0	0.0
chr1	EXTL1	26033228	26033315	0	88	0	4359	0	4271	0.0	0.0
chr1	PDIK1L	26112459	26112650	0	192	132	4565	132	4373	0.0	0.030185227532586324
chr1	CNKSR1	26184070	26184141	18	72	151527	3847	151509	3775	0.25	40.13483443708609
chr1	ZPLD2P	26223376	26223753	204	378	945727	3201	945523	2823	0.5396825396825397	334.93552957846265
chr1	CEP85	26244165	26244318	102	154	1738	5161	1636	5007	0.6623376623376623	0.32674256041541844
chr1	DHDDS	26446315	26446432	0	118	6867	5593	6867	5475	0.0	1.2542465753424659
chr1	DHDDS	26447558	26447660	0	103	6867	5593	6867	5490	0.0	1.2508196721311475
chr1	DHDDS	26460036	26460144	0	109	6867	5593	6867	5484	0.0	1.2521881838074398
chr1	RPS6KA1	26530744	26530902	0	159	12000	5692	12000	5533	0.0	2.1688053497198627
chr1	RPS6KA1	26546866	26546983	0	118	12000	5692	12000	5574	0.0	2.1528525296017222
chr1	RPS6KA1	26560725	26560851	7184	127	12000	5692	4816	5565	56.56692913385827	0.8654088050314466
chr1	RPS6KA1	26547188	26547270	0	83	12000	5692	12000	5609	0.0	2.139418791228383
chr1	RPS6KA1	26544074	26544178	0	105	12000	5692	12000	5587	0.0	2.1478432074458564
chr1	RPS6KA1	26552817	26552896	0	80	12000	5692	12000	5612	0.0	2.1382751247327154
chr1	ARID1A	26774328	26775220	11121	893	104732	12546	93611	11653	12.453527435610303	8.033210332103321
chr1	ARID1A	26774979	26775220	2666	242	104732	12546	102066	12304	11.016528925619834	8.2953511053316
chr1	ARID1A	26775816	26775956	612	141	104732	12546	104120	12405	4.340425531914893	8.393389762192664
chr1	TMEM222	27330984	27331137	0	154	1307	2716	1307	2562	0.0	0.5101483216237315
chr1	TMEM222	27334666	27334754	0	89	1307	2716	1307	2627	0.0	0.4975256947087933
chr1	TMEM222	27333360	27333435	316	76	1307	2716	991	2640	4.157894736842105	0.37537878787878787
chr1	SYTL1	27350793	27350952	0	160	768	5082	768	4922	0.0	0.15603413246647704
chr1	AL445490.1	27669906	27670026	0	121	27317	1636	27317	1515	0.0	18.031023102310233
chr1	AL445490.1	27670311	27670429	0	119	27317	1636	27317	1517	0.0	18.007251153592616
chr1	FAM76A	27734030	27734183	134300	154	182987	4057	48687	3903	872.077922077922	12.474250576479632
chr1	FAM76A	27749067	27749154	0	88	182987	4057	182987	3969	0.0	46.10405643738977
chr1	FAM76A	27730231	27730333	144	103	182987	4057	182843	3954	1.3980582524271845	46.242539200809304
chr1	STX12	27811991	27812060	612	70	2280	3811	1668	3741	8.742857142857142	0.4458700882117081
chr1	PPP1R8	27841013	27841234	0	222	603	2822	603	2600	0.0	0.23192307692307693
chr1	THEMIS2	27876587	27876728	5823	142	18413	2665	12590	2523	41.00704225352113	4.990091161315894
chr1	THEMIS2	27879643	27880054	4460	412	18413	2665	13953	2253	10.825242718446601	6.193075898801598
chr1	THEMIS2	27881970	27882125	102	156	18413	2665	18311	2509	0.6538461538461539	7.298126743722599
chr1	THEMIS2	27881970	27883043	3250	1074	18413	2665	15163	1591	3.026070763500931	9.530483972344438
chr1	THEMIS2	27881970	27882077	102	108	18413	2665	18311	2557	0.9444444444444444	7.16112631990614
chr1	SMPDL3B	27953214	27953358	0	145	102	2674	102	2529	0.0	0.04033214709371293
chr1	SMPDL3B	27942274	27942364	0	91	102	2674	102	2583	0.0	0.03948896631823461
chr1	XKR8	27965350	27965458	0	109	51	3028	51	2919	0.0	0.017471736896197326
chr1	XKR8	27964184	27964235	0	52	51	3028	51	2976	0.0	0.017137096774193547
chr1	XKR8	27964878	27965158	0	281	51	3028	51	2747	0.0	0.018565708045140152
chr1	XKR8	27965718	27965928	0	211	51	3028	51	2817	0.0	0.01810436634717785
chr1	PHACTR4	28432930	28433046	0	117	3249	7336	3249	7219	0.0	0.45006233550353236
chr1	PHACTR4	28457831	28457859	0	29	3249	7336	3249	7307	0.0	0.44464212399069386
chr1	PHACTR4	28457831	28457855	0	25	3249	7336	3249	7311	0.0	0.4443988510463685
chr1	PHACTR4	28489773	28489894	0	122	3249	7336	3249	7214	0.0	0.45037427224840587
chr1	PHACTR4	28494229	28494322	0	94	3249	7336	3249	7242	0.0	0.44863297431648713
chr1	RCC1	28516724	28516867	0	144	64274	3738	64274	3594	0.0	17.883695047301057
chr1	RCC1	28530522	28530615	0	94	64274	3738	64274	3644	0.0	17.638309549945117
chr1	RCC1	28516724	28516853	0	130	64274	3738	64274	3608	0.0	17.81430155210643
chr1	RCC1	28532673	28532757	0	85	64274	3738	64274	3653	0.0	17.59485354503148
chr1	RCC1	28530522	28530573	0	52	64274	3738	64274	3686	0.0	17.437330439500816
chr1	YTHDF2	28737657	28737682	26	26	11743	3737	11717	3711	1.0	3.1573699811371596
chr1	EPB41	28993329	28993542	0	214	280693	17917	280693	17703	0.0	15.855674179517596
chr1	EPB41	28997214	28997319	51	106	280693	17917	280642	17811	0.4811320754716981	15.756667228117456
chr1	EPB41	29064981	29065158	1006	178	280693	17917	279687	17739	5.651685393258427	15.766785049890073
chr1	EPB41	29109335	29109437	0	103	280693	17917	280693	17814	0.0	15.75687661389918
chr1	EPB41	29058810	29058852	0	43	280693	17917	280693	17874	0.0	15.703983439632987
chr1	EPB41	29060421	29060484	0	64	280693	17917	280693	17853	0.0	15.72245560970145
chr1	EPB41	29058588	29058645	0	58	280693	17917	280693	17859	0.0	15.717173413964948
chr1	EPB41	29068732	29068783	3175	52	280693	17917	277518	17865	61.05769230769231	15.534172963895886
chr1	EPB41	29065683	29065825	0	143	280693	17917	280693	17774	0.0	15.792337121638349
chr1	EPB41	28989355	28989435	0	81	280693	17917	280693	17836	0.0	15.737441130298274
chr1	EPB41	29035005	29035283	0	279	280693	17917	280693	17638	0.0	15.914105907699286
chr1	EPB41	29068732	29068768	1813	37	280693	17917	278880	17880	49.0	15.59731543624161
chr1	EPB41	29031787	29031913	0	127	280693	17917	280693	17790	0.0	15.77813378302417
chr1	EPB41	29096154	29096604	35213	451	280693	17917	245480	17466	78.07760532150776	14.05473491354632
chr1	PTPRU	29289682	29289712	0	31	1034	6715	1034	6684	0.0	0.15469778575703172
chr1	PTPRU	29307128	29307146	0	19	1034	6715	1034	6696	0.0	0.1544205495818399
chr1	MATN1-AS1	30720976	30721174	0	199	0	3750	0	3551	0.0	0.0
chr1	LINC01778	30826533	30826652	0	120	31	2117	31	1997	0.0	0.015523284927391086
chr1	LINC01778	30826604	30826652	0	49	31	2117	31	2068	0.0	0.014990328820116054
chr1	LINC01778	30826554	30826652	0	99	31	2117	31	2018	0.0	0.015361744301288404
chr1	LINC01778	30826130	30826194	0	65	31	2117	31	2052	0.0	0.015107212475633527
chr1	LINC01778	30829747	30829882	0	136	31	2117	31	1981	0.0	0.015648662291771833
chr1	LINC01778	30826055	30826194	31	140	31	2117	0	1977	0.22142857142857142	0.0
chr1	LINC01778	30826133	30826194	0	62	31	2117	31	2055	0.0	0.01508515815085158
chr1	ZCCHC17	31318166	31318236	0	71	1275	1930	1275	1859	0.0	0.685852608929532
chr1	ZCCHC17	31337174	31337275	0	102	1275	1930	1275	1828	0.0	0.6974835886214442
chr1	ZCCHC17	31348828	31348974	0	147	1275	1930	1275	1783	0.0	0.715086932136848
chr1	ZCCHC17	31346639	31346740	897	102	1275	1930	378	1828	8.794117647058824	0.20678336980306344
chr1	ZCCHC17	31310043	31310164	0	122	1275	1930	1275	1808	0.0	0.7051991150442478
chr1	LDC1P	31507295	31507350	0	56	1491	2358	1491	2302	0.0	0.6476976542137272
chr1	TINAGL1	31577133	31577458	0	326	51	5290	51	4964	0.0	0.010273972602739725
chr1	TINAGL1	31583148	31583241	0	94	51	5290	51	5196	0.0	0.009815242494226328
chr1	HCRTR1	31619050	31619391	51	342	1403	2570	1352	2228	0.14912280701754385	0.6068222621184919
chr1	HCRTR1	31619531	31619710	0	180	1403	2570	1403	2390	0.0	0.5870292887029289
chr1	PEF1-AS1	31655951	31656044	0	94	51	2148	51	2054	0.0	0.024829600778967866
chr1	PEF1-AS1	31652110	31652244	0	135	51	2148	51	2013	0.0	0.02533532041728763
chr1	PEF1-AS1	31655910	31656044	0	135	51	2148	51	2013	0.0	0.02533532041728763
chr1	PEF1-AS1	31655951	31656185	0	235	51	2148	51	1913	0.0	0.026659696811291166
chr1	PEF1-AS1	31656896	31657061	0	166	51	2148	51	1982	0.0	0.025731584258324926
chr1	PEF1-AS1	31653439	31653574	0	136	51	2148	51	2012	0.0	0.025347912524850896
chr1	KHDRBS1	32031523	32031640	0	118	204	3555	204	3437	0.0	0.059354087867326155
chr1	TMEM39B	32076762	32076846	0	85	44105	2802	44105	2717	0.0	16.23297754876702
chr1	TMEM39B	32077163	32077318	0	156	44105	2802	44105	2646	0.0	16.668556311413454
chr1	KPNA6	32159399	32159531	0	133	2531	7472	2531	7339	0.0	0.3448698732797384
chr1	CCDC28B	32204185	32204379	1038	195	43396	2043	42358	1848	5.323076923076923	22.92099567099567
chr1	CCDC28B	32204232	32204379	0	148	43396	2043	43396	1895	0.0	22.900263852242745
chr1	EIF3I	32222357	32222444	720	88	17127	5731	16407	5643	8.181818181818182	2.9074960127591707
chr1	EIF3I	32222537	32222630	0	94	17127	5731	17127	5637	0.0	3.0383182543906333
chr1	EIF3I	32226170	32226320	0	151	17127	5731	17127	5580	0.0	3.0693548387096774
chr1	EIF3I	32226402	32226530	0	129	17127	5731	17127	5602	0.0	3.0573009639414495
chr1	EIF3I	32229134	32229208	0	75	17127	5731	17127	5656	0.0	3.028111739745403
chr1	EIF3I	32230265	32230376	0	112	17127	5731	17127	5619	0.0	3.0480512546716496
chr1	EIF3I	32222540	32222630	0	91	17127	5731	17127	5640	0.0	3.0367021276595745
chr1	EIF3I	32227963	32228110	0	148	17127	5731	17127	5583	0.0	3.067705534658786
chr1	EIF3I	32226148	32226320	0	173	17127	5731	17127	5558	0.0	3.081504138179201
chr1	EIF3I	32226170	32226283	0	114	17127	5731	17127	5617	0.0	3.049136549759658
chr1	EIF3I	32230926	32231019	0	94	17127	5731	17127	5637	0.0	3.0383182543906333
chr1	EIF3I	32226104	32226320	0	217	17127	5731	17127	5514	0.0	3.1060935799782374
chr1	LCK	32276336	32276489	0	154	51	3193	51	3039	0.0	0.01678183613030602
chr1	HDAC1	32302620	32302733	0	114	2244	3233	2244	3119	0.0	0.719461365822379
chr1	HDAC1	32324478	32324553	0	76	2244	3233	2244	3157	0.0	0.710801393728223
chr1	RBBP4	32657426	32657572	1023	147	307145	9163	306122	9016	6.959183673469388	33.953194321206745
chr1	RBBP4	32668224	32668398	272	175	307145	9163	306873	8988	1.5542857142857143	34.14252336448598
chr1	RBBP4	32668319	32668398	216	80	307145	9163	306929	9083	2.7	33.791588682153474
chr1	RBBP4	32662245	32662337	75363	93	307145	9163	231782	9070	810.3548387096774	25.554796030871003
chr1	RBBP4	32673458	32673580	7662	123	307145	9163	299483	9040	62.292682926829265	33.12865044247788
chr1	RBBP4	32679639	32679817	0	179	307145	9163	307145	8984	0.0	34.18800089047195
chr1	RBBP4	32679634	32679698	1	65	307145	9163	307144	9098	0.015384615384615385	33.75950758408442
chr1	S100PBP	32820546	32820599	1317	54	92597	9206	91280	9152	24.38888888888889	9.973776223776223
chr1	S100PBP	32825312	32825429	9484	118	92597	9206	83113	9088	80.37288135593221	9.145356514084508
chr1	S100PBP	32825312	32825485	10460	174	92597	9206	82137	9032	60.11494252873563	9.093999114260408
chr1	HPCA	32888877	32889276	0	400	0	1970	0	1570	0.0	0.0
chr1	AZIN2	33082177	33082354	29	178	355258	7260	355229	7082	0.16292134831460675	50.15941824343406
chr1	AZIN2	33083953	33084127	0	175	355258	7260	355258	7085	0.0	50.14227240649259
chr1	AZIN2	33081600	33081812	629	213	355258	7260	354629	7047	2.9530516431924885	50.323400028380874
chr1	AZIN2	33092049	33092222	2043	174	355258	7260	353215	7086	11.741379310344827	49.846881174146205
chr1	AZIN2	33083017	33083142	0	126	355258	7260	355258	7134	0.0	49.79786935800392
chr1	AZIN2	33083062	33083142	0	81	355258	7260	355258	7179	0.0	49.48572224543808
chr1	AZIN2	33101832	33101902	930	71	355258	7260	354328	7189	13.098591549295774	49.2875226039783
chr1	ZNF362	33270486	33270612	116	127	83748	3394	83632	3267	0.9133858267716536	25.599020508111415
chr1	AL513327.1	33314689	33314823	153	135	36566	3838	36413	3703	1.1333333333333333	9.833378341884957
chr1	AL513327.1	33314509	33314823	946	315	36566	3838	35620	3523	3.003174603174603	10.11070110701107
chr1	CSMD2-AS1	33882585	33882668	0	84	6568	2628	6568	2544	0.0	2.5817610062893084
chr1	CSMD2-AS1	33884569	33884814	0	246	6568	2628	6568	2382	0.0	2.757346767422334
chr1	CSMD2-AS1	33875463	33875592	0	130	6568	2628	6568	2498	0.0	2.6293034427542032
chr1	CSMD2-AS1	33882162	33882234	23	73	6568	2628	6545	2555	0.3150684931506849	2.5616438356164384
chr1	CSMD2-AS1	33875441	33875592	0	152	6568	2628	6568	2476	0.0	2.652665589660743
chr1	ZMYM1	35093319	35093441	0	123	0	5220	0	5097	0.0	0.0
chr1	ZMYM1	35093913	35094009	0	97	0	5220	0	5123	0.0	0.0
chr1	ZMYM1	35093913	35094083	0	171	0	5220	0	5049	0.0	0.0
chr1	ZMYM1	35093393	35093441	0	49	0	5220	0	5171	0.0	0.0
chr1	ZMYM4	35295926	35295988	0	63	1403	7937	1403	7874	0.0	0.17818135636271273
chr1	NCDN	35558155	35558223	102	69	84468	4926	84366	4857	1.4782608695652173	17.369981470043236
chr1	AGO3	35966954	35967075	0	122	841904	21176	841904	21054	0.0	39.98784079034863
chr1	AGO3	36005718	36005858	0	141	841904	21176	841904	21035	0.0	40.02396006655574
chr1	AGO3	35973374	35973511	0	138	841904	21176	841904	21038	0.0	40.0182526856165
chr1	MAP7D1	36174897	36175008	561	112	198643	4365	198082	4253	5.008928571428571	46.574653185986364
chr1	THRAP3	36224970	36225102	0	133	68658	4735	68658	4602	0.0	14.91916558018253
chr1	THRAP3	36225411	36225463	0	53	68658	4735	68658	4682	0.0	14.664246048697137
chr1	SH3D21	36307516	36307607	0	92	176698	6435	176698	6343	0.0	27.857165379158126
chr1	SH3D21	36319441	36319536	6823	96	176698	6435	169875	6339	71.07291666666667	26.79839091339328
chr1	SH3D21	36319259	36319312	6244	54	176698	6435	170454	6381	115.62962962962963	26.712740949694407
chr1	DNALI1	37559326	37559496	0	171	0	3254	0	3083	0.0	0.0
chr1	MANEAL	37796743	37796820	0	78	153	3022	153	2944	0.0	0.051970108695652176
chr1	LINC01685	38493570	38493621	108	52	261	3681	153	3629	2.076923076923077	0.042160374758886746
chr1	LINC01685	38476728	38476803	0	76	261	3681	261	3605	0.0	0.0723994452149792
chr1	AL139260.1	38875940	38876018	0	79	0	2010	0	1931	0.0	0.0
chr1	AKIRIN1	38998170	38998311	0	142	0	2693	0	2551	0.0	0.0
chr1	AKIRIN1	39000971	39001106	0	136	0	2693	0	2557	0.0	0.0
chr1	AKIRIN1	39003346	39003418	0	73	0	2693	0	2620	0.0	0.0
chr1	MACF1	39083362	39083417	0	56	306202	41060	306202	41004	0.0	7.467612915813091
chr1	MACF1	39302923	39303078	94	156	306202	41060	306108	40904	0.6025641025641025	7.483571288871504
chr1	MACF1	39378460	39378523	44	64	306202	41060	306158	40996	0.6875	7.46799687774417
chr1	MACF1	39427960	39428287	0	328	306202	41060	306202	40732	0.0	7.517480113915349
chr1	MACF1	39436481	39436490	0	10	306202	41060	306202	41050	0.0	7.459244823386115
chr1	MACF1	39437776	39438008	0	233	306202	41060	306202	40827	0.0	7.499987753202538
chr1	MACF1	39251845	39251941	0	97	306202	41060	306202	40963	0.0	7.475087273881307
chr1	MACF1	39465094	39465112	0	19	306202	41060	306202	41041	0.0	7.460880582831803
chr1	MACF1	39469546	39469615	0	70	306202	41060	306202	40990	0.0	7.4701634545010975
chr1	MACF1	39480919	39481030	51	112	306202	41060	306151	40948	0.45535714285714285	7.476580052749829
chr1	MACF1	39299251	39299257	0	7	306202	41060	306202	41053	0.0	7.458699729617811
chr1	MACF1	39328600	39328706	836	107	306202	41060	305366	40953	7.813084112149533	7.4564989133885184
chr1	MACF1	39391867	39391955	3013	89	306202	41060	303189	40971	33.853932584269664	7.400087867027898
chr1	MACF1	39459817	39459832	567	16	306202	41060	305635	41044	35.4375	7.446520806938895
chr1	PABPC4-AS1	39566582	39566674	59	93	1186	1413	1127	1320	0.6344086021505376	0.8537878787878788
chr1	PPIE	39745374	39745498	0	125	6319	11133	6319	11008	0.0	0.5740370639534884
chr1	PPIE	39745374	39748767	1676	3394	6319	11133	4643	7739	0.4938126104890984	0.5999483137356247
chr1	PPIE	39762516	39762651	0	136	6319	11133	6319	10997	0.0	0.5746112576157134
chr1	PPIE	39745413	39745498	0	86	6319	11133	6319	11047	0.0	0.5720105005883951
chr1	CAP1	40041428	40041493	72570	66	75024	3616	2454	3550	1099.5454545454545	0.6912676056338029
chr1	CAP1	40057445	40057495	0	51	75024	3616	75024	3565	0.0	21.04460028050491
chr1	ZMPSTE24	40280119	40280312	0	194	51	4036	51	3842	0.0	0.01327433628318584
chr1	ZMPSTE24	40262833	40262983	0	151	51	4036	51	3885	0.0	0.013127413127413128
chr1	ZMPSTE24	40267390	40267507	0	118	51	4036	51	3918	0.0	0.013016845329249618
chr1	ZFP69B	40454202	40454288	0	87	19	2571	19	2484	0.0	0.007648953301127214
chr1	EXO5	40509450	40509625	0	176	561	2819	561	2643	0.0	0.2122587968217934
chr1	EXO5	40509732	40509790	0	59	561	2819	561	2760	0.0	0.20326086956521738
chr1	ZNF684	40532732	40532808	111	77	8127	3108	8016	3031	1.4415584415584415	2.6446717255031342
chr1	ZNF684	40533142	40533181	400	40	8127	3108	7727	3068	10.0	2.5185788787483703
chr1	NFYC	40747533	40747605	6	73	135543	5237	135537	5164	0.0821917808219178	26.246514329976762
chr1	NFYC	40749572	40749686	0	115	135543	5237	135543	5122	0.0	26.46290511518938
chr1	NFYC	40753150	40753246	0	97	135543	5237	135543	5140	0.0	26.37023346303502
chr1	NFYC	40766917	40766974	698	58	135543	5237	134845	5179	12.03448275862069	26.036879706507047
chr1	NFYC	40723688	40723792	0	105	135543	5237	135543	5132	0.0	26.411340607950116
chr1	NFYC	40712686	40712821	0	136	135543	5237	135543	5101	0.0	26.571848657126054
chr1	NFYC	40763362	40763489	0	128	135543	5237	135543	5109	0.0	26.530240751614798
chr1	KCNQ4	40824096	40824258	0	163	12213	4424	12213	4261	0.0	2.8662285848392397
chr1	KCNQ4	40826637	40826694	0	58	12213	4424	12213	4366	0.0	2.7972972972972974
chr1	CTPS1	41007448	41007545	0	98	115361	6125	115361	6027	0.0	19.140700182512028
chr1	CTPS1	40980885	40981043	20769	159	115361	6125	94592	5966	130.62264150943398	15.855179349648006
chr1	CTPS1	41000434	41000566	505	133	115361	6125	114856	5992	3.7969924812030076	19.16822429906542
chr1	AC093151.2	41263840	41264108	0	269	765	2258	765	1989	0.0	0.38461538461538464
chr1	RIMKLA	42396439	42396500	0	62	0	10644	0	10582	0.0	0.0
chr1	CCDC30	42480460	42480566	0	107	152932	22898	152932	22791	0.0	6.710192619893817
chr1	CCDC30	42577019	42577229	0	211	152932	22898	152932	22687	0.0	6.740952968660467
chr1	CCDC30	42630403	42630525	0	123	152932	22898	152932	22775	0.0	6.714906695938529
chr1	CCDC30	42646134	42646317	916	184	152932	22898	152016	22714	4.978260869565218	6.692612485691644
chr1	CCDC30	42521162	42521256	0	95	152932	22898	152932	22803	0.0	6.706661404201202
chr1	CCDC30	42637236	42637378	0	143	152932	22898	152932	22755	0.0	6.72080861349154
chr1	CCDC30	42506946	42507069	0	124	152932	22898	152932	22774	0.0	6.715201545622201
chr1	CCDC30	42473121	42473303	0	183	152932	22898	152932	22715	0.0	6.732643627558882
chr1	CCDC30	42539172	42539310	0	139	152932	22898	152932	22759	0.0	6.719627400149392
chr1	CCDC30	42556155	42556405	0	251	152932	22898	152932	22647	0.0	6.75285909833532
chr1	CCDC30	42477107	42477136	0	30	152932	22898	152932	22868	0.0	6.687598390764387
chr1	CCDC30	42534888	42534989	0	102	152932	22898	152932	22796	0.0	6.708720828215476
chr1	CCDC30	42545409	42545579	0	171	152932	22898	152932	22727	0.0	6.729088749064989
chr1	CCDC30	42536475	42536601	0	127	152932	22898	152932	22771	0.0	6.716086250054895
chr1	CCDC30	42558138	42558276	0	139	152932	22898	152932	22759	0.0	6.719627400149392
chr1	CCDC30	42537191	42537290	0	100	152932	22898	152932	22798	0.0	6.708132292306343
chr1	CCDC30	42529601	42529721	0	121	152932	22898	152932	22777	0.0	6.71431707424156
chr1	CCDC30	42580831	42580981	51	151	152932	22898	152881	22747	0.33774834437086093	6.72093023255814
chr1	PPIH	42668046	42668151	192	106	5057	4021	4865	3915	1.8113207547169812	1.2426564495530013
chr1	PPIH	42675366	42675448	0	83	5057	4021	5057	3938	0.0	1.2841543930929407
chr1	PPIH	42663417	42663543	0	127	5057	4021	5057	3894	0.0	1.2986646122239343
chr1	PPIH	42675287	42675327	0	41	5057	4021	5057	3980	0.0	1.2706030150753769
chr1	YBX1	42696198	42696288	0	91	4233	3403	4233	3312	0.0	1.2780797101449275
chr1	ERMAP	42817533	42817815	0	283	10	5141	10	4858	0.0	0.0020584602717167557
chr1	ZNF691	42849564	42849742	0	179	1327	2041	1327	1862	0.0	0.7126745435016112
chr1	ZNF691	42849290	42849413	0	124	1327	2041	1327	1917	0.0	0.692227438706312
chr1	ZNF691	42850658	42850743	0	86	1327	2041	1327	1955	0.0	0.6787723785166241
chr1	SLC2A1-AS1	42973973	42974188	0	216	102	4280	102	4064	0.0	0.025098425196850394
chr1	FAM183A	43152827	43152931	0	105	523	811	523	706	0.0	0.7407932011331445
chr1	FAM183A	43152827	43152979	0	153	523	811	523	658	0.0	0.7948328267477204
chr1	CFAP57	43232065	43232164	0	100	29256	5416	29256	5316	0.0	5.503386004514673
chr1	CFAP57	43177120	43177211	0	92	29256	5416	29256	5324	0.0	5.4951164537941395
chr1	TIE1	43307795	43307924	999	130	128465	6231	127466	6101	7.684615384615385	20.89264055072939
chr1	MPL	43349836	43349962	47	127	932	3950	885	3823	0.3700787401574803	0.2314935914203505
chr1	SZT2	43426367	43426538	51	172	36229	24016	36178	23844	0.29651162790697677	1.5172789800369066
chr1	SZT2	43426437	43426538	51	102	36229	24016	36178	23914	0.5	1.5128376683114493
chr1	PTPRF	43597747	43598053	1868	307	16003	10480	14135	10173	6.084690553745928	1.3894623021724173
chr1	PTPRF	43602070	43602097	0	28	16003	10480	16003	10452	0.0	1.5310945273631842
chr1	PTPRF	43603610	43604189	3320	580	16003	10480	12683	9900	5.724137931034483	1.281111111111111
chr1	PTPRF	43612767	43612800	0	34	16003	10480	16003	10446	0.0	1.531973961324909
chr1	ST3GAL3	43792101	43792149	0	49	359390	18223	359390	18174	0.0	19.77495322988885
chr1	ST3GAL3	43838218	43838311	236	94	359390	18223	359154	18129	2.5106382978723403	19.81102101605163
chr1	ST3GAL3	43894382	43894477	1275	96	359390	18223	358115	18127	13.28125	19.755889005351133
chr1	ST3GAL3	43899540	43899727	643	188	359390	18223	358747	18035	3.4202127659574466	19.891710562794565
chr1	ST3GAL3	43920781	43920928	1257	148	359390	18223	358133	18075	8.493243243243244	19.81372060857538
chr1	KDM4A	43653662	43653799	0	138	313	5208	313	5070	0.0	0.06173570019723866
chr1	ST3GAL3	43801281	43801541	13	261	359390	18223	359377	17962	0.04980842911877394	20.007627213005232
chr1	ST3GAL3	43801281	43801545	13	265	359390	18223	359377	17958	0.04905660377358491	20.012083750974497
chr1	ST3GAL3	43858134	43858308	51	175	359390	18223	359339	18048	0.2914285714285714	19.91018395390071
chr1	ST3GAL3	43814890	43815004	0	115	359390	18223	359390	18108	0.0	19.847028937486193
chr1	ST3GAL3	43814890	43814933	0	44	359390	18223	359390	18179	0.0	19.76951427471258
chr1	ST3GAL3	43824730	43824892	30432	163	359390	18223	328958	18060	186.69938650306747	18.21472868217054
chr1	ST3GAL3	43921442	43921638	51	197	359390	18223	359339	18026	0.25888324873096447	19.934483523798956
chr1	ST3GAL3	43709413	43709526	0	114	359390	18223	359390	18109	0.0	19.84593296151085
chr1	ST3GAL3	43879334	43879507	264	174	359390	18223	359126	18049	1.5172413793103448	19.897279627680202
chr1	ST3GAL3	43899508	43899727	1330	220	359390	18223	358060	18003	6.045454545454546	19.8889074043215
chr1	ST3GAL3	43879026	43879231	537	206	359390	18223	358853	18017	2.6067961165048543	19.917466836876283
chr1	ST3GAL3	43920801	43920928	786	128	359390	18223	358604	18095	6.140625	19.81785023487151
chr1	ST3GAL3	43921511	43921638	51	128	359390	18223	359339	18095	0.3984375	19.858469190384085
chr1	ST3GAL3	43831654	43831794	1095	141	359390	18223	358295	18082	7.76595744680851	19.815009401614866
chr1	ST3GAL3	43896729	43896822	7077	94	359390	18223	352313	18129	75.2872340425532	19.433669810800374
chr1	ST3GAL3	43920403	43920550	0	148	359390	18223	359390	18075	0.0	19.88326417704011
chr1	ST3GAL3	43819113	43819236	0	124	359390	18223	359390	18099	0.0	19.85689817116968
chr1	ST3GAL3	43920781	43920940	1269	160	359390	18223	358121	18063	7.93125	19.82621934340918
chr1	ST3GAL3	43900748	43900833	1817	86	359390	18223	357573	18137	21.127906976744185	19.715112752935987
chr1	ST3GAL3	43911166	43911243	585	78	359390	18223	358805	18145	7.5	19.774317993937725
chr1	ARTN	43934111	43934260	0	150	1938	2662	1938	2512	0.0	0.7714968152866242
chr1	DPH2	43970965	43971189	0	225	0	2729	0	2504	0.0	0.0
chr1	DPH2	43971386	43972070	0	685	0	2729	0	2044	0.0	0.0
chr1	DPH2	43970905	43971189	0	285	0	2729	0	2444	0.0	0.0
chr1	DPH2	43971659	43972070	0	412	0	2729	0	2317	0.0	0.0
chr1	ATP6V0B	43976589	43976659	0	71	2958	2433	2958	2362	0.0	1.2523285351397122
chr1	ATP6V0B	43975799	43975848	45	50	2958	2433	2913	2383	0.9	1.2224087284934957
chr1	ATP6V0B	43975664	43975848	96	185	2958	2433	2862	2248	0.518918918918919	1.2731316725978647
chr1	B4GALT2	43982816	43982930	0	115	3851	5400	3851	5285	0.0	0.7286660359508041
chr1	AL139220.2	44048357	44048486	1184	130	138097	9671	136913	9541	9.107692307692307	14.349963316214234
chr1	AL139220.2	44061131	44061227	4784	97	138097	9671	133313	9574	49.31958762886598	13.924482974723208
chr1	AL139220.2	44048362	44048486	1184	125	138097	9671	136913	9546	9.472	14.342447098261053
chr1	AL139220.2	44050949	44051158	9479	210	138097	9671	128618	9461	45.13809523809524	13.59454603107494
chr1	AL139220.2	44074837	44074963	0	127	138097	9671	138097	9544	0.0	14.469509639564125
chr1	AL139220.2	44050949	44051107	8281	159	138097	9671	129816	9512	52.081761006289305	13.647603027754416
chr1	AL139220.2	44052111	44052186	5687	76	138097	9671	132410	9595	74.82894736842105	13.799895779051589
chr1	AL139220.2	44069880	44069934	0	55	138097	9671	138097	9616	0.0	14.361168885191347
chr1	AL139220.2	44110393	44110597	0	205	138097	9671	138097	9466	0.0	14.58873864356645
chr1	DMAP1	44214538	44214616	190	79	4135	2653	3945	2574	2.4050632911392404	1.5326340326340326
chr1	ARMH1	44684392	44684656	14999	265	20984	3290	5985	3025	56.6	1.9785123966942149
chr1	ARMH1	44688195	44688319	1511	125	20984	3290	19473	3165	12.088	6.15260663507109
chr1	ARMH1	44698062	44698229	612	168	20984	3290	20372	3122	3.642857142857143	6.525304292120436
chr1	ARMH1	44704088	44704173	0	86	20984	3290	20984	3204	0.0	6.549313358302122
chr1	ARMH1	44685333	44685457	2905	125	20984	3290	18079	3165	23.24	5.71216429699842
chr1	ARMH1	44723802	44723906	0	105	20984	3290	20984	3185	0.0	6.5883830455259025
chr1	ARMH1	44689108	44689224	294	117	20984	3290	20690	3173	2.5128205128205128	6.520642924676962
chr1	ARMH1	44689741	44689874	0	134	20984	3290	20984	3156	0.0	6.6489226869455
chr1	KIF2C	44753131	44753254	0	124	45570	3547	45570	3423	0.0	13.312883435582823
chr1	PLK3	44804649	44804779	48509	131	179290	3191	130781	3060	370.2977099236641	42.73888888888889
chr1	BTBD19	44810212	44810426	102	215	14840	3529	14738	3314	0.4744186046511628	4.447193723596862
chr1	BTBD19	44812457	44812522	0	66	14840	3529	14840	3463	0.0	4.285301761478487
chr1	UROD	45013135	45013215	0	81	840	3179	840	3098	0.0	0.2711426726920594
chr1	UROD	45013291	45013354	0	64	840	3179	840	3115	0.0	0.2696629213483146
chr1	UROD	45014939	45015006	0	68	840	3179	840	3111	0.0	0.2700096432015429
chr1	UROD	45013908	45014070	0	163	840	3179	840	3016	0.0	0.27851458885941643
chr1	UROD	45014438	45014576	0	139	840	3179	840	3040	0.0	0.27631578947368424
chr1	UROD	45013354	45013426	0	73	840	3179	840	3106	0.0	0.27044430135222153
chr1	TOE1	45341472	45341569	306	98	17346	2244	17040	2146	3.122448979591837	7.940354147250699
chr1	AKR1A1	45552435	45552563	0	129	51	2518	51	2389	0.0	0.021347844286312263
chr1	AKR1A1	45568484	45568684	0	201	51	2518	51	2317	0.0	0.0220112214069918
chr1	AKR1A1	45561788	45561878	0	91	51	2518	51	2427	0.0	0.021013597033374538
chr1	NASP	45591222	45591270	0	49	2448	8254	2448	8205	0.0	0.2983546617915905
chr1	NASP	45602254	45602365	0	112	2448	8254	2448	8142	0.0	0.3006632277081798
chr1	NASP	45604935	45605016	0	82	2448	8254	2448	8172	0.0	0.29955947136563876
chr1	NASP	45607320	45608337	0	1018	2448	8254	2448	7236	0.0	0.3383084577114428
chr1	NASP	45617462	45617591	0	130	2448	8254	2448	8124	0.0	0.30132939438700146
chr1	NASP	45600384	45600457	0	74	2448	8254	2448	8180	0.0	0.29926650366748164
chr1	NASP	45594693	45594773	0	81	2448	8254	2448	8173	0.0	0.2995228190382968
chr1	NASP	45588650	45588948	0	299	2448	8254	2448	7955	0.0	0.3077309868007542
chr1	NASP	45604916	45605016	0	101	2448	8254	2448	8153	0.0	0.30025757389917823
chr1	NASP	45606481	45606591	0	111	2448	8254	2448	8143	0.0	0.30062630480167013
chr1	TMEM69	45690973	45691110	0	138	0	1468	0	1330	0.0	0.0
chr1	MAST2	46010729	46010939	0	211	583865	7806	583865	7595	0.0	76.87491770901909
chr1	MAST2	46000958	46000979	0	22	583865	7806	583865	7784	0.0	75.00835046248716
chr1	TSPAN1	46180525	46180658	765	134	5259	2305	4494	2171	5.708955223880597	2.0700138185168124
chr1	TSPAN1	46184593	46184668	0	76	5259	2305	5259	2229	0.0	2.3593539703903095
chr1	RAD54L	46248343	46248408	0	66	44622	4044	44622	3978	0.0	11.217194570135746
chr1	RAD54L	46259963	46260099	0	137	44622	4044	44622	3907	0.0	11.421039160481188
chr1	RAD54L	46270658	46270785	0	128	44622	4044	44622	3916	0.0	11.394790602655771
chr1	RAD54L	46273354	46273465	0	112	44622	4044	44622	3932	0.0	11.348423194303153
chr1	RAD54L	46273623	46273747	0	125	44622	4044	44622	3919	0.0	11.386067874457769
chr1	RAD54L	46248317	46248408	0	92	44622	4044	44622	3952	0.0	11.290991902834008
chr1	RAD54L	46257741	46257817	0	77	44622	4044	44622	3967	0.0	11.248298462314091
chr1	RAD54L	46271367	46271442	0	76	44622	4044	44622	3968	0.0	11.24546370967742
chr1	UQCRH	46309896	46310044	0	149	816	1345	816	1196	0.0	0.6822742474916388
chr1	NSUN4	46346920	46347075	0	156	12138	8320	12138	8164	0.0	1.4867711905928467
chr1	NSUN4	46341322	46341497	0	176	12138	8320	12138	8144	0.0	1.4904223968565815
chr1	FAAH	46411611	46411651	460	41	520	2707	60	2666	11.21951219512195	0.02250562640660165
chr1	FAAHP1	46439522	46439577	0	56	1513	2350	1513	2294	0.0	0.6595466434176112
chr1	FAAHP1	46477347	46477504	0	158	1513	2350	1513	2192	0.0	0.6902372262773723
chr1	MKNK1-AS1	46540929	46541009	0	81	1887	1569	1887	1488	0.0	1.2681451612903225
chr1	MKNK1-AS1	46559669	46559811	0	143	1887	1569	1887	1426	0.0	1.3232819074333801
chr1	EFCAB14-AS1	46682180	46682264	0	85	8368	588	8368	503	0.0	16.636182902584494
chr1	CYP4B1	46811139	46811184	1710	46	38951	3487	37241	3441	37.17391304347826	10.82272595175821
chr1	CYP4B1	46812176	46812348	0	173	38951	3487	38951	3314	0.0	11.753470126735063
chr1	CYP4B1	46810807	46810949	1528	143	38951	3487	37423	3344	10.685314685314685	11.191088516746412
chr1	CYP4A22	47143761	47143916	17285	156	110491	3865	93206	3709	110.80128205128206	25.129684551091938
chr1	CMPK1	47368468	47368615	0	148	0	3851	0	3703	0.0	0.0
chr1	CMPK1	47374908	47374985	0	78	0	3851	0	3773	0.0	0.0
chr1	SLC5A9	48229102	48229165	0	64	0	4404	0	4340	0.0	0.0
chr1	SLC5A9	48231945	48232151	0	207	0	4404	0	4197	0.0	0.0
chr1	SLC5A9	48229102	48229177	0	76	0	4404	0	4328	0.0	0.0
chr1	SLC5A9	48241943	48242216	0	274	0	4404	0	4130	0.0	0.0
chr1	ELAVL4	50178173	50178402	0	230	51	8008	51	7778	0.0	0.006556955515556699
chr1	ELAVL4	50197428	50197467	0	40	51	8008	51	7968	0.0	0.006400602409638554
chr1	ELAVL4	50141771	50141858	0	88	51	8008	51	7920	0.0	0.006439393939393939
chr1	ELAVL4	50120844	50121054	0	211	51	8008	51	7797	0.0	0.006540977298961139
chr1	C1ORF185	51145723	51145760	0	38	0	1125	0	1087	0.0	0.0
chr1	RNF11	51269955	51270125	0	171	0	3115	0	2944	0.0	0.0
chr1	OSBPL9	51651990	51652041	0	52	1649	7377	1649	7325	0.0	0.22511945392491467
chr1	OSBPL9	51669433	51669512	0	80	1649	7377	1649	7297	0.0	0.2259832808003289
chr1	OSBPL9	51772069	51772182	0	114	1649	7377	1649	7263	0.0	0.22704116756161366
chr1	OSBPL9	51776832	51776918	0	87	1649	7377	1649	7290	0.0	0.2262002743484225
chr1	OSBPL9	51669433	51669814	0	382	1649	7377	1649	6995	0.0	0.2357398141529664
chr1	OSBPL9	51740142	51740211	0	70	1649	7377	1649	7307	0.0	0.22567401122211578
chr1	OSBPL9	51756319	51756358	0	40	1649	7377	1649	7337	0.0	0.22475126073326973
chr1	OSBPL9	51752502	51752725	1173	224	1649	7377	476	7153	5.236607142857143	0.06654550538235705
chr1	OSBPL9	51745535	51745631	0	97	1649	7377	1649	7280	0.0	0.226510989010989
chr1	OSBPL9	51749501	51749588	0	88	1649	7377	1649	7289	0.0	0.22623130744958156
chr1	BTF3L4	52060427	52060659	0	233	1479	5956	1479	5723	0.0	0.25843089288834525
chr1	BTF3L4	52083339	52083541	0	203	1479	5956	1479	5753	0.0	0.2570832609073527
chr1	BTF3L4	52059834	52059901	0	68	1479	5956	1479	5888	0.0	0.25118885869565216
chr1	ZFYVE9	52266654	52266831	102	178	120376	7995	120274	7817	0.5730337078651685	15.386209543303057
chr1	ZFYVE9	52199250	52199431	0	182	120376	7995	120376	7813	0.0	15.407141942915654
chr1	SHISAL2A	52659400	52659580	0	181	51	2691	51	2510	0.0	0.020318725099601594
chr1	ZYG11B	52805470	52805524	1281	55	469108	8221	467827	8166	23.29090909090909	57.289615478814596
chr1	ZYG11A	52856997	52857749	1683	753	10881	4456	9198	3703	2.235059760956175	2.4839319470699435
chr1	SCP2	52941795	52941853	0	59	2231	6178	2231	6119	0.0	0.36460205915999344
chr1	SCP2	52948008	52948080	0	73	2231	6178	2231	6105	0.0	0.36543816543816543
chr1	SCP2	52950754	52950886	22	133	2231	6178	2209	6045	0.16541353383458646	0.3654259718775848
chr1	SCP2	52974768	52974832	0	65	2231	6178	2231	6113	0.0	0.3649599214788156
chr1	SCP2	52976682	52976769	0	88	2231	6178	2231	6090	0.0	0.3663382594417077
chr1	SCP2	53027968	53028071	0	104	2231	6178	2231	6074	0.0	0.36730325979585116
chr1	SCP2	53038916	53039046	0	131	2231	6178	2231	6047	0.0	0.368943277658343
chr1	SCP2	52993257	52996000	0	2744	2231	6178	2231	3434	0.0	0.6496796738497379
chr1	SCP2	53027977	53028071	0	95	2231	6178	2231	6083	0.0	0.366759822456025
chr1	PODN	53063468	53063559	0	92	15449	4913	15449	4821	0.0	3.204521883426675
chr1	PODN	53063369	53063559	0	191	15449	4913	15449	4722	0.0	3.271706903854299
chr1	PODN	53066811	53066867	0	57	15449	4913	15449	4856	0.0	3.1814250411861615
chr1	CPT2	53202322	53202429	6	108	414	5091	408	4983	0.05555555555555555	0.08187838651414811
chr1	CPT2	53210014	53211250	0	1237	414	5091	414	3854	0.0	0.10742086144265697
chr1	CPT2	53200718	53200799	0	82	414	5091	414	5009	0.0	0.08265122778997804
chr1	CPT2	53210014	53211369	0	1356	414	5091	414	3735	0.0	0.1108433734939759
chr1	CPT2	53212780	53212816	0	37	414	5091	414	5054	0.0	0.08191531460229522
chr1	CPT2	53197302	53197507	204	206	414	5091	210	4885	0.9902912621359223	0.042988741044012284
chr1	CPT2	53210014	53211319	0	1306	414	5091	414	3785	0.0	0.10937912813738442
chr1	AL606760.1	53241846	53241945	0	100	51	1945	51	1845	0.0	0.027642276422764227
chr1	DIO1	53904665	53904809	0	145	82	2265	82	2120	0.0	0.038679245283018866
chr1	DIO1	53906094	53906294	0	201	82	2265	82	2064	0.0	0.03972868217054264
chr1	DIO1	53894438	53894547	31	110	82	2265	51	2155	0.2818181818181818	0.023665893271461718
chr1	DIO1	53904733	53904809	0	77	82	2265	82	2188	0.0	0.037477148080438755
chr1	LRRC42	53947861	53947981	0	121	408	2093	408	1972	0.0	0.20689655172413793
chr1	LRRC42	53947787	53947821	0	35	408	2093	408	2058	0.0	0.19825072886297376
chr1	TCEANC2	54068755	54068897	0	143	2556	4725	2556	4582	0.0	0.5578350065473592
chr1	ACOT11	54585834	54585904	0	71	180431	9790	180431	9719	0.0	18.56477003806976
chr1	MROH7	54670496	54670576	0	81	196291	6269	196291	6188	0.0	31.721234647705234
chr1	MROH7	54679890	54680045	119	156	196291	6269	196172	6113	0.7628205128205128	32.09095370521839
chr1	MROH7	54682655	54682794	2084	140	196291	6269	194207	6129	14.885714285714286	31.686572034589656
chr1	MROH7	54686257	54686448	1581	192	196291	6269	194710	6077	8.234375	32.04048050024683
chr1	MROH7	54709013	54709076	0	64	196291	6269	196291	6205	0.0	31.634327155519742
chr1	MROH7	54695695	54695855	51	161	196291	6269	196240	6108	0.3167701863354037	32.12835625409299
chr1	LEXM	54841615	54841702	0	88	0	1788	0	1700	0.0	0.0
chr1	DHCR24-DT	54887860	54887968	0	109	1122	691	1122	582	0.0	1.9278350515463918
chr1	PCSK9	55051342	55051453	0	112	1117	5316	1117	5204	0.0	0.2146425826287471
chr1	PCSK9	55059485	55059663	0	179	1117	5316	1117	5137	0.0	0.2174420868211018
chr1	AL603840.1	55978493	55978578	0	86	83	8505	83	8419	0.0	0.009858653046680129
chr1	AL603840.1	56019130	56019206	0	77	83	8505	83	8428	0.0	0.00984812529663028
chr1	DAB1-AS1	57864421	57864594	0	174	0	4284	0	4110	0.0	0.0
chr1	DAB1-AS1	57864706	57864824	0	119	0	4284	0	4165	0.0	0.0
chr1	DAB1-AS1	57876730	57876842	0	113	0	4284	0	4171	0.0	0.0
chr1	DAB1-AS1	57880118	57880269	0	152	0	4284	0	4132	0.0	0.0
chr1	LINC01135	58893544	58893717	0	174	0	5023	0	4849	0.0	0.0
chr1	LINC01135	58896256	58896385	0	130	0	5023	0	4893	0.0	0.0
chr1	LINC01358	59021126	59021286	0	161	6847	8361	6847	8200	0.0	0.835
chr1	LINC01358	59056839	59056861	0	23	6847	8361	6847	8338	0.0	0.8211801391220916
chr1	LINC01358	59062114	59062184	0	71	6847	8361	6847	8290	0.0	0.825934861278649
chr1	LINC01358	59088014	59088152	0	139	6847	8361	6847	8222	0.0	0.8327657504256872
chr1	LINC01358	59083427	59083520	0	94	6847	8361	6847	8267	0.0	0.8282327325511069
chr1	LINC01358	59056937	59057032	0	96	6847	8361	6847	8265	0.0	0.8284331518451301
chr1	LINC01358	59082567	59082708	0	142	6847	8361	6847	8219	0.0	0.8330697165105244
chr1	LINC01358	59082636	59082708	0	73	6847	8361	6847	8288	0.0	0.8261341698841699
chr1	LINC01358	59086402	59086596	0	195	6847	8361	6847	8166	0.0	0.8384766103355376
chr1	LINC01358	59082220	59082437	0	218	6847	8361	6847	8143	0.0	0.8408448974579393
chr1	FGGY	59318592	59318708	0	117	2624	12210	2624	12093	0.0	0.21698503266352434
chr1	FGGY	59321535	59321750	0	216	2624	12210	2624	11994	0.0	0.21877605469401368
chr1	FGGY	59339957	59340069	0	113	2624	12210	2624	12097	0.0	0.21691328428536
chr1	FGGY	59346246	59346398	663	153	2624	12210	1961	12057	4.333333333333333	0.16264410715766775
chr1	FGGY	59554123	59554227	48	105	2624	12210	2576	12105	0.45714285714285713	0.21280462618752582
chr1	FGGY	59674038	59674133	51	96	2624	12210	2573	12114	0.53125	0.21239887733201254
chr1	FGGY	59641279	59641351	0	73	2624	12210	2624	12137	0.0	0.21619840158193954
chr1	FGGY	59315719	59315736	0	18	2624	12210	2624	12192	0.0	0.2152230971128609
chr1	FGGY	59638227	59638375	0	149	2624	12210	2624	12061	0.0	0.21756073294088385
chr1	FGGY	59378748	59378837	0	90	2624	12210	2624	12120	0.0	0.2165016501650165
chr1	FGGY	59474101	59474202	0	102	2624	12210	2624	12108	0.0	0.21671622068054178
chr1	FGGY	59667282	59667403	0	122	2624	12210	2624	12088	0.0	0.21707478491065518
chr1	NFIA	61277519	61277585	0	67	214	32389	214	32322	0.0	0.0066208774209516735
chr1	NFIA	61383236	61383365	0	130	214	32389	214	32259	0.0	0.006633807619579032
chr1	NFIA	61426464	61426556	0	93	214	32389	214	32296	0.0	0.006626207579886054
chr1	NFIA	60973745	60973951	0	207	214	32389	214	32182	0.0	0.006649679945311043
chr1	NFIA	61443522	61443577	0	56	214	32389	214	32333	0.0	0.006618624934277673
chr1	NFIA	61372696	61372744	0	49	214	32389	214	32340	0.0	0.006617192331478046
chr1	NFIA	61385870	61385924	0	55	214	32389	214	32334	0.0	0.006618420238757964
chr1	NFIA	61399375	61399520	0	146	214	32389	214	32243	0.0	0.006637099525478398
chr1	NFIA	61439450	61439518	0	69	214	32389	214	32320	0.0	0.006621287128712871
chr1	PATJ	62100318	62100408	0	91	37923	10505	37923	10414	0.0	3.6415402342999807
chr1	PATJ	62108436	62108520	0	85	37923	10505	37923	10420	0.0	3.639443378119002
chr1	PATJ	62153357	62153481	1287	125	37923	10505	36636	10380	10.296	3.529479768786127
chr1	PATJ	61833357	61833377	0	21	37923	10505	37923	10484	0.0	3.6172262495230827
chr1	ALG6	63396512	63396597	0	86	51	5100	51	5014	0.0	0.010171519744714799
chr1	ALG6	63411681	63411806	0	126	51	5100	51	4974	0.0	0.010253317249698432
chr1	PGM1	63654989	63655111	0	123	32	4092	32	3969	0.0	0.008062484252960444
chr1	UBE2U	64232560	64232649	0	90	0	1838	0	1748	0.0	0.0
chr1	CACHD1	64632598	64632743	0	146	576	7052	576	6906	0.0	0.08340573414422242
chr1	RAVER2	64807205	64807474	0	270	357	6082	357	5812	0.0	0.06142463867859601
chr1	DNAJC6	65345610	65345723	102	114	126522	6981	126420	6867	0.8947368421052632	18.40978593272171
chr1	LEPROT	65429861	65430048	0	188	19203	5243	19203	5055	0.0	3.798813056379822
chr1	LEPROT	65429930	65430048	0	119	19203	5243	19203	5124	0.0	3.747658079625293
chr1	LEPROT	65421327	65421459	522	133	19203	5243	18681	5110	3.924812030075188	3.6557729941291583
chr1	SGIP1	66634079	66634163	0	85	3876	13353	3876	13268	0.0	0.29213144407597225
chr1	SGIP1	66684106	66684187	0	82	3876	13353	3876	13271	0.0	0.29206540577198403
chr1	SGIP1	66635943	66636015	0	73	3876	13353	3876	13280	0.0	0.29186746987951806
chr1	SGIP1	66681868	66682369	0	502	3876	13353	3876	12851	0.0	0.3016107695899152
chr1	MIER1	66928889	66928963	0	75	51	6542	51	6467	0.0	0.007886191433431266
chr1	MIER1	66946149	66946295	0	147	51	6542	51	6395	0.0	0.007974980453479281
chr1	MIER1	66928886	66928963	0	78	51	6542	51	6464	0.0	0.007889851485148515
chr1	IL12RB2	67390028	67390128	145	101	10151	6084	10006	5983	1.4356435643564356	1.6724051479191042
chr1	IL12RB2	67313912	67314000	0	89	10151	6084	10151	5995	0.0	1.6932443703085904
chr1	IL12RB2	67386578	67386669	0	92	10151	6084	10151	5992	0.0	1.6940921228304406
chr1	LINC01702	67527377	67527437	0	61	0	953	0	892	0.0	0.0
chr1	LINC01702	67529652	67529749	0	98	0	953	0	855	0.0	0.0
chr1	LINC01702	67530314	67530378	0	65	0	953	0	888	0.0	0.0
chr1	LINC01702	67529618	67529749	0	132	0	953	0	821	0.0	0.0
chr1	LINC01702	67530228	67530378	0	151	0	953	0	802	0.0	0.0
chr1	GADD45A	67686349	67686587	0	239	0	1706	0	1467	0.0	0.0
chr1	GADD45A	67686024	67686126	0	103	0	1706	0	1603	0.0	0.0
chr1	GADD45A	67686403	67686587	0	185	0	1706	0	1521	0.0	0.0
chr1	GNG12-AS1	68138296	68138450	0	155	0	3481	0	3326	0.0	0.0
chr1	LINC01707	69214383	69214559	0	177	10	6166	10	5989	0.0	0.0016697278343629988
chr1	LINC01707	69085179	69085298	0	120	10	6166	10	6046	0.0	0.0016539861065167053
chr1	LRRC7	70043953	70044094	0	142	51	14308	51	14166	0.0	0.003600169419737399
chr1	LRRC7	69716141	69716218	0	78	51	14308	51	14230	0.0	0.003583977512297962
chr1	LRRC7	70130127	70130256	0	130	51	14308	51	14178	0.0	0.0035971223021582736
chr1	LRRC7	70132202	70132288	0	87	51	14308	51	14221	0.0	0.003586245692989241
chr1	LRRC7	70140542	70140614	0	73	51	14308	51	14235	0.0	0.003582718651211802
chr1	LRRC7	70140348	70140614	0	267	51	14308	51	14041	0.0	0.0036322199273556015
chr1	LRRC7	70147026	70147077	0	52	51	14308	51	14256	0.0	0.0035774410774410776
chr1	SRSF11	70231858	70231975	0	118	153	6054	153	5936	0.0	0.025774932614555258
chr1	SRSF11	70231094	70231203	0	110	153	6054	153	5944	0.0	0.025740242261103635
chr1	HHLA3	70366932	70366984	0	53	10965	1228	10965	1175	0.0	9.331914893617022
chr1	HHLA3	70366145	70366328	0	184	10965	1228	10965	1044	0.0	10.50287356321839
chr1	CTH	70424284	70424416	0	133	0	2426	0	2293	0.0	0.0
chr1	CTH	70417936	70418032	0	97	0	2426	0	2329	0.0	0.0
chr1	LINC01788	70777529	70777695	130	167	114567	2464	114437	2297	0.7784431137724551	49.820200261210275
chr1	ZRANB2-AS2	71223056	71223114	0	59	47	14846	47	14787	0.0	0.0031784675728680598
chr1	ZRANB2-AS2	71365037	71365199	0	163	47	14846	47	14683	0.0	0.003200980726009671
chr1	ZRANB2-AS2	71193674	71193728	0	55	47	14846	47	14791	0.0	0.003177608004867825
chr1	ZRANB2-AS2	71304358	71304415	0	58	47	14846	47	14788	0.0	0.003178252637273465
chr1	ZRANB2-AS2	71402495	71402571	0	77	47	14846	47	14769	0.0	0.0031823413907508973
chr1	ZRANB2-AS2	71093132	71093251	0	120	47	14846	47	14726	0.0	0.0031916338449001764
chr1	ZRANB2-AS2	71368054	71368088	0	35	47	14846	47	14811	0.0	0.003173317129160759
chr1	ZRANB2-AS2	71184346	71184571	0	226	47	14846	47	14620	0.0	0.0032147742818057455
chr1	ZRANB2-AS2	71198866	71198991	0	126	47	14846	47	14720	0.0	0.003192934782608696
chr1	ZRANB2-AS2	71202347	71202422	29	76	47	14846	18	14770	0.3815789473684211	0.0012186865267433988
chr1	ZRANB2-AS2	71208180	71208296	0	117	47	14846	47	14729	0.0	0.0031909837735080455
chr1	ZRANB2-AS2	71268434	71268478	0	45	47	14846	47	14801	0.0	0.0031754611174920613
chr1	ZRANB2-AS2	71202034	71202056	0	23	47	14846	47	14823	0.0	0.0031707481616406936
chr1	ZRANB2-AS2	71237129	71237195	0	67	47	14846	47	14779	0.0	0.0031801881047432167
chr1	ZRANB2-AS2	71402098	71402571	0	474	47	14846	47	14372	0.0	0.0032702477038686335
chr1	ZRANB2-AS2	71280525	71280615	0	91	47	14846	47	14755	0.0	0.003185360894611996
chr1	ZRANB2-AS2	71461560	71461817	0	258	47	14846	47	14588	0.0	0.0032218261584864272
chr1	ZRANB2-AS2	71477376	71477453	0	78	47	14846	47	14768	0.0	0.0031825568797399784
chr1	AL513166.1	72462192	72462304	0	113	0	6431	0	6318	0.0	0.0
chr1	AL513166.1	72583014	72583192	0	179	0	6431	0	6252	0.0	0.0
chr1	LINC01360	73307167	73307363	0	197	51	5538	51	5341	0.0	0.009548773637895525
chr1	LINC01360	73310852	73310990	0	139	51	5538	51	5399	0.0	0.009446193739581403
chr1	FPGT	74200691	74200818	0	128	153	3573	153	3445	0.0	0.0444121915820029
chr1	FPGT-TNNI3K	74240807	74240835	0	29	0	9928	0	9899	0.0	0.0
chr1	FPGT	74204390	74204456	0	67	153	3573	153	3506	0.0	0.043639475185396466
chr1	FPGT-TNNI3K	74260693	74260754	0	62	0	9928	0	9866	0.0	0.0
chr1	TYW3	74738689	74738788	0	100	0	4625	0	4525	0.0	0.0
chr1	TYW3	74734117	74734182	0	66	0	4625	0	4559	0.0	0.0
chr1	ACADM	75733527	75733628	0	102	30	4672	30	4570	0.0	0.006564551422319475
chr1	ACADM	75728400	75728488	6	89	30	4672	24	4583	0.06741573033707865	0.005236744490508401
chr1	ACADM	75732643	75732741	0	99	30	4672	30	4573	0.0	0.0065602449158101905
chr1	ACADM	75733050	75733149	0	100	30	4672	30	4572	0.0	0.006561679790026247
chr1	ACADM	75734790	75734871	0	82	30	4672	30	4590	0.0	0.006535947712418301
chr1	ACADM	75754932	75755089	0	158	30	4672	30	4514	0.0	0.00664599025254763
chr1	ACADM	75728388	75728488	30	101	30	4672	0	4571	0.297029702970297	0.0
chr1	RABGGTB	75789158	75789356	0	199	0	4958	0	4759	0.0	0.0
chr1	RABGGTB	75789951	75790057	0	107	0	4958	0	4851	0.0	0.0
chr1	AC092813.1	75935924	75936154	0	231	0	2089	0	1858	0.0	0.0
chr1	AC092813.1	75972219	75972265	0	47	0	2089	0	2042	0.0	0.0
chr1	AC092813.1	76013259	76013330	0	72	0	2089	0	2017	0.0	0.0
chr1	AC092813.1	76010739	76010853	0	115	0	2089	0	1974	0.0	0.0
chr1	AC092813.1	75935950	75936154	0	205	0	2089	0	1884	0.0	0.0
chr1	AC092813.1	75983444	75983560	0	117	0	2089	0	1972	0.0	0.0
chr1	AC092813.1	75997414	75997566	0	153	0	2089	0	1936	0.0	0.0
chr1	AC092813.1	76010763	76010853	0	91	0	2089	0	1998	0.0	0.0
chr1	AC092813.1	75982696	75982775	0	80	0	2089	0	2009	0.0	0.0
chr1	NEXN	77925187	77925229	0	43	106	4215	106	4172	0.0	0.025407478427612654
chr1	NEXN	77917565	77917757	102	193	106	4215	4	4022	0.5284974093264249	0.000994530084535057
chr1	DNAJB4	78013050	78013619	0	570	746	3709	746	3139	0.0	0.23765530423701817
chr1	PTGFR	78532212	78532353	0	142	2258	5771	2258	5629	0.0	0.40113696926629955
chr1	PTGFR	78497873	78497944	0	72	2258	5771	2258	5699	0.0	0.39620986137918934
chr1	IFI44L	78627905	78628393	51	489	102	7676	51	7187	0.10429447852760736	0.0070961458188395716
chr1	IFI44	78660553	78660654	0	102	131	1958	131	1856	0.0	0.07058189655172414
chr1	IFI44	78650185	78650652	0	468	131	1958	131	1490	0.0	0.08791946308724832
chr1	IFI44	78650540	78650652	0	113	131	1958	131	1845	0.0	0.07100271002710028
chr1	IFI44	78662703	78662878	0	176	131	1958	131	1782	0.0	0.07351290684624018
chr1	LINC01781	80540588	80540636	0	49	0	968	0	919	0.0	0.0
chr1	ADGRL2	81580875	81580980	0	106	10464	19025	10464	18919	0.0	0.5530947724509752
chr1	ADGRL2	81942033	81942045	0	13	10464	19025	10464	19012	0.0	0.5503892278560909
chr1	ADGRL2	81986900	81987029	0	130	10464	19025	10464	18895	0.0	0.5537973008732469
chr1	ADGRL2	81980794	81980839	0	46	10464	19025	10464	18979	0.0	0.551346224774751
chr1	ADGRL2	81952986	81953025	0	40	10464	19025	10464	18985	0.0	0.5511719778772716
chr1	ADGRL2	81985258	81985355	0	98	10464	19025	10464	18927	0.0	0.5528609922333175
chr1	ADGRL2	81981123	81981150	0	28	10464	19025	10464	18997	0.0	0.5508238142864663
chr1	ADGRL2	81987259	81987341	0	83	10464	19025	10464	18942	0.0	0.552423186569528
chr1	ADGRL2	81989656	81989695	0	40	10464	19025	10464	18985	0.0	0.5511719778772716
chr1	ADGRL2	81989656	81989709	0	54	10464	19025	10464	18971	0.0	0.5515787254230141
chr1	ADGRL2	81941192	81942045	0	854	10464	19025	10464	18171	0.0	0.5758626382697705
chr1	ADGRL2	81811842	81811923	0	82	10464	19025	10464	18943	0.0	0.5523940241777966
chr1	ADGRL2	81987288	81987341	0	54	10464	19025	10464	18971	0.0	0.5515787254230141
chr1	ADGRL2	81987868	81987886	0	19	10464	19025	10464	19006	0.0	0.5505629801115437
chr1	LINC01362	82991859	82991980	0	122	0	2150	0	2028	0.0	0.0
chr1	LINC01362	82952671	82952728	0	58	0	2150	0	2092	0.0	0.0
chr1	LINC01362	82952671	82952837	0	167	0	2150	0	1983	0.0	0.0
chr1	PRKACB	84184036	84184135	0	100	0	6412	0	6312	0.0	0.0
chr1	PRKACB	84173328	84173352	0	25	0	6412	0	6387	0.0	0.0
chr1	PRKACB	84175798	84175807	0	10	0	6412	0	6402	0.0	0.0
chr1	PRKACB	84175032	84175056	0	25	0	6412	0	6387	0.0	0.0
chr1	SPATA1	84545633	84545759	0	127	1724	4298	1724	4171	0.0	0.4133301366578758
chr1	SPATA1	84550431	84550530	0	100	1724	4298	1724	4198	0.0	0.4106717484516436
chr1	DNAI3	85073053	85073092	0	40	7343	3947	7343	3907	0.0	1.8794471461479396
chr1	DNAI3	85090115	85090232	0	118	7343	3947	7343	3829	0.0	1.9177330895795246
chr1	CLCA3P	86647162	86647222	26	61	33	3453	7	3392	0.4262295081967213	0.002063679245283019
chr1	SH3GLB1	86715723	86715865	0	143	0	6893	0	6750	0.0	0.0
chr1	SH3GLB1	86728402	86728489	0	88	0	6893	0	6805	0.0	0.0
chr1	LINC01140	87165388	87165981	5678	594	5678	6060	0	5466	9.558922558922559	0.0
chr1	LINC01140	87132663	87132863	0	201	5678	6060	5678	5859	0.0	0.9691073562041304
chr1	LINC01140	87132611	87132912	0	302	5678	6060	5678	5758	0.0	0.9861062869051754
chr1	LINC02801	87216932	87217000	0	69	18133	4934	18133	4865	0.0	3.727235354573484
chr1	PKN2	88784638	88784824	0	187	6	6701	6	6514	0.0	0.00092109303039607
chr1	PKN2	88804390	88804534	0	145	6	6701	6	6556	0.0	0.0009151921903599756
chr1	LRRC8B	89588312	89588368	0	57	7306	8278	7306	8221	0.0	0.8886996715728014
chr1	LRRC8B	89526961	89526986	0	26	7306	8278	7306	8252	0.0	0.8853611245758604
chr1	LRRC8B	89572473	89572612	765	140	7306	8278	6541	8138	5.464285714285714	0.8037601376259523
chr1	LRRC8D	89929807	89929878	0	72	51	4860	51	4788	0.0	0.010651629072681704
chr1	CDC7	91513947	91514043	0	97	43	3612	43	3515	0.0	0.012233285917496443
chr1	BRDT	91949889	91949958	0	70	29498	4344	29498	4274	0.0	6.901731399157698
chr1	BRDT	91964626	91964764	0	139	29498	4344	29498	4205	0.0	7.014982164090369
chr1	BRDT	91949637	91949682	20	46	29498	4344	29478	4298	0.43478260869565216	6.858538855281526
chr1	BRDT	91950715	91950811	0	97	29498	4344	29498	4247	0.0	6.945608664939957
chr1	BRDT	91949899	91950474	0	576	29498	4344	29498	3768	0.0	7.828556263269639
chr1	BRDT	91962717	91962946	0	230	29498	4344	29498	4114	0.0	7.170150704910063
chr1	BRDT	91950107	91950474	0	368	29498	4344	29498	3976	0.0	7.419014084507042
chr1	BRDT	91957528	91957600	0	73	29498	4344	29498	4271	0.0	6.90657925544369
chr1	BRDT	91950304	91950474	0	171	29498	4344	29498	4173	0.0	7.068775461298825
chr1	BTBD8	92141114	92141211	0	98	8403	8361	8403	8263	0.0	1.0169429989108072
chr1	BTBD8	92175062	92175249	0	188	8403	8361	8403	8173	0.0	1.0281414413312124
chr1	C1ORF146	92240705	92240936	0	232	0	1093	0	861	0.0	0.0
chr1	RPAP2	92301475	92301590	0	116	750	17061	750	16945	0.0	0.04426084390675716
chr1	RPL5	92833388	92833458	768	71	3975	2191	3207	2120	10.816901408450704	1.5127358490566039
chr1	RPL5	92833795	92833949	255	155	3975	2191	3720	2036	1.6451612903225807	1.8271119842829076
chr1	MTF2	93120548	93120672	0	125	1241	5924	1241	5799	0.0	0.21400241420934643
chr1	MTF2	93129277	93129448	0	172	1241	5924	1241	5752	0.0	0.2157510431154381
chr1	MTF2	93127231	93127299	0	69	1241	5924	1241	5855	0.0	0.21195559350982066
chr1	CCDC18	93183977	93184146	0	170	1481	5355	1481	5185	0.0	0.28563162970106076
chr1	CCDC18	93210801	93210926	0	126	1481	5355	1481	5229	0.0	0.2832281506980302
chr1	CCDC18	93217737	93217869	0	133	1481	5355	1481	5222	0.0	0.2836078130984297
chr1	CCDC18	93236247	93236390	16	144	1481	5355	1465	5211	0.1111111111111111	0.2811360583381309
chr1	CCDC18	93270346	93270814	0	469	1481	5355	1481	4886	0.0	0.30311092918542776
chr1	ARHGAP29-AS1	94250378	94250544	0	167	33571	3779	33571	3612	0.0	9.294296788482836
chr1	ARHGAP29-AS1	94257960	94258029	11	70	33571	3779	33560	3709	0.15714285714285714	9.048260986788891
chr1	SLC44A3	94892280	94892517	0	238	0	2888	0	2650	0.0	0.0
chr1	SLC44A3	94820948	94821056	0	109	0	2888	0	2779	0.0	0.0
chr1	SLC44A3	94825832	94825942	0	111	0	2888	0	2777	0.0	0.0
chr1	AC105942.1	94961316	94961433	51	118	909	2318	858	2200	0.4322033898305085	0.39
chr1	AC105942.1	94939828	94939925	0	98	909	2318	909	2220	0.0	0.40945945945945944
chr1	AC105942.1	94930801	94930845	0	45	909	2318	909	2273	0.0	0.39991201055873293
chr1	RWDD3	95244210	95244715	0	506	0	1781	0	1275	0.0	0.0
chr1	LINC02607	95512519	95512622	51	104	102	6933	51	6829	0.49038461538461536	0.007468150534485283
chr1	LINC02790	95996120	95996194	0	75	0	2786	0	2711	0.0	0.0
chr1	LINC02790	96006192	96006421	0	230	0	2786	0	2556	0.0	0.0
chr1	LINC02790	96002100	96002212	0	113	0	2786	0	2673	0.0	0.0
chr1	LINC02790	96006169	96006421	0	253	0	2786	0	2533	0.0	0.0
chr1	LINC02790	96003362	96003444	0	83	0	2786	0	2703	0.0	0.0
chr1	LINC02790	96005756	96005867	0	112	0	2786	0	2674	0.0	0.0
chr1	LINC02790	96006196	96006421	0	226	0	2786	0	2560	0.0	0.0
chr1	LINC02790	96006362	96006421	0	60	0	2786	0	2726	0.0	0.0
chr1	LINC02790	96021297	96021396	0	100	0	2786	0	2686	0.0	0.0
chr1	PTBP2	96806418	96806452	0	35	357	14696	357	14661	0.0	0.024350317167996727
chr1	PTBP2	96813028	96813106	0	79	357	14696	357	14617	0.0	0.024423616337141685
chr1	PTBP2	96751424	96751500	0	77	357	14696	357	14619	0.0	0.02442027498460907
chr1	SNX7	98738236	98738389	0	154	1087	2079	1087	1925	0.0	0.5646753246753247
chr1	SNX7	98691534	98691699	0	166	1087	2079	1087	1913	0.0	0.5682174594877156
chr1	SNX7	98662696	98662816	1036	121	1087	2079	51	1958	8.561983471074381	0.026046986721144024
chr1	AL445433.2	99144035	99144130	0	96	1263	5989	1263	5893	0.0	0.21432207704055659
chr1	AL445433.2	99008625	99008735	141	111	1263	5989	1122	5878	1.2702702702702702	0.19088125212657367
chr1	PLPPR4	99301723	99301897	0	175	5406	5547	5406	5372	0.0	1.0063291139240507
chr1	AGL	99852560	99852703	0	144	255	8193	255	8049	0.0	0.03168095415579575
chr1	SLC35A3	99999260	99999415	0	156	306	15955	306	15799	0.0	0.019368314450281664
chr1	SLC35A3	100007033	100007156	0	124	306	15955	306	15831	0.0	0.019329164297896533
chr1	SLC35A3	99974970	99975069	0	100	306	15955	306	15855	0.0	0.019299905392620626
chr1	SLC35A3	100017681	100017815	0	135	306	15955	306	15820	0.0	0.019342604298356512
chr1	SLC35A3	100015301	100015420	0	120	306	15955	306	15835	0.0	0.019324281654562677
chr1	AC118553.2	100043072	100043229	0	158	51	5784	51	5626	0.0	0.009065055101315321
chr1	AC118553.2	100069613	100069685	0	73	51	5784	51	5711	0.0	0.008930134827525827
chr1	SLC35A3	100009287	100009323	0	37	306	15955	306	15918	0.0	0.019223520542781758
chr1	TRMT13	100140181	100140251	0	71	1644	4144	1644	4073	0.0	0.40363368524429166
chr1	RTCA	100267499	100267538	0	40	0	3041	0	3001	0.0	0.0
chr1	CDC14A	100353761	100353852	0	92	20863	6533	20863	6441	0.0	3.2390933084924702
chr1	CDC14A	100455404	100455492	0	89	20863	6533	20863	6444	0.0	3.237585350713842
chr1	CDC14A	100485825	100485901	869	77	20863	6533	19994	6456	11.285714285714286	3.0969640644361833
chr1	CDC14A	100383465	100383640	1419	176	20863	6533	19444	6357	8.0625	3.05867547585339
chr1	CDC14A	100480949	100481082	5396	134	20863	6533	15467	6399	40.26865671641791	2.4170964213158306
chr1	CDC14A	100504813	100504937	0	125	20863	6533	20863	6408	0.0	3.2557740324594255
chr1	VCAM1	100729106	100729382	798	277	69287	3110	68489	2833	2.88086642599278	24.175432403812213
chr1	VCAM1	100731197	100731518	157	322	69287	3110	69130	2788	0.48757763975155277	24.79555236728838
chr1	AC093157.1	101075394	101075716	0	323	0	7130	0	6807	0.0	0.0
chr1	AC093157.1	101072659	101072830	0	172	0	7130	0	6958	0.0	0.0
chr1	AC093157.1	101080886	101080998	0	113	0	7130	0	7017	0.0	0.0
chr1	AC093157.1	101080388	101080613	0	226	0	7130	0	6904	0.0	0.0
chr1	AC093157.1	101083460	101083574	0	115	0	7130	0	7015	0.0	0.0
chr1	AC093157.1	101077362	101077508	0	147	0	7130	0	6983	0.0	0.0
chr1	AC093157.1	101085051	101085157	0	107	0	7130	0	7023	0.0	0.0
chr1	LINC01709	101646253	101646352	0	100	0	2787	0	2687	0.0	0.0
chr1	LINC01709	101733329	101733556	0	228	0	2787	0	2559	0.0	0.0
chr1	LINC01709	101786604	101786716	0	113	0	2787	0	2674	0.0	0.0
chr1	LINC01709	101737223	101737357	0	135	0	2787	0	2652	0.0	0.0
chr1	LINC01709	101729270	101729567	0	298	0	2787	0	2489	0.0	0.0
chr1	LINC01709	101785592	101785729	0	138	0	2787	0	2649	0.0	0.0
chr1	LINC01709	101641782	101641849	0	68	0	2787	0	2719	0.0	0.0
chr1	LINC01709	101784281	101784803	0	523	0	2787	0	2264	0.0	0.0
chr1	LINC01709	101730940	101731053	0	114	0	2787	0	2673	0.0	0.0
chr1	RNPC3	103526066	103526262	0	197	51	5469	51	5272	0.0	0.009673748103186646
chr1	AMY2B	103565434	103565594	0	161	0	4634	0	4473	0.0	0.0
chr1	AMY2B	103577489	103577608	0	120	0	4634	0	4514	0.0	0.0
chr1	AMY2A	103619553	103619784	0	232	0	1909	0	1677	0.0	0.0
chr1	AC092506.1	104092007	104092204	0	198	0	3126	0	2928	0.0	0.0
chr1	AL355306.2	106047625	106047774	0	150	0	8939	0	8789	0.0	0.0
chr1	AL355306.2	106041831	106041911	0	81	0	8939	0	8858	0.0	0.0
chr1	AL355306.2	105961469	105961523	0	55	0	8939	0	8884	0.0	0.0
chr1	AL355306.2	106041831	106042040	0	210	0	8939	0	8729	0.0	0.0
chr1	AL355306.2	106082964	106083086	0	123	0	8939	0	8816	0.0	0.0
chr1	NTNG1	107436664	107436799	0	136	0	9155	0	9019	0.0	0.0
chr1	NTNG1	107418579	107418645	0	67	0	9155	0	9088	0.0	0.0
chr1	NTNG1	107430749	107430917	0	169	0	9155	0	8986	0.0	0.0
chr1	NTNG1	107421083	107421143	0	61	0	9155	0	9094	0.0	0.0
chr1	LINC02785	108052310	108052461	0	152	0	4139	0	3987	0.0	0.0
chr1	NBPF6	108457247	108457334	0	88	64	2602	64	2514	0.0	0.02545743834526651
chr1	PRPF38B	108693589	108693642	0	54	158666	6962	158666	6908	0.0	22.96844238563984
chr1	FNDC7	108737494	108737524	0	31	78115	3103	78115	3072	0.0	25.428059895833332
chr1	GPSM2	108885274	108885578	0	305	12506	18055	12506	17750	0.0	0.7045633802816902
chr1	GPSM2	108901789	108901945	51	157	12506	18055	12455	17898	0.3248407643312102	0.6958878086937088
chr1	GPSM2	108914337	108914408	255	72	12506	18055	12251	17983	3.5416666666666665	0.6812545181560362
chr1	GPSM2	108918612	108918789	747	178	12506	18055	11759	17877	4.196629213483146	0.6577725569167087
chr1	GPSM2	108922416	108922576	357	161	12506	18055	12149	17894	2.217391304347826	0.6789426623449201
chr1	GPSM2	108923999	108924214	0	216	12506	18055	12506	17839	0.0	0.7010482650372779
chr1	GPSM2	108882475	108882625	0	151	12506	18055	12506	17904	0.0	0.698503127792672
chr1	GPSM2	108885506	108885578	0	73	12506	18055	12506	17982	0.0	0.6954732510288066
chr1	GPSM2	108882579	108882625	0	47	12506	18055	12506	18008	0.0	0.6944691248334074
chr1	GPSM2	108918612	108919150	1968	539	12506	18055	10538	17516	3.6512059369202228	0.6016213747430921
chr1	GPSM2	108886078	108886172	0	95	12506	18055	12506	17960	0.0	0.696325167037862
chr1	GPSM2	108877530	108877774	0	245	12506	18055	12506	17810	0.0	0.7021897810218978
chr1	ELAPOR1	109161893	109162014	0	122	265817	9175	265817	9053	0.0	29.3623108361869
chr1	ELAPOR1	109173687	109173837	51	151	265817	9175	265766	9024	0.33774834437086093	29.4510195035461
chr1	ELAPOR1	109185044	109185133	0	90	265817	9175	265817	9085	0.0	29.258888277380297
chr1	ELAPOR1	109201318	109201417	178	100	265817	9175	265639	9075	1.78	29.271515151515153
chr1	SARS1	109236804	109236870	0	67	34084	3445	34084	3378	0.0	10.089994079336886
chr1	ATXN7L2	109485331	109485509	5790	179	131013	4493	125223	4314	32.3463687150838	29.02712100139082
chr1	CYB561D1	109495142	109495180	8	39	83095	5618	83087	5579	0.20512820512820512	14.892812331959133
chr1	CYB561D1	109494519	109494623	0	105	83095	5618	83095	5513	0.0	15.072555777253763
chr1	AMPD2	109625302	109625433	0	132	46677	8217	46677	8085	0.0	5.773283858998145
chr1	AMPD2	109628642	109628806	204	165	46677	8217	46473	8052	1.2363636363636363	5.771609538002981
chr1	AMPD2	109629799	109629916	204	118	46677	8217	46473	8099	1.728813559322034	5.738115816767502
chr1	AMPD2	109620913	109621266	840	354	46677	8217	45837	7863	2.3728813559322033	5.829454406714994
chr1	AMPD2	109629795	109629916	204	122	46677	8217	46473	8095	1.6721311475409837	5.74095120444719
chr1	AMPD2	109630682	109630793	2533	112	46677	8217	44144	8105	22.616071428571427	5.446514497223935
chr1	AMPD2	109623978	109624089	14	112	46677	8217	46663	8105	0.125	5.757310302282542
chr1	AMPD2	109622184	109622353	0	170	46677	8217	46677	8047	0.0	5.800546787622716
chr1	GSTM4	109657589	109657671	0	83	1224	3643	1224	3560	0.0	0.3438202247191011
chr1	GSTM4	109657532	109657671	0	140	1224	3643	1224	3503	0.0	0.34941478732514986
chr1	GSTM2	109671472	109671583	0	112	912	5816	912	5704	0.0	0.15988779803646563
chr1	GSTM4	109659789	109659959	0	171	1224	3643	1224	3472	0.0	0.35253456221198154
chr1	GSTM1	109689047	109689129	0	83	0	2094	0	2011	0.0	0.0
chr1	GSTM1	109688169	109688245	0	77	0	2094	0	2017	0.0	0.0
chr1	GSTM1	109690453	109690564	0	112	0	2094	0	1982	0.0	0.0
chr1	GSTM1	109688990	109689129	0	140	0	2094	0	1954	0.0	0.0
chr1	GSTM1	109690270	109690366	0	97	0	2094	0	1997	0.0	0.0
chr1	GSTM1	109688116	109688245	0	130	0	2094	0	1964	0.0	0.0
chr1	GSTM5	109716001	109716090	0	90	0	3359	0	3269	0.0	0.0
chr1	CSF1	109910812	109911062	0	251	1281	5251	1281	5000	0.0	0.2562
chr1	CSF1	109914258	109914381	0	124	1281	5251	1281	5127	0.0	0.24985371562317144
chr1	CSF1	109923165	109923711	0	547	1281	5251	1281	4704	0.0	0.27232142857142855
chr1	STRIP1	110039823	110039937	5263	115	202665	6781	197402	6666	45.76521739130435	29.613261326132612
chr1	KCNC4	110232220	110232597	459	378	207559	22579	207100	22201	1.2142857142857142	9.328408630241881
chr1	RBM15	110345538	110345649	0	112	3575	3757	3575	3645	0.0	0.9807956104252401
chr1	LAMTOR5-AS1	110414151	110414231	0	81	1030	11148	1030	11067	0.0	0.09306948585885967
chr1	LAMTOR5-AS1	110417488	110417640	0	153	1030	11148	1030	10995	0.0	0.09367894497498863
chr1	LAMTOR5-AS1	110413320	110413410	51	91	1030	11148	979	11057	0.5604395604395604	0.08854119562268246
chr1	LAMTOR5-AS1	110430108	110431361	0	1254	1030	11148	1030	9894	0.0	0.10410349706893067
chr1	LAMTOR5-AS1	110409084	110409158	0	75	1030	11148	1030	11073	0.0	0.0930190553598844
chr1	LAMTOR5-AS1	110408921	110409158	0	238	1030	11148	1030	10910	0.0	0.09440879926672777
chr1	LAMTOR5-AS1	110411444	110411521	0	78	1030	11148	1030	11070	0.0	0.0930442637759711
chr1	LAMTOR5-AS1	110413038	110413094	0	57	1030	11148	1030	11091	0.0	0.09286809124515373
chr1	LAMTOR5-AS1	110416008	110416188	0	181	1030	11148	1030	10967	0.0	0.09391811799033464
chr1	LAMTOR5-AS1	110417818	110417916	0	99	1030	11148	1030	11049	0.0	0.09322110598244185
chr1	LAMTOR5-AS1	110417793	110417916	0	124	1030	11148	1030	11024	0.0	0.09343251088534107
chr1	LAMTOR5-AS1	110421634	110421716	0	83	1030	11148	1030	11065	0.0	0.09308630817894262
chr1	LAMTOR5-AS1	110431276	110431361	0	86	1030	11148	1030	11062	0.0	0.09311155306454529
chr1	AL358215.3	110484475	110484621	0	147	0	1194	0	1047	0.0	0.0
chr1	CYMP	110489426	110489571	0	146	29	1272	29	1126	0.0	0.02575488454706927
chr1	CHI3L2	111229851	111229881	0	31	0	3296	0	3265	0.0	0.0
chr1	CHI3L2	111231237	111231294	0	58	0	3296	0	3238	0.0	0.0
chr1	CHI3L2	111238749	111238932	0	184	0	3296	0	3112	0.0	0.0
chr1	CHI3L2	111242226	111242366	0	141	0	3296	0	3155	0.0	0.0
chr1	CHIAP2	111280523	111280553	0	31	0	2199	0	2168	0.0	0.0
chr1	CHIAP2	111284064	111284249	0	186	0	2199	0	2013	0.0	0.0
chr1	CHIA	111312189	111312391	0	203	0	3684	0	3481	0.0	0.0
chr1	CHIA	111315269	111315435	0	167	0	3684	0	3517	0.0	0.0
chr1	CHIA	111315733	111315872	0	140	0	3684	0	3544	0.0	0.0
chr1	PIFO	111347673	111347772	0	100	204	3954	204	3854	0.0	0.052932018681888945
chr1	ATP5PB	111454210	111454356	0	147	505	3146	505	2999	0.0	0.1683894631543848
chr1	ATP5PB	111449836	111449873	76	38	505	3146	429	3108	2.0	0.13803088803088803
chr1	RAP1A	111627469	111627563	0	95	59597	5543	59597	5448	0.0	10.93924375917768
chr1	INKA2-AS1	111744374	111744529	0	156	0	2417	0	2261	0.0	0.0
chr1	DDX20	111759399	111759568	0	170	102	4387	102	4217	0.0	0.024187811240218165
chr1	WNT2B	112491010	112491081	0	72	51	12381	51	12309	0.0	0.004143309773336583
chr1	LINC01357	112876939	112876984	0	46	0	797	0	751	0.0	0.0
chr1	SLC16A1-AS1	113033674	113033838	0	165	92741	12689	92741	12524	0.0	7.405062280421591
chr1	MAGI3	113618531	113618606	0	76	11764	8438	11764	8362	0.0	1.4068404687873715
chr1	MAGI3	113682211	113682302	0	92	11764	8438	11764	8346	0.0	1.409537502995447
chr1	DCLRE1B	113906995	113907161	0	167	102	3872	102	3705	0.0	0.027530364372469637
chr1	DCLRE1B	113908008	113908191	0	184	102	3872	102	3688	0.0	0.027657266811279828
chr1	HIPK1	113963386	113963521	153	136	1523	9171	1370	9035	1.125	0.15163254012174876
chr1	OLFML3	113979974	113980126	0	153	102	2495	102	2342	0.0	0.04355251921434671
chr1	SYCP1	114913974	114914045	0	72	1182	4313	1182	4241	0.0	0.2787078519217166
chr1	SYCP1	114947245	114947320	42	76	1182	4313	1140	4237	0.5526315789473685	0.26905829596412556
chr1	SYCP1	114984724	114984868	0	145	1182	4313	1182	4168	0.0	0.28358925143953934
chr1	TTF2	117097350	117097433	0	84	20308	9739	20308	9655	0.0	2.1033661315380634
chr1	WARS2-AS1	119146952	119147069	0	118	102	8221	102	8103	0.0	0.012587930396149574
chr1	WARS2-AS1	119141746	119141813	0	68	102	8221	102	8153	0.0	0.012510732245799093
chr1	HAO2	119380503	119380723	0	221	0	1886	0	1665	0.0	0.0
chr1	PHGDH	119723375	119723441	1821	67	31547	6218	29726	6151	27.17910447761194	4.8327101284344005
chr1	PHGDH	119741766	119741897	0	132	31547	6218	31547	6086	0.0	5.183535984226093
chr1	PHGDH	119741766	119741876	0	111	31547	6218	31547	6107	0.0	5.165711478631079
chr1	PHGDH	119724318	119724469	4990	152	31547	6218	26557	6066	32.828947368421055	4.37800857237059
chr1	PHGDH	119740385	119740518	0	134	31547	6218	31547	6084	0.0	5.1852399737015125
chr1	PHGDH	119742806	119743044	0	239	31547	6218	31547	5979	0.0	5.276300384679712
chr1	PHGDH	119729508	119729633	0	126	31547	6218	31547	6092	0.0	5.178430728824688
chr1	PHGDH	119724784	119724875	4593	92	31547	6218	26954	6126	49.92391304347826	4.399934704538035
chr1	PHGDH	119724784	119724957	8029	174	31547	6218	23518	6044	46.14367816091954	3.8911317008603574
chr1	PHGDH	119724784	119724967	8169	184	31547	6218	23378	6034	44.39673913043478	3.8743785217103084
chr1	NBPF26	120805555	120805765	37	211	35337	6817	35300	6606	0.17535545023696683	5.343627005752347
chr1	NBPF26	120807606	120807709	20	104	35337	6817	35317	6713	0.19230769230769232	5.260986146283331
chr1	NBPF26	120822103	120822267	460	165	35337	6817	34877	6652	2.787878787878788	5.243084786530367
chr1	NBPF26	120822103	120822156	460	54	35337	6817	34877	6763	8.518518518518519	5.157030903445216
chr1	LINC00623	121008410	121008499	0	90	102	2606	102	2516	0.0	0.04054054054054054
chr1	FCGR1B	121094673	121094958	0	286	51	4239	51	3953	0.0	0.012901593726283835
chr1	LINC02798	121427981	121428064	0	84	0	4744	0	4660	0.0	0.0
chr1	LINC02798	121397620	121397787	0	168	0	4744	0	4576	0.0	0.0
chr1	EMBP1	121538322	121538420	0	99	0	5755	0	5656	0.0	0.0
chr1	GPR89A	145616233	145616293	0	61	103429	4656	103429	4595	0.0	22.509031556039172
chr1	GPR89A	145630686	145630807	0	122	103429	4656	103429	4534	0.0	22.811865902073226
chr1	GPR89A	145608347	145608675	76157	329	103429	4656	27272	4327	231.48024316109422	6.302750173330252
chr1	GPR89A	145612201	145612247	56	47	103429	4656	103373	4609	1.1914893617021276	22.42850943805598
chr1	CD160	145730743	145731070	0	328	0	1793	0	1465	0.0	0.0
chr1	NUDT17	145846012	145846196	0	185	0	1664	0	1479	0.0	0.0
chr1	LIX1L-AS1	145932083	145932159	0	77	1727	3264	1727	3187	0.0	0.5418889237527456
chr1	LIX1L-AS1	145936390	145936588	425	199	1727	3264	1302	3065	2.135678391959799	0.42479608482871123
chr1	LIX1L-AS1	145934252	145934390	0	139	1727	3264	1727	3125	0.0	0.55264
chr1	LIX1L-AS1	145947096	145947361	0	266	1727	3264	1727	2998	0.0	0.576050700466978
chr1	LIX1L-AS1	145947096	145947145	0	50	1727	3264	1727	3214	0.0	0.5373366521468576
chr1	LIX1L-AS1	145958360	145958438	0	79	1727	3264	1727	3185	0.0	0.5422291993720565
chr1	POLR3GL	145977083	145977152	0	70	0	1316	0	1246	0.0	0.0
chr1	POLR3GL	145975306	145975436	0	131	0	1316	0	1185	0.0	0.0
chr1	LINC01719	146058557	146059662	16983	1106	34193	2631	17210	1525	15.355334538878843	11.285245901639344
chr1	LINC01719	146057693	146057988	5349	296	34193	2631	28844	2335	18.070945945945947	12.352890792291221
chr1	LINC01719	146058312	146058461	518	150	34193	2631	33675	2481	3.453333333333333	13.573155985489722
chr1	NBPF12	146951813	146952037	0	225	0	7308	0	7083	0.0	0.0
chr1	NBPF12	146982927	146983091	0	165	0	7308	0	7143	0.0	0.0
chr1	CHD1L	147264428	147264584	0	157	0	4200	0	4043	0.0	0.0
chr1	CHD1L	147268781	147268878	0	98	0	4200	0	4102	0.0	0.0
chr1	CHD1L	147272170	147272281	0	112	0	4200	0	4088	0.0	0.0
chr1	CHD1L	147280025	147280191	0	167	0	4200	0	4033	0.0	0.0
chr1	CHD1L	147254869	147254976	0	108	0	4200	0	4092	0.0	0.0
chr1	CHD1L	147256530	147256562	0	33	0	4200	0	4167	0.0	0.0
chr1	CHD1L	147259836	147259918	0	83	0	4200	0	4117	0.0	0.0
chr1	CHD1L	147264421	147264584	0	164	0	4200	0	4036	0.0	0.0
chr1	CHD1L	147270931	147271005	0	75	0	4200	0	4125	0.0	0.0
chr1	CHD1L	147252622	147252735	0	114	0	4200	0	4086	0.0	0.0
chr1	CHD1L	147256530	147256570	0	41	0	4200	0	4159	0.0	0.0
chr1	CHD1L	147270931	147271113	0	183	0	4200	0	4017	0.0	0.0
chr1	CHD1L	147270931	147271195	0	265	0	4200	0	3935	0.0	0.0
chr1	CHD1L	147254897	147254976	0	80	0	4200	0	4120	0.0	0.0
chr1	CHD1L	147272446	147272630	0	185	0	4200	0	4015	0.0	0.0
chr1	CHD1L	147272170	147272630	0	461	0	4200	0	3739	0.0	0.0
chr1	CHD1L	147284350	147284499	0	150	0	4200	0	4050	0.0	0.0
chr1	GPR89B	147936626	147936686	0	61	102	5227	102	5166	0.0	0.019744483159117306
chr1	GPR89B	147968331	147968428	0	98	102	5227	102	5129	0.0	0.019886917527783193
chr1	LINC02805	148163791	148163866	0	76	0	5857	0	5781	0.0	0.0
chr1	LINC02805	148163756	148163815	0	60	0	5857	0	5797	0.0	0.0
chr1	LINC02805	148163756	148163866	0	111	0	5857	0	5746	0.0	0.0
chr1	LINC02805	148163791	148163815	0	25	0	5857	0	5832	0.0	0.0
chr1	LINC02805	148174249	148174515	0	267	0	5857	0	5590	0.0	0.0
chr1	AC245100.4	148424062	148424189	0	128	0	3322	0	3194	0.0	0.0
chr1	AC245100.4	148424626	148424638	0	13	0	3322	0	3309	0.0	0.0
chr1	AC245100.4	148417662	148417765	0	104	0	3322	0	3218	0.0	0.0
chr1	AC245100.4	148424626	148424678	0	53	0	3322	0	3269	0.0	0.0
chr1	AC245100.4	148420819	148420937	0	119	0	3322	0	3203	0.0	0.0
chr1	PDE4DIP	148929196	148929273	0	78	6068	23819	6068	23741	0.0	0.2555915926035129
chr1	PDE4DIP	149024444	149024684	0	241	6068	23819	6068	23578	0.0	0.2573585545847824
chr1	PDE4DIP	149030231	149030278	0	48	6068	23819	6068	23771	0.0	0.25526902528290774
chr1	PDE4DIP	149010442	149010595	0	154	6068	23819	6068	23665	0.0	0.2564124234100993
chr1	PDE4DIP	149012590	149012776	0	187	6068	23819	6068	23632	0.0	0.25677048070413
chr1	PDE4DIP	148889783	148889894	0	112	6068	23819	6068	23707	0.0	0.2559581558189564
chr1	PDE4DIP	149047638	149047788	0	151	6068	23819	6068	23668	0.0	0.25637992225790096
chr1	AC245297.3	149177157	149177212	0	56	0	4300	0	4244	0.0	0.0
chr1	AC245297.3	149190635	149190795	0	161	0	4300	0	4139	0.0	0.0
chr1	NBPF19	149486129	149486293	0	165	306	13847	306	13682	0.0	0.022365151293670515
chr1	LINC00869	149661301	149661419	0	119	16158	10886	16158	10767	0.0	1.5006965728615214
chr1	LINC00869	149664520	149664646	0	127	16158	10886	16158	10759	0.0	1.5018124361000094
chr1	LINC00869	149665804	149666124	198	321	16158	10886	15960	10565	0.616822429906542	1.510648367250355
chr1	LINC00869	149658151	149658254	0	104	16158	10886	16158	10782	0.0	1.4986087924318308
chr1	LINC00869	149665956	149666124	184	169	16158	10886	15974	10717	1.0887573964497042	1.4905290659699544
chr1	VPS45	150142837	150142931	0	95	16832	5991	16832	5896	0.0	2.8548168249660786
chr1	VPS45	150098849	150099080	4876	232	16832	5991	11956	5759	21.017241379310345	2.0760548706372632
chr1	PLEKHO1	150157384	150157486	0	103	7878	6559	7878	6456	0.0	1.220260223048327
chr1	CA14	150263793	150263878	0	86	2456	3005	2456	2919	0.0	0.84138403562864
chr1	CA14	150260282	150260387	0	106	2456	3005	2456	2899	0.0	0.8471886857537082
chr1	C1ORF54	150279642	150279741	182	100	15812	1278	15630	1178	1.82	13.268251273344651
chr1	CIART	150283804	150283880	10	77	163	2702	153	2625	0.12987012987012986	0.05828571428571429
chr1	RPRD2	150441880	150441958	0	79	162757	8751	162757	8672	0.0	18.768104243542435
chr1	TARS2	150504631	150504733	47	103	10792	4095	10745	3992	0.4563106796116505	2.6916332665330662
chr1	TARS2	150490600	150490725	540	126	10792	4095	10252	3969	4.285714285714286	2.583018392542202
chr1	TARS2	150491597	150491662	0	66	10792	4095	10792	4029	0.0	2.6785802928766445
chr1	TARS2	150497529	150497747	0	219	10792	4095	10792	3876	0.0	2.784313725490196
chr1	TARS2	150492410	150492489	402	80	10792	4095	10390	4015	5.025	2.587795765877958
chr1	ECM1	150511456	150511831	0	376	204	2947	204	2571	0.0	0.07934655775962661
chr1	ADAMTSL4	150554565	150554634	0	70	1398259	6453	1398259	6383	0.0	219.05984646717843
chr1	SETDB1	150939939	150939974	38883	36	121385	7114	82502	7078	1080.0833333333333	11.656117547329755
chr1	SETDB1	150942851	150943053	597	203	121385	7114	120788	6911	2.9408866995073892	17.47764433511793
chr1	ANXA9	150983089	150983180	6	92	3986	1608	3980	1516	0.06521739130434782	2.62532981530343
chr1	PRUNE1	151018556	151018669	73	114	132322	3165	132249	3051	0.6403508771929824	43.346116027531956
chr1	PRUNE1	151018466	151018669	73	204	132322	3165	132249	2961	0.35784313725490197	44.66362715298885
chr1	PRUNE1	151028785	151028944	1701	160	132322	3165	130621	3005	10.63125	43.46788685524127
chr1	PRUNE1	151031371	151031464	462	94	132322	3165	131860	3071	4.914893617021277	42.937154021491374
chr1	PRUNE1	151024610	151024795	64077	186	132322	3165	68245	2979	344.5	22.90869419268211
chr1	PRUNE1	151017811	151017904	0	94	132322	3165	132322	3071	0.0	43.0875936177141
chr1	PRUNE1	151025514	151025673	54799	160	132322	3165	77523	3005	342.49375	25.798003327787022
chr1	BNIPL	151044879	151045033	306	155	9540	3554	9234	3399	1.9741935483870967	2.7166813768755516
chr1	GABPB2	151103561	151103675	284	115	60932	9200	60648	9085	2.4695652173913043	6.675619152449092
chr1	GABPB2	151117391	151117516	1692	126	60932	9200	59240	9074	13.428571428571429	6.528543090147675
chr1	GABPB2	151090405	151090573	11993	169	60932	9200	48939	9031	70.96449704142012	5.419001218026796
chr1	PIP5K1A	151238181	151238265	689	85	137443	5373	136754	5288	8.105882352941176	25.861195158850226
chr1	PIP5K1A	151242122	151242269	0	148	137443	5373	137443	5225	0.0	26.30488038277512
chr1	PIP5K1A	151224370	151224406	0	37	137443	5373	137443	5336	0.0	25.757683658170915
chr1	PSMD4	151265393	151265609	32809	217	220280	2624	187471	2407	151.19354838709677	77.88574989613628
chr1	PSMD4	151266939	151266978	6313	40	220280	2624	213967	2584	157.825	82.80456656346749
chr1	ZNF687	151285205	151286074	1785	870	114730	6334	112945	5464	2.0517241379310347	20.67075402635432
chr1	CGN	151515494	151515616	1167	123	113108	6639	111941	6516	9.487804878048781	17.179404542664212
chr1	TUFT1	151564524	151564614	0	91	2111	3434	2111	3343	0.0	0.6314687406521089
chr1	TUFT1	151562090	151562165	0	76	2111	3434	2111	3358	0.0	0.6286480047647409
chr1	SNX27	151638887	151639119	0	233	157502	16235	157502	16002	0.0	9.842644669416323
chr1	RIIAD1	151727574	151727621	0	48	11	2288	11	2240	0.0	0.004910714285714286
chr1	OAZ3	151768057	151768233	0	177	55506	4640	55506	4463	0.0	12.436925834640377
chr1	OAZ3	151770171	151770257	42	87	55506	4640	55464	4553	0.4827586206896552	12.181858115528224
chr1	OAZ3	151768144	151768233	0	90	55506	4640	55506	4550	0.0	12.19912087912088
chr1	FLG-AS1	152251652	152251758	0	107	2905	12348	2905	12241	0.0	0.23731721264602565
chr1	SPRR3	153002602	153002686	0	85	0	1445	0	1360	0.0	0.0
chr1	S100A1	153628781	153628867	0	87	98673	1071	98673	984	0.0	100.27743902439025
chr1	CHTOP	153643226	153643364	0	139	653578	4833	653578	4694	0.0	139.23689816787387
chr1	CHTOP	153642245	153642429	58948	185	653578	4833	594630	4648	318.6378378378378	127.93244406196213
chr1	SNAPIN	153659137	153659184	15	48	376	1519	361	1471	0.3125	0.24541128484024474
chr1	INTS3	153761019	153761109	103	91	23309	9073	23206	8982	1.1318681318681318	2.5836116677800045
chr1	SLC27A3	153777760	153777885	4155	126	239197	3384	235042	3258	32.976190476190474	72.14303253529773
chr1	RPS27	153990913	153991034	40	122	598	689	558	567	0.32786885245901637	0.9841269841269841
chr1	UBAP2L	154269361	154269412	0	52	140763	6628	140763	6576	0.0	21.405565693430656
chr1	HAX1	154273479	154273598	0	120	102	1613	102	1493	0.0	0.06831882116543872
chr1	HAX1	154273335	154273534	0	200	102	1613	102	1413	0.0	0.07218683651804671
chr1	HAX1	154273335	154273598	0	264	102	1613	102	1349	0.0	0.07561156412157154
chr1	AQP10	154321932	154322059	34927	128	143770	2297	108843	2169	272.8671875	50.18118948824343
chr1	IL6R	154435968	154436110	0	143	105	6465	105	6322	0.0	0.016608668142992725
chr1	IL6R	154454487	154454581	0	95	105	6465	105	6370	0.0	0.016483516483516484
chr1	IL6R	154445046	154445094	0	49	105	6465	105	6416	0.0	0.016365336658354115
chr1	TDRD10	154542730	154542821	0	92	8761	2719	8761	2627	0.0	3.3349828701941377
chr1	TDRD10	154544371	154544517	102	147	8761	2719	8659	2572	0.6938775510204082	3.3666407465007775
chr1	CHRNB2	154577005	154577253	0	249	82898	4878	82898	4629	0.0	17.908403542881832
chr1	FLAD1	154989559	154989707	121	149	204753	3992	204632	3843	0.8120805369127517	53.247983346344
chr1	FLAD1	154990338	154990528	18628	191	204753	3992	186125	3801	97.52879581151832	48.96737700605104
chr1	FLAD1	154983841	154984066	1625	226	204753	3992	203128	3766	7.1902654867256635	53.93733404142326
chr1	DCST1	155034652	155034727	7876	76	113217	3211	105341	3135	103.63157894736842	33.60159489633174
chr1	DCST1	155047786	155047929	0	144	113217	3211	113217	3067	0.0	36.91457450277144
chr1	ADAM15	155053416	155053493	0	78	8716	4801	8716	4723	0.0	1.8454372221045945
chr1	ADAM15	155055789	155055852	0	64	8716	4801	8716	4737	0.0	1.8399831116740553
chr1	ADAM15	155060762	155060832	0	71	8716	4801	8716	4730	0.0	1.842706131078224
chr1	ADAM15	155061417	155061489	0	73	8716	4801	8716	4728	0.0	1.8434856175972927
chr1	ADAM15	155061903	155061975	0	73	8716	4801	8716	4728	0.0	1.8434856175972927
chr1	ADAM15	155061414	155061489	0	76	8716	4801	8716	4725	0.0	1.8446560846560847
chr1	ADAM15	155061903	155062117	0	215	8716	4801	8716	4586	0.0	1.900566942869603
chr1	ADAM15	155052530	155052559	0	30	8716	4801	8716	4771	0.0	1.8268706770069167
chr1	EFNA3	155086127	155086205	0	79	48	1950	48	1871	0.0	0.025654730090860504
chr1	EFNA1	155133502	155133568	0	67	100	2170	100	2103	0.0	0.0475511174512601
chr1	SLC50A1	155137560	155137722	0	163	51	1885	51	1722	0.0	0.029616724738675958
chr1	SLC50A1	155137578	155137722	0	145	51	1885	51	1740	0.0	0.029310344827586206
chr1	SLC50A1	155136827	155136951	0	125	51	1885	51	1760	0.0	0.028977272727272727
chr1	TRIM46	155174600	155174641	3569	42	576844	4548	573275	4506	84.97619047619048	127.2248113626276
chr1	TRIM46	155175385	155175647	13263	263	576844	4548	563581	4285	50.42965779467681	131.52415402567095
chr1	TRIM46	155178808	155178846	1030	39	576844	4548	575814	4509	26.41025641025641	127.70326014637392
chr1	THBS3-AS1	155203122	155203271	20598	150	187863	2476	167265	2326	137.32	71.9110060189166
chr1	MTX1	155212126	155212219	204	94	51662	2569	51458	2475	2.1702127659574466	20.79111111111111
chr1	HCN3	155283973	155284135	1197	163	602315	3866	601118	3703	7.343558282208589	162.33270321361059
chr1	HCN3	155285723	155285964	5495	242	602315	3866	596820	3624	22.706611570247933	164.68543046357615
chr1	FDPS	155310063	155310205	255	143	4826	3010	4571	2867	1.7832167832167831	1.5943494942448553
chr1	FDPS	155310042	155310205	255	164	4826	3010	4571	2846	1.5548780487804879	1.6061138439915672
chr1	FDPS	155310335	155310453	816	119	4826	3010	4010	2891	6.857142857142857	1.3870632998962298
chr1	FDPS	155309788	155309965	627	178	4826	3010	4199	2832	3.5224719101123596	1.4826977401129944
chr1	FDPS	155309752	155309965	901	214	4826	3010	3925	2796	4.210280373831775	1.40379113018598
chr1	MSTO1	155611215	155611291	0	77	9091	4041	9091	3964	0.0	2.2933905146316853
chr1	DAP3	155729041	155729122	0	82	57901	4354	57901	4272	0.0	13.553604868913858
chr1	DAP3	155731943	155732033	3799	91	57901	4354	54102	4263	41.747252747252745	12.69106263194933
chr1	DAP3	155736945	155737063	1938	119	57901	4354	55963	4235	16.285714285714285	13.214403778040142
chr1	DAP3	155709032	155709125	54	94	57901	4354	57847	4260	0.574468085106383	13.579107981220657
chr1	DAP3	155717005	155717128	15443	124	57901	4354	42458	4230	124.54032258064517	10.037352245862884
chr1	DAP3	155721516	155721618	2992	103	57901	4354	54909	4251	29.04854368932039	12.916725476358504
chr1	DAP3	155725381	155725411	598	31	57901	4354	57303	4323	19.29032258064516	13.255378209576683
chr1	DAP3	155736607	155736694	0	88	57901	4354	57901	4266	0.0	13.572667604313175
chr1	DAP3	155737005	155737063	978	59	57901	4354	56923	4295	16.576271186440678	13.253317811408614
chr1	AL355388.2	156030732	156030861	0	130	33049	2372	33049	2242	0.0	14.74085637823372
chr1	LAMTOR2	156057977	156058067	3398	91	18649	1339	15251	1248	37.34065934065934	12.220352564102564
chr1	RAB25	156065910	156066106	5027	197	26060	1694	21033	1497	25.517766497461928	14.050100200400802
chr1	LMNA	156130616	156130773	224	158	324066	7357	323842	7199	1.4177215189873418	44.98430337546881
chr1	LMNA	156137653	156137743	0	91	324066	7357	324066	7266	0.0	44.600330305532616
chr1	LMNA	156126735	156126915	0	181	324066	7357	324066	7176	0.0	45.15969899665552
chr1	LMNA	156126735	156126949	0	215	324066	7357	324066	7142	0.0	45.37468496219547
chr1	LMNA	156129826	156129908	0	83	324066	7357	324066	7274	0.0	44.5512785262579
chr1	SEMA4A	156158387	156158486	0	100	12683	6084	12683	5984	0.0	2.119485294117647
chr1	SEMA4A	156153330	156153476	0	147	12683	6084	12683	5937	0.0	2.1362641064510695
chr1	SEMA4A	156154549	156154717	0	169	12683	6084	12683	5915	0.0	2.1442096365173287
chr1	SLC25A44	156207861	156208013	7827	153	23630	3772	15803	3619	51.15686274509804	4.366675877314175
chr1	SLC25A44	156207885	156208013	6445	129	23630	3772	17185	3643	49.96124031007752	4.717265989569037
chr1	PMF1	156232319	156232425	0	107	86173	2529	86173	2422	0.0	35.57927332782824
chr1	PMF1	156236287	156236483	49664	197	86173	2529	36509	2332	252.10152284263958	15.65566037735849
chr1	PMF1	156225556	156225668	88	113	86173	2529	86085	2416	0.7787610619469026	35.631208609271525
chr1	PMF1	156233627	156233728	102	102	86173	2529	86071	2427	1.0	35.46394725999176
chr1	PMF1	156236348	156236483	45983	136	86173	2529	40190	2393	338.1102941176471	16.794818219807773
chr1	TMEM79	156285524	156285983	18320	460	36529	3037	18209	2577	39.82608695652174	7.065968180054327
chr1	RHBG	156381805	156381943	0	139	0	3394	0	3255	0.0	0.0
chr1	RHBG	156374606	156374729	0	124	0	3394	0	3270	0.0	0.0
chr1	RHBG	156371181	156371254	0	74	0	3394	0	3320	0.0	0.0
chr1	TTC24	156583041	156583170	0	130	51	2644	51	2514	0.0	0.02028639618138425
chr1	TTC24	156583799	156583895	0	97	51	2644	51	2547	0.0	0.020023557126030624
chr1	BCAN	156647507	156647682	0	176	51	4571	51	4395	0.0	0.011604095563139932
chr1	BCAN	156647345	156647394	0	50	51	4571	51	4521	0.0	0.0112806901128069
chr1	RRNAD1	156731990	156732115	192	126	13315	2891	13123	2765	1.5238095238095237	4.746112115732369
chr1	RRNAD1	156732984	156733047	4	64	13315	2891	13311	2827	0.0625	4.7085249380969225
chr1	RRNAD1	156734008	156734493	918	486	13315	2891	12397	2405	1.8888888888888888	5.1546777546777545
chr1	RRNAD1	156734008	156734052	0	45	13315	2891	13315	2846	0.0	4.678496134926212
chr1	PRCC	156791696	156791792	0	97	612	4062	612	3965	0.0	0.15435056746532155
chr1	PRCC	156791066	156791162	0	97	612	4062	612	3965	0.0	0.15435056746532155
chr1	NTRK1	156871622	156871755	0	134	561	4584	561	4450	0.0	0.12606741573033708
chr1	NTRK1	156837725	156837865	0	141	561	4584	561	4443	0.0	0.1262660364618501
chr1	NTRK1	156874382	156874400	0	19	561	4584	561	4565	0.0	0.12289156626506025
chr1	NTRK1	156880448	156880539	255	92	561	4584	306	4492	2.7717391304347827	0.06812110418521816
chr1	PEAR1	156904943	156904998	3170	56	192891	5554	189721	5498	56.607142857142854	34.50727537286286
chr1	PEAR1	156902187	156902285	153	99	192891	5554	192738	5455	1.5454545454545454	35.33235563703025
chr1	LINC02772	157280718	157280853	0	136	0	1651	0	1515	0.0	0.0
chr1	CD1D	158182877	158183156	0	280	51	4291	51	4011	0.0	0.012715033657442034
chr1	CD1C	158293211	158293302	0	92	0	2448	0	2356	0.0	0.0
chr1	CD1E	158355299	158355569	0	271	51	2210	51	1939	0.0	0.02630221763795771
chr1	CD1E	158354376	158354673	0	298	51	2210	51	1912	0.0	0.026673640167364017
chr1	PYHIN1	158973646	158973771	118	126	118	3495	0	3369	0.9365079365079365	0.0
chr1	IFI16	159016532	159016700	0	169	77	5088	77	4919	0.0	0.015653588127668226
chr1	IFI16	159045296	159045464	0	169	77	5088	77	4919	0.0	0.015653588127668226
chr1	IFI16	159049431	159049599	0	169	77	5088	77	4919	0.0	0.015653588127668226
chr1	IFI16	159016617	159016700	0	84	77	5088	77	5004	0.0	0.015387689848121503
chr1	CADM3	159189770	159189872	0	103	51	3857	51	3754	0.0	0.013585508790623336
chr1	FCRL6	159802419	159802455	0	37	13471	2371	13471	2334	0.0	5.771636675235647
chr1	FCRL6	159808960	159809245	1134	286	13471	2371	12337	2085	3.965034965034965	5.917026378896883
chr1	FCRL6	159815427	159815459	0	33	13471	2371	13471	2338	0.0	5.761762189905903
chr1	SLAMF8	159829865	159830192	1781	328	32642	1906	30861	1578	5.429878048780488	19.55703422053232
chr1	SLAMF8	159836669	159836795	6247	127	32642	1906	26395	1779	49.188976377952756	14.836987071388421
chr1	LINC01133	159965498	159965645	0	148	0	3683	0	3535	0.0	0.0
chr1	NCSTN	160344475	160344614	0	140	204	4150	204	4010	0.0	0.05087281795511222
chr1	NCSTN	160351221	160351372	0	152	204	4150	204	3998	0.0	0.05102551275637819
chr1	NCSTN	160352886	160352991	0	106	204	4150	204	4044	0.0	0.050445103857566766
chr1	NCSTN	160343703	160343802	0	100	204	4150	204	4050	0.0	0.05037037037037037
chr1	NCSTN	160343703	160343888	0	186	204	4150	204	3964	0.0	0.05146316851664985
chr1	NCSTN	160353322	160353501	102	180	204	4150	102	3970	0.5666666666666667	0.025692695214105794
chr1	NCSTN	160351287	160351372	0	86	204	4150	204	4064	0.0	0.05019685039370079
chr1	VANGL2	160420410	160420547	0	138	0	5362	0	5224	0.0	0.0
chr1	AL121985.1	160676359	160676504	0	146	0	4131	0	3985	0.0	0.0
chr1	AL121985.1	160684954	160685101	0	148	0	4131	0	3983	0.0	0.0
chr1	AL121985.1	160686608	160686693	0	86	0	4131	0	4045	0.0	0.0
chr1	SLAMF7	160751344	160751448	0	105	153	3183	153	3078	0.0	0.049707602339181284
chr1	SLAMF7	160748193	160748514	0	322	153	3183	153	2861	0.0	0.05347780496329955
chr1	SLAMF7	160750303	160750423	0	121	153	3183	153	3062	0.0	0.04996734160679295
chr1	SLAMF7	160749820	160750093	0	274	153	3183	153	2909	0.0	0.052595393606050186
chr1	LY9	160816593	160816863	0	271	0	5244	0	4973	0.0	0.0
chr1	LY9	160824180	160824249	0	70	0	5244	0	5174	0.0	0.0
chr1	LY9	160797109	160797275	0	167	0	5244	0	5077	0.0	0.0
chr1	LY9	160798825	160799008	0	184	0	5244	0	5060	0.0	0.0
chr1	KLHDC9	161099345	161099505	51	161	5338	1599	5287	1438	0.3167701863354037	3.67663421418637
chr1	NIT1	161118803	161118881	0	79	8085	3450	8085	3371	0.0	2.3983981014535747
chr1	NIT1	161118785	161118881	0	97	8085	3450	8085	3353	0.0	2.4112734864300625
chr1	UFC1	161158120	161158211	0	92	1482	1386	1482	1294	0.0	1.1452859350850078
chr1	USP21	161160365	161160506	6450	142	63835	3470	57385	3328	45.42253521126761	17.243088942307693
chr1	USP21	161160328	161160506	6464	179	63835	3470	57371	3291	36.11173184357542	17.432695229413554
chr1	PPOX	161167370	161167486	0	117	13139	4416	13139	4299	0.0	3.0562921609676668
chr1	PPOX	161168431	161168576	2533	146	13139	4416	10606	4270	17.34931506849315	2.48384074941452
chr1	PPOX	161169905	161170024	0	120	13139	4416	13139	4296	0.0	3.0584264432029795
chr1	PPOX	161170408	161170519	0	112	13139	4416	13139	4304	0.0	3.0527416356877324
chr1	PPOX	161167099	161167234	0	136	13139	4416	13139	4280	0.0	3.069859813084112
chr1	PPOX	161167354	161167486	0	133	13139	4416	13139	4283	0.0	3.067709549381275
chr1	PPOX	161168444	161168576	2305	133	13139	4416	10834	4283	17.330827067669173	2.529535372402522
chr1	PPOX	161167994	161168127	2325	134	13139	4416	10814	4282	17.350746268656717	2.5254553946753853
chr1	PPOX	161168412	161168576	2698	165	13139	4416	10441	4251	16.35151515151515	2.4561279698894376
chr1	NDUFS2	161203436	161203543	0	108	22843	7304	22843	7196	0.0	3.174402445803224
chr1	NDUFS2	161209192	161209313	0	122	22843	7304	22843	7182	0.0	3.1805903648008913
chr1	NDUFS2	161209856	161209931	0	76	22843	7304	22843	7228	0.0	3.160348644161594
chr1	NDUFS2	161210110	161210188	0	79	22843	7304	22843	7225	0.0	3.1616608996539792
chr1	NDUFS2	161212350	161212480	0	131	22843	7304	22843	7173	0.0	3.1845810678934896
chr1	NDUFS2	161212591	161212654	0	64	22843	7304	22843	7240	0.0	3.155110497237569
chr1	NDUFS2	161213156	161213182	0	27	22843	7304	22843	7277	0.0	3.139068297375292
chr1	NDUFS2	161212587	161213182	0	596	22843	7304	22843	6708	0.0	3.4053369111508647
chr1	NDUFS2	161212591	161213182	0	592	22843	7304	22843	6712	0.0	3.4033075089392133
chr1	NDUFS2	161213086	161213182	0	97	22843	7304	22843	7207	0.0	3.169557374774525
chr1	NDUFS2	161213089	161213182	0	94	22843	7304	22843	7210	0.0	3.168238557558946
chr1	NDUFS2	161210303	161210389	0	87	22843	7304	22843	7217	0.0	3.165165581266454
chr1	NDUFS2	161209842	161209931	0	90	22843	7304	22843	7214	0.0	3.166481840864985
chr1	NDUFS2	161206406	161206597	0	192	22843	7304	22843	7112	0.0	3.21189538807649
chr1	NDUFS2	161203786	161203837	0	52	22843	7304	22843	7252	0.0	3.1498896856039713
chr1	NDUFS2	161208004	161208127	0	124	22843	7304	22843	7180	0.0	3.181476323119777
chr1	FCER1G	161217985	161218077	0	93	0	970	0	877	0.0	0.0
chr1	TOMM40L	161227257	161227350	45	94	81	3090	36	2996	0.4787234042553192	0.012016021361815754
chr1	TOMM40L	161227635	161227737	0	103	81	3090	81	2987	0.0	0.02711750920656177
chr1	TOMM40L	161226887	161226955	0	69	81	3090	81	3021	0.0	0.026812313803376366
chr1	SDHC	161328395	161328497	0	103	4868	1910	4868	1807	0.0	2.693967902600996
chr1	SDHC	161356676	161356840	153	165	4868	1910	4715	1745	0.9272727272727272	2.702005730659026
chr1	SDHC	161323613	161323670	49	58	4868	1910	4819	1852	0.8448275862068966	2.602051835853132
chr1	SDHC	161339561	161339588	568	28	4868	1910	4300	1882	20.285714285714285	2.2848034006376197
chr1	SDHC	161326650	161326768	0	119	4868	1910	4868	1791	0.0	2.718034617532105
chr1	FCGR2A	161510833	161510956	0	124	102	4043	102	3919	0.0	0.026027047716254147
chr1	FCGR2A	161513894	161513932	0	39	102	4043	102	4004	0.0	0.025474525474525476
chr1	FCGR2C	161595552	161595590	0	39	94	3594	94	3555	0.0	0.026441631504922646
chr1	FCGR2B	161670251	161670272	0	22	0	5256	0	5234	0.0	0.0
chr1	FCGR2B	161675256	161675313	0	58	0	5256	0	5198	0.0	0.0
chr1	FCRLA	161710759	161710912	0	154	0	2862	0	2708	0.0	0.0
chr1	FCRLA	161710474	161710492	0	19	0	2862	0	2843	0.0	0.0
chr1	FCRLA	161711207	161711474	0	268	0	2862	0	2594	0.0	0.0
chr1	FCRLA	161711933	161712218	0	286	0	2862	0	2576	0.0	0.0
chr1	FCRLB	161722988	161723009	8184	22	206924	2599	198740	2577	372.0	77.12068296468762
chr1	DUSP12	161751865	161751984	0	120	15462	1722	15462	1602	0.0	9.651685393258427
chr1	NOS1AP	162360811	162360924	0	114	983	7866	983	7752	0.0	0.12680598555211559
chr1	UHMK1	162518101	162518190	0	90	169857	9256	169857	9166	0.0	18.531202269255946
chr1	UAP1	162592731	162592782	0	52	38517	3449	38517	3397	0.0	11.338534000588755
chr1	UAP1	162592734	162592782	0	49	38517	3449	38517	3400	0.0	11.328529411764706
chr1	DDR2	162705051	162705131	0	81	145169	11121	145169	11040	0.0	13.149365942028986
chr1	HSD17B7	162795620	162795663	0	44	920	3983	920	3939	0.0	0.23356181772023357
chr1	RGS4	163073455	163073622	0	168	0	3740	0	3572	0.0	0.0
chr1	NUF2	163322866	163323095	7027	230	7078	3228	51	2998	30.55217391304348	0.017011340893929285
chr1	NUF2	163345677	163345818	0	142	7078	3228	7078	3086	0.0	2.2935839274141285
chr1	PBX1	164820071	164820184	2402	114	380111	20254	377709	20140	21.07017543859649	18.754170804369416
chr1	PBX1	164811989	164812149	0	161	380111	20254	380111	20093	0.0	18.917583237943564
chr1	PBX1	164657112	164657372	0	261	380111	20254	380111	19993	0.0	19.012204271495023
chr1	AL356441.1	165605595	165605688	68	94	165711	2014	165643	1920	0.723404255319149	86.27239583333333
chr1	MGST3	165632230	165632274	32442	45	175704	6822	143262	6777	720.9333333333333	21.139442231075698
chr1	UCK2	165885141	165885379	226	239	1696	6996	1470	6757	0.9456066945606695	0.2175521681219476
chr1	MAEL	166989736	166989829	0	94	0	3163	0	3069	0.0	0.0
chr1	POU2F1	167303473	167303574	0	102	16903	15677	16903	15575	0.0	1.0852648475120386
chr1	POU2F1	167374107	167374296	0	190	16903	15677	16903	15487	0.0	1.0914315232130174
chr1	POU2F1	167389587	167389761	1940	175	16903	15677	14963	15502	11.085714285714285	0.9652302928654367
chr1	POU2F1	167319013	167319056	0	44	16903	15677	16903	15633	0.0	1.0812384059361606
chr1	POU2F1	167387180	167387247	880	68	16903	15677	16023	15609	12.941176470588236	1.0265231597155486
chr1	RCSD1	167685420	167685510	13	91	64	8178	51	8087	0.14285714285714285	0.006306417707431681
chr1	RCSD1	167690048	167690120	0	73	64	8178	64	8105	0.0	0.007896360271437385
chr1	MPZL1	167772274	167772488	900	215	29208	7079	28308	6864	4.186046511627907	4.124125874125874
chr1	MPZL1	167776063	167776166	0	104	29208	7079	29208	6975	0.0	4.18752688172043
chr1	DCAF6	167966628	167966721	0	94	62945	6334	62945	6240	0.0	10.087339743589743
chr1	DCAF6	168015780	168015951	435	172	62945	6334	62510	6162	2.5290697674418605	10.144433625446284
chr1	DCAF6	168050891	168050933	5753	43	62945	6334	57192	6291	133.7906976744186	9.09108249880782
chr1	DCAF6	168022987	168023047	0	61	62945	6334	62945	6273	0.0	10.034273872150486
chr1	DCAF6	168019544	168019667	0	124	62945	6334	62945	6210	0.0	10.136070853462158
chr1	SFT2D2	168235100	168235182	0	83	19257	11226	19257	11143	0.0	1.7281701516647223
chr1	TBX19	168305007	168305196	0	190	204	3818	204	3628	0.0	0.05622932745314223
chr1	C1ORF112	169800882	169800971	0	90	16296	6002	16296	5912	0.0	2.756427604871448
chr1	C1ORF112	169807790	169807929	0	140	16296	6002	16296	5862	0.0	2.7799385875127944
chr1	LINC01681	170226363	170226512	0	150	0	2807	0	2657	0.0	0.0
chr1	LINC01681	170239898	170240141	0	244	0	2807	0	2563	0.0	0.0
chr1	LINC01681	170241064	170241285	0	222	0	2807	0	2585	0.0	0.0
chr1	LINC01681	170240229	170240322	0	94	0	2807	0	2713	0.0	0.0
chr1	LINC01681	170226918	170227058	0	141	0	2807	0	2666	0.0	0.0
chr1	LINC01681	170239969	170240141	0	173	0	2807	0	2634	0.0	0.0
chr1	PRRX1	170730276	170730348	0	73	0	8256	0	8183	0.0	0.0
chr1	FMO3	171101079	171101206	0	128	0	3450	0	3322	0.0	0.0
chr1	FMO2	171185707	171185845	0	139	0	6211	0	6072	0.0	0.0
chr1	FMO2	171196648	171196811	0	164	0	6211	0	6047	0.0	0.0
chr1	FMO2	171199345	171199488	0	144	0	6211	0	6067	0.0	0.0
chr1	FMO1	171283143	171283216	0	74	1326	2776	1326	2702	0.0	0.49074759437453735
chr1	FMO1	171267542	171267731	0	190	1326	2776	1326	2586	0.0	0.5127610208816705
chr1	FMO1	171270576	171270745	0	170	1326	2776	1326	2606	0.0	0.508825786646201
chr1	FMO4	171319817	171319957	0	141	714	2552	714	2411	0.0	0.2961426793861468
chr1	PRRC2C	171589368	171589605	0	238	50971	11736	50971	11498	0.0	4.433031831622891
chr1	PRRC2C	171591151	171591204	0	54	50971	11736	50971	11682	0.0	4.3632083547337785
chr1	PRRC2C	171591151	171591200	0	50	50971	11736	50971	11686	0.0	4.361714872497005
chr1	EEF1AKNMT	171790451	171790616	0	166	16	3836	16	3670	0.0	0.004359673024523161
chr1	EEF1AKNMT	171781987	171782120	0	134	16	3836	16	3702	0.0	0.004321988114532685
chr1	DNM3	172323328	172323340	0	13	463215	11354	463215	11341	0.0	40.844281809364254
chr1	DNM3	172093695	172093725	0	31	463215	11354	463215	11323	0.0	40.90921133975095
chr1	SUCO	172553259	172553370	0	112	14562	7919	14562	7807	0.0	1.8652491353913154
chr1	SUCO	172577538	172577559	309	22	14562	7919	14253	7897	14.045454545454545	1.8048626060529316
chr1	FASLG	172660094	172660140	0	47	0	1809	0	1762	0.0	0.0
chr1	DARS2	173828332	173828399	387	68	327202	7142	326815	7074	5.6911764705882355	46.19946282160023
chr1	DARS2	173845228	173845291	108	64	327202	7142	327094	7078	1.6875	46.21277196948291
chr1	DARS2	173853794	173853905	0	112	327202	7142	327202	7030	0.0	46.543669985775246
chr1	DARS2	173850326	173850479	0	154	327202	7142	327202	6988	0.0	46.82341156267888
chr1	ZBTB37	173873466	173873566	0	101	99587	19470	99587	19369	0.0	5.14156642056895
chr1	RABGAP1L	174877391	174877605	0	215	53514	13119	53514	12904	0.0	4.14708617482951
chr1	RABGAP1L	174957890	174958173	299	284	53514	13119	53215	12835	1.0528169014084507	4.146084924035839
chr1	CACYBP	175000088	175000195	0	108	2818	4456	2818	4348	0.0	0.6481140754369825
chr1	AL591043.2	176228184	176228249	0	66	153	3358	153	3292	0.0	0.04647630619684082
chr1	LINC01741	177708956	177709125	0	170	0	1909	0	1739	0.0	0.0
chr1	RASAL2	178470692	178470723	0	32	43511	16105	43511	16073	0.0	2.7070864182168854
chr1	C1ORF220	178544874	178545028	0	155	153	2779	153	2624	0.0	0.058307926829268296
chr1	RALGPS2	178784417	178784522	0	106	13545	9117	13545	9011	0.0	1.5031628010209743
chr1	RALGPS2	178892229	178892307	0	79	13545	9117	13545	9038	0.0	1.4986722726266872
chr1	TOR3A	179085627	179085893	107	267	81125	2835	81018	2568	0.40074906367041196	31.549065420560748
chr1	SOAT1	179302676	179302802	0	127	19362	7022	19362	6895	0.0	2.8081218274111674
chr1	SOAT1	179323436	179323495	19165	60	19362	7022	197	6962	319.4166666666667	0.028296466532605574
chr1	AXDND1	179368799	179368972	0	174	171	6113	171	5939	0.0	0.028792726048156254
chr1	AXDND1	179366403	179366606	0	204	171	6113	171	5909	0.0	0.028938906752411574
chr1	AXDND1	179444969	179445204	0	236	171	6113	171	5877	0.0	0.02909647779479326
chr1	AXDND1	179506832	179506926	0	95	171	6113	171	6018	0.0	0.028414755732801594
chr1	TDRD5	179654200	179654362	0	163	47	4109	47	3946	0.0	0.011910795742524075
chr1	TOR1AIP1	179900125	179900167	0	43	18794	4707	18794	4664	0.0	4.02958833619211
chr1	TOR1AIP1	179913997	179914054	0	58	18794	4707	18794	4649	0.0	4.042589804258981
chr1	TOR1AIP1	179913585	179913630	0	46	18794	4707	18794	4661	0.0	4.032181935207037
chr1	CEP350	179990506	179990621	0	116	3782	14304	3782	14188	0.0	0.26656329292359743
chr1	CEP350	180043055	180043192	0	138	3782	14304	3782	14166	0.0	0.2669772695185656
chr1	CEP350	180052223	180052316	0	94	3782	14304	3782	14210	0.0	0.2661505981703026
chr1	QSOX1	180175930	180176033	0	104	46802	8766	46802	8662	0.0	5.403140152389748
chr1	XPR1	180836521	180836716	51	196	10244	7345	10193	7149	0.2602040816326531	1.4257938173171072
chr1	KIAA1614	180935114	180936670	714	1557	128021	6226	127307	4669	0.45857418111753373	27.266438209466695
chr1	MR1	181052234	181052510	11	277	219020	9356	219009	9079	0.039711191335740074	24.122590593677717
chr1	MR1	181053572	181053677	0	106	219020	9356	219020	9250	0.0	23.67783783783784
chr1	CACNA1E	181731174	181731231	0	58	960	18323	960	18265	0.0	0.05255954010402409
chr1	CACNA1E	181793664	181793793	0	130	960	18323	960	18193	0.0	0.052767547958005825
chr1	RGSL1	182472395	182472557	0	163	21006	8963	21006	8800	0.0	2.3870454545454547
chr1	RGSL1	182449277	182449299	0	23	21006	8963	21006	8940	0.0	2.3496644295302014
chr1	RGSL1	182471281	182471386	0	106	21006	8963	21006	8857	0.0	2.3716834142486167
chr1	RGSL1	182460623	182460756	0	134	21006	8963	21006	8829	0.0	2.379204892966361
chr1	RGSL1	182473574	182474542	0	969	21006	8963	21006	7994	0.0	2.6277207905929445
chr1	RGSL1	182488460	182488543	0	84	21006	8963	21006	8879	0.0	2.3658069602432708
chr1	RGSL1	182488979	182489202	0	224	21006	8963	21006	8739	0.0	2.403707518022657
chr1	RGSL1	182530789	182530910	0	122	21006	8963	21006	8841	0.0	2.3759755683746184
chr1	RGSL1	182556023	182556222	177	200	21006	8963	20829	8763	0.885	2.37692571037316
chr1	RGSL1	182548699	182548824	49	126	21006	8963	20957	8837	0.3888888888888889	2.37150616725133
chr1	RGSL1	182460623	182460734	0	112	21006	8963	21006	8851	0.0	2.3732911535419725
chr1	NPL	182794355	182794439	0	85	11147	4113	11147	4028	0.0	2.7673783515392256
chr1	NPL	182822114	182822199	0	86	11147	4113	11147	4027	0.0	2.768065557486963
chr1	NPL	182825780	182825820	0	41	11147	4113	11147	4072	0.0	2.737475442043222
chr1	NPL	182818812	182818859	0	48	11147	4113	11147	4065	0.0	2.742189421894219
chr1	SMG7	183512836	183512868	0	33	17569	8348	17569	8315	0.0	2.112928442573662
chr1	SMG7	183527625	183527731	0	107	17569	8348	17569	8241	0.0	2.131901468268414
chr1	SMG7	183502252	183502391	13555	140	17569	8348	4014	8208	96.82142857142857	0.48903508771929827
chr1	SMG7	183547102	183547252	0	151	17569	8348	17569	8197	0.0	2.143345126265707
chr1	SMG7	183501130	183501267	0	138	17569	8348	17569	8210	0.0	2.1399512789281365
chr1	TSEN15	184054353	184054435	43	83	298	8390	255	8307	0.5180722891566265	0.030697002527988442
chr1	TSEN15	184054727	184054863	0	137	298	8390	298	8253	0.0	0.036108081909608625
chr1	TSEN15	184072156	184072310	0	155	298	8390	298	8235	0.0	0.03618700667880996
chr1	TSEN15	184058160	184058240	0	81	298	8390	298	8309	0.0	0.03586472499699121
chr1	TSEN15	184072156	184072194	0	39	298	8390	298	8351	0.0	0.03568434917973895
chr1	TSEN15	184095030	184095092	0	63	298	8390	298	8327	0.0	0.03578719827068572
chr1	TSEN15	184112864	184112960	0	97	298	8390	298	8293	0.0	0.03593392017364042
chr1	TSEN15	184054360	184054435	36	76	298	8390	262	8314	0.47368421052631576	0.0315131104161655
chr1	TSEN15	184072156	184072298	0	143	298	8390	298	8247	0.0	0.036134351885534134
chr1	TSEN15	184120964	184121250	0	287	298	8390	298	8103	0.0	0.03677650252992719
chr1	TSEN15	184070615	184070732	255	118	298	8390	43	8272	2.1610169491525424	0.0051982591876208895
chr1	TSEN15	184093624	184093724	0	101	298	8390	298	8289	0.0	0.03595126070696103
chr1	TSEN15	184072050	184072194	0	145	298	8390	298	8245	0.0	0.03614311704063069
chr1	C1ORF21	184592224	184592290	0	67	2126	11609	2126	11542	0.0	0.18419684630046787
chr1	C1ORF21	184509309	184509452	0	144	2126	11609	2126	11465	0.0	0.18543392935019626
chr1	RNF2	185093060	185093276	0	217	12736	3914	12736	3697	0.0	3.444955369218285
chr1	HMCN1	186178415	186178766	0	352	1663	18847	1663	18495	0.0	0.0899161935658286
chr1	PRG4	186304793	186304922	0	130	12261	5062	12261	4932	0.0	2.486009732360097
chr1	PRG4	186304107	186304257	1409	151	12261	5062	10852	4911	9.331125827814569	2.209733251883527
chr1	PRG4	186300090	186300213	0	124	12261	5062	12261	4938	0.0	2.482989064398542
chr1	ODR4	186393946	186394015	0	70	12589	4088	12589	4018	0.0	3.1331508213041315
chr1	ODR4	186385987	186386083	153	97	12589	4088	12436	3991	1.577319587628866	3.1160110248058133
chr1	PDC-AS1	186431205	186431349	0	145	4385	6863	4385	6718	0.0	0.6527240250074426
chr1	PDC-AS1	186456711	186456852	0	142	4385	6863	4385	6721	0.0	0.6524326737092695
chr1	PLA2G4A	186932762	186932899	0	138	504	2897	504	2759	0.0	0.182674882203697
chr1	LINC01036	187326920	187327023	0	104	0	12115	0	12011	0.0	0.0
chr1	LINC01036	187417910	187418003	0	94	0	12115	0	12021	0.0	0.0
chr1	LINC01036	187092824	187092946	0	123	0	12115	0	11992	0.0	0.0
chr1	LINC01036	187303465	187303539	0	75	0	12115	0	12040	0.0	0.0
chr1	LINC01036	187675351	187675442	0	92	0	12115	0	12023	0.0	0.0
chr1	LINC01035	189036038	189036345	0	308	0	1396	0	1088	0.0	0.0
chr1	RGS1	192576284	192576365	0	82	0	4077	0	3995	0.0	0.0
chr1	RGS13	192638163	192638203	0	41	0	5934	0	5893	0.0	0.0
chr1	RO60	193075819	193076040	38	222	69774	8943	69736	8721	0.17117117117117117	7.996330696021099
chr1	RO60	193069033	193069634	415	602	69774	8943	69359	8341	0.6893687707641196	8.315429804579786
chr1	RO60	193069033	193069181	364	149	69774	8943	69410	8794	2.442953020134228	7.892881510120537
chr1	RO60	193059873	193060222	27895	350	69774	8943	41879	8593	79.7	4.873618061212615
chr1	RO60	193084988	193085040	0	53	69774	8943	69774	8890	0.0	7.84859392575928
chr1	RO60	193070553	193070619	256	67	69774	8943	69518	8876	3.8208955223880596	7.83213159080667
chr1	CDC73	193161122	193161190	0	69	9045	10538	9045	10469	0.0	0.8639793676568918
chr1	CDC73	193236255	193236356	990	102	9045	10538	8055	10436	9.705882352941176	0.7718474511307014
chr1	CDC73	193237707	193237854	306	148	9045	10538	8739	10390	2.0675675675675675	0.841097208854668
chr1	CDC73	193141072	193141142	0	71	9045	10538	9045	10467	0.0	0.8641444539982803
chr1	CDC73	193127847	193128138	0	292	9045	10538	9045	10246	0.0	0.8827835252781573
chr1	LINC01031	193349132	193349275	0	144	0	2025	0	1881	0.0	0.0
chr1	LINC01031	193363220	193363298	0	79	0	2025	0	1946	0.0	0.0
chr1	CFH	196677475	196677667	0	193	0	7513	0	7320	0.0	0.0
chr1	CFHR3	196788744	196788944	0	201	153	3366	153	3165	0.0	0.04834123222748815
chr1	CFHR3	196788215	196788398	0	184	153	3366	153	3182	0.0	0.04808296668761785
chr1	CFHR1	196828069	196828246	0	178	0	2230	0	2052	0.0	0.0
chr1	CFHR2	196949454	196949649	0	196	0	2757	0	2561	0.0	0.0
chr1	CFHR2	196950851	196951028	0	178	0	2757	0	2579	0.0	0.0
chr1	CFHR2	196948298	196948553	0	256	0	2757	0	2501	0.0	0.0
chr1	CFHR2	196949616	196949649	0	34	0	2757	0	2723	0.0	0.0
chr1	CFHR2	196950899	196951028	0	130	0	2757	0	2627	0.0	0.0
chr1	CRB1	197428973	197429108	0	136	2601	9131	2601	8995	0.0	0.2891606448026682
chr1	LHX9	197913014	197913120	0	107	0	6492	0	6385	0.0	0.0
chr1	NEK7	198220998	198221110	0	113	416	5465	416	5352	0.0	0.07772795216741404
chr1	PTPRC	198699563	198699704	0	142	0	9077	0	8935	0.0	0.0
chr1	PTPRC	198696711	198696909	0	199	0	9077	0	8878	0.0	0.0
chr1	PTPRC	198702386	198702530	0	145	0	9077	0	8932	0.0	0.0
chr1	PTPRC	198694017	198694140	0	124	0	9077	0	8953	0.0	0.0
chr1	AC096631.1	198975080	198975351	0	272	0	1889	0	1617	0.0	0.0
chr1	NR5A2	200029032	200029728	0	697	102	7555	102	6858	0.0	0.014873140857392825
chr1	NR5A2	200039657	200039795	0	139	102	7555	102	7416	0.0	0.013754045307443365
chr1	NR5A2	200038700	200038772	0	73	102	7555	102	7482	0.0	0.0136327185244587
chr1	AC104461.1	200472040	200472119	0	80	378	4073	378	3993	0.0	0.0946656649135988
chr1	AC104461.1	200444617	200444945	16	329	378	4073	362	3744	0.0486322188449848	0.09668803418803419
chr1	AC104461.1	200444613	200444945	24	333	378	4073	354	3740	0.07207207207207207	0.0946524064171123
chr1	CAMSAP2	200828572	200828605	1841	34	3045	7795	1204	7761	54.14705882352941	0.15513464759695916
chr1	MROH3P	200957706	200957826	0	121	663	3084	663	2963	0.0	0.22375970300371245
chr1	IGFN1	201224678	201224874	0	197	566674	12141	566674	11944	0.0	47.44423978566644
chr1	PKP1	201319815	201319878	0	64	0	5800	0	5736	0.0	0.0
chr1	NAV1	201790553	201790577	208	25	562422	19125	562214	19100	8.32	29.435287958115183
chr1	NAV1	201788467	201788638	0	172	562422	19125	562422	18953	0.0	29.674563393657998
chr1	NAV1	201804488	201804497	0	10	562422	19125	562422	19115	0.0	29.423070886738163
chr1	NAV1	201794171	201794246	2161	76	562422	19125	560261	19049	28.43421052631579	29.411570161163315
chr1	NAV1	201787652	201787768	204	117	562422	19125	562218	19008	1.7435897435897436	29.577967171717173
chr1	RNPEP	201989382	201989531	0	150	315	3183	315	3033	0.0	0.10385756676557864
chr1	RNPEP	201996146	201996263	0	118	315	3183	315	3065	0.0	0.10277324632952692
chr1	RNPEP	201997318	201997554	0	237	315	3183	315	2946	0.0	0.10692464358452139
chr1	RNPEP	201999901	202000015	0	115	315	3183	315	3068	0.0	0.10267275097783572
chr1	ELF3	202011128	202011299	0	172	0	4243	0	4071	0.0	0.0
chr1	ELF3	202011128	202011293	0	166	0	4243	0	4077	0.0	0.0
chr1	PTPRVP	202168844	202169116	0	273	0	6628	0	6355	0.0	0.0
chr1	PTPRVP	202187630	202187707	0	78	0	6628	0	6550	0.0	0.0
chr1	PTPRVP	202184681	202184779	0	99	0	6628	0	6529	0.0	0.0
chr1	PTPRVP	202187852	202187981	0	130	0	6628	0	6498	0.0	0.0
chr1	LGR6	202280780	202280852	0	73	40953	4502	40953	4429	0.0	9.246556784827275
chr1	LGR6	202276305	202276521	0	217	40953	4502	40953	4285	0.0	9.557292882147024
chr1	PPP1R12B	202422619	202422738	0	120	742	21018	742	20898	0.0	0.03550579002775385
chr1	PPP1R12B	202434655	202434768	0	114	742	21018	742	20904	0.0	0.03549559892843475
chr1	PPP1R12B	202445045	202445228	0	184	742	21018	742	20834	0.0	0.035614860324469616
chr1	PPP1R12B	202425565	202425725	0	161	742	21018	742	20857	0.0	0.035575586134151606
chr1	PPP1R12B	202443086	202443127	0	42	742	21018	742	20976	0.0	0.03537376048817696
chr1	PPP1R12B	202575001	202575182	0	182	742	21018	742	20836	0.0	0.03561144173545786
chr1	PPP1R12B	202501858	202502005	0	148	742	21018	742	20870	0.0	0.035553425970292284
chr1	PPFIA4	203061651	203061678	0	28	19864	8892	19864	8864	0.0	2.240974729241877
chr1	PPFIA4	203048917	203048980	0	64	19864	8892	19864	8828	0.0	2.2501132759401905
chr1	ADORA1	203128277	203128432	0	156	153	4200	153	4044	0.0	0.037833827893175076
chr1	ADORA1	203128784	203129182	0	399	153	4200	153	3801	0.0	0.04025256511444357
chr1	ATP2B4	203733222	203733400	0	179	249067	9518	249067	9339	0.0	26.669557768497697
chr1	ZC3H11A	203796292	203796496	1020	205	13902	8033	12882	7828	4.975609756097561	1.645631067961165
chr1	ZC3H11A	203796450	203796607	102	158	13902	8033	13800	7875	0.6455696202531646	1.7523809523809524
chr1	ZC3H11A	203833936	203834102	0	167	13902	8033	13902	7866	0.0	1.7673531655225019
chr1	ZC3H11A	203796292	203796601	1122	310	13902	8033	12780	7723	3.6193548387096772	1.6547973585394278
chr1	SOX13	204112914	204113134	612	221	37721	6980	37109	6759	2.769230769230769	5.490309217339843
chr1	MDM4	204544534	204544684	297	151	19945	10513	19648	10362	1.966887417218543	1.8961590426558579
chr1	MDM4	204537429	204537497	1313	69	19945	10513	18632	10444	19.028985507246375	1.7839908081194944
chr1	MDM4	204542783	204542944	0	162	19945	10513	19945	10351	0.0	1.9268669693749396
chr1	MDM4	204537458	204537497	240	40	19945	10513	19705	10473	6.0	1.8815048219230401
chr1	MDM4	204538208	204538308	0	101	19945	10513	19945	10412	0.0	1.9155781790242028
chr1	NFASC	204977680	204977725	0	46	10570	21307	10570	21261	0.0	0.497154414185598
chr1	NFASC	204985909	204986114	1076	206	10570	21307	9494	21101	5.223300970873787	0.44993128287758877
chr1	NFASC	204950556	204950574	0	19	10570	21307	10570	21288	0.0	0.4965238632093198
chr1	NFASC	204997169	204997406	0	238	10570	21307	10570	21069	0.0	0.5016849399591817
chr1	NFASC	204962107	204962158	420	52	10570	21307	10150	21255	8.076923076923077	0.47753469771818396
chr1	NFASC	204984026	204984142	0	117	10570	21307	10570	21190	0.0	0.49882019820670126
chr1	NFASC	204991291	204991306	0	16	10570	21307	10570	21291	0.0	0.49645390070921985
chr1	NFASC	205002595	205002748	0	154	10570	21307	10570	21153	0.0	0.4996927149813265
chr1	CNTN2	205073655	205073841	0	187	172972	14396	172972	14209	0.0	12.17341121824196
chr1	CNTN2	205073655	205073912	0	258	172972	14396	172972	14138	0.0	12.2345451973405
chr1	CNTN2	205066069	205066220	0	152	172972	14396	172972	14244	0.0	12.14349901713002
chr1	TMCC2	205256329	205256416	0	88	183510	5657	183510	5569	0.0	32.9520560244209
chr1	TMCC2	205268949	205269884	153	936	183510	5657	183357	4721	0.16346153846153846	38.83859351832239
chr1	CDK18	205530258	205530349	0	92	57	5600	57	5508	0.0	0.010348583877995643
chr1	CDK18	205523146	205523297	0	152	57	5600	57	5448	0.0	0.010462555066079295
chr1	MFSD4A	205597779	205597850	235	72	49432	5662	49197	5590	3.263888888888889	8.800894454382826
chr1	MFSD4A	205579750	205579949	4965	200	49432	5662	44467	5462	24.825	8.141157085316733
chr1	MFSD4A	205580660	205580921	13537	262	49432	5662	35895	5400	51.66793893129771	6.647222222222222
chr1	AC119673.2	205853787	205853874	0	88	9399	5942	9399	5854	0.0	1.6055688418175607
chr1	AC119673.2	205864132	205864257	2178	126	9399	5942	7221	5816	17.285714285714285	1.2415749656121045
chr1	AC119673.2	205858142	205858320	0	179	9399	5942	9399	5763	0.0	1.6309213951067152
chr1	AC119673.2	205858142	205858289	0	148	9399	5942	9399	5794	0.0	1.622195374525371
chr1	AC119673.2	205868769	205868833	0	65	9399	5942	9399	5877	0.0	1.599285349668198
chr1	AC119673.2	205858142	205858293	0	152	9399	5942	9399	5790	0.0	1.6233160621761658
chr1	AC119673.2	205882514	205882549	0	36	9399	5942	9399	5906	0.0	1.5914324415848289
chr1	AC119673.2	205836238	205836303	0	66	9399	5942	9399	5876	0.0	1.5995575221238938
chr1	BX571818.1	206060726	206060833	0	108	0	1910	0	1802	0.0	0.0
chr1	RHEX	206099654	206099798	0	145	1756	1728	1756	1583	0.0	1.1092861655085282
chr1	SRGAP2	206458370	206458409	0	40	0	12849	0	12809	0.0	0.0
chr1	IKBKE	206473195	206473314	0	120	474	3813	474	3693	0.0	0.12835093419983754
chr1	IKBKE	206493265	206493378	0	114	474	3813	474	3699	0.0	0.1281427412814274
chr1	RASSF5	206585179	206585295	0	117	31782	5452	31782	5335	0.0	5.9572633552014995
chr1	DYRK3	206636874	206636968	8273	95	176936	10320	168663	10225	87.08421052631579	16.49515892420538
chr1	DYRK3	206638924	206639042	0	119	176936	10320	176936	10201	0.0	17.344966179786294
chr1	IL20	206867383	206867458	0	76	2378	1573	2378	1497	0.0	1.5885103540414163
chr1	IL24	206899316	206899515	172	200	174456	1986	174284	1786	0.86	97.58342665173572
chr1	IL24	206901493	206901652	480	160	174456	1986	173976	1826	3.0	95.27710843373494
chr1	IL24	206899319	206899515	166	197	174456	1986	174290	1789	0.8426395939086294	97.4231414197876
chr1	IL24	206897730	206897876	0	147	174456	1986	174456	1839	0.0	94.86460032626428
chr1	PFKFB2	207034945	207035080	0	136	4875	7139	4875	7003	0.0	0.6961302299014708
chr1	PFKFB2	207049463	207049617	0	155	4875	7139	4875	6984	0.0	0.6980240549828178
chr1	PFKFB2	207060845	207060930	0	86	4875	7139	4875	7053	0.0	0.6911952360697575
chr1	C4BPA	207114675	207114771	0	97	0	2483	0	2386	0.0	0.0
chr1	CD55	207324558	207324750	0	193	729	5771	729	5578	0.0	0.13069200430261743
chr1	CD55	207347446	207347561	0	116	729	5771	729	5655	0.0	0.12891246684350133
chr1	CD55	207340390	207340508	0	119	729	5771	729	5652	0.0	0.12898089171974522
chr1	CD55	207354006	207354099	0	94	729	5771	729	5677	0.0	0.12841289413422582
chr1	CD55	207322235	207322289	0	55	729	5771	729	5716	0.0	0.1275367389783065
chr1	CD55	207370708	207370834	0	127	729	5771	729	5644	0.0	0.1291637136782424
chr1	CR2	207471422	207471499	0	78	0	4907	0	4829	0.0	0.0
chr1	CR2	207476233	207476419	0	187	0	4907	0	4720	0.0	0.0
chr1	CR2	207473544	207473721	0	178	0	4907	0	4729	0.0	0.0
chr1	CD46	207757013	207757202	0	190	102	7781	102	7591	0.0	0.013436964826768542
chr1	CD46	207767778	207767823	0	46	102	7781	102	7735	0.0	0.013186813186813187
chr1	CD46	207770320	207770362	0	43	102	7781	102	7738	0.0	0.013181700697854742
chr1	CD46	207790252	207790345	0	94	102	7781	102	7687	0.0	0.013269155717445037
chr1	CD46	207767606	207767651	0	46	102	7781	102	7735	0.0	0.013186813186813187
chr1	CD46	207785618	207785682	0	65	102	7781	102	7716	0.0	0.013219284603421462
chr1	MIR205HG	209430424	209430500	0	77	0	2601	0	2524	0.0	0.0
chr1	MIR205HG	209431742	209431825	0	84	0	2601	0	2517	0.0	0.0
chr1	MIR205HG	209430424	209430476	0	53	0	2601	0	2548	0.0	0.0
chr1	MIR205HG	209429567	209429620	0	54	0	2601	0	2547	0.0	0.0
chr1	CAMK1G	209607857	209607933	0	77	0	3342	0	3265	0.0	0.0
chr1	CAMK1G	209598274	209598922	0	649	0	3342	0	2693	0.0	0.0
chr1	TRAF3IP3	209777351	209777487	0	137	0	5521	0	5384	0.0	0.0
chr1	TRAF3IP3	209780469	209780606	0	138	0	5521	0	5383	0.0	0.0
chr1	TRAF3IP3	209758725	209758854	0	130	0	5521	0	5391	0.0	0.0
chr1	SYT14	210159420	210159477	0	58	98699	13990	98699	13932	0.0	7.084338214183175
chr1	SYT14	209953054	209953259	3539	206	98699	13990	95160	13784	17.179611650485437	6.903656413232734
chr1	SYT14	210015683	210017099	90462	1417	98699	13990	8237	12573	63.84050811573747	0.6551340173387418
chr1	SYT14	209965892	209966013	0	122	98699	13990	98699	13868	0.0	7.117032016152293
chr1	SYT14	210159399	210159477	0	79	98699	13990	98699	13911	0.0	7.0950327079289774
chr1	HHAT	210400467	210400662	0	196	1871	6661	1871	6465	0.0	0.2894044856921887
chr1	HHAT	210348932	210349066	0	135	1871	6661	1871	6526	0.0	0.28669935642047195
chr1	HHAT	210404463	210404679	0	217	1871	6661	1871	6444	0.0	0.2903476101800124
chr1	RCOR3	211304082	211304140	0	59	51	9078	51	9019	0.0	0.005654728905643641
chr1	RCOR3	211312719	211312961	0	243	51	9078	51	8835	0.0	0.005772495755517827
chr1	RCOR3	211267774	211267870	0	97	51	9078	51	8981	0.0	0.005678654938202873
chr1	RCOR3	211291523	211291599	0	77	51	9078	51	9001	0.0	0.0056660371069881124
chr1	RCOR3	211271527	211271874	0	348	51	9078	51	8730	0.0	0.00584192439862543
chr1	RCOR3	211312719	211312835	0	117	51	9078	51	8961	0.0	0.005691329092735186
chr1	RCOR3	211312354	211312487	0	134	51	9078	51	8944	0.0	0.005702146690518784
chr1	LINC00467	211399376	211399437	0	62	23936	6958	23936	6896	0.0	3.4709976798143853
chr1	LINC00467	211390563	211390670	0	108	23936	6958	23936	6850	0.0	3.4943065693430655
chr1	LINC00467	211394951	211395001	0	51	23936	6958	23936	6907	0.0	3.4654698132329522
chr1	LINC00467	211422538	211422639	0	102	23936	6958	23936	6856	0.0	3.4912485414235706
chr1	LINC00467	211422538	211422700	0	163	23936	6958	23936	6795	0.0	3.522590139808683
chr1	LINC00467	211384441	211384534	0	94	23936	6958	23936	6864	0.0	3.4871794871794872
chr1	LINC00467	211428416	211428575	0	160	23936	6958	23936	6798	0.0	3.5210355987055015
chr1	LINC00467	211422538	211422670	0	133	23936	6958	23936	6825	0.0	3.507106227106227
chr1	LINC01693	211639971	211640189	0	219	19	2205	19	1986	0.0	0.009566968781470292
chr1	LINC01693	211640218	211640360	0	143	19	2205	19	2062	0.0	0.00921435499515034
chr1	LINC01693	211639971	211640360	0	390	19	2205	19	1815	0.0	0.01046831955922865
chr1	LINC01693	211639996	211640189	0	194	19	2205	19	2011	0.0	0.009448035803083043
chr1	LINC01693	211640246	211640360	0	115	19	2205	19	2090	0.0	0.00909090909090909
chr1	LINC01693	211643292	211643431	0	140	19	2205	19	2065	0.0	0.009200968523002421
chr1	LINC01693	211650737	211650815	0	79	19	2205	19	2126	0.0	0.008936970837253057
chr1	DTL	212068223	212068327	0	105	51	4939	51	4834	0.0	0.010550268928423666
chr1	DTL	212042992	212043118	0	127	51	4939	51	4812	0.0	0.01059850374064838
chr1	NENF	212442564	212442625	0	62	0	1269	0	1207	0.0	0.0
chr1	ATF3	212619045	212619266	101234	222	238746	3955	137512	3733	456.009009009009	36.83686043396732
chr1	TATDN3	212797111	212797196	0	86	4478	3983	4478	3897	0.0	1.149089042853477
chr1	TATDN3	212802700	212802763	0	64	4478	3983	4478	3919	0.0	1.1426384281704516
chr1	TATDN3	212807735	212807848	0	114	4478	3983	4478	3869	0.0	1.1574050142155596
chr1	FLVCR1	212872677	212872818	0	142	4706	6434	4706	6292	0.0	0.7479338842975206
chr1	FLVCR1	212887890	212888001	0	112	4706	6434	4706	6322	0.0	0.74438468838975
chr1	VASH2	212951338	212951818	1107	481	73964	8706	72857	8225	2.3014553014553014	8.857993920972644
chr1	RPS6KC1	213117316	213117410	0	95	12784	6207	12784	6112	0.0	2.0916230366492146
chr1	RPS6KC1	213176399	213176492	1001	94	12784	6207	11783	6113	10.648936170212766	1.927531490266645
chr1	RPS6KC1	213072869	213072986	0	118	12784	6207	12784	6089	0.0	2.0995237313187713
chr1	RPS6KC1	213071005	213071041	2	37	12784	6207	12782	6170	0.05405405405405406	2.071636952998379
chr1	RPS6KC1	213077695	213077816	0	122	12784	6207	12784	6085	0.0	2.1009038619556284
chr1	RPS6KC1	213125765	213125843	0	79	12784	6207	12784	6128	0.0	2.0861618798955615
chr1	SMYD2	214305186	214305250	0	65	97	3948	97	3883	0.0	0.02498068503734226
chr1	KCNK2	215171996	215172183	0	188	0	3448	0	3260	0.0	0.0
chr1	KCNK2	215124632	215124750	0	119	0	3448	0	3329	0.0	0.0
chr1	KCTD3	215618087	215618154	0	68	0	4395	0	4327	0.0	0.0
chr1	USH2A-AS2	216079964	216080041	0	78	0	779	0	701	0.0	0.0
chr1	SPATA17	217665278	217665464	345	187	2457	6386	2112	6199	1.8449197860962567	0.3407001129214389
chr1	TGFB2	218363333	218363417	0	85	51	6058	51	5973	0.0	0.008538422903063787
chr1	LINC02869	218523352	218523450	0	99	1942	1248	1942	1149	0.0	1.690165361183638
chr1	LYPLAL1	219193129	219193251	0	123	0	2949	0	2826	0.0	0.0
chr1	LYPLAL1	219193081	219193251	0	171	0	2949	0	2778	0.0	0.0
chr1	MARK1	220599797	220599863	0	67	51	13355	51	13288	0.0	0.0038380493678506922
chr1	MARK1	220657789	220657834	0	46	51	13355	51	13309	0.0	0.0038319933879329775
chr1	MARK1	220604066	220604137	0	72	51	13355	51	13283	0.0	0.003839494090190469
chr1	MARK1	220576645	220576736	0	92	51	13355	51	13263	0.0	0.0038452838724270526
chr1	MARK1	220529671	220529771	0	101	51	13355	51	13254	0.0	0.003847894975101856
chr1	MTARC2	220754367	220754432	42	66	2140	2550	2098	2484	0.6363636363636364	0.8446054750402576
chr1	LINC02474	221968347	221968496	0	150	0	1370	0	1220	0.0	0.0
chr1	TAF1A-AS1	222590257	222590407	0	151	0	2263	0	2112	0.0	0.0
chr1	MIA3	222648828	222648850	598	23	29859	10160	29261	10137	26.0	2.8865542073591794
chr1	BROX	222731356	222731516	420	161	19340	4997	18920	4836	2.608695652173913	3.91232423490488
chr1	BROX	222722418	222722514	112	97	19340	4997	19228	4900	1.1546391752577319	3.924081632653061
chr1	DISP1	222928429	222928570	0	142	44593	10206	44593	10064	0.0	4.430941971383148
chr1	DISP1	222965426	222965477	0	52	44593	10206	44593	10154	0.0	4.391668308055938
chr1	DISP1	222899780	222899865	0	86	44593	10206	44593	10120	0.0	4.406422924901186
chr1	DISP1	222942806	222943332	0	527	44593	10206	44593	9679	0.0	4.607190825498502
chr1	DISP1	222872270	222872428	156	159	44593	10206	44437	10047	0.9811320754716981	4.422912312132975
chr1	AC138393.1	224002521	224002622	0	102	2173	3147	2173	3045	0.0	0.7136288998357964
chr1	AC138393.1	224007293	224007417	0	125	2173	3147	2173	3022	0.0	0.7190602250165453
chr1	FBXO28	224134073	224134212	0	140	38009	6025	38009	5885	0.0	6.4586236193712825
chr1	FBXO28	224153141	224153337	181	197	38009	6025	37828	5828	0.9187817258883249	6.490734385724091
chr1	CNIH4	224371282	224371423	1577	142	976876	4931	975299	4789	11.105633802816902	203.65399874712884
chr1	CNIH3	224513780	224513936	0	157	28800	6388	28800	6231	0.0	4.622051035146846
chr1	CNIH3	224546828	224546939	3801	112	28800	6388	24999	6276	33.9375	3.9832695984703634
chr1	CNIH3	224583163	224583267	171	105	28800	6388	28629	6283	1.6285714285714286	4.556581250994748
chr1	CNIH3	224587165	224587420	51	256	28800	6388	28749	6132	0.19921875	4.688356164383562
chr1	LINC02813	224772709	224773053	0	345	420	1589	420	1244	0.0	0.33762057877813506
chr1	LINC02813	224772639	224773053	0	415	420	1589	420	1174	0.0	0.3577512776831346
chr1	DNAH14	224960152	224960302	0	151	5066	19791	5066	19640	0.0	0.2579429735234216
chr1	DNAH14	225250655	225250703	0	49	5066	19791	5066	19742	0.0	0.2566102725154493
chr1	DNAH14	225271905	225272073	0	169	5066	19791	5066	19622	0.0	0.25817959433289167
chr1	DNAH14	225333290	225333506	1581	217	5066	19791	3485	19574	7.285714285714286	0.17804230101154592
chr1	DNAH14	225353802	225353888	0	87	5066	19791	5066	19704	0.0	0.2571051563134389
chr1	DNAH14	225140767	225141021	51	255	5066	19791	5015	19536	0.2	0.2567055692055692
chr1	DNAH14	225331436	225331577	0	142	5066	19791	5066	19649	0.0	0.25782482569087484
chr1	AC099066.2	225710502	225710568	0	67	67379	3554	67379	3487	0.0	19.322913679380555
chr1	SRP9	225786861	225786985	0	125	1991	2226	1991	2101	0.0	0.9476439790575916
chr1	SRP9	225789033	225789141	192	109	1991	2226	1799	2117	1.761467889908257	0.8497874350495985
chr1	PSEN2	226883704	226883919	0	216	4542	12917	4542	12701	0.0	0.3576096370364538
chr1	PSEN2	226890034	226890133	0	100	4542	12917	4542	12817	0.0	0.3543730982289147
chr1	PSEN2	226910588	226910757	0	170	4542	12917	4542	12747	0.0	0.3563191339138621
chr1	AL391628.1	226933476	226933598	0	123	561	9653	561	9530	0.0	0.05886673662119622
chr1	PSEN2	226890655	226890965	34	311	4542	12917	4508	12606	0.10932475884244373	0.35760748849754087
chr1	PSEN2	226871261	226871404	0	144	4542	12917	4542	12773	0.0	0.35559383073671025
chr1	PSEN2	226889757	226889926	0	170	4542	12917	4542	12747	0.0	0.3563191339138621
chr1	PSEN2	226894006	226894125	0	120	4542	12917	4542	12797	0.0	0.35492693600062514
chr1	PSEN2	226895423	226895587	357	165	4542	12917	4185	12752	2.1636363636363636	0.32818381430363863
chr1	PSEN2	226897719	226899555	154	1837	4542	12917	4388	11080	0.08383233532934131	0.396028880866426
chr1	PSEN2	226885460	226885679	0	220	4542	12917	4542	12697	0.0	0.35772229660549737
chr1	PSEN2	226883709	226883919	0	211	4542	12917	4542	12706	0.0	0.35746891232488587
chr1	PSEN2	226880468	226880724	612	257	4542	12917	3930	12660	2.3813229571984436	0.3104265402843602
chr1	PSEN2	226881540	226881711	175	172	4542	12917	4367	12745	1.0174418604651163	0.3426441741859553
chr1	ZNF678	227582513	227582606	0	94	161	8921	161	8827	0.0	0.01823949246629659
chr1	ZNF678	227650955	227651076	0	122	161	8921	161	8799	0.0	0.018297533810660304
chr1	SNAP47	227747691	227748233	0	543	18	6591	18	6048	0.0	0.002976190476190476
chr1	GUK1	228147405	228147544	20	140	35	2999	15	2859	0.14285714285714285	0.005246589716684155
chr1	GUK1	228148370	228148456	0	87	35	2999	35	2912	0.0	0.01201923076923077
chr1	GUK1	228141625	228141829	0	205	35	2999	35	2794	0.0	0.012526843235504653
chr1	GUK1	228141123	228141288	0	166	35	2999	35	2833	0.0	0.012354394634662902
chr1	GUK1	228148233	228148284	0	52	35	2999	35	2947	0.0	0.011876484560570071
chr1	GUK1	228148370	228148539	0	170	35	2999	35	2829	0.0	0.012371862849063274
chr1	GUK1	228141632	228141829	0	198	35	2999	35	2801	0.0	0.012495537308104248
chr1	GUK1	228147409	228147544	20	136	35	2999	15	2863	0.14705882352941177	0.005239259517988124
chr1	OBSCN	228214173	228214434	0	262	3355766	37944	3355766	37682	0.0	89.05488031420838
chr1	OBSCN	228219323	228219599	0	277	3355766	37944	3355766	37667	0.0	89.09034433323599
chr1	OBSCN	228259500	228259776	510	277	3355766	37944	3355256	37667	1.8411552346570397	89.07680463004752
chr1	OBSCN	228277504	228277666	425	163	3355766	37944	3355341	37781	2.607361963190184	88.81027500595538
chr1	OBSCN	228292522	228292786	0	265	3355766	37944	3355766	37679	0.0	89.06197085909923
chr1	OBSCN	228336199	228336270	2415	72	3355766	37944	3353351	37872	33.541666666666664	88.54433354457119
chr1	OBSCN	228350840	228350943	0	104	3355766	37944	3355766	37840	0.0	88.68303382663848
chr1	OBSCN	228224458	228224734	0	277	3355766	37944	3355766	37667	0.0	89.09034433323599
chr1	OBSCN	228376646	228376698	0	53	3355766	37944	3355766	37891	0.0	88.56366947296192
chr1	LINC01736	230005957	230006024	0	68	357	1189	357	1121	0.0	0.3184656556645852
chr1	LINC01736	230005957	230006098	0	142	357	1189	357	1047	0.0	0.34097421203438394
chr1	COG2	230661324	230661557	0	234	148	10610	148	10376	0.0	0.014263685427910563
chr1	CAPN9	230774553	230774631	0	79	5015	2613	5015	2534	0.0	1.979084451460142
chr1	CAPN9	230798161	230798220	0	60	5015	2613	5015	2553	0.0	1.964355660007834
chr1	ARV1	230988319	230988439	0	121	33081	2003	33081	1882	0.0	17.577577045696067
chr1	ARV1	230990599	230990698	0	100	33081	2003	33081	1903	0.0	17.383604834471885
chr1	ARV1	230999622	230999801	0	180	33081	2003	33081	1823	0.0	18.146461876028525
chr1	GNPAT	231250960	231251143	0	184	0	2954	0	2770	0.0	0.0
chr1	GNPAT	231258221	231258309	0	89	0	2954	0	2865	0.0	0.0
chr1	SPRTN	231347796	231347925	0	130	306	5825	306	5695	0.0	0.05373134328358209
chr1	SPRTN	231344622	231344714	0	93	306	5825	306	5732	0.0	0.053384508025122124
chr1	TSNAX-DISC1	231617952	231618059	0	108	10907	4222	10907	4114	0.0	2.6511910549343702
chr1	DISC1	231701954	231702024	9200	71	32525	12565	23325	12494	129.57746478873239	1.8668961101328638
chr1	DISC1	231749925	231750076	0	152	32525	12565	32525	12413	0.0	2.6202368484653187
chr1	DISC1	231767139	231767269	0	131	32525	12565	32525	12434	0.0	2.6158114846388933
chr1	DISC1	231800107	231800210	0	104	32525	12565	32525	12461	0.0	2.610143648182329
chr1	TSNAX-DISC1	231561127	231561255	0	129	10907	4222	10907	4093	0.0	2.664793549963352
chr1	TSNAX-DISC1	231616643	231616906	0	264	10907	4222	10907	3958	0.0	2.7556846892369884
chr1	DISC1	231795241	231795296	0	56	32525	12565	32525	12509	0.0	2.6001279079063075
chr1	DISC1	231958827	231958888	0	62	32525	12565	32525	12503	0.0	2.6013756698392387
chr1	DISC1	231774638	231774817	0	180	32525	12565	32525	12385	0.0	2.626160678239806
chr1	DISC1	231693825	231694805	1707	981	32525	12565	30818	11584	1.7400611620795108	2.66039364640884
chr1	DISC1	231813229	231813381	0	153	32525	12565	32525	12412	0.0	2.6204479535932967
chr1	DISC1	231770834	231771070	0	237	32525	12565	32525	12328	0.0	2.6383030499675537
chr1	NTPCR	232956346	232956443	0	98	153	15861	153	15763	0.0	0.00970627418638584
chr1	NTPCR	232969908	232970118	0	211	153	15861	153	15650	0.0	0.009776357827476038
chr1	NTPCR	232955556	232955719	0	164	153	15861	153	15697	0.0	0.009747085430337006
chr1	AL357556.3	235335241	235335334	0	94	17682	5210	17682	5116	0.0	3.456215793588741
chr1	TBCE	235380018	235380149	0	132	11570	8049	11570	7917	0.0	1.4614121510673235
chr1	TBCE	235419472	235419561	21	90	11570	8049	11549	7959	0.23333333333333334	1.451061691167232
chr1	TBCE	235430704	235430804	0	101	11570	8049	11570	7948	0.0	1.4557121288374433
chr1	TBCE	235434203	235434280	0	78	11570	8049	11570	7971	0.0	1.4515117300213274
chr1	TBCE	235419416	235419561	51	146	11570	8049	11519	7903	0.3493150684931507	1.4575477666708845
chr1	TBCE	235438768	235438922	1020	155	11570	8049	10550	7894	6.580645161290323	1.3364580694198125
chr1	AL357556.3	235363013	235363128	0	116	17682	5210	17682	5094	0.0	3.471142520612485
chr1	TBCE	235401502	235401587	0	86	11570	8049	11570	7963	0.0	1.4529699861861107
chr1	TBCE	235414432	235414618	0	187	11570	8049	11570	7862	0.0	1.4716357161027729
chr1	TBCE	235432945	235433171	0	227	11570	8049	11570	7822	0.0	1.4791613398107901
chr1	AL357556.3	235342835	235342883	0	49	17682	5210	17682	5161	0.0	3.426080217012207
chr1	AL357556.3	235367101	235367504	78	404	17682	5210	17604	4806	0.19306930693069307	3.662921348314607
chr1	AL357556.3	235359826	235359944	459	119	17682	5210	17223	5091	3.857142857142857	3.3830288744843844
chr1	TBCE	235435744	235436608	51	865	11570	8049	11519	7184	0.058959537572254334	1.603424276169265
chr1	TBCE	235438768	235438988	2000	221	11570	8049	9570	7828	9.049773755656108	1.2225344915687277
chr1	TBCE	235432945	235433098	0	154	11570	8049	11570	7895	0.0	1.4654844838505383
chr1	TBCE	235413875	235413997	0	123	11570	8049	11570	7926	0.0	1.459752712591471
chr1	TBCE	235427139	235427239	140	101	11570	8049	11430	7948	1.386138613861386	1.438097634625063
chr1	TBCE	235438768	235438926	1020	159	11570	8049	10550	7890	6.415094339622642	1.3371356147021547
chr1	TBCE	235419416	235419515	51	100	11570	8049	11519	7949	0.51	1.4491130959869165
chr1	GPR137B	236178413	236178636	0	224	12242	2304	12242	2080	0.0	5.885576923076923
chr1	GPR137B	236168705	236168755	0	51	12242	2304	12242	2253	0.0	5.43364403018198
chr1	LGALS8	236523969	236524061	0	93	1748	9039	1748	8946	0.0	0.19539458976078694
chr1	LGALS8	236537496	236537585	0	90	1748	9039	1748	8949	0.0	0.19532908704883228
chr1	LGALS8	236518423	236518500	0	78	1748	9039	1748	8961	0.0	0.19506751478629616
chr1	LGALS8	236540563	236540683	0	121	1748	9039	1748	8918	0.0	0.19600807355909397
chr1	LGALS8	236542914	236543040	0	127	1748	9039	1748	8912	0.0	0.19614003590664272
chr1	LGALS8	236525423	236525545	0	123	1748	9039	1748	8916	0.0	0.19605204127411396
chr1	LGALS8	236523388	236523624	0	237	1748	9039	1748	8802	0.0	0.1985912292660759
chr1	ACTN2	236727677	236727756	1020	80	30324	5985	29304	5905	12.75	4.962574089754446
chr1	ACTN2	236734432	236734518	0	87	30324	5985	30324	5898	0.0	5.1414038657171925
chr1	ACTN2	236737121	236737214	0	94	30324	5985	30324	5891	0.0	5.147513155661178
chr1	ACTN2	236735634	236735720	850	87	30324	5985	29474	5898	9.770114942528735	4.997287216005425
chr1	ACTN2	236736557	236736668	0	112	30324	5985	30324	5873	0.0	5.163289630512515
chr1	ACTN2	236725932	236726020	0	89	30324	5985	30324	5896	0.0	5.14314789687924
chr1	MTR	236803427	236803642	0	216	10583	12378	10583	12162	0.0	0.8701693800361783
chr1	MTR	236808703	236808773	0	71	10583	12378	10583	12307	0.0	0.859917120338019
chr1	MTR	236831965	236832078	0	114	10583	12378	10583	12264	0.0	0.8629321591650359
chr1	MTR	236861124	236861277	0	154	10583	12378	10583	12224	0.0	0.865755890052356
chr1	MTR	236907044	236907206	0	163	10583	12378	10583	12215	0.0	0.8663937781416291
chr1	RYR2	237678047	237678112	0	66	1835	17966	1835	17900	0.0	0.10251396648044693
chr1	RYR2	237687454	237687504	0	51	1835	17966	1835	17915	0.0	0.10242813284956741
chr1	RYR2	237726272	237726308	0	37	1835	17966	1835	17929	0.0	0.10234815104021418
chr1	RYR2	237830529	237830630	0	102	1835	17966	1835	17864	0.0	0.1027205553067622
chr1	RYR2	237743599	237743623	0	25	1835	17966	1835	17941	0.0	0.10227969455437266
chr1	RYR2	237755060	237755117	0	58	1835	17966	1835	17908	0.0	0.10246817064998884
chr1	RYR2	237769586	237769619	0	34	1835	17966	1835	17932	0.0	0.1023310283292438
chr1	FMN2	240180168	240180180	0	13	0	9266	0	9253	0.0	0.0
chr1	AL365184.1	240770765	240770902	0	138	24	2738	24	2600	0.0	0.009230769230769232
chr1	AL365184.1	240774525	240774600	0	76	24	2738	24	2662	0.0	0.009015777610818933
chr1	AL365184.1	240765437	240765599	0	163	24	2738	24	2575	0.0	0.009320388349514564
chr1	AL359764.1	241360455	241360613	0	159	0	3176	0	3017	0.0	0.0
chr1	AL359764.2	241447125	241447271	0	147	51	9640	51	9493	0.0	0.005372379648161804
chr1	AL359764.2	241436324	241436522	0	199	51	9640	51	9441	0.0	0.005401970130282809
chr1	AL359764.2	241436324	241436503	0	180	51	9640	51	9460	0.0	0.005391120507399577
chr1	AL359764.2	241424625	241424714	0	90	51	9640	51	9550	0.0	0.005340314136125655
chr1	AL359764.2	241430226	241430385	0	160	51	9640	51	9480	0.0	0.005379746835443038
chr1	KMO	241590050	241590113	0	64	34	4774	34	4710	0.0	0.007218683651804671
chr1	KMO	241590011	241590113	0	103	34	4774	34	4671	0.0	0.007278955255833868
chr1	WDR64	241783271	241783381	0	111	58328	4968	58328	4857	0.0	12.009059089973235
chr1	WDR64	241790590	241790696	0	107	58328	4968	58328	4861	0.0	11.99917712404855
chr1	EXO1	241849111	241849216	0	106	102	4110	102	4004	0.0	0.025474525474525476
chr1	EXO1	241852291	241852411	0	121	102	4110	102	3989	0.0	0.025570318375532714
chr1	EXO1	241853357	241853481	0	125	102	4110	102	3985	0.0	0.025595984943538267
chr1	EXO1	241881915	241882017	0	103	102	4110	102	4007	0.0	0.02545545295732468
chr1	EXO1	241849108	241849216	0	109	102	4110	102	4001	0.0	0.02549362659335166
chr1	SDCCAG8	243293090	243293219	1084	130	14864	5112	13780	4982	8.338461538461539	2.765957446808511
chr1	SDCCAG8	243293398	243293494	972	97	14864	5112	13892	5015	10.02061855670103	2.770089730807577
chr1	C1ORF100	244378562	244378639	0	78	0	1156	0	1078	0.0	0.0
chr1	C1ORF100	244378466	244378639	0	174	0	1156	0	982	0.0	0.0
chr1	CATSPERE	244463907	244463956	0	50	62814	4458	62814	4408	0.0	14.25
chr1	CATSPERE	244490446	244490471	0	26	62814	4458	62814	4432	0.0	14.172833935018051
chr1	CATSPERE	244518591	244518698	0	108	62814	4458	62814	4350	0.0	14.44
chr1	CATSPERE	244617528	244617686	0	159	62814	4458	62814	4299	0.0	14.611304954640614
chr1	CATSPERE	244499001	244499079	0	79	62814	4458	62814	4379	0.0	14.344370860927153
chr1	CATSPERE	244552321	244552814	153	494	62814	4458	62661	3964	0.3097165991902834	15.807517658930374
chr1	COX20	244836484	244836520	0	37	5145	4575	5145	4538	0.0	1.133759365359189
chr1	COX20	244841943	244842058	860	116	5145	4575	4285	4459	7.413793103448276	0.9609777977124916
chr1	EFCAB2	245017241	245017326	138200	86	140801	8154	2601	8068	1606.9767441860465	0.32238472979672783
chr1	EFCAB2	245002120	245002232	811	113	140801	8154	139990	8041	7.176991150442478	17.409526178336026
chr1	SMYD3-AS1	246109075	246109434	0	360	0	945	0	585	0.0	0.0
chr1	CNST	246621428	246621634	0	207	7449	5943	7449	5736	0.0	1.2986401673640167
chr1	LINC01341	246781478	246781627	0	150	4644	4672	4644	4522	0.0	1.0269792127377266
chr1	NLRP3	247429584	247429755	0	172	129	4587	129	4415	0.0	0.029218573046432616
chr1	NLRP3	247435969	247436140	0	172	129	4587	129	4415	0.0	0.029218573046432616
chr1	GCSAML	247556406	247556466	0	61	3467	4690	3467	4629	0.0	0.7489738604450206
chr1	GCSAML	247549135	247549220	0	86	3467	4690	3467	4604	0.0	0.7530408340573415
chr1	GCSAML	247538675	247538791	0	117	3467	4690	3467	4573	0.0	0.758145637437131
chr1	GCSAML	247549044	247549220	0	177	3467	4690	3467	4513	0.0	0.7682251274097053
chr1	GCSAML	247526939	247527054	0	116	3467	4690	3467	4574	0.0	0.7579798863139484
chr1	AL390860.1	247746202	247746512	0	311	0	3842	0	3531	0.0	0.0
chr1	OR2L2	248035549	248035624	0	76	51	4378	51	4302	0.0	0.011854951185495118
chr1	OR2L3	248051187	248051241	0	55	0	2933	0	2878	0.0	0.0
chr1	OR2L13	248098650	248098775	0	126	255	2023	255	1897	0.0	0.13442277279915657
chr1	OR2M2	248177917	248177995	0	79	0	1214	0	1135	0.0	0.0
chr1	OR2T2	248449193	248449392	46	200	97	3534	51	3334	0.23	0.015296940611877625
chr1	LYPD9P	248692603	248692770	0	168	0	929	0	761	0.0	0.0
chr1	AL627309.1	120720	120932	385	213	6593	3729	6208	3516	1.807511737089202	1.7656427758816837
chr1	AP006222.1	261549	261634	114	86	11625	5940	11511	5854	1.3255813953488371	1.9663477963785445
chr1	AL732372.2	498072	498305	0	234	0	6130	0	5896	0.0	0.0
chr1	AL732372.2	502186	502243	0	58	0	6130	0	6072	0.0	0.0
chr1	AL732372.2	498398	498456	0	59	0	6130	0	6071	0.0	0.0
chr1	AL732372.2	498046	498305	0	260	0	6130	0	5870	0.0	0.0
chr1	AL669831.3	711710	711922	51	213	3045	5509	2994	5296	0.23943661971830985	0.5653323262839879
chr1	AL669831.3	612740	612864	0	125	3045	5509	3045	5384	0.0	0.5655646359583952
chr1	HES4	999691	999787	913	97	13025	966	12112	869	9.412371134020619	13.937859608745685
chr1	C1ORF159	1090875	1090983	34	109	1497	4115	1463	4006	0.3119266055045872	0.3652021967049426
chr1	C1ORF159	1115021	1115075	0	55	1497	4115	1497	4060	0.0	0.3687192118226601
chr1	C1ORF159	1083914	1084086	0	173	1497	4115	1497	3942	0.0	0.3797564687975647
chr1	C1ORF159	1091277	1091374	15	98	1497	4115	1482	4017	0.15306122448979592	0.36893203883495146
chr1	C1ORF159	1083914	1084011	0	98	1497	4115	1497	4017	0.0	0.3726661687826736
chr1	C1ORF159	1105955	1106049	0	95	1497	4115	1497	4020	0.0	0.3723880597014925
chr1	UBE2J2	1257207	1257310	322	104	387997	4676	387675	4572	3.0961538461538463	84.79330708661418
chr1	UBE2J2	1266097	1266290	0	194	387997	4676	387997	4482	0.0	86.56782686300758
chr1	UBE2J2	1267861	1267992	462	132	387997	4676	387535	4544	3.5	85.2849911971831
chr1	UBE2J2	1267732	1267992	462	261	387997	4676	387535	4415	1.7701149425287357	87.77689694224236
chr1	UBE2J2	1262268	1262390	30285	123	387997	4676	357712	4553	246.21951219512195	78.56622007467604
chr1	UBE2J2	1264782	1264830	0	49	387997	4676	387997	4627	0.0	83.8549816295656
chr1	UBE2J2	1262169	1262390	46897	222	387997	4676	341100	4454	211.24774774774775	76.5828468792097
chr1	UBE2J2	1271509	1271637	4105	129	387997	4676	383892	4547	31.82170542635659	84.42753463822301
chr1	ACAP3	1294717	1294816	814	100	145490	7540	144676	7440	8.14	19.445698924731182
chr1	ACAP3	1307336	1307383	0	48	145490	7540	145490	7492	0.0	19.419380672717566
chr1	INTS11	1312439	1312501	0	63	583314	6765	583314	6702	0.0	87.03581020590869
chr1	INTS11	1314300	1314365	112	66	583314	6765	583202	6699	1.696969696969697	87.0580683684132
chr1	INTS11	1315403	1315438	22	36	583314	6765	583292	6729	0.6111111111111112	86.68331104175955
chr1	INTS11	1321907	1321984	20360	78	583314	6765	562954	6687	261.02564102564105	84.18633168835053
chr1	INTS11	1322891	1323287	273090	397	583314	6765	310224	6368	687.8841309823678	48.71608040201005
chr1	INTS11	1323180	1323287	210770	108	583314	6765	372544	6657	1951.5740740740741	55.96274598167343
chr1	INTS11	1320995	1321093	14	99	583314	6765	583300	6666	0.1414141414141414	87.5037503750375
chr1	INTS11	1319295	1319524	0	230	583314	6765	583314	6535	0.0	89.25998469778118
chr1	INTS11	1323146	1323287	238463	142	583314	6765	344851	6623	1679.3169014084508	52.0686999849011
chr1	INTS11	1321907	1321980	18963	74	583314	6765	564351	6691	256.2567567567568	84.3447915109849
chr1	DVL1	1337017	1337055	1266	39	185122	3895	183856	3856	32.46153846153846	47.6804979253112
chr1	MXRA8	1355449	1355752	408	304	4290	3538	3882	3234	1.3421052631578947	1.2003710575139146
chr1	CCNL2	1388491	1388510	0	20	59013	6208	59013	6188	0.0	9.536683904330964
chr1	CCNL2	1392678	1392803	56	126	59013	6208	58957	6082	0.4444444444444444	9.693686287405459
chr1	CCNL2	1388625	1388743	0	119	59013	6208	59013	6089	0.0	9.691739201839383
chr1	CCNL2	1388815	1388830	0	16	59013	6208	59013	6192	0.0	9.530523255813954
chr1	CCNL2	1392789	1392803	30	15	59013	6208	58983	6193	2.0	9.524140158243178
chr1	CCNL2	1391296	1391575	334	280	59013	6208	58679	5928	1.1928571428571428	9.898616734143049
chr1	ANKRD65	1420051	1420592	62114	542	127423	2647	65309	2105	114.60147601476015	31.02565320665083
chr1	CDK11B	1645125	1645262	1650	138	217634	3502	215984	3364	11.956521739130435	64.20451843043995
chr1	CDK11B	1657255	1657302	272	48	217634	3502	217362	3454	5.666666666666667	62.93051534452808
chr1	CDK11B	1642385	1642508	2041	124	217634	3502	215593	3378	16.45967741935484	63.82267613972765
chr1	SLC35E2B	1690975	1691393	3828	419	962448	8472	958620	8053	9.136038186157517	119.03886750279399
chr1	CDK11A	1722587	1722634	0	48	168180	4549	168180	4501	0.0	37.365029993334815
chr1	SLC35E2A	1744250	1744668	102	419	18343	3273	18241	2854	0.24343675417661098	6.391380518570427
chr1	NADK	1754050	1754208	580	159	243123	5178	242543	5019	3.647798742138365	48.324965132496516
chr1	NADK	1755373	1755476	3139	104	243123	5178	239984	5074	30.182692307692307	47.29680725266062
chr1	NADK	1756778	1756882	111897	105	243123	5178	131226	5073	1065.6857142857143	25.867534003548197
chr1	NADK	1756738	1756882	112413	145	243123	5178	130710	5033	775.2620689655172	25.970594079078083
chr1	GNB1	1817836	1817875	88	40	19175	6282	19087	6242	2.2	3.0578340275552707
chr1	GNB1	1839189	1839238	35	50	19175	6282	19140	6232	0.7	3.0712451861360717
chr1	GNB1	1815755	1815862	0	108	19175	6282	19175	6174	0.0	3.1057661159701975
chr1	CFAP74	1922588	1922723	0	136	1658	8293	1658	8157	0.0	0.20326100281966408
chr1	CFAP74	1956619	1956784	0	166	1658	8293	1658	8127	0.0	0.20401132029039007
chr1	FAAP20	2192844	2192975	4113	132	99991	8807	95878	8675	31.15909090909091	11.052219020172911
chr1	FAAP20	2193997	2194133	1280	137	99991	8807	98711	8670	9.343065693430656	11.385351787773933
chr1	FAAP20	2192646	2192975	7726	330	99991	8807	92265	8477	23.412121212121214	10.884157131060517
chr1	MORN1	2389924	2389996	0	73	227143	5620	227143	5547	0.0	40.94880115377681
chr1	PEX10	2410629	2410868	0	240	0	3454	0	3214	0.0	0.0
chr1	PANK4	2521717	2521800	16284	84	129995	4175	113711	4091	193.85714285714286	27.79540454656563
chr1	PANK4	2515257	2515401	306	145	129995	4175	129689	4030	2.110344827586207	32.18089330024814
chr1	TNFRSF14-AS1	2550572	2550731	0	160	0	4264	0	4104	0.0	0.0
chr1	MMEL1	2591931	2592027	0	97	0	3894	0	3797	0.0	0.0
chr1	PRDM16-DT	3060500	3060604	0	105	0	4427	0	4322	0.0	0.0
chr1	MEGF6	3490911	3490959	0	49	2594	9060	2594	9011	0.0	0.2878703806458773
chr1	MEGF6	3493770	3493899	0	130	2594	9060	2594	8930	0.0	0.290481522956327
chr1	MEGF6	3496987	3497119	0	133	2594	9060	2594	8927	0.0	0.2905791419289795
chr1	MEGF6	3497490	3497621	0	132	2594	9060	2594	8928	0.0	0.29054659498207885
chr1	WRAP73	3635159	3635294	0	136	3767	3935	3767	3799	0.0	0.9915767307186102
chr1	WRAP73	3635943	3636030	0	88	3767	3935	3767	3847	0.0	0.9792045749935014
chr1	TP73-AS1	3738222	3738513	1088	292	167096	6550	166008	6258	3.7260273972602738	26.52732502396932
chr1	TP73-AS1	3742429	3742517	491	89	167096	6550	166605	6461	5.51685393258427	25.786255997523604
chr1	TP73-AS1	3743300	3743371	2007	72	167096	6550	165089	6478	27.875	25.484563136770607
chr1	TP73-AS1	3741219	3741373	1972	155	167096	6550	165124	6395	12.72258064516129	25.820797498045348
chr1	LRRC47	3783769	3783911	684	143	46898	4517	46214	4374	4.783216783216783	10.565614997713762
chr1	CEP104	3823173	3823241	0	69	38388	11552	38388	11483	0.0	3.34302882521989
chr1	CEP104	3826707	3826744	0	38	38388	11552	38388	11514	0.0	3.3340281396560707
chr1	CEP104	3836494	3836692	0	199	38388	11552	38388	11353	0.0	3.3813089051352065
chr1	CEP104	3848607	3848781	0	175	38388	11552	38388	11377	0.0	3.374175969060385
chr1	CEP104	3855873	3856001	0	129	38388	11552	38388	11423	0.0	3.36058828678981
chr1	CEP104	3851685	3851802	0	118	38388	11552	38388	11434	0.0	3.3573552562532796
chr1	CEP104	3828884	3828971	0	88	38388	11552	38388	11464	0.0	3.348569434752268
chr1	CEP104	3841081	3841169	0	89	38388	11552	38388	11463	0.0	3.3488615545668674
chr1	LINC01345	3945493	3945669	0	177	0	1907	0	1730	0.0	0.0
chr1	LINC01345	3947274	3947328	0	55	0	1907	0	1852	0.0	0.0
chr1	Z98259.3	5492487	5492607	0	121	0	1286	0	1165	0.0	0.0
chr1	NPHP4	5952699	5952836	0	138	7687	12312	7687	12174	0.0	0.6314276326597668
chr1	NPHP4	5879345	5879632	0	288	7687	12312	7687	12024	0.0	0.6393047238855623
chr1	NPHP4	5888459	5888610	0	152	7687	12312	7687	12160	0.0	0.6321546052631579
chr1	CHD5	6106394	6106509	58	116	19320	10138	19262	10022	0.5	1.9219716623428458
chr1	CHD5	6113310	6113416	255	107	19320	10138	19065	10031	2.383177570093458	1.9006081148439837
chr1	CHD5	6127082	6127164	0	83	19320	10138	19320	10055	0.0	1.9214321233217304
chr1	RPL22	6200488	6200750	0	263	9122	3060	9122	2797	0.0	3.2613514479799783
chr1	ICMT	6233473	6233643	0	171	2907	2935	2907	2764	0.0	1.0517366136034731
chr1	ICMT	6234404	6234511	102	108	2907	2935	2805	2827	0.9444444444444444	0.9922178988326849
chr1	ACOT7	6282723	6282796	18065	74	151822	3514	133757	3440	244.1216216216216	38.8828488372093
chr1	ACOT7	6282723	6282888	34377	166	151822	3514	117445	3348	207.09036144578315	35.07915173237754
chr1	HES2	6419240	6419340	0	101	153	4128	153	4027	0.0	0.0379935435808294
chr1	TNFRSF25	6462862	6462970	0	109	101	3596	101	3487	0.0	0.028964726125609408
chr1	TNFRSF25	6463071	6463127	0	57	101	3596	101	3539	0.0	0.028539135348968635
chr1	TNFRSF25	6465087	6465222	0	136	101	3596	101	3460	0.0	0.029190751445086704
chr1	TNFRSF25	6463064	6463147	0	84	101	3596	101	3512	0.0	0.028758542141230067
chr1	PLEKHG5	6484289	6484480	0	192	266	6625	266	6433	0.0	0.041349292709466814
chr1	PLEKHG5	6477026	6477089	0	64	266	6625	266	6561	0.0	0.04054260021338211
chr1	PLEKHG5	6495515	6495589	0	75	266	6625	266	6550	0.0	0.040610687022900764
chr1	PLEKHG5	6474696	6474832	0	137	266	6625	266	6488	0.0	0.04099876695437731
chr1	NOL9	6550395	6550615	561	221	170137	7283	169576	7062	2.5384615384615383	24.01246105919003
chr1	DNAJC11	6639901	6640057	0	157	208603	5102	208603	4945	0.0	42.18463094034378
chr1	DNAJC11	6678393	6678467	306	75	208603	5102	208297	5027	4.08	41.4356475034812
chr1	TNFRSF9	7936459	7936563	0	105	0	6365	0	6260	0.0	0.0
chr1	ERRFI1	8015307	8015384	0	78	6278	4183	6278	4105	0.0	1.5293544457978077
chr1	ERRFI1	8015307	8015400	0	94	6278	4183	6278	4089	0.0	1.5353387136219125
chr1	RERE	8614560	8614686	245	127	79957	11873	79712	11746	1.9291338582677164	6.786310233270901
chr1	RERE	8792403	8792588	51	186	79957	11873	79906	11687	0.27419354838709675	6.837169504577736
chr1	RERE	8508626	8508675	0	50	79957	11873	79957	11823	0.0	6.762835151822719
chr1	RERE	8519709	8519792	0	84	79957	11873	79957	11789	0.0	6.782339468996522
chr1	ENO1	8870451	8870510	0	60	3667	4608	3667	4548	0.0	0.8062884784520669
chr1	ENO1	8870824	8870883	0	60	3667	4608	3667	4548	0.0	0.8062884784520669
chr1	ENO1	8873772	8873973	0	202	3667	4608	3667	4406	0.0	0.8322741715842034
chr1	ENO1	8875788	8876031	1326	244	3667	4608	2341	4364	5.434426229508197	0.5364344637946837
chr1	GPR157	9105485	9105680	0	196	408	5201	408	5005	0.0	0.08151848151848153
chr1	CLSTN1	9737497	9737554	77	58	23232	5261	23155	5203	1.3275862068965518	4.450317124735729
chr1	CLSTN1	9756480	9756510	0	31	23232	5261	23232	5230	0.0	4.442065009560229
chr1	CLSTN1	9746888	9747012	307	125	23232	5261	22925	5136	2.456	4.463590342679128
chr1	CTNNBIP1	9883704	9883738	3440	35	78185	3347	74745	3312	98.28571428571429	22.567934782608695
chr1	DFFA	10463430	10463620	0	191	471547	6631	471547	6440	0.0	73.22158385093168
chr1	EXOSC10	11073933	11074008	39643	76	306647	4858	267004	4782	521.6184210526316	55.83521539104977
chr1	EXOSC10	11095415	11095547	0	133	306647	4858	306647	4725	0.0	64.89883597883598
chr1	MTHFR	11796205	11796399	45908	195	160765	6734	114857	6539	235.42564102564103	17.56491818320844
chr1	MTHFR	11801160	11801399	6295	240	160765	6734	154470	6494	26.229166666666668	23.786572220511243
chr1	MTHFR	11791636	11791745	0	110	160765	6734	160765	6624	0.0	24.27007850241546
chr1	KAZN-AS1	14390685	14390751	0	67	0	2835	0	2768	0.0	0.0
chr1	KAZN-AS1	14409405	14409451	0	47	0	2835	0	2788	0.0	0.0
chr1	TMEM51-AS1	15120576	15120697	0	122	102	10809	102	10687	0.0	0.009544306166370356
chr1	CASP9	15495272	15495452	663	181	3314	4712	2651	4531	3.6629834254143647	0.5850805561686162
chr1	CASP9	15505989	15506079	0	91	3314	4712	3314	4621	0.0	0.7171607877082883
chr1	AL450998.2	15725592	15725872	0	281	549	1540	549	1259	0.0	0.43606036536934073
chr1	ZBTB17	15943807	15943895	0	89	6341	3882	6341	3793	0.0	1.671763775375692
chr1	ZBTB17	15948290	15948497	0	208	6341	3882	6341	3674	0.0	1.72591181273816
chr1	FAM131C	16063520	16063636	96	117	95194	1727	95098	1610	0.8205128205128205	59.06708074534161
chr1	EPHA2	16150895	16150963	0	69	161370	4159	161370	4090	0.0	39.45476772616137
chr1	ARHGEF19	16205537	16205667	0	131	1735	3803	1735	3672	0.0	0.4724945533769063
chr1	CPLANE2	16232892	16233017	0	126	357	1579	357	1453	0.0	0.24569855471438404
chr1	SPATA21	16432789	16432924	0	136	111	4528	111	4392	0.0	0.025273224043715847
chr1	CROCCP3	16484822	16484906	0	85	88415	5234	88415	5149	0.0	17.1712953971645
chr1	CROCCP3	16486425	16486661	1419	237	88415	5234	86996	4997	5.987341772151899	17.409645787472485
chr1	CROCCP3	16489684	16489791	0	108	88415	5234	88415	5126	0.0	17.248341786968396
chr1	CROCCP3	16491009	16491316	2264	308	88415	5234	86151	4926	7.35064935064935	17.489037758830694
chr1	CROCCP2	16619844	16620024	9	181	16894	5265	16885	5084	0.049723756906077346	3.3212037765538946
chr1	CROCCP2	16619844	16620038	23	195	16894	5265	16871	5070	0.11794871794871795	3.327613412228797
chr1	CROCCP2	16619844	16620245	102	402	16894	5265	16792	4863	0.2537313432835821	3.453012543697306
chr1	CROCCP2	16630031	16630142	0	112	16894	5265	16894	5153	0.0	3.2784785561808656
chr1	MST1L	16758215	16758293	0	79	15609	5187	15609	5108	0.0	3.0557948316366486
chr1	MST1L	16758674	16758711	0	38	15609	5187	15609	5149	0.0	3.0314624198873568
chr1	BX284668.1	16851573	16851723	0	151	0	842	0	691	0.0	0.0
chr1	ATP13A2	16993628	16993835	0	208	45701	5196	45701	4988	0.0	9.162189254210105
chr1	ATP13A2	16996385	16996496	0	112	45701	5196	45701	5084	0.0	8.989181746656175
chr1	ATP13A2	16986462	16986632	0	171	45701	5196	45701	5025	0.0	9.094726368159204
chr1	ATP13A2	16989886	16990003	0	118	45701	5196	45701	5078	0.0	8.99980307207562
chr1	ATP13A2	16996385	16996478	0	94	45701	5196	45701	5102	0.0	8.957467659741278
chr1	ALDH4A1	18876314	18876467	0	154	0	3649	0	3495	0.0	0.0
chr1	ALDH4A1	18886463	18886511	0	49	0	3649	0	3600	0.0	0.0
chr1	IFFO2	18911383	18911476	0	94	51	6188	51	6094	0.0	0.008368887430259271
chr1	IFFO2	18918361	18918502	0	142	51	6188	51	6046	0.0	0.008435329143235196
chr1	UBR4	19140787	19140892	0	106	9454	22176	9454	22070	0.0	0.428364295423652
chr1	UBR4	19146022	19146106	0	85	9454	22176	9454	22091	0.0	0.42795708659635145
chr1	UBR4	19149762	19149795	0	34	9454	22176	9454	22142	0.0	0.4269713666335471
chr1	EMC1	19243949	19244015	0	67	36257	8562	36257	8495	0.0	4.268040023543261
chr1	EMC1	19234179	19234188	150	10	36257	8562	36107	8552	15.0	4.222053320860617
chr1	AKR7A2	19307313	19307410	0	98	0	1788	0	1690	0.0	0.0
chr1	AKR7A2	19308157	19308262	0	106	0	1788	0	1682	0.0	0.0
chr1	AKR7A2	19307001	19307101	0	101	0	1788	0	1687	0.0	0.0
chr1	CAPZB	19344357	19344434	0	78	99248	19106	99248	19028	0.0	5.215892369140215
chr1	CAPZB	19385504	19385626	0	123	99248	19106	99248	18983	0.0	5.228256861402308
chr1	CAPZB	19419660	19419750	0	91	99248	19106	99248	19015	0.0	5.21945832237707
chr1	CAPZB	19448833	19449330	395	498	99248	19106	98853	18608	0.7931726907630522	5.312392519346518
chr1	CAPZB	19342751	19342864	0	114	99248	19106	99248	18992	0.0	5.225779275484414
chr1	CAPZB	19412235	19417164	89359	4930	99248	19106	9889	14176	18.12555780933063	0.6975874717832957
chr1	TMCO4	19745531	19745651	0	121	162075	4046	162075	3925	0.0	41.29299363057325
chr1	TMCO4	19798136	19798215	0	80	162075	4046	162075	3966	0.0	40.8661119515885
chr1	PLA2G2D	20115506	20115613	0	108	6636	2685	6636	2577	0.0	2.5750873108265426
chr1	LINC01141	20400934	20400987	0	54	0	4291	0	4237	0.0	0.0
chr1	LINC01141	20399479	20399549	0	71	0	4291	0	4220	0.0	0.0
chr1	LINC01141	20408705	20408810	0	106	0	4291	0	4185	0.0	0.0
chr1	LINC01141	20402773	20402846	0	74	0	4291	0	4217	0.0	0.0
chr1	DDOST	20656100	20656187	0	88	102	2732	102	2644	0.0	0.038577912254160365
chr1	KIF17	20687387	20687944	0	558	1224	4306	1224	3748	0.0	0.3265741728922092
chr1	SH2D5	20727957	20728086	0	130	2550	4501	2550	4371	0.0	0.5833905284831846
chr1	HP1BP3	20767583	20767664	0	82	1202	5936	1202	5854	0.0	0.2053296891014691
chr1	HP1BP3	20780344	20780540	0	197	1202	5936	1202	5739	0.0	0.2094441540338038
chr1	HP1BP3	20780349	20780540	0	192	1202	5936	1202	5744	0.0	0.20926183844011143
chr1	EIF4G3	21050865	21050994	5754	130	286547	9643	280793	9513	44.261538461538464	29.516766530011562
chr1	EIF4G3	20941490	20942330	0	841	286547	9643	286547	8802	0.0	32.55476028175415
chr1	EIF4G3	20982387	20982408	0	22	286547	9643	286547	9621	0.0	29.78349443924748
chr1	EIF4G3	20892618	20892729	0	112	286547	9643	286547	9531	0.0	30.064736124226208
chr1	EIF4G3	20997600	20997633	78	34	286547	9643	286469	9609	2.2941176470588234	29.812571547507545
chr1	EIF4G3	21001198	21001312	0	115	286547	9643	286547	9528	0.0	30.074202350965574
chr1	ECE1	21221746	21221842	0	97	15276	7299	15276	7202	0.0	2.1210774784782007
chr1	RAP1GAP	21603657	21603912	0	256	5043	5400	5043	5144	0.0	0.9803654743390358
chr1	RAP1GAP	21603834	21603912	0	79	5043	5400	5043	5321	0.0	0.9477541815448224
chr1	RAP1GAP	21665210	21665317	0	108	5043	5400	5043	5292	0.0	0.9529478458049887
chr1	USP48	21695065	21695221	0	157	28401	9527	28401	9370	0.0	3.0310565635005338
chr1	USP48	21703511	21703618	0	108	28401	9527	28401	9419	0.0	3.0152882471599955
chr1	HSPG2	21836801	21837006	0	206	428	17430	428	17224	0.0	0.024849047840222946
chr1	HSPG2	21832874	21832892	0	19	428	17430	428	17411	0.0	0.02458216070300385
chr1	HSPG2	21888667	21888718	0	52	428	17430	428	17378	0.0	0.024628841063413513
chr1	LINC01635	22024805	22024955	0	151	71	1231	71	1080	0.0	0.06574074074074074
chr1	LINC01635	22024805	22024966	0	162	71	1231	71	1069	0.0	0.06641721234798878
chr1	LUZP1	23109021	23109127	0	107	918	9666	918	9559	0.0	0.09603515012030547
chr1	LUZP1	23109584	23109650	0	67	918	9666	918	9599	0.0	0.09563496197520575
chr1	HNRNPR	23323555	23323732	0	178	235	6774	235	6596	0.0	0.03562765312310491
chr1	HNRNPR	23333517	23333631	0	115	235	6774	235	6659	0.0	0.03529058417179757
chr1	HNRNPR	23340851	23341017	82	167	235	6774	153	6607	0.49101796407185627	0.023157257454215225
chr1	HNRNPR	23340851	23341020	82	170	235	6774	153	6604	0.4823529411764706	0.02316777710478498
chr1	HNRNPR	23338062	23338163	0	102	235	6774	235	6672	0.0	0.03522182254196643
chr1	ASAP3	23439160	23439230	147	71	7435	5015	7288	4944	2.0704225352112675	1.4741100323624596
chr1	ELOA-AS1	23772267	23772426	0	160	21592	2991	21592	2831	0.0	7.626986930413281
chr1	ELOA-AS1	23772271	23772426	0	156	21592	2991	21592	2835	0.0	7.616225749559083
chr1	ELOA-AS1	23771701	23771883	0	183	21592	2991	21592	2808	0.0	7.689458689458689
chr1	GALE	23796508	23796586	0	79	1045	3023	1045	2944	0.0	0.35495923913043476
chr1	GALE	23798886	23799012	0	127	1045	3023	1045	2896	0.0	0.3608425414364641
chr1	SRSF10	23971572	23971626	0	55	240	8967	240	8912	0.0	0.026929982046678635
chr1	SRSF10	23971572	23971623	0	52	240	8967	240	8915	0.0	0.0269209197980931
chr1	IFNLR1	24159051	24159182	0	132	658	1986	658	1854	0.0	0.35490830636461707
chr1	STPG1	24391560	24391679	0	120	2397	5592	2397	5472	0.0	0.4380482456140351
chr1	SYF2	25228997	25229123	51	127	1117	3780	1066	3653	0.4015748031496063	0.2918149466192171
chr1	RSRP1	25244453	25244498	0	46	462	5486	462	5440	0.0	0.0849264705882353
chr1	RHCE	25375348	25375428	0	81	0	2447	0	2366	0.0	0.0
chr1	RHCE	25385710	25385844	0	135	0	2447	0	2312	0.0	0.0
chr1	RHCE	25408682	25408869	0	188	0	2447	0	2259	0.0	0.0
chr1	RHCE	25388975	25389113	0	139	0	2447	0	2308	0.0	0.0
chr1	PAFAH2	25990726	25990863	0	138	0	3807	0	3669	0.0	0.0
chr1	PAFAH2	25997447	25997621	0	175	0	3807	0	3632	0.0	0.0
chr1	SLC30A2	26044297	26044444	0	148	1173	3491	1173	3343	0.0	0.35088244092132814
chr1	UBXN11	26302812	26302918	189	107	25526	4722	25337	4615	1.766355140186916	5.490140845070423
chr1	UBXN11	26294204	26294331	0	128	25526	4722	25526	4594	0.0	5.556377884196778
chr1	UBXN11	26296918	26296995	0	78	25526	4722	25526	4644	0.0	5.496554694229113
chr1	UBXN11	26300925	26301024	6298	100	25526	4722	19228	4622	62.98	4.1601038511466895
chr1	UBXN11	26301693	26301722	0	30	25526	4722	25526	4692	0.0	5.440323955669224
chr1	UBXN11	26303042	26303167	0	126	25526	4722	25526	4596	0.0	5.553959965187119
chr1	UBXN11	26300925	26301053	14590	129	25526	4722	10936	4593	113.10077519379846	2.3810145874156325
chr1	CRYBG2	26338011	26338047	0	37	918	6090	918	6053	0.0	0.15166033371881713
chr1	CRYBG2	26354045	26354785	0	741	918	6090	918	5349	0.0	0.17162086371284352
chr1	ZNF683	26362115	26362175	355	61	1876	2318	1521	2257	5.819672131147541	0.6739034116083297
chr1	ZNF683	26367592	26367797	0	206	1876	2318	1876	2112	0.0	0.8882575757575758
chr1	ZNF683	26367592	26367647	0	56	1876	2318	1876	2262	0.0	0.8293545534924845
chr1	DHDDS-AS1	26466203	26466324	0	122	0	1265	0	1143	0.0	0.0
chr1	MAP3K6	27355668	27355745	0	78	408	5375	408	5297	0.0	0.0770247309797999
chr1	MAP3K6	27364660	27364684	0	25	408	5375	408	5350	0.0	0.07626168224299065
chr1	FCN3	27373487	27373520	0	34	0	1666	0	1632	0.0	0.0
chr1	WASF2	27409691	27410206	0	516	7095	5690	7095	5174	0.0	1.3712794742945498
chr1	AHDC1	27558304	27558530	0	227	1716	4518	1716	4291	0.0	0.3999067816359823
chr1	EYA3	28027788	28027926	0	139	11086	6293	11086	6154	0.0	1.8014299642508937
chr1	EYA3	28042570	28042650	0	81	11086	6293	11086	6212	0.0	1.7846104314230522
chr1	EYA3	28048382	28048426	0	45	11086	6293	11086	6248	0.0	1.7743277848911652
chr1	EYA3	28035543	28035680	0	138	11086	6293	11086	6155	0.0	1.8011372867587327
chr1	PTAFR	28176591	28176673	34852	83	441293	4211	406441	4128	419.90361445783134	98.45954457364341
chr1	SNHG12	28581110	28581229	0	120	1224	3699	1224	3579	0.0	0.34199497066219614
chr1	SNHG12	28581093	28581229	0	137	1224	3699	1224	3562	0.0	0.34362717574396406
chr1	SRSF4	29150102	29150192	0	91	612	8221	612	8130	0.0	0.07527675276752767
chr1	SRSF4	29159863	29160091	0	229	612	8221	612	7992	0.0	0.07657657657657657
chr1	SRSF4	29159863	29160058	0	196	612	8221	612	8025	0.0	0.07626168224299065
chr1	MECR	29203130	29203233	0	104	0	4032	0	3928	0.0	0.0
chr1	PUM1	30941997	30942123	0	127	62	6646	62	6519	0.0	0.009510661144347293
chr1	PUM1	30945345	30945483	0	139	62	6646	62	6507	0.0	0.009528200399569694
chr1	PUM1	30964673	30964910	0	238	62	6646	62	6408	0.0	0.009675405742821473
chr1	PUM1	30980061	30980163	0	103	62	6646	62	6543	0.0	0.009475775638086504
chr1	PUM1	30980061	30980166	0	106	62	6646	62	6540	0.0	0.009480122324159021
chr1	PUM1	30980061	30980178	0	118	62	6646	62	6528	0.0	0.009497549019607842
chr1	PUM1	30941921	30942123	0	203	62	6646	62	6443	0.0	0.009622846500077603
chr1	PUM1	31006993	31007102	0	110	62	6646	62	6536	0.0	0.009485924112607099
chr1	PUM1	31055312	31055380	11	69	62	6646	51	6577	0.15942028985507245	0.007754295271400334
chr1	NKAIN1	31185246	31185327	46	82	1333	1982	1287	1900	0.5609756097560976	0.6773684210526316
chr1	FABP3	31369069	31369136	0	68	787	1405	787	1337	0.0	0.5886312640239342
chr1	PEF1	31635221	31635522	0	302	64	1689	64	1387	0.0	0.046142754145638065
chr1	COL16A1	31662586	31662658	0	73	7745	9320	7745	9247	0.0	0.8375689412782524
chr1	COL16A1	31670601	31670646	0	46	7745	9320	7745	9274	0.0	0.8351304722881173
chr1	COL16A1	31679803	31679851	0	49	7745	9320	7745	9271	0.0	0.8354007118973142
chr1	COL16A1	31684108	31684231	0	124	7745	9320	7745	9196	0.0	0.8422140060896042
chr1	COL16A1	31694143	31694170	0	28	7745	9320	7745	9292	0.0	0.8335126990959966
chr1	COL16A1	31702120	31702227	0	108	7745	9320	7745	9212	0.0	0.8407511940946591
chr1	ADGRB2	31728024	31728081	0	58	153566	7790	153566	7732	0.0	19.86109674081738
chr1	ADGRB2	31735182	31735281	154	100	153566	7790	153412	7690	1.54	19.94954486345904
chr1	ADGRB2	31742837	31743002	248	166	153566	7790	153318	7624	1.4939759036144578	20.109916054564533
chr1	ADGRB2	31744192	31744357	41841	166	153566	7790	111725	7624	252.05421686746988	14.65438090241343
chr1	SPOCD1	31792214	31792401	440	188	4424	6982	3984	6794	2.3404255319148937	0.5863997644980865
chr1	SPOCD1	31796589	31796715	777	127	4424	6982	3647	6855	6.118110236220472	0.5320204230488694
chr1	SPOCD1	31799400	31799485	0	86	4424	6982	4424	6896	0.0	0.6415313225058005
chr1	SPOCD1	31800440	31800617	0	178	4424	6982	4424	6804	0.0	0.6502057613168725
chr1	SPOCD1	31813950	31815372	2448	1423	4424	6982	1976	5559	1.7203092059030218	0.355459615038676
chr1	SPOCD1	31796592	31796715	777	124	4424	6982	3647	6858	6.266129032258065	0.5317876932050161
chr1	SPOCD1	31815347	31815372	0	26	4424	6982	4424	6956	0.0	0.6359976998274871
chr1	PTP4A2	31910037	31910112	0	76	357	6592	357	6516	0.0	0.05478821362799263
chr1	PTP4A2	31911695	31911826	0	132	357	6592	357	6460	0.0	0.05526315789473684
chr1	PTP4A2	31915894	31915987	0	94	357	6592	357	6498	0.0	0.05493998153277932
chr1	PTP4A2	31930038	31930334	0	297	357	6592	357	6295	0.0	0.05671167593328038
chr1	PTP4A2	31913786	31913843	0	58	357	6592	357	6534	0.0	0.05463728191000918
chr1	PTP4A2	31912980	31913023	0	44	357	6592	357	6548	0.0	0.054520464263897374
chr1	PTP4A2	31930932	31931142	0	211	357	6592	357	6381	0.0	0.05594734367653973
chr1	TMEM234	32217436	32217577	0	142	8945	3451	8945	3309	0.0	2.7032336053188275
chr1	MTMR9LP	32234703	32234814	0	112	0	2789	0	2677	0.0	0.0
chr1	MTMR9LP	32234035	32234301	0	267	0	2789	0	2522	0.0	0.0
chr1	MTMR9LP	32239294	32239425	0	132	0	2789	0	2657	0.0	0.0
chr1	MTMR9LP	32234402	32234623	0	222	0	2789	0	2567	0.0	0.0
chr1	BSDC1	32383829	32383997	867	169	7498	6752	6631	6583	5.1301775147929	1.0072915084308067
chr1	BSDC1	32386778	32386895	612	118	7498	6752	6886	6634	5.186440677966102	1.0379861320470305
chr1	BSDC1	32369229	32369338	0	110	7498	6752	7498	6642	0.0	1.1288768443239987
chr1	BSDC1	32383829	32384048	1059	220	7498	6752	6439	6532	4.8136363636363635	0.9857624004898959
chr1	BSDC1	32381213	32381268	0	56	7498	6752	7498	6696	0.0	1.119772998805257
chr1	BSDC1	32383829	32383939	867	111	7498	6752	6631	6641	7.8108108108108105	0.9984942026803192
chr1	BSDC1	32383829	32383906	590	78	7498	6752	6908	6674	7.564102564102564	1.0350614324243332
chr1	ZBTB8OS	32631826	32631879	1747	54	30458	3541	28711	3487	32.351851851851855	8.233725265271007
chr1	ZBTB8OS	32632207	32632345	0	139	30458	3541	30458	3402	0.0	8.95296884185773
chr1	ZBTB8OS	32633261	32633354	8	94	30458	3541	30450	3447	0.0851063829787234	8.833768494342907
chr1	ZBTB8OS	32634767	32634792	0	26	30458	3541	30458	3515	0.0	8.665149359886202
chr1	SYNC	32684009	32684089	15	81	118715	3729	118700	3648	0.18518518518518517	32.53837719298246
chr1	YARS1	32806481	32806611	728	131	122331	8638	121603	8507	5.557251908396947	14.294463383096273
chr1	YARS1	32810910	32811057	881	148	122331	8638	121450	8490	5.952702702702703	14.305064782096585
chr1	YARS1	32804544	32804883	59	340	122331	8638	122272	8298	0.17352941176470588	14.735116895637503
chr1	YARS1	32810590	32810766	0	177	122331	8638	122331	8461	0.0	14.458220068549817
chr1	YARS1	32797591	32797638	697	48	122331	8638	121634	8590	14.520833333333334	14.159953434225844
chr1	TMEM54	32895909	32895969	0	61	965	1424	965	1363	0.0	0.7079970652971387
chr1	AK2	33024441	33024567	0	127	7983	7812	7983	7685	0.0	1.0387768379960962
chr1	AK2	33021366	33021461	0	96	7983	7812	7983	7716	0.0	1.0346034214618973
chr1	AK2	33011447	33011710	715	264	7983	7812	7268	7548	2.7083333333333335	0.9629040805511394
chr1	AK2	33012073	33012122	0	50	7983	7812	7983	7762	0.0	1.0284720432878125
chr1	AK2	33031543	33031661	0	119	7983	7812	7983	7693	0.0	1.0376966073053424
chr1	PHC2	33368535	33368622	0	88	237987	4902	237987	4814	0.0	49.43643539675945
chr1	CSMD2	33605862	33605988	168	127	102227	18235	102059	18108	1.3228346456692914	5.6361276783742
chr1	CSMD2	33804745	33804898	4207	154	102227	18235	98020	18081	27.318181818181817	5.4211603340523205
chr1	ZMYM6	35019352	35019602	0	251	102	9585	102	9334	0.0	0.010927790872080565
chr1	ZMYM6	35030546	35030713	0	168	102	9585	102	9417	0.0	0.01083147499203568
chr1	ZMYM6	35031266	35031337	0	72	102	9585	102	9513	0.0	0.010722169662567014
chr1	KIAA0319L	35470862	35470960	571	99	53667	9295	53096	9196	5.767676767676767	5.773814702044367
chr1	KIAA0319L	35474804	35474906	0	103	53667	9295	53667	9192	0.0	5.8384464751958225
chr1	KIAA0319L	35506611	35507135	0	525	53667	9295	53667	8770	0.0	6.119384264538199
chr1	KIAA0319L	35554349	35554519	375	171	53667	9295	53292	9124	2.192982456140351	5.840859272249014
chr1	CLSPN	35753744	35753936	0	193	10466	9618	10466	9425	0.0	1.1104509283819628
chr1	TRAPPC3	36137795	36137978	0	184	51	3533	51	3349	0.0	0.015228426395939087
chr1	TRAPPC3	36138083	36138232	0	150	51	3533	51	3383	0.0	0.01507537688442211
chr1	STK40	36367847	36368084	4783	238	47653	5632	42870	5394	20.096638655462186	7.947719688542826
chr1	STK40	36367851	36368084	4499	234	47653	5632	43154	5398	19.226495726495727	7.994442386068914
chr1	OSCP1	36420475	36420615	459	141	8146	2655	7687	2514	3.25531914893617	3.0576770087509946
chr1	OSCP1	36444003	36444033	0	31	8146	2655	8146	2624	0.0	3.104420731707317
chr1	OSCP1	36418990	36419054	0	65	8146	2655	8146	2590	0.0	3.145173745173745
chr1	OSCP1	36447812	36447887	0	76	8146	2655	8146	2579	0.0	3.1585886002326484
chr1	CSF3R	36469155	36469257	0	103	8426	8399	8426	8296	0.0	1.0156702025072324
chr1	CSF3R	36479986	36480080	0	95	8426	8399	8426	8304	0.0	1.0146917148362236
chr1	MEAF6	37496706	37496736	0	31	0	2301	0	2270	0.0	0.0
chr1	MEAF6	37496546	37496604	0	59	0	2301	0	2242	0.0	0.0
chr1	SNIP1	37548820	37548987	0	168	0	5537	0	5369	0.0	0.0
chr1	GNL2	37581341	37581545	0	205	0	5764	0	5559	0.0	0.0
chr1	RSPO1	37613703	37613892	0	190	0	3066	0	2876	0.0	0.0
chr1	RSPO1	37631843	37632022	0	180	0	3066	0	2886	0.0	0.0
chr1	C1ORF109	37691458	37691581	0	124	0	3992	0	3868	0.0	0.0
chr1	C1ORF109	37690215	37690438	0	224	0	3992	0	3768	0.0	0.0
chr1	EPHA10	37718952	37719053	0	102	0	8168	0	8066	0.0	0.0
chr1	EPHA10	37722804	37722931	0	128	0	8168	0	8040	0.0	0.0
chr1	EPHA10	37722005	37722296	0	292	0	8168	0	7876	0.0	0.0
chr1	EPHA10	37734579	37734687	0	109	0	8168	0	8059	0.0	0.0
chr1	FHL3	37997962	37998132	0	171	102	2010	102	1839	0.0	0.05546492659053834
chr1	FHL3	37999256	37999432	0	177	102	2010	102	1833	0.0	0.05564648117839607
chr1	LINC01343	38211733	38211822	0	90	0	2578	0	2488	0.0	0.0
chr1	LINC01343	38214264	38214515	0	252	0	2578	0	2326	0.0	0.0
chr1	PPIEL	39524835	39525151	129	317	16407	3504	16278	3187	0.4069400630914827	5.1076247254471285
chr1	PPIEL	39524835	39525057	129	223	16407	3504	16278	3281	0.57847533632287	4.9612922889363
chr1	PPIEL	39547578	39547634	0	57	16407	3504	16407	3447	0.0	4.759791122715405
chr1	PPIEL	39556133	39556201	0	69	16407	3504	16407	3435	0.0	4.776419213973799
chr1	PPIEL	39523561	39523697	102	137	16407	3504	16305	3367	0.7445255474452555	4.842589842589843
chr1	PPIEL	39548669	39548746	0	78	16407	3504	16407	3426	0.0	4.788966725043783
chr1	PPIEL	39523806	39523896	0	91	16407	3504	16407	3413	0.0	4.807207735130384
chr1	PPIEL	39525698	39525848	3772	151	16407	3504	12635	3353	24.980132450331126	3.768267223382046
chr1	PPIEL	39556598	39556738	0	141	16407	3504	16407	3363	0.0	4.878679750223015
chr1	PPIEL	39537190	39537343	0	154	16407	3504	16407	3350	0.0	4.897611940298508
chr1	PABPC4	39563835	39563922	0	88	3670	8427	3670	8339	0.0	0.4401007315025782
chr1	PABPC4	39564685	39564773	0	89	3670	8427	3670	8338	0.0	0.440153514032142
chr1	PABPC4	39569594	39569689	120	96	3670	8427	3550	8331	1.25	0.42611931340775416
chr1	PABPC4	39564700	39564773	0	74	3670	8427	3670	8353	0.0	0.43936310307673887
chr1	PABPC4	39571606	39571705	0	100	3670	8427	3670	8327	0.0	0.4407349585685121
chr1	HPCAL4	39683936	39684152	0	217	1275	4763	1275	4546	0.0	0.28046634403871534
chr1	HPCAL4	39691064	39691170	0	107	1275	4763	1275	4656	0.0	0.27384020618556704
chr1	TRIT1	39844530	39844640	0	111	12189	6546	12189	6435	0.0	1.8941724941724942
chr1	TRIT1	39847219	39847297	0	79	12189	6546	12189	6467	0.0	1.8847997525900726
chr1	TRIT1	39847547	39847660	0	114	12189	6546	12189	6432	0.0	1.8950559701492538
chr1	TRIT1	39852730	39852876	0	147	12189	6546	12189	6399	0.0	1.9048288795124237
chr1	TRIT1	39864709	39865667	51	959	12189	6546	12138	5587	0.053180396246089674	2.172543404331484
chr1	TRIT1	39876061	39876132	2031	72	12189	6546	10158	6474	28.208333333333332	1.5690454124189064
chr1	PPT1	40076841	40076913	0	73	3040	2932	3040	2859	0.0	1.0633088492479887
chr1	PPT1	40089409	40089512	98	104	3040	2932	2942	2828	0.9423076923076923	1.0403111739745403
chr1	PPT1	40092044	40092172	51	129	3040	2932	2989	2803	0.3953488372093023	1.0663574741348556
chr1	PPT1	40093932	40094019	0	88	3040	2932	3040	2844	0.0	1.0689170182841068
chr1	PPT1	40076729	40076913	0	185	3040	2932	3040	2747	0.0	1.1066618128867856
chr1	PPT1	40089409	40089582	714	174	3040	2932	2326	2758	4.103448275862069	0.8433647570703409
chr1	PPT1	40075129	40075245	51	117	3040	2932	2989	2815	0.4358974358974359	1.0618117229129662
chr1	COL9A2	40303130	40303185	0	56	41246	4128	41246	4072	0.0	10.129174852652259
chr1	SLFNL1	41017233	41017377	0	145	4044	3549	4044	3404	0.0	1.1880141010575793
chr1	SCMH1	41033982	41034048	0	67	23350	4464	23350	4397	0.0	5.310438935637935
chr1	SCMH1	41151613	41151684	1886	72	23350	4464	21464	4392	26.194444444444443	4.887067395264117
chr1	SCMH1	41159724	41159933	992	210	23350	4464	22358	4254	4.723809523809524	5.255759285378467
chr1	SCMH1	41152598	41152741	13492	144	23350	4464	9858	4320	93.69444444444444	2.2819444444444446
chr1	EDN2	41481094	41481193	215	100	12129	1657	11914	1557	2.15	7.65189466923571
chr1	HIVEP3	41524734	41524910	0	177	79609	14641	79609	14464	0.0	5.503940818584071
chr1	HIVEP3	41700915	41700995	0	81	79609	14641	79609	14560	0.0	5.467651098901099
chr1	FOXJ3	42205761	42205863	0	103	451	6539	451	6436	0.0	0.07007458048477315
chr1	ZMYND12	42448466	42448638	0	173	221	2189	221	2016	0.0	0.10962301587301587
chr1	ZMYND12	42449917	42450059	0	143	221	2189	221	2046	0.0	0.10801564027370479
chr1	CLDN19	42738228	42738313	0	86	2958	3606	2958	3520	0.0	0.8403409090909091
chr1	P3H1	42751640	42751740	0	101	648	4271	648	4170	0.0	0.1553956834532374
chr1	SLC2A1	42929872	42930035	2025	164	17028	4036	15003	3872	12.347560975609756	3.87474173553719
chr1	SLC2A1	42943225	42943321	0	97	17028	4036	17028	3939	0.0	4.322924600152323
chr1	AC099795.1	42961249	42961471	0	223	77	1102	77	879	0.0	0.0875995449374289
chr1	ELOVL1	43364927	43365008	0	82	0	2516	0	2434	0.0	0.0
chr1	ELOVL1	43365185	43365376	0	192	0	2516	0	2324	0.0	0.0
chr1	HYI	43452902	43453004	0	103	2449	1686	2449	1583	0.0	1.5470625394819961
chr1	SLC6A9	44011560	44011722	0	163	104428	5268	104428	5105	0.0	20.456023506366307
chr1	ERI3	44283985	44284069	102	85	8612	2800	8510	2715	1.2	3.134438305709024
chr1	ERI3	44352849	44352925	0	77	8612	2800	8612	2723	0.0	3.1626882115313992
chr1	ERI3	44232239	44232388	462	150	8612	2800	8150	2650	3.08	3.0754716981132075
chr1	ERI3	44230316	44230470	0	155	8612	2800	8612	2645	0.0	3.255954631379962
chr1	ERI3	44241914	44242080	1152	167	8612	2800	7460	2633	6.8982035928143715	2.8332700341815418
chr1	ERI3	44339044	44339322	0	279	8612	2800	8612	2521	0.0	3.4161047203490678
chr1	TMEM53	44654939	44655209	924	271	924	3566	0	3295	3.4095940959409594	0.0
chr1	TMEM53	44660173	44660295	0	123	924	3566	924	3443	0.0	0.268370607028754
chr1	TMEM53	44645359	44645464	0	106	924	3566	924	3460	0.0	0.26705202312138726
chr1	PTCH2	44821841	44821904	0	64	12448	5358	12448	5294	0.0	2.3513411409142426
chr1	EIF2B3	44857703	44857807	0	105	4469	3430	4469	3325	0.0	1.34406015037594
chr1	EIF2B3	44969977	44970044	0	68	4469	3430	4469	3362	0.0	1.329268292682927
chr1	MUTYH	45334390	45334511	803	122	35062	5148	34259	5026	6.581967213114754	6.816354954237963
chr1	MUTYH	45329888	45330068	0	181	35062	5148	35062	4967	0.0	7.058989329575196
chr1	MUTYH	45331660	45331849	0	190	35062	5148	35062	4958	0.0	7.071803146430012
chr1	MUTYH	45333096	45333170	680	75	35062	5148	34382	5073	9.066666666666666	6.7774492410802285
chr1	MUTYH	45333412	45333561	1172	150	35062	5148	33890	4998	7.8133333333333335	6.780712284913966
chr1	MUTYH	45338506	45338656	2118	151	35062	5148	32944	4997	14.026490066225165	6.592755653392035
chr1	MUTYH	45333412	45333594	1172	183	35062	5148	33890	4965	6.404371584699454	6.825780463242699
chr1	MUTYH	45333412	45333564	1172	153	35062	5148	33890	4995	7.660130718954249	6.784784784784785
chr1	MUTYH	45333412	45333497	482	86	35062	5148	34580	5062	5.604651162790698	6.831291979454761
chr1	MUTYH	45333412	45333603	1172	192	35062	5148	33890	4956	6.104166666666667	6.83817594834544
chr1	TESK2	45385911	45385960	0	50	53192	3331	53192	3281	0.0	16.212130448034134
chr1	MUTYH	45332917	45332959	66	43	35062	5148	34996	5105	1.5348837209302326	6.855239960822723
chr1	MUTYH	45331660	45331872	0	213	35062	5148	35062	4935	0.0	7.104761904761904
chr1	MUTYH	45333412	45333617	1172	206	35062	5148	33890	4942	5.689320388349515	6.857547551598543
chr1	MUTYH	45338185	45338656	5739	472	35062	5148	29323	4676	12.158898305084746	6.270958083832335
chr1	TESK2	45346692	45346779	0	88	53192	3331	53192	3243	0.0	16.40209682392846
chr1	CCDC163	45497298	45497383	0	86	1479	2764	1479	2678	0.0	0.5522778192681105
chr1	CCDC163	45495417	45495545	0	129	1479	2764	1479	2635	0.0	0.5612903225806452
chr1	CCDC163	45495417	45495473	0	57	1479	2764	1479	2707	0.0	0.546361285555966
chr1	CCDC163	45497303	45497383	0	81	1479	2764	1479	2683	0.0	0.551248602310846
chr1	CCDC17	45623556	45623652	0	97	0	2792	0	2695	0.0	0.0
chr1	CCDC17	45623216	45623439	0	224	0	2792	0	2568	0.0	0.0
chr1	GPBP1L1	45685575	45685620	0	46	51	7449	51	7403	0.0	0.006889099013913279
chr1	PIK3R3	46055794	46055971	0	178	78105	7408	78105	7230	0.0	10.802904564315353
chr1	PIK3R3	46131846	46131956	0	111	78105	7408	78105	7297	0.0	10.703713855008909
chr1	POMGNT1	46194843	46194961	0	119	13905	5476	13905	5357	0.0	2.5956692178458094
chr1	KNCN	46549933	46550002	0	70	2355	2938	2355	2868	0.0	0.8211297071129707
chr1	MKNK1	46560233	46560277	0	45	1727	6721	1727	6676	0.0	0.25868783702816056
chr1	MKNK1	46574946	46575020	0	75	1727	6721	1727	6646	0.0	0.25985555221185674
chr1	MKNK1	46580529	46580627	0	99	1727	6721	1727	6622	0.0	0.260797342192691
chr1	MKNK1	46571416	46571539	0	124	1727	6721	1727	6597	0.0	0.26178566014855237
chr1	MKNK1	46561477	46561642	0	166	1727	6721	1727	6555	0.0	0.26346300533943556
chr1	MKNK1	46582813	46582923	0	111	1727	6721	1727	6610	0.0	0.26127080181543116
chr1	MKNK1	46582813	46582905	0	93	1727	6721	1727	6628	0.0	0.2605612552806276
chr1	MKNK1	46585873	46585974	0	102	1727	6721	1727	6619	0.0	0.2609155461550083
chr1	ATPAF1	46653816	46653867	60	52	5555	4748	5495	4696	1.1538461538461537	1.170144804088586
chr1	ATPAF1	46663832	46663923	60	92	5555	4748	5495	4656	0.6521739130434783	1.1801975945017182
chr1	EFCAB14	46688352	46688544	5362	193	81597	13320	76235	13127	27.78238341968912	5.807496000609431
chr1	EFCAB14	46680059	46680138	0	80	81597	13320	81597	13240	0.0	6.162915407854985
chr1	EFCAB14	46685082	46685144	0	63	81597	13320	81597	13257	0.0	6.155012446254808
chr1	CYP4A11	46933945	46934079	0	135	0	3867	0	3732	0.0	0.0
chr1	CYP4A11	46932982	46933047	0	66	0	3867	0	3801	0.0	0.0
chr1	CYP4A11	46934175	46934366	0	192	0	3867	0	3675	0.0	0.0
chr1	CYP4A11	46934999	46935154	0	156	0	3867	0	3711	0.0	0.0
chr1	CYP4A11	46934999	46935058	0	60	0	3867	0	3807	0.0	0.0
chr1	PDZK1IP1	47187318	47187427	0	110	46271	1435	46271	1325	0.0	34.921509433962264
chr1	TAL1	47225442	47225889	0	448	51	5709	51	5261	0.0	0.009693974529557118
chr1	STIL	47312947	47313156	102	210	379	6600	277	6390	0.4857142857142857	0.0433489827856025
chr1	STIL	47312947	47313021	102	75	379	6600	277	6525	1.36	0.042452107279693486
chr1	TRABD2B	47794585	47794760	1034	176	26893	7531	25859	7355	5.875	3.515839564921822
chr1	SPATA6	48413109	48413151	0	43	0	5955	0	5912	0.0	0.0
chr1	SPATA6	48451551	48451600	0	50	0	5955	0	5905	0.0	0.0
chr1	SPATA6	48393254	48393300	0	47	0	5955	0	5908	0.0	0.0
chr1	BEND5	48742622	48742771	0	150	889	2148	889	1998	0.0	0.44494494494494496
chr1	BEND5	48736238	48736452	0	215	889	2148	889	1933	0.0	0.45990688049663736
chr1	BEND5	48761336	48761470	175	135	889	2148	714	2013	1.2962962962962963	0.35469448584202684
chr1	LINC02808	50318281	50318406	0	126	102	3525	102	3399	0.0	0.03000882612533098
chr1	FAF1	50451792	50452193	0	402	0	7571	0	7169	0.0	0.0
chr1	TTC39A	51296078	51296170	0	93	1945	5284	1945	5191	0.0	0.3746869581968792
chr1	TTC39A	51343006	51343078	0	73	1945	5284	1945	5211	0.0	0.37324889656495874
chr1	EPS15	51468472	51468568	117	97	16859	7406	16742	7309	1.2061855670103092	2.290600629361062
chr1	CALR4P	51567173	51567332	0	160	0	2713	0	2553	0.0	0.0
chr1	NRDC	51791577	51791661	0	85	8825	6114	8825	6029	0.0	1.4637585005805274
chr1	NRDC	51806793	51806913	0	121	8825	6114	8825	5993	0.0	1.472551309861505
chr1	NRDC	51837486	51837620	48	135	8825	6114	8777	5979	0.35555555555555557	1.4679712326476
chr1	NRDC	51836368	51836438	0	71	8825	6114	8825	6043	0.0	1.460367367201721
chr1	TXNDC12	52030366	52030548	0	183	202	2873	202	2690	0.0	0.07509293680297398
chr1	TUT4	52458335	52458449	0	115	103567	15476	103567	15361	0.0	6.742204283575288
chr1	TUT4	52481422	52481635	0	214	103567	15476	103567	15262	0.0	6.785938933298388
chr1	TUT4	52497005	52497183	0	179	103567	15476	103567	15297	0.0	6.7704124991828465
chr1	TUT4	52525562	52526373	533	812	103567	15476	103034	14664	0.6564039408866995	7.026322967812329
chr1	ECHDC2	52897436	52897484	2263	49	72802	10086	70539	10037	46.183673469387756	7.027896781906945
chr1	ECHDC2	52899173	52899224	0	52	72802	10086	72802	10034	0.0	7.255531193940602
chr1	ECHDC2	52906518	52906611	1247	94	72802	10086	71555	9992	13.26595744680851	7.161228983186549
chr1	ECHDC2	52905033	52905090	1450	58	72802	10086	71352	10028	25.0	7.115277223773434
chr1	ECHDC2	52907867	52907954	0	88	72802	10086	72802	9998	0.0	7.2816563312662534
chr1	ECHDC2	52915130	52915292	0	163	72802	10086	72802	9923	0.0	7.336692532500252
chr1	ECHDC2	52913894	52914095	51	202	72802	10086	72751	9884	0.2524752475247525	7.360481586402266
chr1	ECHDC2	52917543	52917615	0	73	72802	10086	72802	10013	0.0	7.270748027564166
chr1	SLC1A7	53114757	53114973	0	217	998	3662	998	3445	0.0	0.2896952104499274
chr1	MAGOH	53233541	53233652	0	112	1020	1368	1020	1256	0.0	0.8121019108280255
chr1	LRP8	53249379	53249556	0	178	88986	13559	88986	13381	0.0	6.650175622150811
chr1	LRP8	53257239	53257464	0	226	88986	13559	88986	13333	0.0	6.674116852921323
chr1	LRP8	53262445	53262564	1086	120	88986	13559	87900	13439	9.05	6.540665228067565
chr1	LRP8	53271027	53271153	1773	127	88986	13559	87213	13432	13.960629921259843	6.492927337701013
chr1	LRP8	53271226	53271346	0	121	88986	13559	88986	13438	0.0	6.621967554695639
chr1	LRP8	53276691	53277078	142	388	88986	13559	88844	13171	0.36597938144329895	6.7454255561460785
chr1	LRP8	53275630	53275753	120	124	88986	13559	88866	13435	0.967741935483871	6.6145143282471155
chr1	LRP8	53248462	53248591	0	130	88986	13559	88986	13429	0.0	6.626405540248715
chr1	LRP8	53246955	53247056	0	102	88986	13559	88986	13457	0.0	6.612617968343613
chr1	LRP8	53280586	53280715	0	130	88986	13559	88986	13429	0.0	6.626405540248715
chr1	LRP8	53246923	53247056	0	134	88986	13559	88986	13425	0.0	6.628379888268157
chr1	LRP8	53271226	53271415	0	190	88986	13559	88986	13369	0.0	6.656144812626225
chr1	LRP8	53272603	53272642	0	40	88986	13559	88986	13519	0.0	6.582291589614616
chr1	LRP8	53254910	53254957	0	48	88986	13559	88986	13511	0.0	6.586189031159796
chr1	LRP8	53249379	53249440	0	62	88986	13559	88986	13497	0.0	6.59302067126028
chr1	LRP8	53258008	53258074	0	67	88986	13559	88986	13492	0.0	6.595463978654017
chr1	LINC02812	53367414	53367485	958	72	18313	936	17355	864	13.305555555555555	20.086805555555557
chr1	SLC25A3P1	53415400	53415524	9	125	9	1834	0	1709	0.072	0.0
chr1	NDC1	53835499	53835620	0	122	8175	4738	8175	4616	0.0	1.7710138648180243
chr1	YIPF1	53855000	53855051	0	52	0	2050	0	1998	0.0	0.0
chr1	YIPF1	53883112	53883276	0	165	0	2050	0	1885	0.0	0.0
chr1	YIPF1	53888906	53888986	0	81	0	2050	0	1969	0.0	0.0
chr1	YIPF1	53889243	53889463	0	221	0	2050	0	1829	0.0	0.0
chr1	LDLRAD1	54014235	54014364	0	130	18577	2382	18577	2252	0.0	8.24911190053286
chr1	LDLRAD1	54012142	54012280	1113	139	18577	2382	17464	2243	8.007194244604317	7.786000891662951
chr1	LDLRAD1	54017375	54017427	0	53	18577	2382	18577	2329	0.0	7.976384714469729
chr1	TMEM59	54047266	54047372	1288	107	24584	9158	23296	9051	12.037383177570094	2.5738592420726993
chr1	TMEM59	54048649	54048682	13	34	24584	9158	24571	9124	0.38235294117647056	2.6930074528715475
chr1	CYB5RL	54187651	54187739	0	89	612	8739	612	8650	0.0	0.07075144508670521
chr1	CYB5RL	54190747	54190896	408	150	612	8739	204	8589	2.72	0.023751309814879495
chr1	CYB5RL	54179983	54180233	0	251	612	8739	612	8488	0.0	0.07210179076343072
chr1	CYB5RL	54186180	54186286	0	107	612	8739	612	8632	0.0	0.07089898053753475
chr1	CYB5RL	54179148	54179352	0	205	612	8739	612	8534	0.0	0.07171314741035857
chr1	CYB5RL	54190737	54190896	408	160	612	8739	204	8579	2.55	0.023778995220888215
chr1	SSBP3	54257126	54257186	153	61	11087	3706	10934	3645	2.5081967213114753	2.9997256515775033
chr1	SSBP3	54258068	54258149	408	82	11087	3706	10679	3624	4.975609756097561	2.9467439293598234
chr1	DHCR24	54877901	54877998	0	98	714	4979	714	4881	0.0	0.14628149969268592
chr1	DHCR24	54855988	54856024	0	37	714	4979	714	4942	0.0	0.14447592067988668
chr1	DHCR24	54879748	54879805	0	58	714	4979	714	4921	0.0	0.14509246088193456
chr1	AL590440.2	54977724	54977862	0	139	0	1589	0	1450	0.0	0.0
chr1	AL590440.2	54979558	54979643	0	86	0	1589	0	1503	0.0	0.0
chr1	USP24	55151911	55151975	0	65	2636	12094	2636	12029	0.0	0.21913708537700557
chr1	LINC01753	55921364	55921411	0	48	0	710	0	662	0.0	0.0
chr1	LINC01753	55921311	55921411	0	101	0	710	0	609	0.0	0.0
chr1	AC119674.1	56172555	56172666	0	112	0	6862	0	6750	0.0	0.0
chr1	AC119674.1	56236374	56236434	0	61	0	6862	0	6801	0.0	0.0
chr1	AC119674.1	56166079	56166159	0	81	0	6862	0	6781	0.0	0.0
chr1	AC119674.1	56168238	56168342	0	105	0	6862	0	6757	0.0	0.0
chr1	AC119674.1	56253652	56253893	0	242	0	6862	0	6620	0.0	0.0
chr1	AC119674.1	56258368	56258500	0	133	0	6862	0	6729	0.0	0.0
chr1	AC119674.1	56332292	56332406	0	115	0	6862	0	6747	0.0	0.0
chr1	AC119674.2	56478885	56479111	0	227	0	2666	0	2439	0.0	0.0
chr1	AC119674.1	56341660	56341728	0	69	0	6862	0	6793	0.0	0.0
chr1	AC119674.1	56304464	56304560	0	97	0	6862	0	6765	0.0	0.0
chr1	AC119674.1	56318385	56318576	0	192	0	6862	0	6670	0.0	0.0
chr1	AC119674.2	56400093	56400267	0	175	0	2666	0	2491	0.0	0.0
chr1	FYB2	56738624	56738653	0	30	2550	4670	2550	4640	0.0	0.5495689655172413
chr1	FYB2	56742160	56742221	0	62	2550	4670	2550	4608	0.0	0.5533854166666666
chr1	C8B	56959528	56959657	1419	130	5345	2746	3926	2616	10.915384615384616	1.5007645259938838
chr1	C8B	56963771	56963993	102	223	5345	2746	5243	2523	0.45739910313901344	2.078081648830757
chr1	OMA1	58506059	58506209	0	151	0	3704	0	3553	0.0	0.0
chr1	OMA1	58538794	58539310	0	517	0	3704	0	3187	0.0	0.0
chr1	MYSM1	58671869	58671958	0	90	0	13140	0	13050	0.0	0.0
chr1	MYSM1	58663449	58663522	0	74	0	13140	0	13066	0.0	0.0
chr1	LINC02777	58889148	58889208	0	61	0	1976	0	1915	0.0	0.0
chr1	LINC02777	58896997	58897090	0	94	0	1976	0	1882	0.0	0.0
chr1	LINC02777	58884871	58885005	0	135	0	1976	0	1841	0.0	0.0
chr1	HSD52	59198182	59198512	0	331	16576	6497	16576	6166	0.0	2.688290626013623
chr1	HSD52	59203094	59203306	0	213	16576	6497	16576	6284	0.0	2.6378103119032463
chr1	CYP2J2	59904870	59905058	0	189	0	2983	0	2794	0.0	0.0
chr1	CYP2J2	59904365	59904516	0	152	0	2983	0	2831	0.0	0.0
chr1	LINC01748	60588036	60588162	0	127	51	15481	51	15354	0.0	0.0033216100039077765
chr1	LINC01748	60537680	60537788	0	109	51	15481	51	15372	0.0	0.003317720530835285
chr1	LINC01748	60528918	60529249	0	332	51	15481	51	15149	0.0	0.003366558848768896
chr1	LINC01748	60554472	60554568	0	97	51	15481	51	15384	0.0	0.0033151326053042123
chr1	LINC01748	60573337	60573413	0	77	51	15481	51	15404	0.0	0.0033108283562710986
chr1	LINC01748	60600126	60600250	0	125	51	15481	51	15356	0.0	0.003321177389945298
chr1	LINC01748	60640010	60640126	0	117	51	15481	51	15364	0.0	0.0033194480604009373
chr1	LINC01748	60543476	60543521	0	46	51	15481	51	15435	0.0	0.003304178814382896
chr1	LINC01748	60600126	60600270	0	145	51	15481	51	15336	0.0	0.003325508607198748
chr1	AC099792.1	60733463	60733522	0	60	0	4307	0	4247	0.0	0.0
chr1	AC099792.1	60729574	60729667	0	94	0	4307	0	4213	0.0	0.0
chr1	AC099792.1	60726409	60726476	0	68	0	4307	0	4239	0.0	0.0
chr1	AC099792.1	60677195	60677412	0	218	0	4307	0	4089	0.0	0.0
chr1	AC099792.1	60732446	60732508	0	63	0	4307	0	4244	0.0	0.0
chr1	AC099792.1	60704777	60704959	0	183	0	4307	0	4124	0.0	0.0
chr1	NFIA-AS2	60969930	60970065	0	136	0	5402	0	5266	0.0	0.0
chr1	NFIA-AS2	60963565	60963804	0	240	0	5402	0	5162	0.0	0.0
chr1	NFIA-AS1	61249947	61249981	0	35	0	846	0	811	0.0	0.0
chr1	NFIA-AS1	61251284	61251369	0	86	0	846	0	760	0.0	0.0
chr1	NFIA-AS1	61251284	61251407	0	124	0	846	0	722	0.0	0.0
chr1	NFIA-AS1	61249947	61250128	0	182	0	846	0	664	0.0	0.0
chr1	TM2D1	61723712	61723772	0	61	51	5509	51	5448	0.0	0.009361233480176211
chr1	TM2D1	61724287	61724425	0	139	51	5509	51	5370	0.0	0.009497206703910615
chr1	TM2D1	61686791	61686895	0	105	51	5509	51	5404	0.0	0.009437453737971873
chr1	KANK4	62273203	62275087	328	1885	2011	6824	1683	4939	0.1740053050397878	0.34075723830734966
chr1	DOCK7	62543655	62543745	0	91	1869	19101	1869	19010	0.0	0.09831667543398212
chr1	DOCK7	62544946	62545039	0	94	1869	19101	1869	19007	0.0	0.09833219340243068
chr1	DOCK7	62583183	62583254	0	72	1869	19101	1869	19029	0.0	0.09821850859214883
chr1	DOCK7	62543285	62543321	0	37	1869	19101	1869	19064	0.0	0.09803818715904322
chr1	DOCK7	62633899	62633935	0	37	1869	19101	1869	19064	0.0	0.09803818715904322
chr1	LINC01739	63010877	63010987	0	111	827	2075	827	1964	0.0	0.4210794297352342
chr1	LINC00466	63185558	63185661	0	104	2475	6950	2475	6846	0.0	0.36152497808939527
chr1	LINC00466	63197142	63197389	0	248	2475	6950	2475	6702	0.0	0.3692927484333035
chr1	LINC00466	63198715	63199001	0	287	2475	6950	2475	6663	0.0	0.37145429986492573
chr1	LINC00466	63164243	63164355	0	113	2475	6950	2475	6837	0.0	0.362000877577885
chr1	LINC00466	63183439	63183579	0	141	2475	6950	2475	6809	0.0	0.36348949919224555
chr1	LINC00466	63160887	63161172	0	286	2475	6950	2475	6664	0.0	0.3713985594237695
chr1	LINC00466	63203104	63203167	0	64	2475	6950	2475	6886	0.0	0.35942492012779553
chr1	LINC00466	63170151	63170424	51	274	2475	6950	2424	6676	0.18613138686131386	0.36309167165967643
chr1	LINC00466	63171117	63171175	0	59	2475	6950	2475	6891	0.0	0.3591641271223335
chr1	LINC00466	63200804	63201013	0	210	2475	6950	2475	6740	0.0	0.3672106824925816
chr1	LINC00466	63244355	63244478	0	124	2475	6950	2475	6826	0.0	0.36258423674186935
chr1	LINC00466	63198715	63199020	0	306	2475	6950	2475	6644	0.0	0.37251655629139074
chr1	LINC00466	63257984	63258050	0	67	2475	6950	2475	6883	0.0	0.35958157780037775
chr1	LINC00466	63261741	63262700	51	960	2475	6950	2424	5990	0.053125	0.4046744574290484
chr1	FOXD3-AS1	63321664	63322080	0	417	639	1214	639	797	0.0	0.8017565872020075
chr1	ITGB3BP	63446805	63446856	0	52	153	5316	153	5264	0.0	0.029065349544072947
chr1	ITGB3BP	63508527	63508570	0	44	153	5316	153	5272	0.0	0.02902124430955994
chr1	ITGB3BP	63510064	63510181	0	118	153	5316	153	5198	0.0	0.029434397845325123
chr1	ITGB3BP	63447564	63447614	0	51	153	5316	153	5265	0.0	0.02905982905982906
chr1	ROR1-AS1	64108319	64108393	0	75	52009	4585	52009	4510	0.0	11.531929046563192
chr1	ROR1-AS1	64111111	64111369	0	259	52009	4585	52009	4326	0.0	12.022422561257512
chr1	ROR1-AS1	64113628	64113791	1785	164	52009	4585	50224	4421	10.884146341463415	11.360325718163311
chr1	JAK1	64841450	64841601	0	152	78	11649	78	11497	0.0	0.006784378533530486
chr1	JAK1	64956933	64957017	0	85	78	11649	78	11564	0.0	0.00674507090971982
chr1	JAK1	64841555	64841601	0	47	78	11649	78	11602	0.0	0.00672297879675918
chr1	JAK1	64882891	64883063	0	173	78	11649	78	11476	0.0	0.006796793307772743
chr1	JAK1	65044479	65044582	0	104	78	11649	78	11545	0.0	0.006756171502815072
chr1	LINC01359	64989585	64989668	0	84	0	5118	0	5034	0.0	0.0
chr1	LINC01359	64993476	64993581	0	106	0	5118	0	5012	0.0	0.0
chr1	LINC01359	64993471	64993581	0	111	0	5118	0	5007	0.0	0.0
chr1	LINC01359	64992748	64992889	0	142	0	5118	0	4976	0.0	0.0
chr1	LINC01359	65001897	65001965	0	69	0	5118	0	5049	0.0	0.0
chr1	LINC01359	64987262	64987673	0	412	0	5118	0	4706	0.0	0.0
chr1	DNAI4	66827811	66827910	0	100	5213	6353	5213	6253	0.0	0.8336798336798337
chr1	DNAI4	66835625	66835777	0	153	5213	6353	5213	6200	0.0	0.8408064516129032
chr1	DNAI4	66847483	66847678	0	196	5213	6353	5213	6157	0.0	0.8466785772291701
chr1	DNAI4	66874780	66874937	0	158	5213	6353	5213	6195	0.0	0.8414850686037126
chr1	DNAI4	66919017	66919116	0	100	5213	6353	5213	6253	0.0	0.8336798336798337
chr1	C1ORF141	67095234	67095421	455	188	1785	3403	1330	3215	2.4202127659574466	0.41368584758942456
chr1	C1ORF141	67115351	67115464	0	114	1785	3403	1785	3289	0.0	0.5427181514138036
chr1	C1ORF141	67113613	67113756	0	144	1785	3403	1785	3259	0.0	0.5477140227063516
chr1	WLS	68193954	68194221	0	268	164574	4383	164574	4115	0.0	39.993681652490885
chr1	WLS	68193954	68194227	0	274	164574	4383	164574	4109	0.0	40.05208079824775
chr1	WLS	68228220	68228255	0	36	164574	4383	164574	4347	0.0	37.8592132505176
chr1	WLS	68186539	68186649	0	111	164574	4383	164574	4272	0.0	38.52387640449438
chr1	DEPDC1	68482045	68482897	0	853	102	5916	102	5063	0.0	0.020146158404108237
chr1	DEPDC1	68494429	68494695	0	267	102	5916	102	5649	0.0	0.018056293149229952
chr1	DEPDC1	68483272	68483305	0	34	102	5916	102	5882	0.0	0.017341040462427744
chr1	ANKRD13C	70313744	70313790	0	47	0	2923	0	2876	0.0	0.0
chr1	ANKRD13C	70324852	70324957	0	106	0	2923	0	2817	0.0	0.0
chr1	PTGER3	70974296	70974388	0	93	0	6851	0	6758	0.0	0.0
chr1	PTGER3	70953762	70953789	0	28	0	6851	0	6823	0.0	0.0
chr1	ZRANB2	71065677	71065752	0	76	276	3973	276	3897	0.0	0.07082371054657428
chr1	AL583808.1	72766644	72766687	0	44	0	2770	0	2726	0.0	0.0
chr1	AL583808.1	72850749	72850800	0	52	0	2770	0	2718	0.0	0.0
chr1	AL583808.1	72700939	72701063	0	125	0	2770	0	2645	0.0	0.0
chr1	AL583808.1	72756530	72756558	0	29	0	2770	0	2741	0.0	0.0
chr1	AL583808.1	72735556	72735635	0	80	0	2770	0	2690	0.0	0.0
chr1	AL591463.1	73905928	73906012	0	85	0	3781	0	3696	0.0	0.0
chr1	LRRIQ3	74041212	74041933	0	722	0	6363	0	5641	0.0	0.0
chr1	LRRIQ3	74182537	74182861	0	325	0	6363	0	6038	0.0	0.0
chr1	LRRIQ3	74041690	74041933	0	244	0	6363	0	6119	0.0	0.0
chr1	ERICH3	74623047	74623285	0	239	2171	8847	2171	8608	0.0	0.25220724907063197
chr1	CRYZ	74707102	74707204	51	103	204	3988	153	3885	0.49514563106796117	0.039382239382239385
chr1	CRYZ	74719208	74719372	0	165	204	3988	204	3823	0.0	0.05336123463248758
chr1	CRYZ	74724710	74724834	0	125	204	3988	204	3863	0.0	0.05280869790318406
chr1	CRYZ	74730381	74730420	0	40	204	3988	204	3948	0.0	0.05167173252279635
chr1	AL137803.1	75723667	75723788	0	122	51	1996	51	1874	0.0	0.027214514407684097
chr1	PIGK	77166718	77166830	0	113	0	5525	0	5412	0.0	0.0
chr1	PIGK	77210435	77210489	0	55	0	5525	0	5470	0.0	0.0
chr1	ZZZ3	77631849	77633405	52483	1557	52636	9025	153	7468	33.7077713551702	0.020487412961971076
chr1	ZZZ3	77641383	77641446	0	64	52636	9025	52636	8961	0.0	5.873898002455083
chr1	USP33	77701368	77701471	0	104	4377	6945	4377	6841	0.0	0.6398187399502997
chr1	USP33	77714613	77714783	0	171	4377	6945	4377	6774	0.0	0.646147032772365
chr1	USP33	77745420	77745599	0	180	4377	6945	4377	6765	0.0	0.6470066518847006
chr1	USP33	77746398	77746556	0	159	4377	6945	4377	6786	0.0	0.6450044208664898
chr1	FUBP1	77945505	77945642	0	138	1289	4700	1289	4562	0.0	0.28255151249451993
chr1	FUBP1	77969021	77969084	1016	64	1289	4700	273	4636	15.875	0.0588869715271786
chr1	ADGRL4	78921612	78921786	0	175	16274	5737	16274	5562	0.0	2.925925925925926
chr1	ADGRL4	78926885	78927091	0	207	16274	5737	16274	5530	0.0	2.942857142857143
chr1	ADGRL4	79005069	79005219	11666	151	16274	5737	4608	5586	77.25827814569537	0.8249194414607949
chr1	ADGRL4	78921612	78921805	0	194	16274	5737	16274	5543	0.0	2.9359552588850804
chr1	AL157944.1	82684437	82684573	0	137	102	7228	102	7091	0.0	0.014384430968833732
chr1	LINC01725	83849906	83850022	0	117	51	12439	51	12322	0.0	0.004138938484012335
chr1	TTLL7	83942462	83942679	0	218	51	10574	51	10356	0.0	0.004924681344148319
chr1	TTLL7	83887176	83887284	0	109	51	10574	51	10465	0.0	0.0048733874820831346
chr1	TTLL7	83882668	83882787	0	120	51	10574	51	10454	0.0	0.0048785154008035205
chr1	TTLL7	83933607	83933766	0	160	51	10574	51	10414	0.0	0.004897253696946418
chr1	CTBS	84569930	84570139	0	210	19992	6941	19992	6731	0.0	2.9701381666914277
chr1	SSX2IP	84671176	84671308	525	133	26681	8472	26156	8339	3.9473684210526314	3.1365871207578846
chr1	SSX2IP	84649670	84649948	5839	279	26681	8472	20842	8193	20.92831541218638	2.5438789210301476
chr1	SSX2IP	84655464	84655588	0	125	26681	8472	26681	8347	0.0	3.1964777764466277
chr1	SSX2IP	84680337	84680387	0	51	26681	8472	26681	8421	0.0	3.1683885524284525
chr1	MCOLN3	85041009	85041177	0	169	22642	6622	22642	6453	0.0	3.5087556175422283
chr1	MCOLN3	85047309	85047609	0	301	22642	6622	22642	6321	0.0	3.58202816010125
chr1	MCOLN3	85036709	85036868	0	160	22642	6622	22642	6462	0.0	3.503868771278242
chr1	MCOLN3	85047574	85047609	0	36	22642	6622	22642	6586	0.0	3.4378985727300333
chr1	AC092807.3	85494728	85494761	0	34	7032	1635	7032	1601	0.0	4.392254840724547
chr1	COL24A1	85960757	85960880	1388	124	168909	9632	167521	9508	11.193548387096774	17.618952461085403
chr1	COL24A1	85736145	85736559	117142	415	168909	9632	51767	9217	282.2698795180723	5.6164695671042635
chr1	LINC02795	86315603	86315747	0	145	0	2891	0	2746	0.0	0.0
chr1	ODF2L	86356443	86356602	0	160	102	7821	102	7661	0.0	0.013314188748205195
chr1	ODF2L	86368635	86368722	0	88	102	7821	102	7733	0.0	0.013190223716539506
chr1	ODF2L	86382241	86382358	0	118	102	7821	102	7703	0.0	0.013241594184084124
chr1	ODF2L	86385457	86385590	0	134	102	7821	102	7687	0.0	0.013269155717445037
chr1	ODF2L	86386914	86387079	0	166	102	7821	102	7655	0.0	0.01332462442847812
chr1	ODF2L	86386914	86387086	0	173	102	7821	102	7648	0.0	0.013336820083682008
chr1	ODF2L	86355344	86355383	0	40	102	7821	102	7781	0.0	0.01310885490296877
chr1	SELENOF	86868052	86868102	0	51	0	2208	0	2157	0.0	0.0
chr1	SELENOF	86866071	86866169	0	99	0	2208	0	2109	0.0	0.0
chr1	SELENOF	86887155	86887196	0	42	0	2208	0	2166	0.0	0.0
chr1	PKN2-AS1	87903898	87904077	0	180	1827	16670	1827	16490	0.0	0.11079442086112795
chr1	GTF2B	88887260	88887367	0	108	0	2533	0	2425	0.0	0.0
chr1	GTF2B	88887275	88887367	0	93	0	2533	0	2440	0.0	0.0
chr1	KYAT3	88988251	88988351	420	101	436	2212	16	2111	4.158415841584159	0.007579346281383231
chr1	GBP3	89020531	89020743	0	213	1617	4282	1617	4069	0.0	0.3973949373310396
chr1	GBP3	89020125	89020211	110	87	1617	4282	1507	4195	1.264367816091954	0.3592371871275328
chr1	GBP3	89020129	89020211	90	83	1617	4282	1527	4199	1.0843373493975903	0.3636580138128126
chr1	GBP3	89020352	89020743	0	392	1617	4282	1617	3890	0.0	0.415681233933162
chr1	AL627316.1	90395444	90395521	0	78	30935	3004	30935	2926	0.0	10.572453861927546
chr1	LINC02609	90789397	90789487	0	91	0	14100	0	14009	0.0	0.0
chr1	LINC02609	90831929	90832196	0	268	0	14100	0	13832	0.0	0.0
chr1	LINC02609	90837549	90837765	0	217	0	14100	0	13883	0.0	0.0
chr1	HFM1	91319077	91319209	1428	133	14357	5855	12929	5722	10.736842105263158	2.2595246417336594
chr1	HFM1	91323092	91323199	0	108	14357	5855	14357	5747	0.0	2.4981729598051157
chr1	HFM1	91266016	91266107	0	92	14357	5855	14357	5763	0.0	2.49123720284574
chr1	HFM1	91396292	91396405	0	114	14357	5855	14357	5741	0.0	2.500783835568716
chr1	HFM1	91316390	91316476	190	87	14357	5855	14167	5768	2.1839080459770117	2.4561373092926493
chr1	HFM1	91394092	91394402	0	311	14357	5855	14357	5544	0.0	2.5896464646464645
chr1	TGFBR3	91800958	91801055	0	98	907	8604	907	8506	0.0	0.10663061368445803
chr1	TGFBR3	91866755	91866842	0	88	907	8604	907	8516	0.0	0.1065054015969939
chr1	GLMN	92264553	92264638	0	86	165	2929	165	2843	0.0	0.0580372845585649
chr1	GLMN	92266699	92266741	0	43	165	2929	165	2886	0.0	0.057172557172557176
chr1	EVI5	92663419	92663452	0	34	524	8299	524	8265	0.0	0.06339987900786449
chr1	EVI5	92662718	92662865	0	148	524	8299	524	8151	0.0	0.06428659060238008
chr1	DIPK1A	92876295	92876430	0	136	3630	3098	3630	2962	0.0	1.225523295070898
chr1	DIPK1A	92847182	92847359	39	178	3630	3098	3591	2920	0.21910112359550563	1.2297945205479452
chr1	TMED5	93158814	93158885	0	72	4383	9216	4383	9144	0.0	0.4793307086614173
chr1	TMED5	93156035	93156084	0	50	4383	9216	4383	9166	0.0	0.47818023128954834
chr1	CCDC18-AS1	93269682	93269758	0	77	36241	4958	36241	4881	0.0	7.424912927678754
chr1	CCDC18-AS1	93318167	93318228	0	62	36241	4958	36241	4896	0.0	7.402165032679738
chr1	CCDC18-AS1	93290564	93290686	0	123	36241	4958	36241	4835	0.0	7.495553257497415
chr1	CCDC18-AS1	93309539	93309634	689	96	36241	4958	35552	4862	7.177083333333333	7.3122171945701355
chr1	CCDC18-AS1	93309714	93309790	1165	77	36241	4958	35076	4881	15.12987012987013	7.1862323294406885
chr1	CCDC18-AS1	93311489	93311608	0	120	36241	4958	36241	4838	0.0	7.490905332782141
chr1	CCDC18-AS1	93326601	93326662	0	62	36241	4958	36241	4896	0.0	7.402165032679738
chr1	CCDC18-AS1	93337376	93339274	102	1899	36241	4958	36139	3059	0.053712480252764615	11.813991500490356
chr1	CCDC18-AS1	93339155	93339274	0	120	36241	4958	36241	4838	0.0	7.490905332782141
chr1	CCDC18-AS1	93345539	93345590	0	52	36241	4958	36241	4906	0.0	7.387077048512026
chr1	DNTTIP2	93875644	93875783	108	140	465	6505	357	6365	0.7714285714285715	0.056087981146897094
chr1	GCLM	93904522	93904588	0	67	156	5434	156	5367	0.0	0.029066517607602014
chr1	ABCA4	94056600	94056822	6004	223	152027	8539	146023	8316	26.923766816143498	17.55928330928331
chr1	F3	94532320	94532480	0	161	0	2893	0	2732	0.0	0.0
chr1	SLC44A3-AS1	94732257	94732437	0	181	8896	10264	8896	10083	0.0	0.8822771000694238
chr1	SLC44A3-AS1	94770261	94770313	0	53	8896	10264	8896	10211	0.0	0.8712173146606601
chr1	SLC44A3-AS1	94742268	94742414	0	147	8896	10264	8896	10117	0.0	0.8793120490263913
chr1	SLC44A3-AS1	94705438	94705557	0	120	8896	10264	8896	10144	0.0	0.8769716088328076
chr1	SLC44A3-AS1	94743837	94743993	0	157	8896	10264	8896	10107	0.0	0.8801820520431384
chr1	CNN3	94902120	94902258	0	139	4094	2792	4094	2653	0.0	1.5431586882774218
chr1	AC092802.1	95180333	95180359	0	27	0	4080	0	4053	0.0	0.0
chr1	AC092802.2	95249354	95249448	0	95	0	1425	0	1330	0.0	0.0
chr1	AL445218.1	95372580	95372656	421	77	1491	883	1070	806	5.467532467532467	1.3275434243176178
chr1	DPYD	97720824	97720926	0	103	2089	7161	2089	7058	0.0	0.29597619722300933
chr1	PLPPR5	98897261	98897389	0	129	204	4707	204	4578	0.0	0.04456094364351245
chr1	FRRS1	99712104	99712163	0	60	0	8643	0	8583	0.0	0.0
chr1	LRRC39	100149365	100149435	0	71	5123	1986	5123	1915	0.0	2.675195822454308
chr1	EXTL2	100876793	100876864	0	72	0	4022	0	3950	0.0	0.0
chr1	EXTL2	100878423	100878447	0	25	0	4022	0	3997	0.0	0.0
chr1	EXTL2	100878393	100878447	0	55	0	4022	0	3967	0.0	0.0
chr1	DPH5	100992636	100992740	0	105	0	2126	0	2021	0.0	0.0
chr1	DPH5	101001466	101001587	0	122	0	2126	0	2004	0.0	0.0
chr1	DPH5	101013709	101013818	0	110	0	2126	0	2016	0.0	0.0
chr1	DPH5	101025308	101025466	0	159	0	2126	0	1967	0.0	0.0
chr1	OLFM3	101812409	101813146	0	738	0	4403	0	3665	0.0	0.0
chr1	COL11A1	103025799	103025952	0	154	51	8948	51	8794	0.0	0.005799408687741642
chr1	COL11A1	103026215	103026332	0	118	51	8948	51	8830	0.0	0.005775764439411099
chr1	COL11A1	102979596	102979612	0	17	51	8948	51	8931	0.0	0.005710446758481693
chr1	AC095032.1	103418744	103418815	0	72	150	2780	150	2708	0.0	0.055391432791728215
chr1	AC095032.1	103469341	103469390	0	50	150	2780	150	2730	0.0	0.054945054945054944
chr1	LINC01676	105604162	105604265	0	104	0	3046	0	2942	0.0	0.0
chr1	LINC01676	105600630	105600759	0	130	0	3046	0	2916	0.0	0.0
chr1	LINC01676	105603276	105603558	0	283	0	3046	0	2763	0.0	0.0
chr1	LINC01676	105604162	105604260	0	99	0	3046	0	2947	0.0	0.0
chr1	LINC01676	105612899	105612944	0	46	0	3046	0	3000	0.0	0.0
chr1	LINC01676	105601269	105601385	0	117	0	3046	0	2929	0.0	0.0
chr1	LINC01676	105603276	105603562	0	287	0	3046	0	2759	0.0	0.0
chr1	LINC01677	105954509	105954711	0	203	0	3134	0	2931	0.0	0.0
chr1	VAV3	107683487	107683533	0	47	0	7345	0	7298	0.0	0.0
chr1	VAV3	107576391	107576475	0	85	0	7345	0	7260	0.0	0.0
chr1	VAV3	107609423	107609539	0	117	0	7345	0	7228	0.0	0.0
chr1	SLC25A24	108181940	108182028	0	89	816	5275	816	5186	0.0	0.15734670266101042
chr1	NBPF4	108237010	108237097	0	88	0	2602	0	2514	0.0	0.0
chr1	HENMT1	108655585	108655698	0	114	0	2436	0	2322	0.0	0.0
chr1	HENMT1	108659863	108659962	0	100	0	2436	0	2336	0.0	0.0
chr1	HENMT1	108649340	108649433	0	94	0	2436	0	2342	0.0	0.0
chr1	AKNAD1	108820544	108820626	0	83	5582	5057	5582	4974	0.0	1.1222356252513068
chr1	AKNAD1	108834446	108834528	0	83	5582	5057	5582	4974	0.0	1.1222356252513068
chr1	AKNAD1	108834928	108835056	0	129	5582	5057	5582	4928	0.0	1.1327110389610389
chr1	CLCC1	108941404	108941498	0	95	3798	6514	3798	6419	0.0	0.5916809471880355
chr1	CLCC1	108943835	108944057	0	223	3798	6514	3798	6291	0.0	0.6037195994277539
chr1	CLCC1	108947337	108947508	0	172	3798	6514	3798	6342	0.0	0.5988647114474929
chr1	CLCC1	108950308	108950448	0	141	3798	6514	3798	6373	0.0	0.5959516711125059
chr1	CLCC1	108962308	108962469	0	162	3798	6514	3798	6352	0.0	0.5979219143576826
chr1	CLCC1	108938165	108938308	0	144	3798	6514	3798	6370	0.0	0.5962323390894819
chr1	CLCC1	108943835	108943907	0	73	3798	6514	3798	6441	0.0	0.5896599906846763
chr1	CLCC1	108950308	108950438	0	131	3798	6514	3798	6383	0.0	0.5950180166066114
chr1	CLCC1	108950308	108950394	0	87	3798	6514	3798	6427	0.0	0.5909444530885327
chr1	CLCC1	108938165	108938216	0	52	3798	6514	3798	6462	0.0	0.5877437325905293
chr1	CLCC1	108943474	108943615	0	142	3798	6514	3798	6372	0.0	0.596045197740113
chr1	CLCC1	108962308	108962464	0	157	3798	6514	3798	6357	0.0	0.5974516281264748
chr1	CLCC1	108941404	108941494	0	91	3798	6514	3798	6423	0.0	0.5913124708080336
chr1	WDR47	109017517	109017601	0	85	1982	4440	1982	4355	0.0	0.4551090700344432
chr1	WDR47	109023354	109023521	0	168	1982	4440	1982	4272	0.0	0.4639513108614232
chr1	WDR47	109024864	109024992	0	129	1982	4440	1982	4311	0.0	0.4597541173741591
chr1	C1ORF194	109107920	109108037	0	118	0	1232	0	1114	0.0	0.0
chr1	C1ORF194	109107006	109107122	0	117	0	1232	0	1115	0.0	0.0
chr1	SORT1	109314260	109314384	0	125	22045	9152	22045	9027	0.0	2.442118090173923
chr1	SORT1	109397206	109397340	0	135	22045	9152	22045	9017	0.0	2.4448264389486525
chr1	GSTM3	109739832	109739908	0	77	1734	4562	1734	4485	0.0	0.3866220735785953
chr1	SLC16A4	110378852	110379356	1195	505	4214	3174	3019	2669	2.366336633663366	1.131135256650431
chr1	SLC16A4	110381651	110381795	2346	145	4214	3174	1868	3029	16.179310344827588	0.6167051832287884
chr1	SLC16A4	110382833	110382966	596	134	4214	3174	3618	3040	4.447761194029851	1.1901315789473683
chr1	LAMTOR5	110407032	110407128	0	97	204	1329	204	1232	0.0	0.16558441558441558
chr1	LRIF1	110951287	110952815	12919	1529	39586	3506	26667	1977	8.449313276651406	13.488619119878605
chr1	DRAM2	111124741	111124881	0	141	0	3309	0	3168	0.0	0.0
chr1	DRAM2	111139500	111139666	0	167	0	3309	0	3142	0.0	0.0
chr1	DRAM2	111122615	111122643	0	29	0	3309	0	3280	0.0	0.0
chr1	DRAM2	111139587	111139711	0	125	0	3309	0	3184	0.0	0.0
chr1	KCND3	111778435	111778492	0	58	31748	8036	31748	7978	0.0	3.9794434695412386
chr1	LINC02884	112238069	112238198	0	130	40712	6272	40712	6142	0.0	6.628459785086291
chr1	LINC02884	112271351	112271605	0	255	40712	6272	40712	6017	0.0	6.766162539471497
chr1	ST7L	112550600	112550693	0	94	0	7822	0	7728	0.0	0.0
chr1	ST7L	112555867	112556018	0	152	0	7822	0	7670	0.0	0.0
chr1	ST7L	112581991	112582106	0	116	0	7822	0	7706	0.0	0.0
chr1	ST7L	112583971	112584126	0	156	0	7822	0	7666	0.0	0.0
chr1	ST7L	112600793	112600848	0	56	0	7822	0	7766	0.0	0.0
chr1	ST7L	112616812	112616895	0	84	0	7822	0	7738	0.0	0.0
chr1	ST7L	112540778	112540872	0	95	0	7822	0	7727	0.0	0.0
chr1	ST7L	112541950	112542090	0	141	0	7822	0	7681	0.0	0.0
chr1	ST7L	112618908	112619139	0	232	0	7822	0	7590	0.0	0.0
chr1	ST7L	112616812	112616844	0	33	0	7822	0	7789	0.0	0.0
chr1	RHOC	112705099	112705168	0	70	0	2792	0	2722	0.0	0.0
chr1	RHOC	112705099	112706252	0	1154	0	2792	0	1638	0.0	0.0
chr1	RHOC	112703383	112703457	0	75	0	2792	0	2717	0.0	0.0
chr1	RHOC	112705099	112705123	0	25	0	2792	0	2767	0.0	0.0
chr1	RHOC	112705052	112705168	0	117	0	2792	0	2675	0.0	0.0
chr1	RHOC	112705099	112705201	0	103	0	2792	0	2689	0.0	0.0
chr1	AL603832.3	112711007	112711071	0	65	0	1086	0	1021	0.0	0.0
chr1	RHOC	112705604	112705733	0	130	0	2792	0	2662	0.0	0.0
chr1	PPM1J	112714633	112714727	0	95	0	2461	0	2366	0.0	0.0
chr1	LINC01356	112828476	112828511	0	36	0	3190	0	3154	0.0	0.0
chr1	LINC01356	112848953	112849050	0	98	0	3190	0	3092	0.0	0.0
chr1	LINC01356	112840487	112840580	0	94	0	3190	0	3096	0.0	0.0
chr1	PHTF1	113724758	113724893	0	136	49894	7066	49894	6930	0.0	7.1997113997114
chr1	PHTF1	113738109	113738268	0	160	49894	7066	49894	6906	0.0	7.224732116999711
chr1	RSBN1	113796185	113796303	0	119	0	6622	0	6503	0.0	0.0
chr1	PTPN22	113856547	113856619	0	73	0	4520	0	4447	0.0	0.0
chr1	PTPN22	113854470	113854537	0	68	0	4520	0	4452	0.0	0.0
chr1	PTPN22	113864197	113864382	0	186	0	4520	0	4334	0.0	0.0
chr1	BCL2L15	113881772	113881997	0	226	408	9098	408	8872	0.0	0.045987376014427414
chr1	BCL2L15	113886536	113886658	51	123	408	9098	357	8975	0.4146341463414634	0.03977715877437326
chr1	AP4B1	113901235	113901383	0	149	144	5835	144	5686	0.0	0.0253253605346465
chr1	AP4B1	113902637	113902862	0	226	144	5835	144	5609	0.0	0.025673025494740594
chr1	AP4B1	113902637	113902734	0	98	144	5835	144	5737	0.0	0.02510022659926791
chr1	SYT6	114093734	114093803	0	70	0	5075	0	5005	0.0	0.0
chr1	TRIM33	114397939	114397990	0	52	18182	4931	18182	4879	0.0	3.7265833162533304
chr1	TRIM33	114420379	114420451	0	73	18182	4931	18182	4858	0.0	3.7426924660354057
chr1	BCAS2	114576687	114576758	0	72	183	1296	183	1224	0.0	0.14950980392156862
chr1	DENND2C	114621894	114622065	0	172	146	7434	146	7262	0.0	0.020104654365188653
chr1	AMPD1	114680258	114680478	0	221	0	2917	0	2696	0.0	0.0
chr1	AMPD1	114693435	114693447	0	13	0	2917	0	2904	0.0	0.0
chr1	CSDE1	114739691	114739890	0	200	12	5803	12	5603	0.0	0.0021417097983223274
chr1	CSDE1	114749820	114750207	0	388	12	5803	12	5415	0.0	0.00221606648199446
chr1	CSDE1	114737470	114737563	0	94	12	5803	12	5709	0.0	0.0021019442984760903
chr1	CSDE1	114741526	114741673	0	148	12	5803	12	5655	0.0	0.002122015915119363
chr1	SIKE1	114776345	114776459	0	115	0	5899	0	5784	0.0	0.0
chr1	SIKE1	114780109	114780215	0	107	0	5899	0	5792	0.0	0.0
chr1	TSPAN2	115053378	115053462	324	85	569	3422	245	3337	3.8117647058823527	0.073419238837279
chr1	TSPAN2	115060463	115060538	0	76	569	3422	569	3346	0.0	0.17005379557680814
chr1	NGF	115293626	115293750	0	125	3196	1159	3196	1034	0.0	3.090909090909091
chr1	NGF	115300396	115300483	0	88	3196	1159	3196	1071	0.0	2.984126984126984
chr1	ATP1A1-AS1	116405606	116406148	0	543	639	13019	639	12476	0.0	0.05121833921128567
chr1	ATP1A1-AS1	116400895	116401131	0	237	639	13019	639	12782	0.0	0.04999217649820059
chr1	ATP1A1-AS1	116406927	116407195	0	269	639	13019	639	12750	0.0	0.05011764705882353
chr1	ATP1A1-AS1	116411260	116411315	0	56	639	13019	639	12963	0.0	0.049294144873871786
chr1	ATP1A1-AS1	116411619	116411710	46	92	639	13019	593	12927	0.5	0.04587297903612594
chr1	ATP1A1-AS1	116413761	116413913	0	153	639	13019	639	12866	0.0	0.04966578579200995
chr1	LINC01762	116466189	116466479	0	291	0	1769	0	1478	0.0	0.0
chr1	CD58	116535964	116536228	0	265	80	1790	80	1525	0.0	0.05245901639344262
chr1	IGSF3	116606491	116606551	0	61	306	7413	306	7352	0.0	0.041621327529923834
chr1	VTCN1	117156573	117156921	1247	349	1348	3035	101	2686	3.5730659025787967	0.037602382725241995
chr1	VTCN1	117156573	117157011	1292	439	1348	3035	56	2596	2.9430523917995446	0.02157164869029276
chr1	GDAP2	117877775	117877841	0	67	1044	9948	1044	9881	0.0	0.10565732213338731
chr1	SPAG17	118036769	118036883	0	115	11419	8422	11419	8307	0.0	1.3746238112435296
chr1	TBX15	118890866	118890965	0	100	0	4354	0	4254	0.0	0.0
chr1	WARS2	119042263	119042349	0	87	0	3838	0	3751	0.0	0.0
chr1	AL359915.1	119266616	119266695	16	80	16	2928	0	2848	0.2	0.0
chr1	HMGCS2	119759117	119759282	0	166	1020	2575	1020	2409	0.0	0.42341220423412207
chr1	HMGCS2	119759863	119759989	0	127	1020	2575	1020	2448	0.0	0.4166666666666667
chr1	REG4	119798496	119798602	0	107	832	3421	832	3314	0.0	0.2510561255280628
chr1	REG4	119809028	119809202	628	175	832	3421	204	3246	3.5885714285714285	0.06284658040665435
chr1	NOTCH2	120029905	120029987	0	83	57	19972	57	19889	0.0	0.002865905777062698
chr1	NOTCH2	119976349	119976352	0	4	57	19972	57	19968	0.0	0.0028545673076923075
chr1	NOTCH2	120051483	120051779	0	297	57	19972	57	19675	0.0	0.00289707750952986
chr1	AC244669.1	120340755	120340810	0	56	0	1113	0	1057	0.0	0.0
chr1	AC241952.1	120522098	120522162	0	65	42002	9489	42002	9424	0.0	4.456918505942275
chr1	AC241952.1	120531877	120532089	3050	213	42002	9489	38952	9276	14.31924882629108	4.199223803363519
chr1	FAM72B	121177207	121177332	0	126	0	2555	0	2429	0.0	0.0
chr1	FAM72C	143964854	143964979	0	126	306	2301	306	2175	0.0	0.1406896551724138
chr1	AC245595.1	144290006	144290133	0	128	0	1488	0	1360	0.0	0.0
chr1	AC245595.1	144290786	144290968	0	183	0	1488	0	1305	0.0	0.0
chr1	NBPF15	144450771	144450802	0	32	0	5330	0	5298	0.0	0.0
chr1	LINC01145	145214676	145214731	172	56	693	6063	521	6007	3.0714285714285716	0.08673214582986516
chr1	LINC01145	145169526	145169615	0	90	693	6063	693	5973	0.0	0.11602209944751381
chr1	NBPF20	145394977	145395141	0	165	110512	19134	110512	18969	0.0	5.825926511676947
chr1	PDZK1	145671426	145671489	51	64	4185	2268	4134	2204	0.796875	1.8756805807622505
chr1	PIAS3	145857314	145857416	0	103	0	4092	0	3989	0.0	0.0
chr1	RBM8A	145919186	145919306	306	121	14533	3735	14227	3614	2.5289256198347108	3.9366353071389044
chr1	RBM8A	145923508	145923573	1192	66	14533	3735	13341	3669	18.060606060606062	3.6361406377759606
chr1	ANKRD34A	145962254	145962318	0	65	306	3458	306	3393	0.0	0.09018567639257294
chr1	HJV	146019697	146019734	0	38	615	2423	615	2385	0.0	0.2578616352201258
chr1	HJV	146020134	146020320	0	187	615	2423	615	2236	0.0	0.2750447227191413
chr1	HJV	146019174	146019734	0	561	615	2423	615	1862	0.0	0.33029001074113856
chr1	HJV	146020134	146020338	0	205	615	2423	615	2218	0.0	0.2772768259693417
chr1	AC244394.3	147002428	147002577	0	150	0	888	0	738	0.0	0.0
chr1	PRKAB2	147167766	147167933	0	168	0	5469	0	5301	0.0	0.0
chr1	FMO5	147201151	147201343	0	193	0	5996	0	5803	0.0	0.0
chr1	FMO5	147201151	147201504	0	354	0	5996	0	5642	0.0	0.0
chr1	LINC00624	147408589	147408689	0	101	357	5570	357	5469	0.0	0.06527701590784421
chr1	ACP6	147659646	147659775	0	130	153	10129	153	9999	0.0	0.0153015301530153
chr1	ACP6	147659395	147659526	0	132	153	10129	153	9997	0.0	0.015304591377413223
chr1	NBPF11	148124898	148125001	0	104	0	5942	0	5838	0.0	0.0
chr1	NBPF11	148127140	148127288	0	149	0	5942	0	5793	0.0	0.0
chr1	NBPF11	148137710	148137809	0	100	0	5942	0	5842	0.0	0.0
chr1	NBPF11	148135123	148135247	0	125	0	5942	0	5817	0.0	0.0
chr1	AC239809.3	148200530	148200633	0	104	49367	14907	49367	14803	0.0	3.3349321083564143
chr1	AC239809.3	148207933	148207963	0	31	49367	14907	49367	14876	0.0	3.318566819037376
chr1	AC239809.3	148226493	148226621	0	129	49367	14907	49367	14778	0.0	3.340573825957504
chr1	AC239809.3	148201407	148201478	0	72	49367	14907	49367	14835	0.0	3.327738456353219
chr1	AC239809.3	148208532	148208654	0	123	49367	14907	49367	14784	0.0	3.3392180735930737
chr1	AC239809.3	148228535	148228657	0	123	49367	14907	49367	14784	0.0	3.3392180735930737
chr1	AC239809.3	148226734	148226798	0	65	49367	14907	49367	14842	0.0	3.3261689799218432
chr1	AC239809.3	148216038	148216305	0	268	49367	14907	49367	14639	0.0	3.3722931894255073
chr1	AC239809.3	148225075	148225289	0	215	49367	14907	49367	14692	0.0	3.3601279607949905
chr1	AC239809.3	148226100	148226253	0	154	49367	14907	49367	14753	0.0	3.346234664136108
chr1	LINC01138	148292913	148293048	101	136	4730	7412	4629	7276	0.7426470588235294	0.6362012094557449
chr1	LINC01138	148460730	148461093	0	364	4730	7412	4730	7048	0.0	0.6711123723041997
chr1	NBPF14	148579073	148579237	0	165	273751	12061	273751	11896	0.0	23.012020847343646
chr1	NBPF14	148593597	148593700	24	104	273751	12061	273727	11957	0.23076923076923078	22.89261520448273
chr1	NBPF9	149065525	149065689	0	165	459	8033	459	7868	0.0	0.0583375699034062
chr1	NBPF9	149092754	149092785	0	32	459	8033	459	8001	0.0	0.05736782902137233
chr1	NBPF9	149065636	149065689	0	54	459	8033	459	7979	0.0	0.057526005765133476
chr1	AC243772.3	149728229	149728281	0	53	0	3275	0	3222	0.0	0.0
chr1	MTMR11	149935583	149935705	0	123	15203	4455	15203	4332	0.0	3.5094644506001846
chr1	MTMR11	149931259	149931426	0	168	15203	4455	15203	4287	0.0	3.5463027758339165
chr1	MTMR11	149935583	149935620	0	38	15203	4455	15203	4417	0.0	3.441928911025583
chr1	ANP32E	150223185	150223240	0	56	352	1638	352	1582	0.0	0.2225031605562579
chr1	ANP32E	150229071	150229237	0	167	352	1638	352	1471	0.0	0.23929299796057105
chr1	ANP32E	150230570	150230693	0	124	352	1638	352	1514	0.0	0.23249669749009247
chr1	ANP32E	150231776	150231926	0	151	352	1638	352	1487	0.0	0.2367182246133154
chr1	ANP32E	150223185	150223294	15	110	352	1638	337	1528	0.13636363636363635	0.2205497382198953
chr1	APH1A	150267715	150267789	87	75	244257	3360	244170	3285	1.16	74.32876712328768
chr1	APH1A	150267956	150268127	2677	172	244257	3360	241580	3188	15.563953488372093	75.77791718946048
chr1	APH1A	150267956	150267991	634	36	244257	3360	243623	3324	17.61111111111111	73.29211793020457
chr1	MCL1	150578243	150578491	254	249	27006	5876	26752	5627	1.0200803212851406	4.754220721521237
chr1	ENSA	150626478	150626526	0	49	1624	2646	1624	2597	0.0	0.6253369272237197
chr1	GOLPH3L	150694107	150694173	0	67	2590	3340	2590	3273	0.0	0.791322945310113
chr1	HORMAD1	150700111	150700183	0	73	205	2428	205	2355	0.0	0.0870488322717622
chr1	HORMAD1	150711544	150711571	0	28	205	2428	205	2400	0.0	0.08541666666666667
chr1	HORMAD1	150711832	150711853	0	22	205	2428	205	2406	0.0	0.08520365752285952
chr1	HORMAD1	150714614	150714678	1	65	205	2428	204	2363	0.015384615384615385	0.08633093525179857
chr1	CTSS	150750005	150750171	465	167	2736	1610	2271	1443	2.784431137724551	1.5738045738045738
chr1	CTSS	150755000	150755150	260	151	2736	1610	2476	1459	1.7218543046357615	1.6970527758738863
chr1	CTSS	150748164	150748285	0	122	2736	1610	2736	1488	0.0	1.8387096774193548
chr1	CTSK	150799167	150799273	0	107	132919	7254	132919	7147	0.0	18.597873233524556
chr1	CTSK	150804020	150804239	525	220	132919	7254	132394	7034	2.3863636363636362	18.8220073926642
chr1	CTSK	150806101	150806224	0	124	132919	7254	132919	7130	0.0	18.642215988779803
chr1	CTSK	150799167	150799285	0	119	132919	7254	132919	7135	0.0	18.629152067274003
chr1	CTSK	150807248	150807341	0	94	132919	7254	132919	7160	0.0	18.564106145251397
chr1	CTSK	150806314	150806365	0	52	132919	7254	132919	7202	0.0	18.455845598444878
chr1	ARNT	150823193	150823345	0	153	39226	6472	39226	6319	0.0	6.207627789207153
chr1	ARNT	150842423	150842468	0	46	39226	6472	39226	6426	0.0	6.1042639277933395
chr1	ARNT	150861246	150861302	0	57	39226	6472	39226	6415	0.0	6.114731098986749
chr1	ARNT	150853155	150853278	0	124	39226	6472	39226	6348	0.0	6.179269061121613
chr1	CERS2	150968917	150969131	102	215	53654	4616	53552	4401	0.4744186046511628	12.168143603726426
chr1	CERS2	150968917	150969091	102	175	53654	4616	53552	4441	0.5828571428571429	12.058545372663815
chr1	MINDY1	151000456	151000615	186	160	144699	3804	144513	3644	1.1625	39.65779363336992
chr1	CDC42SE1	151056650	151056786	7	137	4651	4192	4644	4055	0.051094890510948905	1.145252774352651
chr1	CDC42SE1	151056655	151056786	2	132	4651	4192	4649	4060	0.015151515151515152	1.1450738916256158
chr1	SEMA6C	151133959	151134055	322	97	284779	3937	284457	3840	3.3195876288659796	74.07734375
chr1	SEMA6C	151137985	151138105	5254	121	284779	3937	279525	3816	43.421487603305785	73.25078616352201
chr1	SEMA6C	151138315	151138406	1567	92	284779	3937	283212	3845	17.032608695652176	73.65721716514955
chr1	TMOD4	151170518	151170663	1581	146	31318	1545	29737	1399	10.82876712328767	21.25589706933524
chr1	TMOD4	151171432	151171540	17637	109	31318	1545	13681	1436	161.80733944954127	9.527158774373259
chr1	PI4KB	151315572	151316509	153610	938	162929	5088	9319	4150	163.7633262260128	2.2455421686746986
chr1	PI4KB	151310210	151310255	0	46	162929	5088	162929	5042	0.0	32.31435938119794
chr1	PI4KB	151326171	151326373	0	203	162929	5088	162929	4885	0.0	33.352917093142274
chr1	PI4KB	151324744	151324917	0	174	162929	5088	162929	4914	0.0	33.15608465608466
chr1	PI4KB	151293399	151293462	0	64	162929	5088	162929	5024	0.0	32.43013535031847
chr1	PI4KB	151315572	151315672	38316	101	162929	5088	124613	4987	379.36633663366337	24.98756767595749
chr1	RFX5	151346754	151346766	0	13	0	3082	0	3069	0.0	0.0
chr1	RFX5	151345285	151345443	0	159	0	3082	0	2923	0.0	0.0
chr1	SELENBP1	151366721	151366904	0	184	60954	3236	60954	3052	0.0	19.971821756225427
chr1	SELENBP1	151369003	151369189	0	187	60954	3236	60954	3049	0.0	19.991472613971794
chr1	SELENBP1	151369441	151369554	0	114	60954	3236	60954	3122	0.0	19.524023062139655
chr1	SELENBP1	151368999	151369189	0	191	60954	3236	60954	3045	0.0	20.017733990147782
chr1	SELENBP1	151369441	151369506	0	66	60954	3236	60954	3170	0.0	19.228391167192427
chr1	SELENBP1	151367015	151367175	0	161	60954	3236	60954	3075	0.0	19.822439024390246
chr1	POGZ	151411624	151411771	428	148	66515	8685	66087	8537	2.891891891891892	7.74124399672016
chr1	POGZ	151424954	151425061	483	108	66515	8685	66032	8577	4.472222222222222	7.698729159379736
chr1	POGZ	151440927	151441086	0	160	66515	8685	66515	8525	0.0	7.802346041055719
chr1	POGZ	151411624	151411798	428	175	66515	8685	66087	8510	2.4457142857142857	7.765804935370153
chr1	POGZ	151450909	151451047	0	139	66515	8685	66515	8546	0.0	7.783173414462906
chr1	CELF3	151707144	151707294	0	151	250	6085	250	5934	0.0	0.04213009774182676
chr1	MRPL9	151761450	151761552	0	103	12800	1368	12800	1265	0.0	10.118577075098814
chr1	MRPL9	151761961	151762010	0	50	12800	1368	12800	1318	0.0	9.711684370257966
chr1	MRPL9	151761961	151762025	0	65	12800	1368	12800	1303	0.0	9.823484267075978
chr1	TDRKH	151781908	151782019	0	112	153	4678	153	4566	0.0	0.03350854139290407
chr1	RORC	151813487	151813620	0	134	0	3825	0	3691	0.0	0.0
chr1	RORC	151817194	151817280	0	87	0	3825	0	3738	0.0	0.0
chr1	RORC	151813487	151813702	0	216	0	3825	0	3609	0.0	0.0
chr1	RORC	151830927	151831132	0	206	0	3825	0	3619	0.0	0.0
chr1	THEM5	151847737	151847862	0	126	9551	1167	9551	1041	0.0	9.174831892411143
chr1	THEM4	151889982	151890214	0	233	2448	6944	2448	6711	0.0	0.364774251229325
chr1	SPRR2D	153040666	153040779	0	114	0	954	0	840	0.0	0.0
chr1	S100A4	153545469	153545518	0	50	153	804	153	754	0.0	0.20291777188328913
chr1	S100A2	153563414	153563536	0	123	0	1552	0	1429	0.0	0.0
chr1	S100A14	153616294	153616355	11836	62	165204	1283	153368	1221	190.90322580645162	125.6085176085176
chr1	S100A13	153627482	153627598	102	117	39549	1716	39447	1599	0.8717948717948718	24.669793621013135
chr1	AL162258.1	153630449	153630656	0	208	74825	1002	74825	794	0.0	94.23803526448363
chr1	S100A13	153628120	153628237	0	118	39549	1716	39549	1598	0.0	24.749061326658325
chr1	AL162258.1	153633035	153633157	0	123	74825	1002	74825	879	0.0	85.12514220705347
chr1	GATAD2B	153914673	153914740	3488	68	43559	9263	40071	9195	51.294117647058826	4.357911908646003
chr1	GATAD2B	153886423	153886521	0	99	43559	9263	43559	9164	0.0	4.753273679615888
chr1	DENND4B	153942186	153942356	2772	171	858840	7219	856068	7048	16.210526315789473	121.46254256526674
chr1	CRTC2	153951259	153951666	3528	408	352175	3463	348647	3055	8.647058823529411	114.12340425531914
chr1	CRTC2	153948833	153948900	1722	68	352175	3463	350453	3395	25.323529411764707	103.22621502209131
chr1	SLC39A1	153962219	153962350	26	132	525691	3208	525665	3076	0.19696969696969696	170.89239271781534
chr1	TPM3	154176114	154176248	0	135	139005	14152	139005	14017	0.0	9.916886637654278
chr1	TPM3	154170648	154170711	0	64	139005	14152	139005	14088	0.0	9.86690800681431
chr1	TPM3	154158897	154159048	0	152	139005	14152	139005	14000	0.0	9.928928571428571
chr1	TPM3	154169304	154169383	0	80	139005	14152	139005	14072	0.0	9.8781267765776
chr1	TPM3	154173538	154173636	0	99	139005	14152	139005	14053	0.0	9.891482245783818
chr1	TPM3	154171412	154171488	0	77	139005	14152	139005	14075	0.0	9.876021314387211
chr1	TPM3	154172028	154172104	0	77	139005	14152	139005	14075	0.0	9.876021314387211
chr1	C1ORF43	154212319	154212378	0	60	160415	2680	160415	2620	0.0	61.22709923664122
chr1	C1ORF43	154213892	154213946	66	55	160415	2680	160349	2625	1.2	61.08533333333333
chr1	C1ORF43	154218715	154218785	44474	71	160415	2680	115941	2609	626.3943661971831	44.43886546569567
chr1	C1ORF43	154213181	154213303	2262	123	160415	2680	158153	2557	18.390243902439025	61.8509972624169
chr1	C1ORF43	154219835	154219937	51	103	160415	2680	160364	2577	0.49514563106796117	62.22894838960031
chr1	ADAR	154586634	154586941	612	308	24172	9646	23560	9338	1.9870129870129871	2.523024202184622
chr1	KCNN3	154737043	154737088	0	46	324	3372	324	3326	0.0	0.0974143114852676
chr1	PBXIP1	154951794	154951921	8407	128	419649	3603	411242	3475	65.6796875	118.34302158273381
chr1	SHC1	154968203	154968257	0	55	107291	4260	107291	4205	0.0	25.51510107015458
chr1	SHC1	154973292	154973508	0	217	107291	4260	107291	4043	0.0	26.537472174128123
chr1	DCST2	155023552	155023620	1232	69	266886	3086	265654	3017	17.855072463768117	88.05236990387803
chr1	DCST2	155024471	155024602	0	132	266886	3086	266886	2954	0.0	90.34732566012187
chr1	DCST2	155026301	155026402	5322	102	266886	3086	261564	2984	52.1764705882353	87.65549597855228
chr1	MUC1	155187454	155187576	7736	123	282129	3963	274393	3840	62.89430894308943	71.45651041666666
chr1	MUC1	155187721	155187858	17649	138	282129	3963	264480	3825	127.8913043478261	69.14509803921568
chr1	MUC1	155188007	155188063	7617	57	282129	3963	274512	3906	133.6315789473684	70.27956989247312
chr1	MUC1	155188162	155188285	27033	124	282129	3963	255096	3839	218.00806451612902	66.4485543110185
chr1	MUC1	155187454	155187544	5492	91	282129	3963	276637	3872	60.35164835164835	71.4455061983471
chr1	MUC1	155188162	155188231	15662	70	282129	3963	266467	3893	223.74285714285713	68.44772668892885
chr1	MUC1	155186729	155186804	13647	76	282129	3963	268482	3887	179.56578947368422	69.07177772060716
chr1	MUC1	155188327	155188503	637	177	282129	3963	281492	3786	3.598870056497175	74.35076597992604
chr1	MUC1	155188162	155188212	8880	51	282129	3963	273249	3912	174.11764705882354	69.8489263803681
chr1	THBS3	155200450	155200610	1275	161	395854	4646	394579	4485	7.919254658385094	87.97748049052397
chr1	THBS3	155201093	155201204	5475	112	395854	4646	390379	4534	48.88392857142857	86.10035288928098
chr1	THBS3	155203222	155203305	9509	84	395854	4646	386345	4562	113.20238095238095	84.68763700131521
chr1	THBS3	155203512	155203539	1075	28	395854	4646	394779	4618	38.392857142857146	85.48700736249458
chr1	THBS3	155204854	155204957	24059	104	395854	4646	371795	4542	231.33653846153845	81.85711140466755
chr1	GBAP1	155217518	155217593	22530	76	327187	3205	304657	3129	296.44736842105266	97.36561201661873
chr1	GBAP1	155218387	155218479	0	93	327187	3205	327187	3112	0.0	105.13721079691517
chr1	GBAP1	155217704	155217846	6507	143	327187	3205	320680	3062	45.50349650349651	104.72893533638145
chr1	GBA	155239615	155239762	0	148	148644	3264	148644	3116	0.0	47.70346598202824
chr1	FAM189B	155250275	155250821	102	547	93229	4158	93127	3611	0.18647166361974407	25.78980891719745
chr1	FAM189B	155254399	155254456	3684	58	93229	4158	89545	4100	63.51724137931034	21.840243902439024
chr1	SCAMP3	155261656	155261734	0	79	30923	2310	30923	2231	0.0	13.860600627521292
chr1	CLK2	155268707	155268792	0	86	120	3019	120	2933	0.0	0.040913740197749744
chr1	CLK2	155268707	155268795	0	89	120	3019	120	2930	0.0	0.040955631399317405
chr1	RUSC1-AS1	155319802	155319953	41	152	9374	2545	9333	2393	0.26973684210526316	3.900125365649812
chr1	RUSC1-AS1	155322242	155322437	0	196	9374	2545	9374	2349	0.0	3.990634312473393
chr1	ASH1L	155415743	155415923	0	181	13459	13816	13459	13635	0.0	0.9870920425375871
chr1	ASH1L	155462452	155462599	0	148	13459	13816	13459	13668	0.0	0.984708808896693
chr1	ASH1L	155440489	155440593	0	105	13459	13816	13459	13711	0.0	0.9816205966012691
chr1	ASH1L	155440502	155440593	0	92	13459	13816	13459	13724	0.0	0.9806907607111629
chr1	ASH1L	155562152	155562295	182	144	13459	13816	13277	13672	1.2638888888888888	0.9711088355763604
chr1	ASH1L	155562152	155562291	182	140	13459	13816	13277	13676	1.3	0.970824802573852
chr1	ASH1L	155345962	155346207	49	246	13459	13816	13410	13570	0.1991869918699187	0.9882092851879145
chr1	ASH1L	155520224	155520356	36	133	13459	13816	13423	13683	0.2706766917293233	0.9809983190820727
chr1	YY1AP1	155668626	155668777	0	152	7545	4688	7545	4536	0.0	1.6633597883597884
chr1	YY1AP1	155670319	155670464	0	146	7545	4688	7545	4542	0.0	1.6611624834874505
chr1	YY1AP1	155675009	155675096	0	88	7545	4688	7545	4600	0.0	1.6402173913043478
chr1	YY1AP1	155680415	155680456	672	42	7545	4688	6873	4646	16.0	1.4793370641411967
chr1	YY1AP1	155668626	155668717	0	92	7545	4688	7545	4596	0.0	1.641644908616188
chr1	YY1AP1	155680381	155680456	823	76	7545	4688	6722	4612	10.828947368421053	1.4575021682567215
chr1	YY1AP1	155688070	155688201	0	132	7545	4688	7545	4556	0.0	1.6560579455662863
chr1	YY1AP1	155679927	155680008	0	82	7545	4688	7545	4606	0.0	1.638080764220582
chr1	YY1AP1	155679157	155679313	0	157	7545	4688	7545	4531	0.0	1.6651953211211652
chr1	GON4L	155776394	155776481	0	88	76777	11036	76777	10948	0.0	7.012879064669346
chr1	RIT1	155910655	155910804	408	150	85181	4045	84773	3895	2.72	21.764569961489087
chr1	RIT1	155904602	155904605	0	4	85181	4045	85181	4041	0.0	21.079188319722842
chr1	RIT1	155904602	155904610	0	9	85181	4045	85181	4036	0.0	21.10530227948464
chr1	ARHGEF2	155954901	155954969	0	69	574674	8670	574674	8601	0.0	66.81478897802582
chr1	ARHGEF2	155965630	155965760	0	131	574674	8670	574674	8539	0.0	67.29991802318773
chr1	SSR2	156014960	156015069	534	110	137514	5038	136980	4928	4.8545454545454545	27.796266233766232
chr1	SSR2	156018131	156018368	10565	238	137514	5038	126949	4800	44.390756302521005	26.447708333333335
chr1	SSR2	156019084	156019266	51	183	137514	5038	137463	4855	0.2786885245901639	28.313697219361483
chr1	SSR2	156018251	156018368	8348	118	137514	5038	129166	4920	70.7457627118644	26.253252032520326
chr1	SSR2	156012394	156012565	4995	172	137514	5038	132519	4866	29.040697674418606	27.233662145499384
chr1	SSR2	156012384	156012565	5215	182	137514	5038	132299	4856	28.653846153846153	27.24443986820428
chr1	SSR2	156020265	156020346	25008	82	137514	5038	112506	4956	304.9756097560976	22.70096852300242
chr1	PAQR6	156245534	156245661	0	128	10381	2498	10381	2370	0.0	4.380168776371308
chr1	PAQR6	156246680	156246756	0	77	10381	2498	10381	2421	0.0	4.2878975629905
chr1	PAQR6	156245781	156245987	0	207	10381	2498	10381	2291	0.0	4.531209079004801
chr1	PAQR6	156245141	156245238	0	98	10381	2498	10381	2400	0.0	4.3254166666666665
chr1	PAQR6	156244581	156244672	72	92	10381	2498	10309	2406	0.782608695652174	4.284704904405652
chr1	PAQR6	156247509	156247632	0	124	10381	2498	10381	2374	0.0	4.372788542544229
chr1	PAQR6	156245141	156245277	0	137	10381	2498	10381	2361	0.0	4.396865734858111
chr1	GLMP	156293319	156293576	0	258	1184321	2595	1184321	2337	0.0	506.76979032948225
chr1	GLMP	156294758	156295016	408488	259	1184321	2595	775833	2336	1577.1737451737451	332.1202910958904
chr1	GLMP	156293319	156293429	0	111	1184321	2595	1184321	2484	0.0	476.77979066022544
chr1	CCT3	156334712	156334775	0	64	1051	3882	1051	3818	0.0	0.2752750130958617
chr1	CCT3	156335826	156335888	0	63	1051	3882	1051	3819	0.0	0.2752029327048966
chr1	CCT3	156337078	156337240	0	163	1051	3882	1051	3719	0.0	0.2826028502285561
chr1	CCT3	156337676	156337789	0	114	1051	3882	1051	3768	0.0	0.278927813163482
chr1	CCT3	156334867	156334918	0	52	1051	3882	1051	3830	0.0	0.2744125326370757
chr1	CCT3	156333215	156333284	138	70	1051	3882	913	3812	1.9714285714285715	0.2395068205666317
chr1	MIR9-1HG	156407079	156407197	1020	119	67884	7374	66864	7255	8.571428571428571	9.216264645072364
chr1	MIR9-1HG	156414653	156414753	0	101	67884	7374	67884	7273	0.0	9.333699986250515
chr1	MIR9-1HG	156417911	156418034	723	124	67884	7374	67161	7250	5.830645161290323	9.263586206896552
chr1	MIR9-1HG	156414055	156414298	0	244	67884	7374	67884	7130	0.0	9.520897615708275
chr1	MIR9-1HG	156416768	156416864	219	97	67884	7374	67665	7277	2.2577319587628866	9.29847464614539
chr1	MIR9-1HG	156413412	156413497	0	86	67884	7374	67884	7288	0.0	9.314489571899012
chr1	MIR9-1HG	156407841	156407975	0	135	67884	7374	67884	7239	0.0	9.377538334024036
chr1	MIR9-1HG	156414083	156414298	0	216	67884	7374	67884	7158	0.0	9.483654652137469
chr1	MIR9-1HG	156454642	156454795	1513	154	67884	7374	66371	7220	9.824675324675324	9.192659279778393
chr1	MIR9-1HG	156453130	156453252	20670	123	67884	7374	47214	7251	168.0487804878049	6.511377741001241
chr1	MEF2D	156475107	156475237	0	131	9725	3875	9725	3744	0.0	2.5974893162393164
chr1	MEF2D	156476493	156476514	0	22	9725	3875	9725	3853	0.0	2.5240072670646247
chr1	MEF2D	156479585	156479796	0	212	9725	3875	9725	3663	0.0	2.654927654927655
chr1	MEF2D	156499431	156499560	0	130	9725	3875	9725	3745	0.0	2.596795727636849
chr1	IQGAP3	156569375	156569463	1740	89	591221	6779	589481	6690	19.55056179775281	88.11375186846038
chr1	GPATCH4	156598034	156598121	0	88	153	3333	153	3245	0.0	0.047149460708782745
chr1	GPATCH4	156598420	156598494	0	75	153	3333	153	3258	0.0	0.04696132596685083
chr1	GPATCH4	156597799	156597885	0	87	153	3333	153	3246	0.0	0.04713493530499076
chr1	GPATCH4	156597799	156597922	0	124	153	3333	153	3209	0.0	0.04767840448737925
chr1	ARHGEF11	156971696	156971816	0	121	10885	8467	10885	8346	0.0	1.3042175892643182
chr1	FCRL3	157697139	157697424	0	286	4554	5345	4554	5059	0.0	0.9001779007709033
chr1	FCRL3	157697139	157697329	0	191	4554	5345	4554	5154	0.0	0.8835855646100116
chr1	FCRL2	157748552	157748618	32	67	134	3783	102	3716	0.47761194029850745	0.02744886975242196
chr1	FCRL1	157801460	157801577	0	118	0	3961	0	3843	0.0	0.0
chr1	LINC01704	158132573	158132656	0	84	10492	2018	10492	1934	0.0	5.425025853154085
chr1	LINC01704	158133114	158133193	0	80	10492	2018	10492	1938	0.0	5.413828689370485
chr1	LINC01704	158132577	158132656	0	80	10492	2018	10492	1938	0.0	5.413828689370485
chr1	AL365440.1	158479904	158481802	0	1899	948	2501	948	602	0.0	1.5747508305647842
chr1	CRP	159713502	159713640	0	139	0	1062	0	923	0.0	0.0
chr1	SNHG28	159840710	159840866	0	157	41503	3025	41503	2868	0.0	14.471059972105998
chr1	SNHG28	159838364	159838655	0	292	41503	3025	41503	2733	0.0	15.185876326381265
chr1	SNHG28	159840710	159840881	0	172	41503	3025	41503	2853	0.0	14.54714335786891
chr1	SNHG28	159837916	159838027	0	112	41503	3025	41503	2913	0.0	14.247511156882938
chr1	SNHG28	159841125	159841235	0	111	41503	3025	41503	2914	0.0	14.242621825669183
chr1	SNHG28	159838364	159838451	0	88	41503	3025	41503	2937	0.0	14.131086142322097
chr1	SNHG28	159842226	159842314	0	89	41503	3025	41503	2936	0.0	14.135899182561309
chr1	SNHG28	159837916	159840866	0	2951	41503	3025	41503	74	0.0	560.8513513513514
chr1	SNHG28	159838364	159840866	0	2503	41503	3025	41503	522	0.0	79.50766283524904
chr1	AL590560.2	159858733	159858912	0	180	37381	6349	37381	6169	0.0	6.059491003404117
chr1	SNHG28	159840710	159840779	0	70	41503	3025	41503	2955	0.0	14.045008460236886
chr1	SNHG28	159840768	159840866	0	99	41503	3025	41503	2926	0.0	14.18421052631579
chr1	SNHG28	159837092	159837219	4715	128	41503	3025	36788	2897	36.8359375	12.698653779772178
chr1	SNHG28	159837916	159840881	0	2966	41503	3025	41503	59	0.0	703.4406779661017
chr1	CFAP45	159898065	159898268	0	204	353183	2640	353183	2436	0.0	144.98481116584566
chr1	IGSF9	159931137	159931261	0	125	162	6448	162	6323	0.0	0.025620749644156254
chr1	IGSF9	159931452	159931603	0	152	162	6448	162	6296	0.0	0.02573062261753494
chr1	SLAMF9	159952261	159952534	0	274	0	1007	0	733	0.0	0.0
chr1	KCNJ10	160040501	160040601	0	101	30640	4234	30640	4133	0.0	7.413501088797483
chr1	KCNJ10	160044755	160044821	0	67	30640	4234	30640	4167	0.0	7.353011759059275
chr1	DCAF8	160225061	160225119	0	59	288469	6531	288469	6472	0.0	44.57184796044499
chr1	DCAF8	160243959	160244034	0	76	288469	6531	288469	6455	0.0	44.68923315259489
chr1	DCAF8	160261284	160261358	1326	75	288469	6531	287143	6456	17.68	44.47692069392813
chr1	DCAF8	160220458	160220691	2499	234	288469	6531	285970	6297	10.679487179487179	45.41368905828172
chr1	DCAF8	160261284	160261325	1326	42	288469	6531	287143	6489	31.571428571428573	44.250732008013564
chr1	DCAF8	160261284	160261350	1326	67	288469	6531	287143	6464	19.791044776119403	44.421875
chr1	AL139011.2	160278130	160278191	34	62	25291	3223	25257	3161	0.5483870967741935	7.990192976906043
chr1	PEX19	160282416	160282502	1275	87	181741	3122	180466	3035	14.655172413793103	59.46161449752883
chr1	PEX19	160283529	160283639	0	111	181741	3122	181741	3011	0.0	60.35901693789439
chr1	COPA	160293165	160293234	11870	70	37797	7549	25927	7479	169.57142857142858	3.4666399251236797
chr1	COPA	160298844	160298991	153	148	37797	7549	37644	7401	1.0337837837837838	5.08633968382651
chr1	COPA	160299101	160299264	144	164	37797	7549	37653	7385	0.8780487804878049	5.098578199052133
chr1	COPA	160307162	160307245	43	84	37797	7549	37754	7465	0.5119047619047619	5.057468184862692
chr1	COPA	160313989	160314125	255	137	37797	7549	37542	7412	1.8613138686131387	5.06502968159741
chr1	COPA	160333602	160333679	0	78	37797	7549	37797	7471	0.0	5.059162093427921
chr1	COPA	160339908	160339982	0	75	37797	7549	37797	7474	0.0	5.0571313888145575
chr1	COPA	160298844	160298931	78	88	37797	7549	37719	7461	0.8863636363636364	5.055488540410133
chr1	COPA	160335241	160335322	0	82	37797	7549	37797	7467	0.0	5.061872237846525
chr1	SLAMF6	160496060	160496393	0	334	0	2754	0	2420	0.0	0.0
chr1	CD84	160550937	160551035	0	99	51	9263	51	9164	0.0	0.0055652553470100395
chr1	CD84	160565403	160565745	0	343	51	9263	51	8920	0.0	0.005717488789237668
chr1	CD84	160552704	160552737	0	34	51	9263	51	9229	0.0	0.005526059161339257
chr1	SLAMF1	160623502	160623585	0	84	0	2198	0	2114	0.0	0.0
chr1	CD244	160836194	160836254	0	61	0	2779	0	2718	0.0	0.0
chr1	CD244	160841209	160841485	0	277	0	2779	0	2502	0.0	0.0
chr1	CD244	160841209	160841500	0	292	0	2779	0	2487	0.0	0.0
chr1	F11R	161000630	161000777	51	148	52530	5046	52479	4898	0.34459459459459457	10.714373213556554
chr1	AL591806.2	161022749	161022827	0	79	15585	2127	15585	2048	0.0	7.60986328125
chr1	TSTD1	161038550	161038673	0	124	0	1199	0	1075	0.0	0.0
chr1	TSTD1	161038550	161038694	0	145	0	1199	0	1054	0.0	0.0
chr1	USF1	161042115	161042217	0	103	179	2093	179	1990	0.0	0.0899497487437186
chr1	ARHGAP30	161056387	161056532	0	146	21835	5073	21835	4927	0.0	4.431702861782018
chr1	ARHGAP30	161059613	161059716	0	104	21835	5073	21835	4969	0.0	4.394244314751459
chr1	ARHGAP30	161060155	161060262	0	108	21835	5073	21835	4965	0.0	4.39778449144008
chr1	NECTIN4	161073224	161073299	299	76	374256	3467	373957	3391	3.9342105263157894	110.27926865231495
chr1	DEDD	161130814	161130847	5128	34	106125	2740	100997	2706	150.8235294117647	37.32335550628233
chr1	DEDD	161130814	161130843	4409	30	106125	2740	101716	2710	146.96666666666667	37.533579335793355
chr1	DEDD	161124413	161124526	367	114	106125	2740	105758	2626	3.219298245614035	40.27341964965727
chr1	DEDD	161124339	161124526	459	188	106125	2740	105666	2552	2.4414893617021276	41.4051724137931
chr1	APOA2	161222917	161223050	0	134	0	769	0	635	0.0	0.0
chr1	APOA2	161223349	161223425	0	77	0	769	0	692	0.0	0.0
chr1	APOA2	161222917	161222994	0	78	0	769	0	691	0.0	0.0
chr1	APOA2	161222917	161223266	0	350	0	769	0	419	0.0	0.0
chr1	NR1I3	161233168	161233338	0	171	0	2001	0	1830	0.0	0.0
chr1	NR1I3	161231116	161231233	0	118	0	2001	0	1883	0.0	0.0
chr1	NR1I3	161236458	161236598	0	141	0	2001	0	1860	0.0	0.0
chr1	NR1I3	161231116	161231245	0	130	0	2001	0	1871	0.0	0.0
chr1	NR1I3	161232806	161232946	0	141	0	2001	0	1860	0.0	0.0
chr1	NR1I3	161236529	161236598	0	70	0	2001	0	1931	0.0	0.0
chr1	FCGR3B	161626144	161626402	0	259	0	2793	0	2534	0.0	0.0
chr1	RGS5	163168257	163168368	0	112	30943	9121	30943	9009	0.0	3.4346764346764345
chr1	RGS5	163161914	163161976	0	63	30943	9121	30943	9058	0.0	3.4160962684919407
chr1	RXRG	165424750	165424808	0	59	0	2703	0	2644	0.0	0.0
chr1	LRRC52-AS1	165522973	165523087	0	115	1530	4368	1530	4253	0.0	0.359746061603574
chr1	LRRC52-AS1	165575282	165575369	0	88	1530	4368	1530	4280	0.0	0.3574766355140187
chr1	LRRC52-AS1	165508079	165508171	0	93	1530	4368	1530	4275	0.0	0.35789473684210527
chr1	LRRC52-AS1	165499011	165499113	0	103	1530	4368	1530	4265	0.0	0.35873388042203985
chr1	LRRC52-AS1	165528782	165528882	0	101	1530	4368	1530	4267	0.0	0.35856573705179284
chr1	TMCO1	165759524	165759584	0	61	8490	5337	8490	5276	0.0	1.6091736163760424
chr1	TMCO1	165754853	165754990	345	138	8490	5337	8145	5199	2.5	1.5666474321984998
chr1	LINC01675	166484286	166484452	0	167	0	2032	0	1865	0.0	0.0
chr1	ILDR2	166920706	166921379	0	674	0	4354	0	3680	0.0	0.0
chr1	ILDR2	166935300	166935477	0	178	0	4354	0	4176	0.0	0.0
chr1	ILDR2	166939513	166939570	0	58	0	4354	0	4296	0.0	0.0
chr1	ILDR2	166936590	166936737	0	148	0	4354	0	4206	0.0	0.0
chr1	GPA33	167082244	167082311	0	68	0	2956	0	2888	0.0	0.0
chr1	LINC01363	167182041	167182193	0	153	0	1348	0	1195	0.0	0.0
chr1	ADCY10	167901661	167901805	0	145	65860	6176	65860	6031	0.0	10.920245398773005
chr1	ADCY10	167818362	167818412	0	51	65860	6176	65860	6125	0.0	10.752653061224489
chr1	ADCY10	167901661	167901842	0	182	65860	6176	65860	5994	0.0	10.987654320987655
chr1	GPR161	168104476	168104894	3255	419	15924	11010	12669	10591	7.768496420047732	1.1962043244263998
chr1	AL023755.1	168413591	168413687	33	97	104	4252	71	4155	0.3402061855670103	0.017087845968712396
chr1	AL023755.1	168464312	168464373	0	62	104	4252	104	4190	0.0	0.024821002386634844
chr1	AL023755.1	168494045	168494143	0	99	104	4252	104	4153	0.0	0.025042138213339754
chr1	AL023755.1	168407238	168407318	0	81	104	4252	104	4171	0.0	0.024934068568688565
chr1	AL023755.1	168494045	168494124	0	80	104	4252	104	4172	0.0	0.024928092042186004
chr1	NME7	169287302	169287408	0	107	1098	5730	1098	5623	0.0	0.19526942913035747
chr1	NME7	169323116	169323283	0	168	1098	5730	1098	5562	0.0	0.19741100323624594
chr1	NME7	169169446	169169554	0	109	1098	5730	1098	5621	0.0	0.19533890766767478
chr1	NME7	169190642	169190705	0	64	1098	5730	1098	5666	0.0	0.1937875044122838
chr1	NME7	169246987	169247060	18	74	1098	5730	1080	5656	0.24324324324324326	0.19094766619519093
chr1	NME7	169324392	169324500	0	109	1098	5730	1098	5621	0.0	0.19533890766767478
chr1	SLC19A2	169477154	169477757	0	604	916	3979	916	3375	0.0	0.27140740740740743
chr1	SELP	169611491	169611677	0	187	246	3507	246	3320	0.0	0.07409638554216867
chr1	SELP	169612216	169612402	32	187	246	3507	214	3320	0.1711229946524064	0.06445783132530121
chr1	SELP	169593604	169593724	0	121	246	3507	246	3386	0.0	0.07265209686946249
chr1	SELP	169609503	169609689	112	187	246	3507	134	3320	0.5989304812834224	0.04036144578313253
chr1	SELL	169701559	169701688	0	130	0	2591	0	2461	0.0	0.0
chr1	SELE	169727738	169727927	12	190	2256	4601	2244	4411	0.06315789473684211	0.5087281795511222
chr1	SELE	169728057	169728246	0	190	2256	4601	2256	4411	0.0	0.5114486510995239
chr1	SELE	169730431	169730617	0	187	2256	4601	2256	4414	0.0	0.5111010421386497
chr1	SCYL3	169855795	169855957	0	163	1224	6898	1224	6735	0.0	0.18173719376391984
chr1	KIFAP3	170055304	170055436	0	133	12883	5001	12883	4868	0.0	2.646466721446179
chr1	KIFAP3	170041676	170041840	0	165	12883	5001	12883	4836	0.0	2.663978494623656
chr1	LINC01142	170273532	170274507	0	976	0	1808	0	832	0.0	0.0
chr1	BX284613.2	171247565	171247727	0	163	51	7890	51	7727	0.0	0.006600232949398214
chr1	BX284613.2	171121749	171121863	0	115	51	7890	51	7775	0.0	0.0065594855305466234
chr1	BX284613.2	171247580	171247727	0	148	51	7890	51	7742	0.0	0.006587445104624128
chr1	BX284613.2	171203890	171203988	0	99	51	7890	51	7791	0.0	0.006546014632268001
chr1	DNM3OS	172142135	172142213	0	79	0	2594	0	2515	0.0	0.0
chr1	DNM3OS	172142135	172142233	0	99	0	2594	0	2495	0.0	0.0
chr1	SLC9C2	173554732	173554814	0	83	176	5154	176	5071	0.0	0.03470715835140998
chr1	SLC9C2	173600116	173600217	0	102	176	5154	176	5052	0.0	0.03483768804433888
chr1	CENPL	173806438	173806576	715	139	146092	4921	145377	4782	5.143884892086331	30.400878293601004
chr1	CENPL	173802962	173803505	204	544	146092	4921	145888	4377	0.375	33.33059172949509
chr1	CENPL	173806458	173806576	715	119	146092	4921	145377	4802	6.008403361344538	30.274260724698042
chr1	GAS5	173864483	173864506	0	24	12849	4337	12849	4313	0.0	2.9791328541618363
chr1	GAS5	173865228	173865282	147	55	12849	4337	12702	4282	2.672727272727273	2.9663708547407754
chr1	RABGAP1L-DT	174158886	174158990	0	105	1071	2489	1071	2384	0.0	0.44924496644295303
chr1	RABGAP1L-DT	174122083	174122192	0	110	1071	2489	1071	2379	0.0	0.4501891551071879
chr1	KIAA0040	175177610	175177684	0	75	0	4773	0	4698	0.0	0.0
chr1	KIAA0040	175192639	175192716	0	78	0	4773	0	4695	0.0	0.0
chr1	TNR	175403139	175403616	0	478	51	12830	51	12352	0.0	0.004128886010362694
chr1	COP1	176136487	176136547	0	61	10540	4200	10540	4139	0.0	2.5465088185552065
chr1	COP1	176175909	176176007	501	99	10540	4200	10039	4101	5.0606060606060606	2.447939526944648
chr1	COP1	176201260	176201345	0	86	10540	4200	10540	4114	0.0	2.56198347107438
chr1	COP1	176133846	176133900	0	55	10540	4200	10540	4145	0.0	2.542822677925211
chr1	COP1	176168664	176168748	1479	85	10540	4200	9061	4115	17.4	2.2019441069258807
chr1	AL136114.1	177556485	177556556	0	72	0	2756	0	2684	0.0	0.0
chr1	AL136114.1	177576710	177576950	0	241	0	2756	0	2515	0.0	0.0
chr1	AL136114.1	177597570	177597707	0	138	0	2756	0	2618	0.0	0.0
chr1	AL136114.1	177489598	177489649	0	52	0	2756	0	2704	0.0	0.0
chr1	AL136114.1	177399471	177399567	0	97	0	2756	0	2659	0.0	0.0
chr1	SEC16B	177932697	177932806	0	110	299	7408	299	7298	0.0	0.04097012880241162
chr1	CRYZL2P-SEC16B	177960341	177960403	0	63	270	6507	270	6444	0.0	0.04189944134078212
chr1	CRYZL2P	178024403	178024486	0	84	11241	5510	11241	5426	0.0	2.071691854036122
chr1	CRYZL2P	178026154	178026255	0	102	11241	5510	11241	5408	0.0	2.0785872781065087
chr1	CRYZL2P	178030607	178030682	558	76	11241	5510	10683	5434	7.342105263157895	1.965955097534045
chr1	ANGPTL1	178869113	178869223	0	111	1836	3604	1836	3493	0.0	0.5256226739192671
chr1	ABL2	179133311	179133374	0	64	15063	11979	15063	11915	0.0	1.264204783885858
chr1	NPHS2	179557026	179557230	0	205	0	1882	0	1677	0.0	0.0
chr1	TOR1AIP2	179865435	179865854	102	420	41234	18885	41132	18465	0.24285714285714285	2.2275656647711886
chr1	TOR1AIP2	179877238	179877373	25	136	41234	18885	41209	18749	0.18382352941176472	2.1979305562963356
chr1	ACBD6	180326410	180326562	0	153	342	7516	342	7363	0.0	0.04644845850876002
chr1	GLUL	182390496	182390852	0	357	102	10959	102	10602	0.0	0.009620826259196379
chr1	RGS8	182669623	182669752	0	130	0	6695	0	6565	0.0	0.0
chr1	NCF2	183574486	183574621	0	136	207	2526	207	2390	0.0	0.08661087866108787
chr1	NCF2	183573184	183573292	0	109	207	2526	207	2417	0.0	0.08564335953661564
chr1	EDEM3	184749546	184749592	0	47	16416	6328	16416	6281	0.0	2.6135965610571565
chr1	EDEM3	184701496	184701544	0	49	16416	6328	16416	6279	0.0	2.6144290492116578
chr1	NIBAN1	184823637	184823742	0	106	115627	8346	115627	8240	0.0	14.03240291262136
chr1	LINC01350	185563238	185563328	0	91	179	2415	179	2324	0.0	0.0770223752151463
chr1	LINC01350	185563167	185563328	0	162	179	2415	179	2253	0.0	0.07944962272525521
chr1	LINC01350	185565473	185565696	0	224	179	2415	179	2191	0.0	0.08169785486079416
chr1	LINC01350	185568863	185568895	0	33	179	2415	179	2382	0.0	0.07514693534844669
chr1	LINC01350	185622726	185622839	0	114	179	2415	179	2301	0.0	0.0777922642329422
chr1	LINC01350	185585668	185585783	0	116	179	2415	179	2299	0.0	0.07785993910395825
chr1	LINC01350	185621460	185621586	0	127	179	2415	179	2288	0.0	0.07823426573426573
chr1	LINC01350	185626780	185626930	0	151	179	2415	179	2264	0.0	0.07906360424028269
chr1	AL390957.1	192569246	192569304	0	59	153	10139	153	10080	0.0	0.015178571428571428
chr1	AL390957.1	192627340	192627421	0	82	153	10139	153	10057	0.0	0.015213284279606245
chr1	AL390957.1	192589025	192589151	0	127	153	10139	153	10012	0.0	0.015281662005593288
chr1	AL390957.1	192597533	192597747	0	215	153	10139	153	9924	0.0	0.015417170495767836
chr1	AL390957.1	192947623	192947758	0	136	153	10139	153	10003	0.0	0.015295411376587024
chr1	AL390957.1	192947623	192947712	0	90	153	10139	153	10049	0.0	0.015225395561747438
chr1	UCHL5	193020306	193020381	0	76	87807	6676	87807	6600	0.0	13.30409090909091
chr1	UCHL5	193027874	193027955	814	82	87807	6676	86993	6594	9.926829268292684	13.192750985744617
chr1	AL353709.1	195754505	195754542	0	38	0	6534	0	6496	0.0	0.0
chr1	AL353709.1	195759333	195759458	0	126	0	6534	0	6408	0.0	0.0
chr1	AL353709.1	195758745	195758810	0	66	0	6534	0	6468	0.0	0.0
chr1	KCNT2	196305233	196305345	0	113	0	7225	0	7112	0.0	0.0
chr1	KCNT2	196342078	196342228	0	151	0	7225	0	7074	0.0	0.0
chr1	KCNT2	196468993	196469068	0	76	0	7225	0	7149	0.0	0.0
chr1	KCNT2	196319483	196319555	0	73	0	7225	0	7152	0.0	0.0
chr1	KCNT2	196259586	196259624	0	39	0	7225	0	7186	0.0	0.0
chr1	KCNT2	196317173	196317269	0	97	0	7225	0	7128	0.0	0.0
chr1	KCNT2	196326716	196326889	0	174	0	7225	0	7051	0.0	0.0
chr1	KCNT2	196273467	196273488	0	22	0	7225	0	7203	0.0	0.0
chr1	KCNT2	196529394	196529486	0	93	0	7225	0	7132	0.0	0.0
chr1	ASPM	197100430	197105185	5409	4756	23765	10916	18356	6160	1.137300252312868	2.97987012987013
chr1	ZBTB41	197175930	197176014	147	85	20953	8691	20806	8606	1.7294117647058824	2.4176156170113874
chr1	DENND1B	197647054	197647114	0	61	2302	11873	2302	11812	0.0	0.19488655604470032
chr1	DENND1B	197715030	197715074	0	45	2302	11873	2302	11828	0.0	0.19462292864389585
chr1	DENND1B	197735585	197735796	0	212	2302	11873	2302	11661	0.0	0.19741017065431782
chr1	ATP6V1G3	198536678	198536724	0	47	0	683	0	636	0.0	0.0
chr1	ATP6V1G3	198536678	198536696	0	19	0	683	0	664	0.0	0.0
chr1	LINC00862	200371045	200371165	1606	121	62556	3543	60950	3422	13.272727272727273	17.811221507890124
chr1	KIF21B	200983055	200983094	0	40	3903	11444	3903	11404	0.0	0.34224833391792353
chr1	CACNA1S	201054504	201054561	0	58	9922	6097	9922	6039	0.0	1.6429872495446265
chr1	TNNT2	201362385	201362394	0	10	0	5980	0	5970	0.0	0.0
chr1	TNNT2	201372026	201372041	0	16	0	5980	0	5964	0.0	0.0
chr1	TNNT2	201365190	201365307	0	118	0	5980	0	5862	0.0	0.0
chr1	TNNT2	201369815	201369845	0	31	0	5980	0	5949	0.0	0.0
chr1	TNNT2	201362385	201362391	0	7	0	5980	0	5973	0.0	0.0
chr1	LAD1	201391077	201391195	0	119	44	3275	44	3156	0.0	0.01394169835234474
chr1	CSRP1	201496191	201496304	1224	114	69197	6152	67973	6038	10.736842105263158	11.257535607817157
chr1	CSRP1	201496191	201496261	498	71	69197	6152	68699	6081	7.014084507042254	11.29731951981582
chr1	ARL8A	202135458	202135526	0	69	1887	1981	1887	1912	0.0	0.9869246861924686
chr1	PTPN7	202158117	202158301	0	185	740	3851	740	3666	0.0	0.20185488270594654
chr1	PTPN7	202158117	202158248	0	132	740	3851	740	3719	0.0	0.1989782199515999
chr1	PTPN7	202159280	202159454	0	175	740	3851	740	3676	0.0	0.20130576713819368
chr1	PTPN7	202158117	202158320	0	204	740	3851	740	3647	0.0	0.20290649849191117
chr1	UBE2T	202334988	202335058	0	71	102	1657	102	1586	0.0	0.06431273644388398
chr1	KDM5B	202766925	202767060	0	136	216426	17458	216426	17322	0.0	12.494284724627642
chr1	KDM5B	202774612	202774735	0	124	216426	17458	216426	17334	0.0	12.485635167878158
chr1	KDM5B	202777016	202777094	0	79	216426	17458	216426	17379	0.0	12.453305713792508
chr1	KDM5B	202766396	202766504	0	109	216426	17458	216426	17349	0.0	12.474840048417777
chr1	KDM5B	202766925	202767051	0	127	216426	17458	216426	17331	0.0	12.487796434135364
chr1	KDM5B	202776104	202776220	630	117	216426	17458	215796	17341	5.384615384615385	12.444265036618418
chr1	KLHL12	202893238	202893425	0	188	27276	3521	27276	3333	0.0	8.183618361836183
chr1	ADIPOR1	202954240	202954307	0	68	0	3123	0	3055	0.0	0.0
chr1	CYB5R1	202966527	202966600	0	74	0	3200	0	3126	0.0	0.0
chr1	CHI3L1	203180469	203180652	0	184	0	3371	0	3187	0.0	0.0
chr1	CHIT1	203225047	203225104	0	58	107	7752	107	7694	0.0	0.01390694047309592
chr1	CHIT1	203223134	203223259	0	126	107	7752	107	7626	0.0	0.014030946761080514
chr1	CHIT1	203217301	203217372	0	72	107	7752	107	7680	0.0	0.013932291666666667
chr1	CHIT1	203217934	203218091	0	158	107	7752	107	7594	0.0	0.014090071108770082
chr1	CHIT1	203230014	203230084	0	71	107	7752	107	7681	0.0	0.013930477802369483
chr1	FMOD	203347291	203348277	0	987	0	2329	0	1342	0.0	0.0
chr1	ETNK2	204146641	204146764	0	124	102	4420	102	4296	0.0	0.023743016759776536
chr1	PLEKHA6	204243113	204243263	0	151	4143	9689	4143	9538	0.0	0.43436779198993497
chr1	PIK3C2B	204489815	204489931	108	117	18343	9450	18235	9333	0.9230769230769231	1.9538197792778313
chr1	LRRN2	204682869	204682997	0	129	0	5690	0	5561	0.0	0.0
chr1	RBBP5	205115857	205115883	649	27	19108	4418	18459	4391	24.037037037037038	4.203826007743111
chr1	DSTYK	205148204	205148339	0	136	7563	8489	7563	8353	0.0	0.9054232012450617
chr1	KLHDC8A	205343228	205343793	0	566	0	3675	0	3109	0.0	0.0
chr1	KLHDC8A	205348375	205348590	0	216	0	3675	0	3459	0.0	0.0
chr1	KLHDC8A	205344133	205344458	0	326	0	3675	0	3349	0.0	0.0
chr1	LEMD1	205416231	205416296	1697	66	1697	1049	0	983	25.71212121212121	0.0
chr1	LEMD1	205384287	205384364	0	78	1697	1049	1697	971	0.0	1.7476828012358394
chr1	LEMD1	205419229	205419352	0	124	1697	1049	1697	925	0.0	1.8345945945945945
chr1	RAB29	205772495	205772567	0	73	62605	3871	62605	3798	0.0	16.48367561874671
chr1	RAB29	205774832	205775086	0	255	62605	3871	62605	3616	0.0	17.3133296460177
chr1	RAB29	205771471	205771653	0	183	62605	3871	62605	3688	0.0	16.975325379609544
chr1	PM20D1	205832597	205832766	0	170	7043	2624	7043	2454	0.0	2.8700081499592502
chr1	PM20D1	205842153	205842215	0	63	7043	2624	7043	2561	0.0	2.750097618117923
chr1	RAB7B	205985539	205985665	0	127	0	3692	0	3565	0.0	0.0
chr1	CTSE	206022900	206023057	0	158	0	3572	0	3414	0.0	0.0
chr1	CTSE	206012307	206012406	0	100	0	3572	0	3472	0.0	0.0
chr1	CTSE	206012507	206012649	0	143	0	3572	0	3429	0.0	0.0
chr1	CTSE	206014646	206014793	0	148	0	3572	0	3424	0.0	0.0
chr1	EIF2D	206609375	206609459	63	85	50585	5561	50522	5476	0.7411764705882353	9.226077428780131
chr1	DYRK3-AS1	206635095	206635130	715	36	127159	941	126444	905	19.86111111111111	139.7171270718232
chr1	IL10	206773679	206773809	0	131	145	3447	145	3316	0.0	0.043727382388419785
chr1	FCMR	206910209	206910340	0	132	371366	3427	371366	3295	0.0	112.70591805766313
chr1	FCMR	206913758	206914094	0	337	371366	3427	371366	3090	0.0	120.1831715210356
chr1	FCMR	206913861	206914094	0	234	371366	3427	371366	3193	0.0	116.30629502035703
chr1	FCMR	206921340	206921433	168	94	371366	3427	371198	3333	1.7872340425531914	111.37053705370538
chr1	FCAMR	206960421	206961223	0	803	0	3549	0	2746	0.0	0.0
chr1	FCAMR	206969226	206969358	0	133	0	3549	0	3416	0.0	0.0
chr1	C1ORF116	207027493	207027679	0	187	51	5505	51	5318	0.0	0.009590071455434375
chr1	AL137789.1	207600624	207600855	0	232	0	1513	0	1281	0.0	0.0
chr1	MIR29B2CHG	207818961	207819146	0	186	510	11453	510	11267	0.0	0.04526493299014822
chr1	AC092810.2	209153505	209153750	0	246	0	3124	0	2878	0.0	0.0
chr1	AC092810.2	209151404	209151505	0	102	0	3124	0	3022	0.0	0.0
chr1	AC092810.2	209211755	209211886	0	132	0	3124	0	2992	0.0	0.0
chr1	AC092810.2	209161714	209161841	0	128	0	3124	0	2996	0.0	0.0
chr1	AC092810.2	209159483	209159562	0	80	0	3124	0	3044	0.0	0.0
chr1	AC092810.2	209153664	209153750	0	87	0	3124	0	3037	0.0	0.0
chr1	AC092810.2	209155799	209155896	0	98	0	3124	0	3026	0.0	0.0
chr1	AC092810.2	209153571	209153750	0	180	0	3124	0	2944	0.0	0.0
chr1	AL023754.1	209531246	209531374	102	129	102	1078	0	949	0.7906976744186046	0.0
chr1	IRF6	209793133	209793183	0	51	4029	4981	4029	4930	0.0	0.8172413793103448
chr1	KCNH1	210775347	210775544	0	198	51	4644	51	4446	0.0	0.011470985155195682
chr1	KCNH1	210919639	210920069	0	431	51	4644	51	4213	0.0	0.012105388084500356
chr1	KCNH1	211090561	211090690	0	130	51	4644	51	4514	0.0	0.01129818342933097
chr1	AC092017.3	211175088	211175253	0	166	51	2372	51	2206	0.0	0.023118766999093383
chr1	RD3	211481119	211481429	0	311	18693	3514	18693	3203	0.0	5.83609116453325
chr1	INTS7	212020720	212020754	0	35	20889	5042	20889	5007	0.0	4.171959257040144
chr1	INTS7	212020121	212020268	0	148	20889	5042	20889	4894	0.0	4.2682876992235395
chr1	INTS7	212030736	212030940	0	205	20889	5042	20889	4837	0.0	4.318585900351458
chr1	LINC02608	212234801	212234919	0	119	17061	1198	17061	1079	0.0	15.811862835959221
chr1	LINC02608	212234502	212234696	0	195	17061	1198	17061	1003	0.0	17.009970089730807
chr1	LINC02608	212232367	212232407	0	41	17061	1198	17061	1157	0.0	14.74589455488332
chr1	PACC1	212413897	212414080	51	184	329	2929	278	2745	0.27717391304347827	0.10127504553734062
chr1	NSL1	212739533	212739601	0	69	14917	13874	14917	13805	0.0	1.080550525172039
chr1	NSL1	212766188	212766273	0	86	14917	13874	14917	13788	0.0	1.0818827966347548
chr1	ANGEL2	213013092	213013418	0	327	3570	7328	3570	7001	0.0	0.5099271532638194
chr1	PROX1-AS1	213966070	213966284	0	215	0	9778	0	9563	0.0	0.0
chr1	PROX1-AS1	213965303	213965481	0	179	0	9778	0	9599	0.0	0.0
chr1	PROX1-AS1	213966070	213966258	0	189	0	9778	0	9589	0.0	0.0
chr1	PROX1-AS1	213839737	213839797	0	61	0	9778	0	9717	0.0	0.0
chr1	PROX1-AS1	213840680	213840829	0	150	0	9778	0	9628	0.0	0.0
chr1	PROX1-AS1	213843482	213843568	0	87	0	9778	0	9691	0.0	0.0
chr1	PROX1-AS1	213895393	213895518	0	126	0	9778	0	9652	0.0	0.0
chr1	PROX1-AS1	213840507	213840600	0	94	0	9778	0	9684	0.0	0.0
chr1	PROX1-AS1	213915934	213916099	0	166	0	9778	0	9612	0.0	0.0
chr1	PROX1-AS1	213876637	213876806	0	170	0	9778	0	9608	0.0	0.0
chr1	PROX1-AS1	213921472	213921580	0	109	0	9778	0	9669	0.0	0.0
chr1	PROX1-AS1	213842059	213842240	0	182	0	9778	0	9596	0.0	0.0
chr1	PROX1-AS1	213835852	213836054	0	203	0	9778	0	9575	0.0	0.0
chr1	PROX1-AS1	213840092	213840196	0	105	0	9778	0	9673	0.0	0.0
chr1	PROX1-AS1	213895426	213895518	0	93	0	9778	0	9685	0.0	0.0
chr1	PROX1-AS1	213963863	213963936	0	74	0	9778	0	9704	0.0	0.0
chr1	PROX1-AS1	213894662	213894743	0	82	0	9778	0	9696	0.0	0.0
chr1	PROX1-AS1	213837292	213837295	0	4	0	9778	0	9774	0.0	0.0
chr1	PROX1-AS1	213979310	213979419	0	110	0	9778	0	9668	0.0	0.0
chr1	PROX1-AS1	213963863	213963985	0	123	0	9778	0	9655	0.0	0.0
chr1	PROX1-AS1	213895807	213895891	0	85	0	9778	0	9693	0.0	0.0
chr1	PROX1-AS1	213901294	213901409	0	116	0	9778	0	9662	0.0	0.0
chr1	PROX1-AS1	213977128	213977418	0	291	0	9778	0	9487	0.0	0.0
chr1	PTPN14	214401684	214401772	0	89	272041	18774	272041	18685	0.0	14.55932566229596
chr1	USH2A	215630188	215630260	0	73	5191	20706	5191	20633	0.0	0.25158726312218294
chr1	ESRRG	216650972	216651089	0	118	0	10959	0	10841	0.0	0.0
chr1	ESRRG	216714515	216714634	0	120	0	10959	0	10839	0.0	0.0
chr1	ESRRG	216865060	216865178	0	119	0	10959	0	10840	0.0	0.0
chr1	ESRRG	216959561	216959685	0	125	0	10959	0	10834	0.0	0.0
chr1	ESRRG	216707358	216707486	0	129	0	10959	0	10830	0.0	0.0
chr1	ESRRG	216715073	216715249	0	177	0	10959	0	10782	0.0	0.0
chr1	ESRRG	216936661	216936699	0	39	0	10959	0	10920	0.0	0.0
chr1	LYPLAL1-DT	219149938	219150031	0	94	0	5524	0	5430	0.0	0.0
chr1	LYPLAL1-DT	219156119	219156199	0	81	0	5524	0	5443	0.0	0.0
chr1	LYPLAL1-DT	219081397	219081943	0	547	0	5524	0	4977	0.0	0.0
chr1	LYPLAL1-AS1	219429044	219429175	0	132	401	2629	401	2497	0.0	0.16059271125350422
chr1	LYPLAL1-AS1	219427269	219427321	0	53	401	2629	401	2576	0.0	0.15566770186335405
chr1	EPRS1	220018448	220018508	38	61	893	5356	855	5295	0.6229508196721312	0.16147308781869688
chr1	EPRS1	220019987	220020221	0	235	893	5356	893	5121	0.0	0.17438000390548722
chr1	EPRS1	220030385	220030480	0	96	893	5356	893	5260	0.0	0.16977186311787074
chr1	EPRS1	220018125	220018146	0	22	893	5356	893	5334	0.0	0.16741657292838394
chr1	BPNT1	220072849	220072957	0	109	0	2818	0	2709	0.0	0.0
chr1	BPNT1	220079726	220079854	0	129	0	2818	0	2689	0.0	0.0
chr1	BPNT1	220066072	220066117	0	46	0	2818	0	2772	0.0	0.0
chr1	RAB3GAP2	220210800	220210876	0	77	76347	10381	76347	10304	0.0	7.409452639751553
chr1	DUSP10	221738933	221739787	0	855	0	2833	0	1978	0.0	0.0
chr1	AL513314.2	222480302	222480426	0	125	51	1548	51	1423	0.0	0.035839775122979624
chr1	TAF1A	222579758	222579872	0	115	10	2904	10	2789	0.0	0.0035855145213338113
chr1	TAF1A	222584127	222584297	0	171	10	2904	10	2733	0.0	0.003658982802780827
chr1	TAF1A	222579758	222579825	0	68	10	2904	10	2836	0.0	0.003526093088857546
chr1	AIDA	222670132	222670250	144	119	21708	3582	21564	3463	1.2100840336134453	6.226970834536529
chr1	AL929091.1	223098689	223098976	0	288	0	4473	0	4185	0.0	0.0
chr1	TLR5	223137177	223137263	0	87	4182	7742	4182	7655	0.0	0.5463096015676029
chr1	TLR5	223141647	223141763	0	117	4182	7742	4182	7625	0.0	0.5484590163934426
chr1	SUSD4	223292438	223292651	0	214	0	4430	0	4216	0.0	0.0
chr1	CAPN8	223538398	223538491	0	94	8	4820	8	4726	0.0	0.0016927634363097758
chr1	CAPN8	223642682	223642833	0	152	8	4820	8	4668	0.0	0.001713796058269066
chr1	TP53BP2	223798214	223798677	0	464	0	5901	0	5437	0.0	0.0
chr1	TP53BP2	223821219	223821367	0	149	0	5901	0	5752	0.0	0.0
chr1	TP53BP2	223818205	223818337	0	133	0	5901	0	5768	0.0	0.0
chr1	GTF2IP20	223984381	223984440	0	60	360851	3980	360851	3920	0.0	92.05382653061224
chr1	NVL	224232088	224232182	0	95	612	4451	612	4356	0.0	0.14049586776859505
chr1	NVL	224233200	224233289	0	90	612	4451	612	4361	0.0	0.1403347855996331
chr1	NVL	224304735	224304812	0	78	612	4451	612	4373	0.0	0.1399496912874457
chr1	NVL	224311799	224311857	0	59	612	4451	612	4392	0.0	0.13934426229508196
chr1	NVL	224307990	224308263	0	274	612	4451	612	4177	0.0	0.14651663873593487
chr1	NVL	224301690	224301771	0	82	612	4451	612	4369	0.0	0.14007782101167315
chr1	NVL	224326390	224326464	0	75	612	4451	612	4376	0.0	0.13985374771480805
chr1	NVL	224313049	224313155	0	107	612	4451	612	4344	0.0	0.1408839779005525
chr1	NVL	224313049	224313151	0	103	612	4451	612	4348	0.0	0.140754369825207
chr1	WDR26	224393827	224394013	0	187	15285	10645	15285	10458	0.0	1.461560527825588
chr1	WDR26	224431681	224431781	0	101	15285	10645	15285	10544	0.0	1.4496396054628224
chr1	WDR26	224402003	224402109	0	107	15285	10645	15285	10538	0.0	1.4504649838679067
chr1	WDR26	224413252	224413335	0	84	15285	10645	15285	10561	0.0	1.447306126313796
chr1	CNIH3-AS2	224615203	224615427	102	225	1280	4139	1178	3914	0.4533333333333333	0.30097087378640774
chr1	LINC02765	225462393	225462493	0	101	0	2015	0	1914	0.0	0.0
chr1	LINC02765	225461540	225461729	0	190	0	2015	0	1825	0.0	0.0
chr1	LINC02765	225450478	225450678	0	201	0	2015	0	1814	0.0	0.0
chr1	ENAH	225504990	225505053	0	64	1683	15063	1683	14999	0.0	0.11220748049869991
chr1	ENAH	225531045	225531057	0	13	1683	15063	1683	15050	0.0	0.11182724252491694
chr1	ENAH	225535506	225535563	0	58	1683	15063	1683	15005	0.0	0.1121626124625125
chr1	PYCR2	225921857	225922079	0	223	510	3483	510	3260	0.0	0.15644171779141106
chr1	ACBD3	226159183	226159358	0	176	139	3597	139	3421	0.0	0.040631394329143526
chr1	LIN9	226295841	226295946	25	106	7584	4458	7559	4352	0.2358490566037736	1.7369025735294117
chr1	PARP1	226374225	226374354	5953	130	13862	16916	7909	16786	45.792307692307695	0.4711664482306684
chr1	CDC42BPA	227059372	227059411	0	40	36436	13908	36436	13868	0.0	2.6273435246610903
chr1	CDC42BPA	227112670	227112913	51	244	36436	13908	36385	13664	0.20901639344262296	2.662836651053864
chr1	CDC42BPA	227010877	227011063	0	187	36436	13908	36436	13721	0.0	2.6554915822461918
chr1	CDC42BPA	227051880	227051985	0	106	36436	13908	36436	13802	0.0	2.639907259817418
chr1	CDC42BPA	227068653	227068701	0	49	36436	13908	36436	13859	0.0	2.6290497149866514
chr1	MRPL55	228107976	228108137	1079	162	16924	1672	15845	1510	6.660493827160494	10.493377483443709
chr1	MRPL55	228108436	228108508	30	73	16924	1672	16894	1599	0.410958904109589	10.565353345841151
chr1	MRPL55	228107976	228108084	719	109	16924	1672	16205	1563	6.5963302752293576	10.367882277671145
chr1	MRPL55	228108436	228108474	1	39	16924	1672	16923	1633	0.02564102564102564	10.36313533374158
chr1	MRPL55	228108440	228108508	29	69	16924	1672	16895	1603	0.42028985507246375	10.539613225202745
chr1	MRPL55	228108954	228109021	51	68	16924	1672	16873	1604	0.75	10.519326683291771
chr1	MRPL55	228108436	228109021	358	586	16924	1672	16566	1086	0.6109215017064846	15.25414364640884
chr1	OBSCN-AS1	228204329	228204433	0	105	0	2798	0	2693	0.0	0.0
chr1	OBSCN-AS1	228205323	228205447	0	125	0	2798	0	2673	0.0	0.0
chr1	TRIM11	228400963	228401194	1298	232	18001	8493	16703	8261	5.594827586206897	2.0219101803655732
chr1	TRIM11	228402065	228402161	1236	97	18001	8493	16765	8396	12.742268041237113	1.9967841829442592
chr1	AL162595.1	229267953	229269627	0	1675	0	4970	0	3295	0.0	0.0
chr1	AL162595.1	229268242	229269627	0	1386	0	4970	0	3584	0.0	0.0
chr1	LINC01682	229885539	229885818	0	280	0	2680	0	2400	0.0	0.0
chr1	LINC01682	229875336	229875435	0	100	0	2680	0	2580	0.0	0.0
chr1	AL512328.1	230776849	230776990	0	142	14408	1349	14408	1207	0.0	11.937033968516984
chr1	TTC13	230956420	230956560	0	141	760	4237	760	4096	0.0	0.185546875
chr1	C1ORF131	231229149	231229209	0	61	0	3253	0	3192	0.0	0.0
chr1	C1ORF131	231229149	231229206	0	58	0	3253	0	3195	0.0	0.0
chr1	EGLN1	231367568	231367636	230	69	13311	5387	13081	5318	3.3333333333333335	2.4597593080105304
chr1	EGLN1	231370561	231370698	0	138	13311	5387	13311	5249	0.0	2.5359116022099446
chr1	AL445524.1	231527337	231527415	0	79	306	4123	306	4044	0.0	0.07566765578635015
chr1	EGLN1	231367568	231368187	490	620	13311	5387	12821	4767	0.7903225806451613	2.6895322005454165
chr1	AL445524.1	231524282	231524376	0	95	306	4123	306	4028	0.0	0.0759682224428997
chr1	AL445524.1	231527765	231527792	0	28	306	4123	306	4095	0.0	0.07472527472527472
chr1	AL445524.1	231524425	231524547	0	123	306	4123	306	4000	0.0	0.0765
chr1	AL136171.2	231822724	231822834	51	111	102	5695	51	5584	0.4594594594594595	0.009133237822349571
chr1	AL136171.2	231822679	231822834	51	156	102	5695	51	5539	0.3269230769230769	0.009207438165733887
chr1	SIPA1L2	232404124	232404178	0	55	2796	8582	2796	8527	0.0	0.327899612994019
chr1	SIPA1L2	232471370	232471528	0	159	2796	8582	2796	8423	0.0	0.33194823697020065
chr1	SIPA1L2	232533489	232533583	0	95	2796	8582	2796	8487	0.0	0.3294450335807706
chr1	SIPA1L2	232608826	232608988	0	163	2796	8582	2796	8419	0.0	0.3321059508255137
chr1	SIPA1L2	232608911	232608988	0	78	2796	8582	2796	8504	0.0	0.3287864534336783
chr1	SIPA1L2	232574173	232574222	3	50	2796	8582	2793	8532	0.06	0.32735583684950775
chr1	SIPA1L2	232433413	232433566	0	154	2796	8582	2796	8428	0.0	0.3317513051732321
chr1	SIPA1L2	232419874	232419920	0	47	2796	8582	2796	8535	0.0	0.32759226713532513
chr1	LINC01744	232735700	232735750	0	51	0	2274	0	2223	0.0	0.0
chr1	PCNX2	233025145	233025399	0	255	4790	12393	4790	12138	0.0	0.3946284396111386
chr1	PCNX2	233160282	233160433	0	152	4790	12393	4790	12241	0.0	0.39130789968139856
chr1	PCNX2	233217898	233217931	0	34	4790	12393	4790	12359	0.0	0.38757181001699165
chr1	PCNX2	233227225	233227371	0	147	4790	12393	4790	12246	0.0	0.3911481300016332
chr1	PCNX2	233112844	233112966	950	123	4790	12393	3840	12270	7.723577235772358	0.31295843520782396
chr1	TARBP1	234393361	234393486	0	126	5189	7852	5189	7726	0.0	0.6716282681853482
chr1	TARBP1	234393361	234393476	0	116	5189	7852	5189	7736	0.0	0.670760082730093
chr1	TARBP1	234398381	234398553	0	173	5189	7852	5189	7679	0.0	0.6757390285193384
chr1	AL391832.2	234962545	234962635	0	91	443	2943	443	2852	0.0	0.15532959326788218
chr1	AL391832.2	234962313	234962415	0	103	443	2943	443	2840	0.0	0.15598591549295773
chr1	RBM34	235152705	235152765	0	61	0	2905	0	2844	0.0	0.0
chr1	RBM34	235160510	235160647	0	138	0	2905	0	2767	0.0	0.0
chr1	RBM34	235156594	235156681	0	88	0	2905	0	2817	0.0	0.0
chr1	ARID4B	235213768	235214026	0	259	196	9671	196	9412	0.0	0.0208244793880153
chr1	ARID4B	235176747	235176903	0	157	196	9671	196	9514	0.0	0.020601219255833508
chr1	B3GALNT2	235458602	235458786	0	185	8883	10294	8883	10109	0.0	0.8787219309526165
chr1	B3GALNT2	235489167	235489268	0	102	8883	10294	8883	10192	0.0	0.8715659340659341
chr1	B3GALNT2	235457165	235457251	0	87	8883	10294	8883	10207	0.0	0.8702850984618399
chr1	B3GALNT2	235496185	235496308	40	124	8883	10294	8843	10170	0.3225806451612903	0.8695181907571288
chr1	GNG4	235595399	235595511	81	113	6466	5200	6385	5087	0.7168141592920354	1.2551602123058778
chr1	LYST	235791698	235792125	1275	428	145623	19662	144348	19234	2.9789719626168223	7.504835187688468
chr1	LYST	235747169	235747331	0	163	145623	19662	145623	19499	0.0	7.468229139955895
chr1	HEATR1	236574660	236574903	0	244	1372	9106	1372	8862	0.0	0.15481832543443919
chr1	CHRM3-AS2	239727653	239727808	0	156	51	9402	51	9246	0.0	0.0055158987670343934
chr1	CHRM3-AS2	239720138	239720178	0	41	51	9402	51	9361	0.0	0.005448135882918492
chr1	AL359918.2	240179316	240179475	0	160	0	500	0	340	0.0	0.0
chr1	RGS7	240800640	240800721	0	82	0	2595	0	2513	0.0	0.0
chr1	RGS7	240801454	240801508	0	55	0	2595	0	2540	0.0	0.0
chr1	OPN3	241604259	241604579	0	321	0	3735	0	3414	0.0	0.0
chr1	OPN3	241604419	241604579	0	161	0	3735	0	3574	0.0	0.0
chr1	PLD5	242288361	242288530	0	170	24240	9558	24240	9388	0.0	2.582019599488709
chr1	SEPTIN14P21	243039280	243039492	0	213	0	1465	0	1252	0.0	0.0
chr1	LINC01347	243089320	243089379	0	60	51	3859	51	3799	0.0	0.013424585417215057
chr1	CEP170	243185778	243186072	51	295	3504	8930	3453	8635	0.17288135593220338	0.3998841922408801
chr1	CEP170	243126377	243126494	0	118	3504	8930	3504	8812	0.0	0.3976395823876532
chr1	CEP170	243176701	243176816	0	116	3504	8930	3504	8814	0.0	0.3975493533015657
chr1	AKT3	243613670	243613739	0	70	24090	11633	24090	11563	0.0	2.083369367811122
chr1	AKT3	243843124	243843282	0	159	24090	11633	24090	11474	0.0	2.099529370751264
chr1	AKT3	243504387	243505334	2930	948	24090	11633	21160	10685	3.090717299578059	1.9803462798315394
chr1	AKT3	243683196	243683310	0	115	24090	11633	24090	11518	0.0	2.0915089425247437
chr1	HNRNPU	244848787	244848856	0	70	46764	15411	46764	15341	0.0	3.0483019359885275
chr1	HNRNPU	244854972	244855044	423	73	46764	15411	46341	15338	5.794520547945205	3.021319598383101
chr1	HNRNPU	244856456	244856625	38	170	46764	15411	46726	15241	0.2235294117647059	3.0658093300964504
chr1	HNRNPU	244862618	244862730	0	113	46764	15411	46764	15298	0.0	3.05687017910838
chr1	HNRNPU	244847001	244847101	0	101	46764	15411	46764	15310	0.0	3.0544741998693663
chr1	HNRNPU	244847001	244847053	0	53	46764	15411	46764	15358	0.0	3.044927724964188
chr1	HNRNPU	244862460	244862534	24	75	46764	15411	46740	15336	0.32	3.04773082942097
chr1	SMYD3	245764040	245764149	0	110	2095	5892	2095	5782	0.0	0.362331373227257
chr1	SMYD3	245915529	245915640	0	112	2095	5892	2095	5780	0.0	0.3624567474048443
chr1	KIF28P	246780948	246781057	0	110	4717	3552	4717	3442	0.0	1.3704241719930272
chr1	AHCTF1	246842693	246842776	0	84	32040	9618	32040	9534	0.0	3.360604153555695
chr1	AHCTF1	246843794	246843928	54	135	32040	9618	31986	9483	0.4	3.372983233154065
chr1	ZNF695	246988120	246988255	0	136	1347	3762	1347	3626	0.0	0.3714837286265858
chr1	ZNF695	246988124	246988255	0	132	1347	3762	1347	3630	0.0	0.37107438016528926
chr1	ZNF669	247101730	247101791	0	62	2269	1726	2269	1664	0.0	1.3635817307692308
chr1	ZNF496	247322697	247322805	267	109	57883	8915	57616	8806	2.44954128440367	6.542811719282308
chr1	OR6F1	247713890	247713954	0	65	0	1765	0	1700	0.0	0.0
chr1	OR2T27	248651423	248651572	0	150	0	1195	0	1045	0.0	0.0
chr1	ZNF692	248850681	248850781	0	101	0	3751	0	3650	0.0	0.0
chr1	ZNF692	248855557	248855635	0	79	0	3751	0	3672	0.0	0.0
chr1	ZNF692	248856287	248856422	0	136	0	3751	0	3615	0.0	0.0
chr1	ZNF692	248856372	248856422	0	51	0	3751	0	3700	0.0	0.0
chr1	ZNF692	248850862	248850947	0	86	0	3751	0	3665	0.0	0.0
chr1	ZNF692	248857827	248857859	0	33	0	3751	0	3718	0.0	0.0
chr1	ZNF692	248857827	248858017	0	191	0	3751	0	3560	0.0	0.0
chr2	SH3YL1	233100	233229	8514	130	191528	8808	183014	8678	65.49230769230769	21.089421525697166
chr2	SH3YL1	224863	224920	169	58	191528	8808	191359	8750	2.913793103448276	21.8696
chr2	SH3YL1	242797	242871	386	75	191528	8808	191142	8733	5.1466666666666665	21.887323943661972
chr2	SH3YL1	243502	243562	3110	61	191528	8808	188418	8747	50.98360655737705	21.540871155824853
chr2	SH3YL1	244626	244738	1283	113	191528	8808	190245	8695	11.353982300884956	21.879815986198963
chr2	SH3YL1	256206	256690	102	485	191528	8808	191426	8323	0.21030927835051547	22.99963955304578
chr2	SH3YL1	260084	260702	52116	619	191528	8808	139412	8189	84.19386106623587	17.024300891439736
chr2	SH3YL1	262630	262750	4636	121	191528	8808	186892	8687	38.31404958677686	21.513986416484403
chr2	SH3YL1	262630	262786	5798	157	191528	8808	185730	8651	36.92993630573248	21.46919431279621
chr2	SH3YL1	263210	263368	8100	159	191528	8808	183428	8649	50.943396226415096	21.208000924962423
chr2	SH3YL1	263210	263372	8136	163	191528	8808	183392	8645	49.91411042944785	21.21364950838635
chr2	AC079779.3	312956	313157	0	202	255	3482	255	3280	0.0	0.07774390243902439
chr2	AC079779.3	313873	313884	0	12	255	3482	255	3470	0.0	0.07348703170028818
chr2	AC079779.3	313873	313892	0	20	255	3482	255	3462	0.0	0.07365684575389948
chr2	AC079779.3	311487	311659	0	173	255	3482	255	3309	0.0	0.0770625566636446
chr2	TMEM18	675757	676238	50149	482	567681	8014	517532	7532	104.04356846473028	68.71109930961232
chr2	LINC01115	853978	854215	0	238	33	6823	33	6585	0.0	0.005011389521640091
chr2	LINC01115	794472	795158	0	687	33	6823	33	6136	0.0	0.005378096479791395
chr2	LINC01115	835274	835359	33	86	33	6823	0	6737	0.38372093023255816	0.0
chr2	PXDN	1638845	1638978	0	134	2505703	11294	2505703	11160	0.0	224.52535842293906
chr2	PXDN	1648171	1649675	117669	1505	2505703	11294	2388034	9789	78.18538205980066	243.95076105833078
chr2	PXDN	1687631	1687703	19	73	2505703	11294	2505684	11221	0.2602739726027397	223.3030924160057
chr2	MYT1L	1886538	1886607	0	70	0	31707	0	31637	0.0	0.0
chr2	MYT1L	1922291	1923263	0	973	0	31707	0	30734	0.0	0.0
chr2	MYT1L	1942981	1943334	0	354	0	31707	0	31353	0.0	0.0
chr2	MYT1L	1979164	1979227	0	64	0	31707	0	31643	0.0	0.0
chr2	MYT1L	1922285	1923263	0	979	0	31707	0	30728	0.0	0.0
chr2	MYT1L	2284403	2284503	0	101	0	31707	0	31606	0.0	0.0
chr2	MYT1L	1887058	1887121	0	64	0	31707	0	31643	0.0	0.0
chr2	MYT1L	1791872	1792007	0	136	0	31707	0	31571	0.0	0.0
chr2	MYT1L	1922285	1923260	0	976	0	31707	0	30731	0.0	0.0
chr2	MYT1L	2326035	2326111	0	77	0	31707	0	31630	0.0	0.0
chr2	MYT1L	2002372	2002515	0	144	0	31707	0	31563	0.0	0.0
chr2	MYT1L	1860161	1860251	0	91	0	31707	0	31616	0.0	0.0
chr2	MYT1L	2326035	2326309	0	275	0	31707	0	31432	0.0	0.0
chr2	EIPR1	3274338	3274419	0	82	1116	5742	1116	5660	0.0	0.1971731448763251
chr2	EIPR1	3257298	3257455	0	158	1116	5742	1116	5584	0.0	0.1998567335243553
chr2	EIPR1	3338016	3338149	0	134	1116	5742	1116	5608	0.0	0.19900142653352354
chr2	EIPR1	3353205	3353323	0	119	1116	5742	1116	5623	0.0	0.19847056731282234
chr2	EIPR1	3318856	3318958	0	103	1116	5742	1116	5639	0.0	0.1979074303954602
chr2	AC108488.1	3533107	3533190	0	84	0	1197	0	1113	0.0	0.0
chr2	AC108488.1	3536197	3536313	0	117	0	1197	0	1080	0.0	0.0
chr2	RNASEH1	3557674	3557843	0	170	0	5954	0	5784	0.0	0.0
chr2	LINC01304	3959563	3959774	0	212	0	6379	0	6167	0.0	0.0
chr2	LINC01304	3961769	3961894	0	126	0	6379	0	6253	0.0	0.0
chr2	LINC01304	3959251	3959395	0	145	0	6379	0	6234	0.0	0.0
chr2	LINC01304	3968178	3968288	0	111	0	6379	0	6268	0.0	0.0
chr2	LINC01304	3959563	3959636	0	74	0	6379	0	6305	0.0	0.0
chr2	LINC01304	3961769	3961803	0	35	0	6379	0	6344	0.0	0.0
chr2	LINC01304	3965054	3965209	0	156	0	6379	0	6223	0.0	0.0
chr2	LINC01249	4634893	4635059	0	167	0	3785	0	3618	0.0	0.0
chr2	MIR7515HG	6635575	6635640	0	66	14908	7267	14908	7201	0.0	2.0702680183307876
chr2	MIR7515HG	6626136	6626238	0	103	14908	7267	14908	7164	0.0	2.080960357342267
chr2	MIR7515HG	6632697	6632742	0	46	14908	7267	14908	7221	0.0	2.0645339980612105
chr2	MIR7515HG	6625028	6625145	0	118	14908	7267	14908	7149	0.0	2.0853266191075677
chr2	MIR7515HG	6634594	6634733	0	140	14908	7267	14908	7127	0.0	2.091763715448295
chr2	MIR7515HG	6638090	6638153	0	64	14908	7267	14908	7203	0.0	2.0696931833958074
chr2	MIR7515HG	6633668	6633969	0	302	14908	7267	14908	6965	0.0	2.140416367552046
chr2	MIR7515HG	6634799	6634872	0	74	14908	7267	14908	7193	0.0	2.072570554705964
chr2	MIR7515HG	6649210	6649263	0	54	14908	7267	14908	7213	0.0	2.0668237903784834
chr2	MIR7515HG	6639050	6639277	0	228	14908	7267	14908	7039	0.0	2.1179144764881377
chr2	MIR7515HG	6647535	6647721	0	187	14908	7267	14908	7080	0.0	2.105649717514124
chr2	MIR7515HG	6639050	6639273	0	224	14908	7267	14908	7043	0.0	2.116711628567372
chr2	MIR7515HG	6618062	6618315	0	254	14908	7267	14908	7013	0.0	2.1257664337658633
chr2	MIR7515HG	6625028	6625127	0	100	14908	7267	14908	7167	0.0	2.080089298172178
chr2	MIR7515HG	6649210	6649381	0	172	14908	7267	14908	7095	0.0	2.101198026779422
chr2	MIR7515HG	6639113	6639277	0	165	14908	7267	14908	7102	0.0	2.099127006477049
chr2	MIR7515HG	6634442	6634548	0	107	14908	7267	14908	7160	0.0	2.082122905027933
chr2	MIR7515HG	6634799	6634911	0	113	14908	7267	14908	7154	0.0	2.083869164103998
chr2	MIR7515HG	6635119	6635251	0	133	14908	7267	14908	7134	0.0	2.0897112419400057
chr2	MIR7515HG	6634594	6634911	0	318	14908	7267	14908	6949	0.0	2.145344653907037
chr2	MIR7515HG	6634594	6634872	0	279	14908	7267	14908	6988	0.0	2.1333714939896966
chr2	MIR7515HG	6638966	6639277	0	312	14908	7267	14908	6955	0.0	2.143493889288282
chr2	MIR7515HG	6636807	6636848	54	42	14908	7267	14854	7225	1.2857142857142858	2.055916955017301
chr2	MIR7515HG	6649210	6649327	0	118	14908	7267	14908	7149	0.0	2.0853266191075677
chr2	MIR7515HG	6649568	6649722	0	155	14908	7267	14908	7112	0.0	2.0961754780652417
chr2	AC007463.1	7889485	7889559	0	75	0	888	0	813	0.0	0.0
chr2	AC007463.1	7887774	7887809	0	36	0	888	0	852	0.0	0.0
chr2	LINC00298	7968144	7968279	0	136	0	4416	0	4280	0.0	0.0
chr2	LINC00298	7925638	7925752	0	115	0	4416	0	4301	0.0	0.0
chr2	LINC00299	8312725	8312849	0	125	1149	22103	1149	21978	0.0	0.05227955227955228
chr2	LINC00299	8383476	8383655	0	180	1149	22103	1149	21923	0.0	0.05241071021301829
chr2	LINC00299	8376531	8376633	0	103	1149	22103	1149	22000	0.0	0.052227272727272726
chr2	LINC01814	8545147	8545236	0	90	0	13537	0	13447	0.0	0.0
chr2	LINC01814	8579910	8580047	0	138	0	13537	0	13399	0.0	0.0
chr2	LINC01814	8575889	8575961	0	73	0	13537	0	13464	0.0	0.0
chr2	LINC01814	8582977	8583073	0	97	0	13537	0	13440	0.0	0.0
chr2	LINC01814	8578951	8579060	0	110	0	13537	0	13427	0.0	0.0
chr2	ID2-AS1	8675743	8676029	0	287	102	6592	102	6305	0.0	0.0161776367961935
chr2	ID2-AS1	8675743	8675855	0	113	102	6592	102	6479	0.0	0.015743170242321344
chr2	ID2-AS1	8677418	8677560	0	143	102	6592	102	6449	0.0	0.015816405644285936
chr2	KIDINS220	8727188	8727267	0	80	216	14698	216	14618	0.0	0.014776303187850596
chr2	KIDINS220	8747144	8747201	0	58	216	14698	216	14640	0.0	0.014754098360655738
chr2	KIDINS220	8747886	8748000	0	115	216	14698	216	14583	0.0	0.01481176712610574
chr2	KIDINS220	8825742	8825913	0	172	216	14698	216	14526	0.0	0.01486988847583643
chr2	KIDINS220	8740151	8740184	0	34	216	14698	216	14664	0.0	0.014729950900163666
chr2	KIDINS220	8749370	8749421	0	52	216	14698	216	14646	0.0	0.014748054076198279
chr2	MBOAT2	8862270	8862322	16	53	9193	8666	9177	8613	0.3018867924528302	1.0654824103099965
chr2	MBOAT2	8862589	8862722	20	134	9193	8666	9173	8532	0.14925373134328357	1.0751289263947492
chr2	ITGB1BP1	9407448	9407598	0	151	510	6364	510	6213	0.0	0.08208594881699662
chr2	ITGB1BP1	9414177	9414256	0	80	510	6364	510	6284	0.0	0.08115849777211967
chr2	ITGB1BP1	9418625	9418732	0	108	510	6364	510	6256	0.0	0.08152173913043478
chr2	ITGB1BP1	9419989	9420100	0	112	510	6364	510	6252	0.0	0.08157389635316699
chr2	ADAM17	9505165	9505365	0	201	51892	10467	51892	10266	0.0	5.054743814533412
chr2	ADAM17	9523248	9523338	387	91	51892	10467	51505	10376	4.252747252747253	4.963858905165767
chr2	NOL10	10657741	10657891	0	151	1286	3858	1286	3707	0.0	0.3469112489884003
chr2	NOL10	10675793	10675871	0	79	1286	3858	1286	3779	0.0	0.34030166710770043
chr2	NOL10	10684566	10684612	0	47	1286	3858	1286	3811	0.0	0.3374442403568617
chr2	PDIA6	10810242	10810420	0	179	2886	4116	2886	3937	0.0	0.7330454660909321
chr2	PDIA6	10820770	10820918	0	149	2886	4116	2886	3967	0.0	0.7275018905974288
chr2	AC062028.1	11106695	11106787	0	93	0	4225	0	4132	0.0	0.0
chr2	AC062028.1	11123151	11123289	0	139	0	4225	0	4086	0.0	0.0
chr2	AC062028.1	11128983	11129098	0	116	0	4225	0	4109	0.0	0.0
chr2	ROCK2	11235701	11235962	0	262	185	10233	185	9971	0.0	0.018553806037508776
chr2	E2F6	11458280	11458351	0	72	1020	4076	1020	4004	0.0	0.2547452547452547
chr2	E2F6	11457178	11457233	0	56	1020	4076	1020	4020	0.0	0.2537313432835821
chr2	E2F6	11455341	11455474	0	134	1020	4076	1020	3942	0.0	0.258751902587519
chr2	AC064875.1	13002423	13002608	0	186	3211	4174	3211	3988	0.0	0.8051654964894684
chr2	AC064875.1	12981036	12981118	0	83	3211	4174	3211	4091	0.0	0.7848936690295771
chr2	AC064875.1	12972531	12972586	0	56	3211	4174	3211	4118	0.0	0.7797474502185527
chr2	AC064875.1	13001587	13001741	0	155	3211	4174	3211	4019	0.0	0.7989549639213734
chr2	NBAS	15178987	15179116	0	130	4594	9002	4594	8872	0.0	0.5178088367899009
chr2	NBAS	15218772	15218968	0	197	4594	9002	4594	8805	0.0	0.5217490062464509
chr2	NBAS	15483261	15483368	0	108	4594	9002	4594	8894	0.0	0.5165279964020688
chr2	CYRIA	16622938	16623137	0	200	40	5464	40	5264	0.0	0.007598784194528876
chr2	SMC6	17752977	17753064	0	88	0	9859	0	9771	0.0	0.0
chr2	SMC6	17799150	17799225	0	76	0	9859	0	9783	0.0	0.0
chr2	SMC6	17740744	17740822	0	79	0	9859	0	9780	0.0	0.0
chr2	SMC6	17713384	17713580	0	197	0	9859	0	9662	0.0	0.0
chr2	SMC6	17753001	17753064	0	64	0	9859	0	9795	0.0	0.0
chr2	NT5C1B	18563844	18564119	0	276	0	3862	0	3586	0.0	0.0
chr2	NT5C1B	18586993	18587173	0	181	0	3862	0	3681	0.0	0.0
chr2	NT5C1B	18586942	18587173	0	232	0	3862	0	3630	0.0	0.0
chr2	LINC01376	19031323	19031380	0	58	51	3056	51	2998	0.0	0.017011340893929285
chr2	TTC32	19897868	19898035	0	168	0	1999	0	1831	0.0	0.0
chr2	WDR35	19914036	19914277	0	242	1071	7835	1071	7593	0.0	0.1410509679968392
chr2	WDR35	19960553	19960614	0	62	1071	7835	1071	7773	0.0	0.13778463913546893
chr2	WDR35	19962294	19962327	0	34	1071	7835	1071	7801	0.0	0.13729009101397258
chr2	MATN3	20003160	20003286	0	127	0	3159	0	3032	0.0	0.0
chr2	SDC1	20223202	20223278	0	77	20444	2932	20444	2855	0.0	7.16077057793345
chr2	PUM2	20278582	20278819	0	238	230963	6889	230963	6651	0.0	34.726056232145545
chr2	PUM2	20311493	20311663	0	171	230963	6889	230963	6718	0.0	34.379726108961
chr2	PUM2	20318536	20318645	0	110	230963	6889	230963	6779	0.0	34.070364360525154
chr2	PUM2	20326260	20326385	0	126	230963	6889	230963	6763	0.0	34.15096850510129
chr2	HS1BP3	20640972	20641180	0	209	51	10915	51	10706	0.0	0.0047636839155613675
chr2	HS1BP3	20645339	20645505	0	167	51	10915	51	10748	0.0	0.004745068850018608
chr2	LDAH	20739970	20740205	0	236	2707	3421	2707	3185	0.0	0.8499215070643642
chr2	LDAH	20801291	20801465	0	175	2707	3421	2707	3246	0.0	0.8339494762784966
chr2	LDAH	20790254	20790398	0	145	2707	3421	2707	3276	0.0	0.8263125763125763
chr2	LDAH	20801309	20801465	0	157	2707	3421	2707	3264	0.0	0.8293504901960784
chr2	APOB	21016438	21016649	0	212	306	14858	306	14646	0.0	0.020893076607947564
chr2	APOB	21037957	21038111	0	155	306	14858	306	14703	0.0	0.020812079167516834
chr2	AC009411.1	21639172	21639298	0	127	0	1365	0	1238	0.0	0.0
chr2	LINC01822	21692835	21692994	0	160	51	2303	51	2143	0.0	0.02379841343910406
chr2	LINC01822	21692835	21692999	0	165	51	2303	51	2138	0.0	0.023854069223573433
chr2	AC096570.1	21946340	21946554	0	215	14	5616	14	5401	0.0	0.0025921125717459728
chr2	AC096570.1	21964552	21964613	0	62	14	5616	14	5554	0.0	0.0025207057976233344
chr2	AC096570.1	22530123	22530353	14	231	14	5616	0	5385	0.06060606060606061	0.0
chr2	AC018467.1	23030541	23030660	0	120	0	1777	0	1657	0.0	0.0
chr2	AC018467.1	23166734	23166963	0	230	0	1777	0	1547	0.0	0.0
chr2	AC018467.1	23077819	23077917	0	99	0	1777	0	1678	0.0	0.0
chr2	AC012506.4	23376237	23376329	0	93	0	757	0	664	0.0	0.0
chr2	AC012506.4	23380123	23380241	0	119	0	757	0	638	0.0	0.0
chr2	ATAD2B	23883593	23883635	0	43	765	10538	765	10495	0.0	0.07289185326345879
chr2	WDCP	24032828	24032946	0	119	205	3875	205	3756	0.0	0.05457933972310969
chr2	TP53I3	24079443	24079640	0	198	1805	2318	1805	2120	0.0	0.8514150943396226
chr2	PFN4	24122418	24122547	0	130	51	1611	51	1481	0.0	0.03443619176232275
chr2	PFN4	24122751	24122833	0	83	51	1611	51	1528	0.0	0.03337696335078534
chr2	ITSN2	24209099	24209221	1020	123	81340	11889	80320	11766	8.292682926829269	6.826449090600034
chr2	ITSN2	24284762	24284843	0	82	81340	11889	81340	11807	0.0	6.88913356483442
chr2	ITSN2	24206243	24206275	0	33	81340	11889	81340	11856	0.0	6.860661268556005
chr2	ITSN2	24308877	24308952	0	76	81340	11889	81340	11813	0.0	6.885634470498603
chr2	ADCY3	24872569	24872719	0	151	0	5388	0	5237	0.0	0.0
chr2	ADCY3	24838846	24838912	0	67	0	5388	0	5321	0.0	0.0
chr2	ADCY3	24820383	24820451	0	69	0	5388	0	5319	0.0	0.0
chr2	DNAJC27	24951393	24951554	0	162	0	5634	0	5472	0.0	0.0
chr2	DNAJC27	24953549	24953635	0	87	0	5634	0	5547	0.0	0.0
chr2	DNAJC27	24958546	24958601	0	56	0	5634	0	5578	0.0	0.0
chr2	POMC	25165635	25165685	0	51	884	1542	884	1491	0.0	0.5928906773977196
chr2	DNMT3A	25236935	25237005	0	71	3668	12088	3668	12017	0.0	0.30523425147707417
chr2	DNMT3A	25240301	25240450	0	150	3668	12088	3668	11938	0.0	0.30725414642318644
chr2	DNMT3A	25241561	25241707	0	147	3668	12088	3668	11941	0.0	0.3071769533539905
chr2	DNMT3A	25249656	25249724	0	69	3668	12088	3668	12019	0.0	0.3051834595224228
chr2	DNMT3A	25239314	25239513	0	200	3668	12088	3668	11888	0.0	0.3085464333781965
chr2	DTNB	25419514	25419535	0	22	45021	7172	45021	7150	0.0	6.296643356643357
chr2	DTNB	25455404	25455494	1602	91	45021	7172	43419	7081	17.604395604395606	6.131761050699054
chr2	DTNB	25596085	25596240	0	156	45021	7172	45021	7016	0.0	6.416904218928164
chr2	DTNB	25607235	25607321	0	87	45021	7172	45021	7085	0.0	6.354410726887791
chr2	DTNB	25639013	25639094	591	82	45021	7172	44430	7090	7.2073170731707314	6.266572637517631
chr2	DTNB	25383835	25383889	0	55	45021	7172	45021	7117	0.0	6.325839539131657
chr2	DTNB	25387288	25387378	0	91	45021	7172	45021	7081	0.0	6.358000282445982
chr2	DTNB	25628170	25628384	0	215	45021	7172	45021	6957	0.0	6.4713238464855545
chr2	KIF3C	25938234	25938348	0	115	3757	6411	3757	6296	0.0	0.5967280813214739
chr2	KIF3C	25934032	25934156	0	125	3757	6411	3757	6286	0.0	0.5976773783009863
chr2	HADHA	26232159	26232279	0	121	6003	4348	6003	4227	0.0	1.4201561391057487
chr2	HADHA	26236854	26236988	0	135	6003	4348	6003	4213	0.0	1.424875385710895
chr2	HADHA	26199242	26199366	0	125	6003	4348	6003	4223	0.0	1.4215013023916647
chr2	HADHA	26210694	26210814	0	121	6003	4348	6003	4227	0.0	1.4201561391057487
chr2	HADHA	26210544	26210814	0	271	6003	4348	6003	4077	0.0	1.4724061810154525
chr2	OTOF	26460007	26460205	0	199	157790	8072	157790	7873	0.0	20.041915407087515
chr2	MAPRE3-AS1	26986660	26986770	0	111	1708	2446	1708	2335	0.0	0.7314775160599571
chr2	CGREF1	27102359	27102430	0	72	0	3355	0	3283	0.0	0.0
chr2	CGREF1	27110672	27110968	0	297	0	3355	0	3058	0.0	0.0
chr2	PREB	27132229	27132403	0	175	0	2369	0	2194	0.0	0.0
chr2	PREB	27131671	27131831	0	161	0	2369	0	2208	0.0	0.0
chr2	PREB	27133531	27133721	0	191	0	2369	0	2178	0.0	0.0
chr2	PREB	27133531	27133654	0	124	0	2369	0	2245	0.0	0.0
chr2	PREB	27131673	27131831	0	159	0	2369	0	2210	0.0	0.0
chr2	SLC5A6	27206482	27206534	0	53	0	5118	0	5065	0.0	0.0
chr2	SLC5A6	27208613	27208686	0	74	0	5118	0	5044	0.0	0.0
chr2	SLC5A6	27208393	27208448	0	56	0	5118	0	5062	0.0	0.0
chr2	SLC5A6	27212019	27212146	0	128	0	5118	0	4990	0.0	0.0
chr2	SLC30A3	27257904	27258058	9415	155	249919	5592	240504	5437	60.74193548387097	44.234688247195145
chr2	SLC30A3	27263345	27263459	16839	115	249919	5592	233080	5477	146.42608695652174	42.556143874383785
chr2	SLC30A3	27264009	27264082	37133	74	249919	5592	212786	5518	501.7972972972973	38.562160202972095
chr2	MPV17	27311898	27311951	0	54	91928	4256	91928	4202	0.0	21.877201332698714
chr2	MPV17	27312493	27312589	43	97	91928	4256	91885	4159	0.44329896907216493	22.09305121423419
chr2	MPV17	27312213	27312246	0	34	91928	4256	91928	4222	0.0	21.773567029843676
chr2	MPV17	27312679	27312772	0	94	91928	4256	91928	4162	0.0	22.087457952907258
chr2	MPV17	27316158	27316186	112	29	91928	4256	91816	4227	3.8620689655172415	21.721315353678733
chr2	MPV17	27312993	27313109	0	117	91928	4256	91928	4139	0.0	22.21019569944431
chr2	MPV17	27317077	27317234	0	158	91928	4256	91928	4098	0.0	22.432406051732553
chr2	GTF3C2	27356086	27356186	19093	101	70436	5782	51343	5681	189.03960396039605	9.037669424397114
chr2	GTF3C2	27350313	27350632	0	320	70436	5782	70436	5462	0.0	12.895642621750275
chr2	IFT172	27445744	27445843	16856	100	664046	12448	647190	12348	168.56	52.41253644314869
chr2	IFT172	27449498	27449562	9412	65	664046	12448	654634	12383	144.8	52.86554146814181
chr2	IFT172	27453629	27453739	1612	111	664046	12448	662434	12337	14.522522522522523	53.69490151576559
chr2	IFT172	27476640	27476726	0	87	664046	12448	664046	12361	0.0	53.721058166814984
chr2	IFT172	27484226	27484266	0	41	664046	12448	664046	12407	0.0	53.52188280809221
chr2	IFT172	27486158	27486242	0	85	664046	12448	664046	12363	0.0	53.712367548329695
chr2	IFT172	27445552	27445629	94	78	664046	12448	663952	12370	1.205128205128205	53.67437348423606
chr2	IFT172	27484027	27484106	0	80	664046	12448	664046	12368	0.0	53.690653298835706
chr2	FNDC4	27492665	27492790	0	126	0	1943	0	1817	0.0	0.0
chr2	SUPT7L	27660983	27661388	1189	406	233087	5317	231898	4911	2.9285714285714284	47.22011810221951
chr2	SUPT7L	27660983	27661601	1734	619	233087	5317	231353	4698	2.8012924071082392	49.244997871434656
chr2	RBKS	27869771	27870890	58293	1120	61774	3164	3481	2044	52.04732142857143	1.7030332681017613
chr2	RBKS	27861412	27861546	0	135	61774	3164	61774	3029	0.0	20.394189501485638
chr2	FLJ31356	28387760	28387911	204	152	204	3004	0	2852	1.3421052631578947	0.0
chr2	AC092164.1	28731665	28731737	0	73	0	5024	0	4951	0.0	0.0
chr2	AC092164.1	28731910	28731983	0	74	0	5024	0	4950	0.0	0.0
chr2	TRMT61B	28851071	28851298	0	228	0	2045	0	1817	0.0	0.0
chr2	ALK	29224617	29224678	0	62	255	7416	255	7354	0.0	0.03467500679902094
chr2	CAPN13	30775929	30776045	0	117	3	4978	3	4861	0.0	0.0006171569635877391
chr2	CAPN13	30806180	30806266	0	87	3	4978	3	4891	0.0	0.0006133714986710284
chr2	GALNT14	30966203	30966302	0	100	11580	4371	11580	4271	0.0	2.711308826972606
chr2	GALNT14	30992837	30993007	0	171	11580	4371	11580	4200	0.0	2.757142857142857
chr2	GALNT14	31114742	31114827	0	86	11580	4371	11580	4285	0.0	2.7024504084014
chr2	GALNT14	31125153	31125253	0	101	11580	4371	11580	4270	0.0	2.711943793911007
chr2	GALNT14	31132629	31132712	0	84	11580	4371	11580	4287	0.0	2.701189643107068
chr2	CAPN14	31201861	31201998	0	138	2024	4008	2024	3870	0.0	0.5229974160206718
chr2	MEMO1	31883385	31883462	0	78	0	5233	0	5155	0.0	0.0
chr2	MEMO1	31932066	31932135	0	70	0	5233	0	5163	0.0	0.0
chr2	MEMO1	32010186	32010264	0	79	0	5233	0	5154	0.0	0.0
chr2	DPY30	32023676	32023808	0	133	0	2602	0	2469	0.0	0.0
chr2	NLRC4	32249606	32251601	13931	1996	30209	3799	16278	1803	6.979458917835672	9.028286189683861
chr2	FAM98A	33586561	33586678	4045	118	98276	4926	94231	4808	34.279661016949156	19.598793677204657
chr2	FAM98A	33588334	33588519	19477	186	98276	4926	78799	4740	104.71505376344086	16.624261603375526
chr2	FEZ2	36558437	36558513	0	77	2224	5090	2224	5013	0.0	0.44364651905046876
chr2	FEZ2	36555976	36556060	0	85	2224	5090	2224	5005	0.0	0.44435564435564434
chr2	FEZ2	36581504	36581590	0	87	2224	5090	2224	5003	0.0	0.44453328003198084
chr2	FEZ2	36560784	36560865	0	82	2224	5090	2224	5008	0.0	0.4440894568690096
chr2	FEZ2	36554169	36554262	0	94	2224	5090	2224	4996	0.0	0.44515612489991996
chr2	STRN	36886715	36886826	0	112	110	14334	110	14222	0.0	0.00773449585149768
chr2	EIF2AK2	37126288	37126411	1916	124	21151	6264	19235	6140	15.451612903225806	3.1327361563517915
chr2	SULT6B1	37191220	37191253	0	34	2	1336	2	1302	0.0	0.0015360983102918587
chr2	PRKD3	37260222	37260384	0	163	44391	9554	44391	9391	0.0	4.726972633372378
chr2	PRKD3	37316236	37317179	8516	944	44391	9554	35875	8610	9.021186440677965	4.166666666666667
chr2	PRKD3	37268300	37268372	2005	73	44391	9554	42386	9481	27.465753424657535	4.470625461449214
chr2	LINC00211	37875742	37875883	0	142	10448	3817	10448	3675	0.0	2.8429931972789118
chr2	LINC00211	37871807	37871888	1533	82	10448	3817	8915	3735	18.695121951219512	2.3868808567603748
chr2	RMDN2-AS1	38029854	38029920	0	67	16	3034	16	2967	0.0	0.005392652510953826
chr2	RMDN2-AS1	38030318	38030474	0	157	16	3034	16	2877	0.0	0.005561348627042058
chr2	RMDN2-AS1	38030686	38030825	0	140	16	3034	16	2894	0.0	0.0055286800276434
chr2	ATL2	38343267	38343512	0	246	2840014	5619	2840014	5373	0.0	528.571375395496
chr2	ATL2	38296685	38296700	8388	16	2840014	5619	2831626	5603	524.25	505.3767624486882
chr2	ATL2	38354066	38354177	0	112	2840014	5619	2840014	5507	0.0	515.7098238605412
chr2	ATL2	38358442	38358688	246	247	2840014	5619	2839768	5372	0.9959514170040485	528.6239761727476
chr2	LINC02613	38424421	38424469	0	49	51	5399	51	5350	0.0	0.009532710280373832
chr2	LINC02613	38462902	38462971	0	70	51	5399	51	5329	0.0	0.009570275849127416
chr2	LINC02613	38456318	38456390	0	73	51	5399	51	5326	0.0	0.009575666541494556
chr2	HNRNPLL	38582071	38582173	0	103	3688	5109	3688	5006	0.0	0.7367159408709548
chr2	HNRNPLL	38577919	38578002	0	84	3688	5109	3688	5025	0.0	0.7339303482587065
chr2	SRSF7	38746143	38746179	0	37	51	3873	51	3836	0.0	0.013295099061522419
chr2	SRSF7	38748897	38749346	0	450	51	3873	51	3423	0.0	0.014899211218229623
chr2	SRSF7	38747061	38747130	0	70	51	3873	51	3803	0.0	0.013410465422035235
chr2	SRSF7	38748897	38749173	0	277	51	3873	51	3596	0.0	0.01418242491657397
chr2	DHX57	38806558	38806693	832	136	2164	7002	1332	6866	6.117647058823529	0.1939994174191669
chr2	DHX57	38868181	38868411	0	231	2164	7002	2164	6771	0.0	0.31959828681140157
chr2	SOS1	38989269	38989314	0	46	4312	9674	4312	9628	0.0	0.4478604071458247
chr2	CDKL4	39225838	39225960	0	123	10972	2083	10972	1960	0.0	5.59795918367347
chr2	MAP4K3	39307942	39308005	0	64	18662	6093	18662	6029	0.0	3.095372366893349
chr2	MAP4K3	39378065	39378123	0	59	18662	6093	18662	6034	0.0	3.0928074245939676
chr2	MAP4K3	39303073	39303117	0	45	18662	6093	18662	6048	0.0	3.0856481481481484
chr2	THUMPD2	39757247	39757368	0	122	0	3435	0	3313	0.0	0.0
chr2	THUMPD2	39771504	39771640	0	137	0	3435	0	3298	0.0	0.0
chr2	THUMPD2	39771514	39771640	0	127	0	3435	0	3308	0.0	0.0
chr2	THUMPD2	39768900	39769093	0	194	0	3435	0	3241	0.0	0.0
chr2	SLC8A1	40178386	40178493	0	108	255	21938	255	21830	0.0	0.01168117269812185
chr2	SLC8A1	40174705	40174720	0	16	255	21938	255	21922	0.0	0.011632150351245324
chr2	SLC8A1	40170280	40170349	0	70	255	21938	255	21868	0.0	0.011660874336930674
chr2	SLC8A1	40453160	40453349	0	190	255	21938	255	21748	0.0	0.011725216111826375
chr2	SLC8A1	40446414	40446648	0	235	255	21938	255	21703	0.0	0.011749527715062434
chr2	LINC01914	41932419	41932528	0	110	0	1088	0	978	0.0	0.0
chr2	HAAO	42769712	42769858	0	147	0	2486	0	2339	0.0	0.0
chr2	HAAO	42770492	42770582	0	91	0	2486	0	2395	0.0	0.0
chr2	HAAO	42789007	42789166	0	160	0	2486	0	2326	0.0	0.0
chr2	LINC01819	43032733	43032902	0	170	1358	3848	1358	3678	0.0	0.3692224034801523
chr2	LINC01819	43033229	43033526	0	298	1358	3848	1358	3550	0.0	0.38253521126760565
chr2	LINC01819	43038522	43038599	102	78	1358	3848	1256	3770	1.3076923076923077	0.33315649867374003
chr2	LINC02580	43100319	43100398	0	80	0	3098	0	3018	0.0	0.0
chr2	THADA	43428099	43428231	0	133	1676	14267	1676	14134	0.0	0.11857931229658979
chr2	THADA	43556344	43556555	0	212	1676	14267	1676	14055	0.0	0.1192458199928851
chr2	THADA	43430212	43430302	0	91	1676	14267	1676	14176	0.0	0.11822799097065463
chr2	THADA	43592843	43592890	0	48	1676	14267	1676	14219	0.0	0.1178704550249666
chr2	ABCG5	43824218	43824432	0	215	1885	3732	1885	3517	0.0	0.5359681546772818
chr2	LRPPRC	43890222	43890362	0	141	9894	10068	9894	9927	0.0	0.9966757328498036
chr2	PREPL	44332458	44332656	0	199	153	6296	153	6097	0.0	0.02509430867639823
chr2	PREPL	44338350	44338536	0	187	153	6296	153	6109	0.0	0.02504501555082665
chr2	PREPL	44344519	44344586	0	68	153	6296	153	6228	0.0	0.024566473988439308
chr2	PREPL	44359496	44360038	0	543	153	6296	153	5753	0.0	0.02659482009386407
chr2	PREPL	44359496	44359750	0	255	153	6296	153	6041	0.0	0.025326932627048503
chr2	PREPL	44360618	44360676	0	59	153	6296	153	6237	0.0	0.024531024531024532
chr2	LINC01121	45211600	45211660	0	61	102	4879	102	4818	0.0	0.021170610211706103
chr2	LINC01121	45190882	45191084	0	203	102	4879	102	4676	0.0	0.021813515825491875
chr2	SRBD1	45476992	45477075	0	84	0	5070	0	4986	0.0	0.0
chr2	PIGF	46613693	46613785	41137	93	196039	3770	154902	3677	442.3333333333333	42.12727767201523
chr2	PIGF	46591802	46591925	0	124	196039	3770	196039	3646	0.0	53.76823916620955
chr2	PIGF	46588074	46588179	29902	106	196039	3770	166137	3664	282.0943396226415	45.34306768558952
chr2	MCFD2	46907809	46907969	51	161	51	5539	0	5378	0.3167701863354037	0.0
chr2	MCFD2	46912542	46912658	0	117	51	5539	51	5422	0.0	0.009406123201770564
chr2	MCFD2	46909022	46909177	0	156	51	5539	51	5383	0.0	0.009474270852684376
chr2	MCFD2	46910779	46910873	0	95	51	5539	51	5444	0.0	0.009368111682586333
chr2	CALM2	47162285	47162392	341	108	1950	5477	1609	5369	3.1574074074074074	0.29968336747997765
chr2	CALM2	47172413	47172459	0	47	1950	5477	1950	5430	0.0	0.35911602209944754
chr2	CALM2	47167475	47167690	0	216	1950	5477	1950	5261	0.0	0.3706519673065957
chr2	AC092650.1	48148974	48149108	0	135	12985	8084	12985	7949	0.0	1.6335388099131967
chr2	AC092650.1	48243468	48243619	0	152	12985	8084	12985	7932	0.0	1.637039838628341
chr2	LHCGR	48694223	48694304	0	82	18836	4117	18836	4035	0.0	4.66815365551425
chr2	LHCGR	48729152	48729227	93	76	18836	4117	18743	4041	1.2236842105263157	4.638208364266271
chr2	FSHR	48968697	48968883	16	187	16	3172	0	2985	0.0855614973262032	0.0
chr2	FSHR	48988976	48989054	0	79	16	3172	16	3093	0.0	0.005172971225347559
chr2	FSHR	49014696	49014947	0	252	16	3172	16	2920	0.0	0.005479452054794521
chr2	AC009975.2	49339510	49339574	0	65	286	2105	286	2040	0.0	0.14019607843137255
chr2	NRXN1	50054954	50055044	0	91	0	25608	0	25517	0.0	0.0
chr2	NRXN1	50528624	50528651	0	28	0	25608	0	25580	0.0	0.0
chr2	NRXN1	50621225	50621249	0	25	0	25608	0	25583	0.0	0.0
chr2	NRXN1	50921868	50921880	0	13	0	25608	0	25595	0.0	0.0
chr2	NRXN1	50925937	50925955	0	19	0	25608	0	25589	0.0	0.0
chr2	NRXN1	49926287	49926390	0	104	0	25608	0	25504	0.0	0.0
chr2	NRXN1	50621204	50621249	0	46	0	25608	0	25562	0.0	0.0
chr2	NRXN1	51026370	51026469	0	100	0	25608	0	25508	0.0	0.0
chr2	NRXN1	50185541	50185650	0	110	0	25608	0	25498	0.0	0.0
chr2	NRXN1	50466460	50466487	0	28	0	25608	0	25580	0.0	0.0
chr2	NRXN1	50547469	50547523	0	55	0	25608	0	25553	0.0	0.0
chr2	NRXN1	50624807	50624967	0	161	0	25608	0	25447	0.0	0.0
chr2	NRXN1	50925937	50925952	0	16	0	25608	0	25592	0.0	0.0
chr2	AC010967.1	52723737	52723897	0	161	0	847	0	686	0.0	0.0
chr2	AC010967.1	52732741	52732777	0	37	0	847	0	810	0.0	0.0
chr2	ASB3	53765376	53765585	0	210	109	6051	109	5841	0.0	0.018661188152713577
chr2	PSME4	53869375	53869538	0	164	40532	10440	40532	10276	0.0	3.9443363176333204
chr2	PSME4	53874338	53874494	0	157	40532	10440	40532	10283	0.0	3.9416512690848973
chr2	PSME4	53925538	53925689	0	152	40532	10440	40532	10288	0.0	3.9397356143079314
chr2	RTN4	55025085	55027485	51	2401	57	6380	6	3979	0.0212411495210329	0.0015079165619502387
chr2	RTN4	55028163	55028220	0	58	57	6380	57	6322	0.0	0.009016134134767479
chr2	CLHC1	55181569	55181744	0	176	488813	6648	488813	6472	0.0	75.52734857849197
chr2	CLHC1	55208625	55208710	4093	86	488813	6648	484720	6562	47.593023255813954	73.86772325510515
chr2	CLHC1	55180509	55180712	0	204	488813	6648	488813	6444	0.0	75.85552451893234
chr2	CLHC1	55228031	55228204	0	174	488813	6648	488813	6474	0.0	75.50401606425703
chr2	CLHC1	55222234	55222493	0	260	488813	6648	488813	6388	0.0	76.52050720100188
chr2	MTIF2	55254040	55254201	3488	162	15910	3390	12422	3228	21.530864197530864	3.84820322180917
chr2	MTIF2	55268577	55268739	0	163	15910	3390	15910	3227	0.0	4.9302757979547565
chr2	MTIF2	55266380	55266518	51	139	15910	3390	15859	3251	0.3669064748201439	4.878191325745925
chr2	CCDC88A	55299838	55299919	0	82	11014	27139	11014	27057	0.0	0.4070665631814318
chr2	CCDC88A	55303068	55303152	0	85	11014	27139	11014	27054	0.0	0.40711170252088413
chr2	CCDC88A	55308808	55309023	0	216	11014	27139	11014	26923	0.0	0.40909259740742115
chr2	CCDC88A	55317205	55317349	0	145	11014	27139	11014	26994	0.0	0.40801659628065495
chr2	CCDC88A	55322527	55322692	0	166	11014	27139	11014	26973	0.0	0.408334260186112
chr2	CCDC88A	55339463	55339648	0	186	11014	27139	11014	26953	0.0	0.4086372574481505
chr2	CCDC88A	55349517	55349599	0	83	11014	27139	11014	27056	0.0	0.4070816085156712
chr2	CCDC88A	55355578	55355751	0	174	11014	27139	11014	26965	0.0	0.4084554051548303
chr2	CCDC88A	55362307	55362448	0	142	11014	27139	11014	26997	0.0	0.4079712560654888
chr2	CCDC88A	55301871	55302072	0	202	11014	27139	11014	26937	0.0	0.40887997921075103
chr2	CCDC88A	55317563	55317841	0	279	11014	27139	11014	26860	0.0	0.4100521221146686
chr2	CCDC88A	55299827	55299919	0	93	11014	27139	11014	27046	0.0	0.40723212304961914
chr2	CCDC88A	55300956	55300996	0	41	11014	27139	11014	27098	0.0	0.4064506605653554
chr2	CCDC88A	55300252	55300339	0	88	11014	27139	11014	27051	0.0	0.4071568518723892
chr2	CCDC88A	55363611	55363733	0	123	11014	27139	11014	27016	0.0	0.4076843352087652
chr2	CCDC88A	55363949	55364033	0	85	11014	27139	11014	27054	0.0	0.40711170252088413
chr2	PPP4R3B	55573618	55573777	63	160	3562	8236	3499	8076	0.39375	0.43325903912828134
chr2	PPP4R3B	55578246	55578342	0	97	3562	8236	3562	8139	0.0	0.43764590244501783
chr2	PNPT1	55656304	55656371	0	68	2647	4809	2647	4741	0.0	0.5583210293187091
chr2	EFEMP1	55922898	55922939	0	42	1678	3973	1678	3931	0.0	0.4268633935385398
chr2	EFEMP1	55922609	55922747	0	139	1678	3973	1678	3834	0.0	0.43766301512780387
chr2	EFEMP1	55922609	55922691	0	83	1678	3973	1678	3890	0.0	0.43136246786632393
chr2	EFEMP1	55922570	55922691	0	122	1678	3973	1678	3851	0.0	0.4357309789665022
chr2	EFEMP1	55922570	55922747	0	178	1678	3973	1678	3795	0.0	0.4421607378129117
chr2	AC007743.1	56179602	56180162	0	561	0	4275	0	3714	0.0	0.0
chr2	AC132153.1	57294122	57294218	70	97	121	4556	51	4459	0.7216494845360825	0.011437542049786947
chr2	FANCL	58163433	58163517	0	85	0	2345	0	2260	0.0	0.0
chr2	FANCL	58221941	58222042	0	102	0	2345	0	2243	0.0	0.0
chr2	FANCL	58194228	58194273	0	46	0	2345	0	2299	0.0	0.0
chr2	AC007179.2	59384623	59384793	0	171	0	5116	0	4945	0.0	0.0
chr2	AC007179.2	59249108	59249165	0	58	0	5116	0	5058	0.0	0.0
chr2	AC007179.2	59240920	59241103	0	184	0	5116	0	4932	0.0	0.0
chr2	AC007179.2	59249488	59249693	0	206	0	5116	0	4910	0.0	0.0
chr2	AC007179.2	59240992	59241103	0	112	0	5116	0	5004	0.0	0.0
chr2	AC007179.2	59240289	59240341	0	53	0	5116	0	5063	0.0	0.0
chr2	AC007179.2	59241713	59241821	0	109	0	5116	0	5007	0.0	0.0
chr2	AC007179.2	59322257	59322318	0	62	0	5116	0	5054	0.0	0.0
chr2	BCL11A	60468731	60468833	0	103	0	10714	0	10611	0.0	0.0
chr2	BCL11A	60478163	60478239	0	77	0	10714	0	10637	0.0	0.0
chr2	BCL11A	60460681	60461744	0	1064	0	10714	0	9650	0.0	0.0
chr2	BCL11A	60508605	60508824	0	220	0	10714	0	10494	0.0	0.0
chr2	PUS10	61010655	61010888	0	234	6182	7352	6182	7118	0.0	0.8685023883113234
chr2	AC016747.1	61144168	61144266	0	99	612	3112	612	3013	0.0	0.20311981413873217
chr2	USP34	61214059	61214694	306	636	344255	17149	343949	16513	0.4811320754716981	20.828983225337613
chr2	USP34	61214059	61214278	0	220	344255	17149	344255	16929	0.0	20.335223580837617
chr2	XPO1	61481184	61481281	0	98	11664	18326	11664	18228	0.0	0.6398946675444371
chr2	XPO1	61490641	61490776	0	136	11664	18326	11664	18190	0.0	0.6412314458493678
chr2	XPO1	61501995	61502040	0	46	11664	18326	11664	18280	0.0	0.638074398249453
chr2	XPO1	61520390	61520475	0	86	11664	18326	11664	18240	0.0	0.6394736842105263
chr2	XPO1	61499712	61499894	0	183	11664	18326	11664	18143	0.0	0.6428925756490106
chr2	XPO1	61514061	61514200	0	140	11664	18326	11664	18186	0.0	0.6413724843286044
chr2	XPO1	61529065	61529159	0	95	11664	18326	11664	18231	0.0	0.6397893697548133
chr2	XPO1	61534557	61534678	0	122	11664	18326	11664	18204	0.0	0.6407382992748847
chr2	XPO1	61534557	61534654	0	98	11664	18326	11664	18228	0.0	0.6398946675444371
chr2	XPO1	61502248	61502310	0	63	11664	18326	11664	18263	0.0	0.638668345835843
chr2	XPO1	61537561	61537668	0	108	11664	18326	11664	18218	0.0	0.6402459106378308
chr2	XPO1	61537561	61537587	0	27	11664	18326	11664	18299	0.0	0.6374118804306246
chr2	FAM161A	61838537	61838705	0	169	0	5267	0	5098	0.0	0.0
chr2	FAM161A	61836582	61836872	0	291	0	5267	0	4976	0.0	0.0
chr2	FAM161A	61846758	61846996	0	239	0	5267	0	5028	0.0	0.0
chr2	CCT4	61883458	61883548	0	91	40	2716	40	2625	0.0	0.015238095238095238
chr2	AC018462.1	62137548	62137605	0	58	87321	1846	87321	1788	0.0	48.83724832214765
chr2	AC092155.1	62661894	62661933	0	40	156	7620	156	7580	0.0	0.02058047493403694
chr2	AC092155.1	62624952	62625011	54	60	156	7620	102	7560	0.9	0.013492063492063493
chr2	AC092155.1	62613605	62613702	0	98	156	7620	156	7522	0.0	0.020739165115660728
chr2	AC092155.1	62629352	62629476	0	125	156	7620	156	7495	0.0	0.020813875917278186
chr2	AC092155.1	62625126	62625220	0	95	156	7620	156	7525	0.0	0.02073089700996678
chr2	AC092155.1	62629352	62629460	0	109	156	7620	156	7511	0.0	0.02076953801091732
chr2	AC092155.1	62625126	62625143	0	18	156	7620	156	7602	0.0	0.020520915548539857
chr2	AC092155.1	62629352	62629444	0	93	156	7620	156	7527	0.0	0.02072538860103627
chr2	AC007098.1	63046036	63046141	0	106	153	3322	153	3216	0.0	0.04757462686567164
chr2	WDPCP	63259306	63259409	0	104	2414	12791	2414	12687	0.0	0.19027350831559864
chr2	WDPCP	63486541	63486586	0	46	2414	12791	2414	12745	0.0	0.1894076108277756
chr2	WDPCP	63571374	63571626	0	253	2414	12791	2414	12538	0.0	0.19253469452863295
chr2	WDPCP	63711496	63711591	0	96	2414	12791	2414	12695	0.0	0.19015360378101615
chr2	VPS54	63947382	63947490	0	109	101	5472	101	5363	0.0	0.018832742867797875
chr2	VPS54	63913824	63913925	0	102	101	5472	101	5370	0.0	0.018808193668528865
chr2	LINC00309	64192355	64192458	51	104	1530	2798	1479	2694	0.49038461538461536	0.5489977728285078
chr2	RAB1A	65097970	65098066	0	97	714	3321	714	3224	0.0	0.22146401985111663
chr2	RAB1A	65090982	65091078	0	97	714	3321	714	3224	0.0	0.22146401985111663
chr2	SPRED2	65316733	65316883	3586	151	781241	5516	777655	5365	23.748344370860927	144.94967381174277
chr2	SPRED2	65334114	65334265	0	152	781241	5516	781241	5364	0.0	145.6452274422073
chr2	AC012370.2	65450232	65450759	498	528	4810	2484	4312	1956	0.9431818181818182	2.2044989775051125
chr2	AC012370.2	65450475	65450759	327	285	4810	2484	4483	2199	1.1473684210526316	2.0386539336061844
chr2	AC012370.2	65453882	65453982	612	101	4810	2484	4198	2383	6.0594059405940595	1.761644985312631
chr2	AC012370.2	65456018	65456096	102	79	4810	2484	4708	2405	1.2911392405063291	1.9575883575883577
chr2	LINC01797	66699910	66700108	0	199	0	1886	0	1687	0.0	0.0
chr2	LINC01797	66699910	66700394	0	485	0	1886	0	1401	0.0	0.0
chr2	C1D	68053060	68053286	0	227	0	3571	0	3344	0.0	0.0
chr2	GFPT1	69328270	69328438	0	169	14122	8872	14122	8703	0.0	1.6226588532689876
chr2	GFPT1	69354258	69354312	0	55	14122	8872	14122	8817	0.0	1.601678575479188
chr2	GFPT1	69371309	69371472	408	164	14122	8872	13714	8708	2.4878048780487805	1.574873679375287
chr2	NFU1	69400363	69400538	0	176	594	1756	594	1580	0.0	0.3759493670886076
chr2	NFU1	69399238	69399382	0	145	594	1756	594	1611	0.0	0.3687150837988827
chr2	NFU1	69423581	69423717	562	137	594	1756	32	1619	4.102189781021898	0.019765287214329835
chr2	NFU1	69429903	69430021	0	119	594	1756	594	1637	0.0	0.3628588882101405
chr2	AAK1	69495984	69496080	0	97	788333	21266	788333	21169	0.0	37.239973546223254
chr2	PCBP1-AS1	69964230	69964427	0	198	332385	25966	332385	25768	0.0	12.89913846631481
chr2	PCBP1-AS1	69988741	69988838	160	98	332385	25966	332225	25868	1.6326530612244898	12.843087985155405
chr2	PCBP1-AS1	69996685	69996888	180	204	332385	25966	332205	25762	0.8823529411764706	12.8951556556168
chr2	PCBP1-AS1	70032132	70032255	0	124	332385	25966	332385	25842	0.0	12.86220106802879
chr2	PCBP1-AS1	70081369	70081490	129	122	332385	25966	332256	25844	1.0573770491803278	12.856214208326884
chr2	PCBP1-AS1	69988445	69988505	0	61	332385	25966	332385	25905	0.0	12.830920671685003
chr2	PCBP1-AS1	70011654	70011718	0	65	332385	25966	332385	25901	0.0	12.832902204548088
chr2	PCBP1-AS1	70059642	70059680	0	39	332385	25966	332385	25927	0.0	12.820033170054383
chr2	PCBP1-AS1	70051202	70051305	366	104	332385	25966	332019	25862	3.519230769230769	12.838102234939294
chr2	PCBP1-AS1	69975558	69975635	0	78	332385	25966	332385	25888	0.0	12.839346415327565
chr2	PCBP1-AS1	70015447	70015517	0	71	332385	25966	332385	25895	0.0	12.835875651670207
chr2	PCBP1-AS1	69968398	69968520	0	123	332385	25966	332385	25843	0.0	12.8617033626127
chr2	PCBP1-AS1	70018014	70018131	0	118	332385	25966	332385	25848	0.0	12.859215413184772
chr2	PCBP1-AS1	70083506	70083687	0	182	332385	25966	332385	25784	0.0	12.891134036611852
chr2	PCBP1-AS1	70053730	70053792	0	63	332385	25966	332385	25903	0.0	12.831911361618346
chr2	PCBP1-AS1	70015447	70015580	16	134	332385	25966	332369	25832	0.11940298507462686	12.866560854753795
chr2	PCBP1-AS1	70011654	70011834	0	181	332385	25966	332385	25785	0.0	12.89063408958697
chr2	PCBP1-AS1	70055713	70055910	0	198	332385	25966	332385	25768	0.0	12.89913846631481
chr2	PCBP1-AS1	70011654	70011752	0	99	332385	25966	332385	25867	0.0	12.849769977191016
chr2	PCBP1-AS1	69964368	69964427	0	60	332385	25966	332385	25906	0.0	12.830425384080907
chr2	PCBP1-AS1	69996857	69996888	0	32	332385	25966	332385	25934	0.0	12.816572838744506
chr2	PCBP1-AS1	70083537	70083687	0	151	332385	25966	332385	25815	0.0	12.875653689715282
chr2	PCBP1-AS1	70055655	70055910	0	256	332385	25966	332385	25710	0.0	12.928238039673278
chr2	PCBP1-AS1	70003045	70003315	0	271	332385	25966	332385	25695	0.0	12.935785172212492
chr2	PCBP1-AS1	70077300	70077381	102	82	332385	25966	332283	25884	1.2439024390243902	12.837389893370421
chr2	PCBP1-AS1	69975348	69975461	0	114	332385	25966	332385	25852	0.0	12.857225746557326
chr2	PCBP1-AS1	69997912	69998134	0	223	332385	25966	332385	25743	0.0	12.911665307073768
chr2	PCBP1-AS1	70085815	70085903	0	89	332385	25966	332385	25877	0.0	12.8448042663369
chr2	PCBP1-AS1	70053730	70053812	0	83	332385	25966	332385	25883	0.0	12.841826681605687
chr2	PCBP1-AS1	70053730	70053815	0	86	332385	25966	332385	25880	0.0	12.843315301391035
chr2	PCBP1-AS1	70052619	70052800	149932	182	332385	25966	182453	25784	823.8021978021978	7.076210052745889
chr2	PCBP1-AS1	70053730	70053994	0	265	332385	25966	332385	25701	0.0	12.93276526205206
chr2	PCBP1-AS1	70085815	70085930	0	116	332385	25966	332385	25850	0.0	12.858220502901354
chr2	C2ORF42	70182666	70182935	0	270	3172	3521	3172	3251	0.0	0.9756997846816364
chr2	C2ORF42	70190542	70190715	18	174	3172	3521	3154	3347	0.10344827586206896	0.9423364206752316
chr2	TIA1	70229058	70229091	0	34	4038	6250	4038	6216	0.0	0.6496138996138996
chr2	TIA1	70225327	70225393	0	67	4038	6250	4038	6183	0.0	0.6530810286268801
chr2	TIA1	70228343	70228462	0	120	4038	6250	4038	6130	0.0	0.6587275693311583
chr2	SNRPG	70289349	70289372	0	24	1223	1396	1223	1372	0.0	0.891399416909621
chr2	SNRPG	70287264	70287371	306	108	1223	1396	917	1288	2.8333333333333335	0.7119565217391305
chr2	FAM136A	70301407	70301603	0	197	1224	3023	1224	2826	0.0	0.43312101910828027
chr2	TGFA	70451728	70451760	9385	33	50707	2892	41322	2859	284.3939393939394	14.45330535152151
chr2	ADD2	70713065	70713184	0	120	614	12701	614	12581	0.0	0.048803751689054924
chr2	ADD2	70673240	70673326	78	87	614	12701	536	12614	0.896551724137931	0.04249246868558744
chr2	ADD2	70741340	70741406	0	67	614	12701	614	12634	0.0	0.04859901852145006
chr2	TEX261	70991829	70991983	0	155	0	4189	0	4034	0.0	0.0
chr2	ATP6V1B1-AS1	70947533	70947671	0	139	0	1142	0	1003	0.0	0.0
chr2	MCEE	71129716	71129817	58	102	1027	1469	969	1367	0.5686274509803921	0.7088514996342355
chr2	CYP26B1	72143988	72144213	0	226	0	5022	0	4796	0.0	0.0
chr2	EXOC6B	72480615	72480750	0	136	51	10224	51	10088	0.0	0.005055511498810468
chr2	EXOC6B	72741303	72741469	0	167	51	10224	51	10057	0.0	0.005071094759868748
chr2	EXOC6B	72182893	72182905	0	13	51	10224	51	10211	0.0	0.004994613651943982
chr2	SFXN5	72961130	72961248	0	119	4851	11003	4851	10884	0.0	0.44570011025358325
chr2	SFXN5	72971569	72971685	0	117	4851	11003	4851	10886	0.0	0.4456182252434319
chr2	SFXN5	73022521	73022576	2	56	4851	11003	4849	10947	0.03571428571428571	0.44295240705216044
chr2	SFXN5	73041606	73041661	0	56	4851	11003	4851	10947	0.0	0.44313510550835844
chr2	RAB11FIP5	73079650	73081663	51	2014	0	5513	-51	3499	0.0253227408142999	-0.014575593026579023
chr2	PRADC1	73228794	73228962	0	169	1745	1409	1745	1240	0.0	1.407258064516129
chr2	TPRKB	73734527	73734591	0	65	2448	2011	2448	1946	0.0	1.2579650565262077
chr2	TPRKB	73734428	73734591	0	164	2448	2011	2448	1847	0.0	1.325392528424472
chr2	TPRKB	73732583	73732700	0	118	2448	2011	2448	1893	0.0	1.2931854199683044
chr2	TPRKB	73734527	73734588	0	62	2448	2011	2448	1949	0.0	1.2560287326834274
chr2	DUSP11	73766417	73766594	0	178	1530	3556	1530	3378	0.0	0.45293072824156305
chr2	BOLA3	74142271	74142360	0	90	11898	1750	11898	1660	0.0	7.167469879518072
chr2	SLC4A5	74222867	74222952	0	86	18463	6641	18463	6555	0.0	2.8166285278413423
chr2	SLC4A5	74224839	74225011	0	173	18463	6641	18463	6468	0.0	2.8545145330859616
chr2	SLC4A5	74227516	74227564	0	49	18463	6641	18463	6592	0.0	2.8008191747572817
chr2	SLC4A5	74232468	74232647	0	180	18463	6641	18463	6461	0.0	2.8576071815508435
chr2	SLC4A5	74235100	74235214	0	115	18463	6641	18463	6526	0.0	2.8291449586270305
chr2	SLC4A5	74304488	74304680	816	193	18463	6641	17647	6448	4.227979274611399	2.736817617866005
chr2	SLC4A5	74328119	74328186	163	68	18463	6641	18300	6573	2.3970588235294117	2.784116841624829
chr2	SLC4A5	74224839	74224995	0	157	18463	6641	18463	6484	0.0	2.847470697100555
chr2	SLC4A5	74314944	74315025	4538	82	18463	6641	13925	6559	55.34146341463415	2.1230370483305383
chr2	DCTN1	74363613	74363628	14	16	173698	9854	173684	9838	0.875	17.654401301077456
chr2	DCTN1	74366458	74366620	0	163	173698	9854	173698	9691	0.0	17.92364049117738
chr2	DCTN1	74376741	74376762	381	22	173698	9854	173317	9832	17.318181818181817	17.627847843775427
chr2	DCTN1	74390582	74390728	0	147	173698	9854	173698	9707	0.0	17.894097043370763
chr2	DCTN1	74378904	74378972	0	69	173698	9854	173698	9785	0.0	17.75145631067961
chr2	DCTN1	74383742	74383806	5114	65	173698	9854	168584	9789	78.67692307692307	17.221779548472774
chr2	RTKN	74439550	74439977	2447	428	327827	4493	325380	4065	5.7172897196261685	80.04428044280442
chr2	MOGS	74464495	74464722	0	228	1581	3170	1581	2942	0.0	0.5373895309313392
chr2	MOGS	74463189	74463219	0	31	1581	3170	1581	3139	0.0	0.5036635871296591
chr2	MOGS	74464895	74464987	0	93	1581	3170	1581	3077	0.0	0.5138121546961326
chr2	MOGS	74464665	74464722	0	58	1581	3170	1581	3112	0.0	0.5080334190231363
chr2	MRPL53	74472357	74472470	51	114	2906	687	2855	573	0.4473684210526316	4.982547993019197
chr2	DQX1	74525492	74525748	0	257	1278	2764	1278	2507	0.0	0.5097726366174711
chr2	DQX1	74525008	74525202	0	195	1278	2764	1278	2569	0.0	0.4974698326196964
chr2	LOXL3	74535587	74535755	0	169	2915	4535	2915	4366	0.0	0.6676591846083372
chr2	LOXL3	74536708	74536928	0	221	2915	4535	2915	4314	0.0	0.6757070004636069
chr2	M1AP	74559697	74559709	0	13	7353	3014	7353	3001	0.0	2.450183272242586
chr2	M1AP	74607054	74607223	0	170	7353	3014	7353	2844	0.0	2.5854430379746836
chr2	M1AP	74614963	74615149	550	187	7353	3014	6803	2827	2.9411764705882355	2.406437920056597
chr2	EVA1A	75522364	75522487	0	124	0	2756	0	2632	0.0	0.0
chr2	EVA1A	75526111	75526199	0	89	0	2756	0	2667	0.0	0.0
chr2	GCFC2	75665928	75666053	0	126	51	5480	51	5354	0.0	0.009525588345162496
chr2	GCFC2	75680192	75680314	0	123	51	5480	51	5357	0.0	0.009520253873436624
chr2	GCFC2	75691976	75692100	0	125	51	5480	51	5355	0.0	0.009523809523809525
chr2	GCFC2	75696199	75696315	0	117	51	5480	51	5363	0.0	0.009509602834234571
chr2	GCFC2	75702198	75702423	0	226	51	5480	51	5254	0.0	0.009706889988580129
chr2	GCFC2	75702312	75702423	0	112	51	5480	51	5368	0.0	0.009500745156482861
chr2	LRRTM4	77521667	77521818	0	152	153	5416	153	5264	0.0	0.029065349544072947
chr2	LRRTM4	77521667	77521748	0	82	153	5416	153	5334	0.0	0.028683914510686165
chr2	CTNNA2-AS1	79499176	79499242	0	67	0	2074	0	2007	0.0	0.0
chr2	LRRTM1	80303995	80304013	38	19	66	4963	28	4944	2.0	0.0056634304207119745
chr2	AC008067.1	80605160	80605307	0	148	0	3369	0	3221	0.0	0.0
chr2	LINC01815	81461696	81461752	0	57	0	1379	0	1322	0.0	0.0
chr2	SUCLG1	84436051	84436127	0	77	0	4176	0	4099	0.0	0.0
chr2	SUCLG1	84448928	84448947	0	20	0	4176	0	4156	0.0	0.0
chr2	TRABD2A	84841860	84842007	0	148	196	8785	196	8637	0.0	0.022693064721546835
chr2	RETSAT	85343998	85344165	0	168	102	4060	102	3892	0.0	0.026207605344295993
chr2	RETSAT	85351679	85351862	0	184	102	4060	102	3876	0.0	0.02631578947368421
chr2	CAPG	85413142	85413244	9	103	9	2163	0	2060	0.08737864077669903	0.0
chr2	GGCX	85560814	85560985	0	172	1439744	6215	1439744	6043	0.0	238.24987588945888
chr2	TMEM150A	85600344	85600412	0	69	5604	2915	5604	2846	0.0	1.9690794096978215
chr2	TMEM150A	85600499	85600759	408	261	5604	2915	5196	2654	1.5632183908045978	1.9577995478522985
chr2	ST3GAL5	85844395	85844554	750	160	136363	15937	135613	15777	4.6875	8.595613868289282
chr2	ST3GAL5	85847860	85848204	0	345	136363	15937	136363	15592	0.0	8.745702924576706
chr2	ST3GAL5	85861180	85861292	0	113	136363	15937	136363	15824	0.0	8.617479777553084
chr2	ST3GAL5	85863361	85863485	0	125	136363	15937	136363	15812	0.0	8.624019731849229
chr2	ST3GAL5	85847381	85847562	0	182	136363	15937	136363	15755	0.0	8.655220564900032
chr2	ST3GAL5	85846376	85846563	8533	188	136363	15937	127830	15749	45.388297872340424	8.11670582259191
chr2	ST3GAL5	85851263	85851703	0	441	136363	15937	136363	15496	0.0	8.799883840991223
chr2	ST3GAL5	85852859	85853000	0	142	136363	15937	136363	15795	0.0	8.633301677746122
chr2	ST3GAL5	85847860	85848084	0	225	136363	15937	136363	15712	0.0	8.67890784114053
chr2	ST3GAL5	85870071	85870258	0	188	136363	15937	136363	15749	0.0	8.65851800114293
chr2	ST3GAL5	85858133	85858247	0	115	136363	15937	136363	15822	0.0	8.618569081026418
chr2	ST3GAL5	85846376	85846424	8176	49	136363	15937	128187	15888	166.85714285714286	8.068164652567976
chr2	ST3GAL5	85847860	85848381	102	522	136363	15937	136261	15415	0.19540229885057472	8.83950697372689
chr2	ST3GAL5	85867844	85868058	0	215	136363	15937	136363	15722	0.0	8.673387609718866
chr2	ST3GAL5	85852859	85853091	0	233	136363	15937	136363	15704	0.0	8.683329088130412
chr2	ST3GAL5	85844395	85844521	750	127	136363	15937	135613	15810	5.905511811023622	8.577672359266288
chr2	ST3GAL5	85875414	85875545	33	132	136363	15937	136330	15805	0.25	8.625751344511231
chr2	ST3GAL5	85852859	85853099	0	241	136363	15937	136363	15696	0.0	8.687754841997961
chr2	ST3GAL5	85852859	85853097	0	239	136363	15937	136363	15698	0.0	8.686647980634476
chr2	POLR1A	86088784	86088870	0	87	10177	13555	10177	13468	0.0	0.7556430056430057
chr2	IMMT	86170748	86170841	0	94	198	3687	198	3593	0.0	0.055107152797105485
chr2	IMMT	86171207	86171312	0	106	198	3687	198	3581	0.0	0.05529181792795308
chr2	IMMT	86170748	86170844	0	97	198	3687	198	3590	0.0	0.05515320334261838
chr2	IMMT	86171207	86171345	0	139	198	3687	198	3548	0.0	0.05580608793686584
chr2	REEP1	86227362	86227398	0	37	61762	5860	61762	5823	0.0	10.606560192340718
chr2	REEP1	86282169	86282242	0	74	61762	5860	61762	5786	0.0	10.67438645005185
chr2	REEP1	86240020	86240071	0	52	61762	5860	61762	5808	0.0	10.633953168044076
chr2	REEP1	86219969	86220121	0	153	61762	5860	61762	5707	0.0	10.822148239004731
chr2	REEP1	86239921	86240071	0	151	61762	5860	61762	5709	0.0	10.81835698020669
chr2	CHMP3	86542251	86542312	0	62	510	7030	510	6968	0.0	0.07319173363949483
chr2	CD8A	86789322	86789433	0	112	24126	3058	24126	2946	0.0	8.189409368635438
chr2	CD8A	86789639	86789750	107	112	24126	3058	24019	2946	0.9553571428571429	8.153088934147997
chr2	CD8B	86822320	86822374	0	55	34825	5288	34825	5233	0.0	6.654882476590866
chr2	CD8B	86846683	86846773	102	91	34825	5288	34723	5197	1.120879120879121	6.681354627669809
chr2	CD8B	86844921	86844958	0	38	34825	5288	34825	5250	0.0	6.633333333333334
chr2	EIF2AK3	88593912	88594108	0	197	0	5207	0	5010	0.0	0.0
chr2	MALLP2	88814307	88814430	0	124	0	1025	0	901	0.0	0.0
chr2	LSP1P5	89580557	89580635	0	79	0	2420	0	2341	0.0	0.0
chr2	AC026273.1	94196572	94196720	0	149	0	1450	0	1301	0.0	0.0
chr2	MRPS5	95104639	95104730	0	92	0	8383	0	8291	0.0	0.0
chr2	LINC00342	95813315	95813957	73058	643	277274	7663	204216	7020	113.62052877138413	29.09059829059829
chr2	LINC00342	95814670	95814791	10098	122	277274	7663	267176	7541	82.77049180327869	35.42978384829598
chr2	ANKRD36C	95867439	95867581	0	143	9217	8656	9217	8513	0.0	1.0826970515681897
chr2	ANKRD36C	95938828	95938901	390	74	9217	8656	8827	8582	5.27027027027027	1.0285481239804242
chr2	GPAT2	96026696	96026909	0	214	3442	5194	3442	4980	0.0	0.6911646586345381
chr2	NEURL3	96499189	96499274	60	86	4641	2501	4581	2415	0.6976744186046512	1.8968944099378882
chr2	NEURL3	96504530	96504709	630	180	4641	2501	4011	2321	3.5	1.7281344248168893
chr2	KANSL3	96602115	96602338	153	224	12010	9053	11857	8829	0.6830357142857143	1.3429606977007589
chr2	KANSL3	96619671	96619762	349	92	12010	9053	11661	8961	3.7934782608695654	1.3013056578506863
chr2	KANSL3	96615491	96615544	0	54	12010	9053	12010	8999	0.0	1.3345927325258362
chr2	KANSL3	96606969	96607047	0	79	12010	9053	12010	8974	0.0	1.3383106752841543
chr2	KANSL3	96598080	96598160	0	81	12010	9053	12010	8972	0.0	1.338609005795809
chr2	KANSL3	96619358	96619544	0	187	12010	9053	12010	8866	0.0	1.3546131288066772
chr2	KANSL3	96634148	96634178	0	31	12010	9053	12010	9022	0.0	1.3311904234094436
chr2	KANSL3	96631311	96631482	0	172	12010	9053	12010	8881	0.0	1.3523251886048868
chr2	LMAN2L	96733518	96733601	0	84	153	2719	153	2635	0.0	0.05806451612903226
chr2	LMAN2L	96737948	96738067	0	120	153	2719	153	2599	0.0	0.05886879569065025
chr2	LMAN2L	96737136	96737217	0	82	153	2719	153	2637	0.0	0.05802047781569966
chr2	LMAN2L	96713106	96713139	0	34	153	2719	153	2685	0.0	0.05698324022346369
chr2	ANKRD23	96840826	96840912	0	87	507	3843	507	3756	0.0	0.13498402555910544
chr2	ANKRD23	96840786	96840912	0	127	507	3843	507	3716	0.0	0.13643702906350916
chr2	FAHD2B	97091461	97091712	0	252	0	2630	0	2378	0.0	0.0
chr2	FAHD2B	97091862	97091988	0	127	0	2630	0	2503	0.0	0.0
chr2	AC092683.1	97422954	97423084	0	131	61622	5579	61622	5448	0.0	11.310939794419971
chr2	AC092683.1	97423801	97423918	0	118	61622	5579	61622	5461	0.0	11.284013916865042
chr2	AC092683.1	97423788	97423918	0	131	61622	5579	61622	5448	0.0	11.310939794419971
chr2	AC092683.1	97422438	97422659	0	222	61622	5579	61622	5357	0.0	11.503080082135524
chr2	AC092683.1	97424294	97424405	0	112	61622	5579	61622	5467	0.0	11.271629778672033
chr2	ANKRD36B	97576378	97576446	0	69	33293	6818	33293	6749	0.0	4.9330271151281675
chr2	TMEM131	97794929	97795115	102	187	31947	11049	31845	10862	0.5454545454545454	2.931780519241392
chr2	TMEM131	97818612	97818721	0	110	31947	11049	31947	10939	0.0	2.920468050095987
chr2	AC092675.1	98333440	98333503	0	64	0	1169	0	1105	0.0	0.0
chr2	CRACDL	98832861	98832997	0	137	0	4720	0	4583	0.0	0.0
chr2	CRACDL	98897376	98897481	0	106	0	4720	0	4614	0.0	0.0
chr2	TSGA10	99020279	99020482	0	204	5321	5121	5321	4917	0.0	1.0821639210900955
chr2	TSGA10	99035229	99035439	0	211	5321	5121	5321	4910	0.0	1.0837067209775968
chr2	TSGA10	99073017	99073073	84	57	5321	5121	5237	5064	1.4736842105263157	1.0341627172195893
chr2	TSGA10	99078658	99078813	102	156	5321	5121	5219	4965	0.6538461538461539	1.0511581067472306
chr2	TSGA10	99118550	99118686	0	137	5321	5121	5321	4984	0.0	1.0676163723916532
chr2	TSGA10	99117543	99117759	51	217	5321	5121	5270	4904	0.2350230414746544	1.0746329526916802
chr2	TSGA10	99127047	99127176	0	130	5321	5121	5321	4991	0.0	1.066119014225606
chr2	MITD1	99171342	99171429	0	88	24944	2343	24944	2255	0.0	11.061640798226165
chr2	MITD1	99173413	99173502	748	90	24944	2343	24196	2253	8.311111111111112	10.739458499778074
chr2	LYG2	99243411	99243472	0	62	2990	1214	2990	1152	0.0	2.595486111111111
chr2	TXNDC9	99327534	99327653	0	120	834	2824	834	2704	0.0	0.3084319526627219
chr2	TXNDC9	99322560	99322659	0	100	834	2824	834	2724	0.0	0.30616740088105726
chr2	REV1	99451344	99451501	0	158	7077	7767	7077	7609	0.0	0.9300827966881324
chr2	AFF3	99580600	99580728	0	129	17943	15102	17943	14973	0.0	1.1983570426768182
chr2	AFF3	100011496	100011571	0	76	17943	15102	17943	15026	0.0	1.194130174364435
chr2	AFF3	100105503	100105583	66	81	17943	15102	17877	15021	0.8148148148148148	1.190133812662273
chr2	AFF3	100129223	100129306	14	84	17943	15102	17929	15018	0.16666666666666666	1.1938340657877213
chr2	AFF3	100112385	100112524	0	140	17943	15102	17943	14962	0.0	1.1992380697767677
chr2	CHST10	100402563	100402655	0	93	0	4387	0	4294	0.0	0.0
chr2	CHST10	100408542	100408660	0	119	0	4387	0	4268	0.0	0.0
chr2	CHST10	100416222	100416525	0	304	0	4387	0	4083	0.0	0.0
chr2	CHST10	100416722	100417070	0	349	0	4387	0	4038	0.0	0.0
chr2	NPAS2-AS1	100975532	100975668	0	137	51	2117	51	1980	0.0	0.025757575757575757
chr2	TBC1D8	101191300	101191458	51	159	27861	6443	27810	6284	0.32075471698113206	4.425525143220878
chr2	RFX8	101414853	101414912	0	60	0	3282	0	3222	0.0	0.0
chr2	RFX8	101428955	101429019	0	65	0	3282	0	3217	0.0	0.0
chr2	MFSD9	102732023	102732138	0	116	64	2075	64	1959	0.0	0.03266972945380296
chr2	AC013727.1	103859474	103859643	0	170	0	2132	0	1962	0.0	0.0
chr2	LINC01831	104413575	104413660	0	86	0	849	0	763	0.0	0.0
chr2	MRPS9-AS1	105098601	105098668	0	68	0	1182	0	1114	0.0	0.0
chr2	MRPS9-AS1	105099247	105099300	0	54	0	1182	0	1128	0.0	0.0
chr2	FHL2	105373558	105373733	0	176	0	6508	0	6332	0.0	0.0
chr2	FHL2	105396646	105396697	0	52	0	6508	0	6456	0.0	0.0
chr2	FHL2	105390106	105390227	0	122	0	6508	0	6386	0.0	0.0
chr2	FHL2	105377995	105378117	0	123	0	6508	0	6385	0.0	0.0
chr2	FHL2	105389875	105390227	0	353	0	6508	0	6155	0.0	0.0
chr2	UXS1	106145189	106145370	0	182	255	6685	255	6503	0.0	0.03921267107488851
chr2	UXS1	106159144	106159382	255	239	255	6685	0	6446	1.0669456066945606	0.0
chr2	LINC01885	107386742	107386864	0	123	0	2430	0	2307	0.0	0.0
chr2	RGPD4-AS1	107824560	107824743	0	184	0	2376	0	2192	0.0	0.0
chr2	EDAR	108940210	108940326	0	117	0	4438	0	4321	0.0	0.0
chr2	SEPTIN10	109553086	109553219	0	134	0	3956	0	3822	0.0	0.0
chr2	SEPTIN10	109593050	109593119	0	70	0	3956	0	3886	0.0	0.0
chr2	SEPTIN10	109545459	109545542	0	84	0	3956	0	3872	0.0	0.0
chr2	SEPTIN10	109585720	109585838	0	119	0	3956	0	3837	0.0	0.0
chr2	SEPTIN10	109545384	109545542	0	159	0	3956	0	3797	0.0	0.0
chr2	SEPTIN10	109604834	109604933	0	100	0	3956	0	3856	0.0	0.0
chr2	SEPTIN10	109574580	109574767	0	188	0	3956	0	3768	0.0	0.0
chr2	SEPTIN10	109585125	109585321	0	197	0	3956	0	3759	0.0	0.0
chr2	MALL	110097498	110097604	0	107	2907	2628	2907	2521	0.0	1.1531138437128123
chr2	NPHP1	110201420	110201494	0	75	0	12937	0	12862	0.0	0.0
chr2	NPHP1	110156367	110156481	0	115	0	12937	0	12822	0.0	0.0
chr2	NPHP1	110125188	110125323	0	136	0	12937	0	12801	0.0	0.0
chr2	NPHP1	110125218	110125323	0	106	0	12937	0	12831	0.0	0.0
chr2	NPHP1	110202372	110202479	0	108	0	12937	0	12829	0.0	0.0
chr2	LINC01106	110377649	110377777	0	129	49771	3061	49771	2932	0.0	16.975102319236015
chr2	AC112229.1	110407937	110408028	0	92	73	2891	73	2799	0.0	0.026080743122543767
chr2	AC112229.1	110407937	110408019	0	83	73	2891	73	2808	0.0	0.025997150997150997
chr2	AC112229.1	110433435	110433533	0	99	73	2891	73	2792	0.0	0.026146131805157593
chr2	RGPD6	110562611	110562757	0	147	1011	12910	1011	12763	0.0	0.07921335109300322
chr2	RGPD6	110569656	110569724	0	69	1011	12910	1011	12841	0.0	0.07873218596682502
chr2	RGPD6	110569656	110569721	0	66	1011	12910	1011	12844	0.0	0.07871379632513235
chr2	BUB1	110674305	110674365	0	61	9267	6333	9267	6272	0.0	1.4775191326530612
chr2	BUB1	110676576	110676623	0	48	9267	6333	9267	6285	0.0	1.4744630071599045
chr2	BUB1	110676532	110676623	0	92	9267	6333	9267	6241	0.0	1.4848581958019549
chr2	MIR4435-2HG	111367486	111367575	82	90	30363	26838	30281	26748	0.9111111111111111	1.1320846418423807
chr2	MIR4435-2HG	111184532	111184642	0	111	30363	26838	30363	26727	0.0	1.1360422045122909
chr2	MIR4435-2HG	111248147	111248241	0	95	30363	26838	30363	26743	0.0	1.1353625247728378
chr2	MIR4435-2HG	111239801	111239996	0	196	30363	26838	30363	26642	0.0	1.139666691689813
chr2	MIR4435-2HG	111233627	111233739	0	113	30363	26838	30363	26725	0.0	1.1361272217025258
chr2	MIR4435-2HG	111365560	111367575	510	2016	30363	26838	29853	24822	0.25297619047619047	1.202683103698332
chr2	MIR4435-2HG	111479906	111480061	0	156	30363	26838	30363	26682	0.0	1.1379581740499214
chr2	MIR4435-2HG	111274706	111274861	705	156	30363	26838	29658	26682	4.519230769230769	1.111535866876546
chr2	MIR4435-2HG	111344060	111344237	0	178	30363	26838	30363	26660	0.0	1.1388972243060764
chr2	MIR4435-2HG	111208487	111208661	0	175	30363	26838	30363	26663	0.0	1.1387690807486028
chr2	MIR4435-2HG	111207719	111208661	0	943	30363	26838	30363	25895	0.0	1.1725429619617687
chr2	MIR4435-2HG	111208755	111208977	2919	223	30363	26838	27444	26615	13.089686098654708	1.031147848957355
chr2	MIR4435-2HG	111208755	111208936	2919	182	30363	26838	27444	26656	16.03846153846154	1.0295618247298919
chr2	MIR4435-2HG	111350607	111350761	0	155	30363	26838	30363	26683	0.0	1.1379155267398717
chr2	MIR4435-2HG	111330214	111330554	0	341	30363	26838	30363	26497	0.0	1.1459033098086575
chr2	MIR4435-2HG	111447211	111447349	0	139	30363	26838	30363	26699	0.0	1.137233604254841
chr2	MIR4435-2HG	111247429	111247558	0	130	30363	26838	30363	26708	0.0	1.1368503819080424
chr2	MIR4435-2HG	111377622	111377917	0	296	30363	26838	30363	26542	0.0	1.1439605154095396
chr2	MIR4435-2HG	111365560	111365662	0	103	30363	26838	30363	26735	0.0	1.1357022629511875
chr2	MIR4435-2HG	111469786	111469987	0	202	30363	26838	30363	26636	0.0	1.1399234119237123
chr2	MIR4435-2HG	111477335	111477481	0	147	30363	26838	30363	26691	0.0	1.1375744633022367
chr2	MIR4435-2HG	111494556	111494778	0	223	30363	26838	30363	26615	0.0	1.1408228442607553
chr2	MIR4435-2HG	111471988	111472097	0	110	30363	26838	30363	26728	0.0	1.1359997006884166
chr2	MIR4435-2HG	111469602	111469987	0	386	30363	26838	30363	26452	0.0	1.1478527143505217
chr2	AC017002.3	111613151	111613235	0	85	36	1314	36	1229	0.0	0.029292107404393815
chr2	AC017002.3	111613151	111613293	0	143	36	1314	36	1171	0.0	0.030742954739538857
chr2	ANAPC1	111873307	111873408	0	102	1853	12406	1853	12304	0.0	0.15060143042912874
chr2	RGPD8	112417192	112417338	0	147	51	8209	51	8062	0.0	0.006325973703795584
chr2	RGPD8	112424239	112424307	0	69	51	8209	51	8140	0.0	0.006265356265356265
chr2	RGPD8	112412430	112412626	0	197	51	8209	51	8012	0.0	0.0063654518222666
chr2	CKAP2L	112760712	112760764	99	53	4179	4835	4080	4782	1.8679245283018868	0.8531994981179423
chr2	PAX8	113227154	113227256	0	103	4468	6861	4468	6758	0.0	0.6611423498076354
chr2	PAX8	113235393	113235503	0	111	4468	6861	4468	6750	0.0	0.6619259259259259
chr2	PAX8	113235393	113235582	0	190	4468	6861	4468	6671	0.0	0.6697646529755659
chr2	PAX8	113236600	113236721	153	122	4468	6861	4315	6739	1.2540983606557377	0.6403027155364297
chr2	PGM5P4-AS1	113534559	113534713	0	155	1188	2429	1188	2274	0.0	0.5224274406332454
chr2	PGM5P4-AS1	113534559	113534716	0	158	1188	2429	1188	2271	0.0	0.523117569352708
chr2	SLC35F5	113733364	113733403	0	40	3832	4957	3832	4917	0.0	0.7793369941020948
chr2	DPP10-AS1	115135636	115136161	0	526	0	9102	0	8576	0.0	0.0
chr2	DPP10-AS1	115131826	115131924	0	99	0	9102	0	9003	0.0	0.0
chr2	CCDC93	117944732	117944797	0	66	408	8019	408	7953	0.0	0.05130139569973595
chr2	THORLNC	118184442	118184655	0	214	0	2777	0	2563	0.0	0.0
chr2	THORLNC	118185337	118185390	0	54	0	2777	0	2723	0.0	0.0
chr2	C2ORF76	119340158	119340361	0	204	0	1563	0	1359	0.0	0.0
chr2	SCTR	119465788	119465886	0	99	1990	3432	1990	3333	0.0	0.5970597059705971
chr2	SCTR	119480688	119480813	0	126	1990	3432	1990	3306	0.0	0.6019358741681791
chr2	CLASP1	121401867	121401870	0	4	0	10990	0	10986	0.0	0.0
chr2	CLASP1	121409023	121409047	0	25	0	10990	0	10965	0.0	0.0
chr2	CLASP1	121427403	121427430	0	28	0	10990	0	10962	0.0	0.0
chr2	CLASP1	121382207	121382324	0	118	0	10990	0	10872	0.0	0.0
chr2	CLASP1	121418621	121418729	0	109	0	10990	0	10881	0.0	0.0
chr2	CLASP1	121444938	121444962	0	25	0	10990	0	10965	0.0	0.0
chr2	CLASP1	121445448	121445496	0	49	0	10990	0	10941	0.0	0.0
chr2	CLASP1	121402594	121402663	0	70	0	10990	0	10920	0.0	0.0
chr2	NIFK	121728476	121728536	0	61	0	1932	0	1871	0.0	0.0
chr2	LINC01941	126112932	126113170	0	239	0	1004	0	765	0.0	0.0
chr2	BIN1	127060595	127060640	0	46	0	5365	0	5319	0.0	0.0
chr2	BIN1	127057472	127057601	0	130	0	5365	0	5235	0.0	0.0
chr2	BIN1	127052254	127052362	0	109	0	5365	0	5256	0.0	0.0
chr2	BIN1	127068162	127068255	0	94	0	5365	0	5271	0.0	0.0
chr2	BIN1	127051153	127051243	0	91	0	5365	0	5274	0.0	0.0
chr2	CYP27C1	127205899	127206090	0	192	0	5215	0	5023	0.0	0.0
chr2	ERCC3	127272864	127272961	0	98	0	6406	0	6308	0.0	0.0
chr2	ERCC3	127280446	127280631	0	186	0	6406	0	6220	0.0	0.0
chr2	ERCC3	127290223	127290273	0	51	0	6406	0	6355	0.0	0.0
chr2	ERCC3	127280897	127280972	0	76	0	6406	0	6330	0.0	0.0
chr2	ERCC3	127284170	127284289	0	120	0	6406	0	6286	0.0	0.0
chr2	IWS1	127485873	127486033	0	161	262	4167	262	4006	0.0	0.0654018971542686
chr2	IWS1	127523675	127523791	0	117	262	4167	262	4050	0.0	0.06469135802469136
chr2	LIMS2	127640069	127640145	0	77	153	7746	153	7669	0.0	0.019950449863085147
chr2	LIMS2	127642048	127642199	0	152	153	7746	153	7594	0.0	0.02014748485646563
chr2	LIMS2	127674313	127674421	0	109	153	7746	153	7637	0.0	0.020034044781982455
chr2	LIMS2	127673677	127673743	0	67	153	7746	153	7679	0.0	0.019924469331944264
chr2	WDR33	127770777	127771004	0	228	5917	14069	5917	13841	0.0	0.42749801314933894
chr2	POLR2D	127850589	127850685	0	97	1173	5227	1173	5130	0.0	0.22865497076023392
chr2	POLR2D	127852924	127853105	0	182	1173	5227	1173	5045	0.0	0.23250743310208127
chr2	SAP130	127977984	127978089	339	106	73016	4395	72677	4289	3.19811320754717	16.944975518768945
chr2	LINC02572	129869426	129869535	0	110	51	4097	51	3987	0.0	0.012791572610985704
chr2	LINC02572	129872605	129872751	0	147	51	4097	51	3950	0.0	0.012911392405063291
chr2	CCDC74B	130140178	130140371	0	194	0	3013	0	2819	0.0	0.0
chr2	CCDC74B	130144371	130144474	0	104	0	3013	0	2909	0.0	0.0
chr2	SMPD4	130157250	130157396	0	147	40	7065	40	6918	0.0	0.005782017924255565
chr2	SMPD4	130161185	130161272	0	88	40	7065	40	6977	0.0	0.005733123118818977
chr2	SMPD4	130173278	130173354	0	77	40	7065	40	6988	0.0	0.005724098454493417
chr2	SMPD4	130173513	130173604	0	92	40	7065	40	6973	0.0	0.00573641187437258
chr2	SMPD4	130159512	130159634	0	123	40	7065	40	6942	0.0	0.005762028233938346
chr2	SMPD4	130174913	130175000	0	88	40	7065	40	6977	0.0	0.005733123118818977
chr2	SMPD4	130173513	130173656	0	144	40	7065	40	6921	0.0	0.005779511631267158
chr2	SMPD4	130156584	130156675	0	92	40	7065	40	6973	0.0	0.00573641187437258
chr2	CCDC115	130339559	130339762	0	204	0	2582	0	2378	0.0	0.0
chr2	FAR2P2	130425913	130426038	0	126	0	4636	0	4510	0.0	0.0
chr2	FAR2P2	130426165	130426263	0	99	0	4636	0	4537	0.0	0.0
chr2	FAR2P2	130425464	130425611	0	148	0	4636	0	4488	0.0	0.0
chr2	CFC1	130597867	130597982	0	116	0	1678	0	1562	0.0	0.0
chr2	CFC1	130597493	130597603	0	111	0	1678	0	1567	0.0	0.0
chr2	NF1P8	131193518	131193591	0	74	0	1606	0	1532	0.0	0.0
chr2	ANKRD30BL	132153531	132153694	0	164	15124	4955	15124	4791	0.0	3.1567522437904403
chr2	NCKAP5	132725626	132725759	0	134	12623	9586	12623	9452	0.0	1.3354845535336437
chr2	NCKAP5	132773815	132773894	0	80	12623	9586	12623	9506	0.0	1.3278981695771093
chr2	NCKAP5	132728815	132728952	0	138	12623	9586	12623	9448	0.0	1.3360499576629974
chr2	CCNT2-AS1	134877519	134877643	0	125	34	3241	34	3116	0.0	0.010911424903722721
chr2	MAP3K19	134985799	134988253	0	2455	0	6971	0	4516	0.0	0.0
chr2	MAP3K19	134985799	134988274	0	2476	0	6971	0	4495	0.0	0.0
chr2	MAP3K19	135024625	135024741	0	117	0	6971	0	6854	0.0	0.0
chr2	MAP3K19	134983675	134983825	0	151	0	6971	0	6820	0.0	0.0
chr2	MAP3K19	135030311	135030500	0	190	0	6971	0	6781	0.0	0.0
chr2	MAP3K19	135021714	135021830	0	117	0	6971	0	6854	0.0	0.0
chr2	ZRANB3	135271300	135271395	0	96	33856	9098	33856	9002	0.0	3.760942012886025
chr2	LCT	135800606	135800809	0	204	6664	6597	6664	6393	0.0	1.0423901141873924
chr2	DARS1	135912485	135912566	81	82	15021	4752	14940	4670	0.9878048780487805	3.1991434689507496
chr2	LRP1B	140234785	140234884	0	100	79	16448	79	16348	0.0	0.0048323954000489356
chr2	LRP1B	140269267	140269381	0	115	79	16448	79	16333	0.0	0.004836833404763362
chr2	AC079793.1	143471971	143472019	0	49	0	3377	0	3328	0.0	0.0
chr2	GTDC1	143957194	143957339	0	146	51	13660	51	13514	0.0	0.003773864140890928
chr2	GTDC1	144007181	144007535	0	355	51	13660	51	13305	0.0	0.0038331454340473506
chr2	GTDC1	143970652	143970762	0	111	51	13660	51	13549	0.0	0.0037641154328732747
chr2	GTDC1	144177134	144177240	0	107	51	13660	51	13553	0.0	0.0037630045008485206
chr2	GTDC1	144230240	144230322	0	83	51	13660	51	13577	0.0	0.0037563526552257492
chr2	ZEB2	144424795	144424867	35	73	37	21461	2	21388	0.4794520547945205	9.35103796521414e-05
chr2	ZEB2	144404835	144405024	0	190	37	21461	37	21271	0.0	0.0017394574773165342
chr2	ZEB2	144424795	144424953	37	159	37	21461	0	21302	0.23270440251572327	0.0
chr2	ZEB2	144394392	144394480	0	89	37	21461	37	21372	0.0	0.0017312371326969867
chr2	ZEB2	144424795	144424864	35	70	37	21461	2	21391	0.5	9.349726520499275e-05
chr2	ZEB2	144518292	144518446	0	155	37	21461	37	21306	0.0	0.0017366000187740542
chr2	ZEB2	144497707	144497764	0	58	37	21461	37	21403	0.0	0.001728729617343363
chr2	ZEB2	144519938	144520208	0	271	37	21461	37	21190	0.0	0.0017461066540821143
chr2	ZEB2	144516457	144516553	0	97	37	21461	37	21364	0.0	0.0017318854147163453
chr2	ORC4	147975901	147975975	0	75	0	8740	0	8665	0.0	0.0
chr2	ORC4	147981927	147982081	0	155	0	8740	0	8585	0.0	0.0
chr2	MMADHC	149572229	149572331	0	103	51	2159	51	2056	0.0	0.02480544747081712
chr2	NMI	151281947	151282043	0	97	0	3321	0	3224	0.0	0.0
chr2	NMI	151288890	151289077	0	188	0	3321	0	3133	0.0	0.0
chr2	NEB	151502792	151502885	0	94	208	30273	208	30179	0.0	0.006892209814771861
chr2	NEB	151506908	151507013	0	106	208	30273	208	30167	0.0	0.006894951437000696
chr2	NEB	151508004	151508109	0	106	208	30273	208	30167	0.0	0.006894951437000696
chr2	NEB	151514817	151514928	0	112	208	30273	208	30161	0.0	0.006896323066211333
chr2	NEB	151499297	151499390	0	94	208	30273	208	30179	0.0	0.006892209814771861
chr2	NEB	151533441	151533546	0	106	208	30273	208	30167	0.0	0.006894951437000696
chr2	NEB	151534214	151534319	0	106	208	30273	208	30167	0.0	0.006894951437000696
chr2	NEB	151494160	151494253	0	94	208	30273	208	30179	0.0	0.006892209814771861
chr2	NEB	151501390	151501483	0	94	208	30273	208	30179	0.0	0.006892209814771861
chr2	NEB	151496940	151497033	0	94	208	30273	208	30179	0.0	0.006892209814771861
chr2	CACNB4	151841667	151841739	0	73	255	14196	255	14123	0.0	0.018055653897897046
chr2	CACNB4	151869176	151869735	0	560	255	14196	255	13636	0.0	0.0187004986799648
chr2	CACNB4	151870841	151870861	0	21	255	14196	255	14175	0.0	0.01798941798941799
chr2	CACNB4	151880799	151880922	0	124	255	14196	255	14072	0.0	0.018121091529278
chr2	CACNB4	151971544	151971704	0	161	255	14196	255	14035	0.0	0.01816886355539722
chr2	ARL5A	151810377	151810561	0	185	204	6732	204	6547	0.0	0.031159309607453795
chr2	CACNB4	151841902	151842088	0	187	255	14196	255	14009	0.0	0.018202584053108716
chr2	CACNB4	151853447	151853543	0	97	255	14196	255	14099	0.0	0.018086389105610327
chr2	CACNB4	151869176	151869235	0	60	255	14196	255	14136	0.0	0.01803904923599321
chr2	CACNB4	151853447	151853564	0	118	255	14196	255	14078	0.0	0.0181133683761898
chr2	CACNB4	151860710	151860820	0	111	255	14196	255	14085	0.0	0.01810436634717785
chr2	CACNB4	151870530	151870611	0	82	255	14196	255	14114	0.0	0.01806716735156582
chr2	CACNB4	151970280	151970426	0	147	255	14196	255	14049	0.0	0.018150758061071963
chr2	CACNB4	151874919	151874970	0	52	255	14196	255	14144	0.0	0.018028846153846152
chr2	CACNB4	151962844	151962911	0	68	255	14196	255	14128	0.0	0.018049263873159683
chr2	CACNB4	151870841	151870902	0	62	255	14196	255	14134	0.0	0.01804160181123532
chr2	CACNB4	151869176	151870611	0	1436	255	14196	255	12760	0.0	0.019984326018808778
chr2	CACNB4	151971544	151971700	0	157	255	14196	255	14039	0.0	0.01816368687228435
chr2	CACNB4	151855223	151855375	0	153	255	14196	255	14043	0.0	0.01815851313821833
chr2	CACNB4	151869176	151869193	0	18	255	14196	255	14178	0.0	0.017985611510791366
chr2	CACNB4	151967536	151967610	0	75	255	14196	255	14121	0.0	0.018058211174845976
chr2	CACNB4	151872416	151872493	0	78	255	14196	255	14118	0.0	0.01806204844878878
chr2	STAM2	152150144	152150229	0	86	49416	6791	49416	6705	0.0	7.370022371364653
chr2	PRPF40A	152679055	152679109	0	55	99651	9227	99651	9172	0.0	10.864696903619713
chr2	PRPF40A	152693157	152693476	0	320	99651	9227	99651	8907	0.0	11.187942068036376
chr2	AC011901.1	153187451	153187569	0	119	520	1031	520	912	0.0	0.5701754385964912
chr2	AC012501.2	153423435	153423492	0	58	0	988	0	930	0.0	0.0
chr2	LINC01876	156013672	156013783	0	112	0	2723	0	2611	0.0	0.0
chr2	LINC01876	156150484	156150602	0	119	0	2723	0	2604	0.0	0.0
chr2	LINC01876	156024484	156024607	0	124	0	2723	0	2599	0.0	0.0
chr2	LINC01876	156024465	156024607	0	143	0	2723	0	2580	0.0	0.0
chr2	LINC01876	156024469	156024607	0	139	0	2723	0	2584	0.0	0.0
chr2	NR4A2	156330667	156330791	0	125	153	3973	153	3848	0.0	0.03976091476091476
chr2	NR4A2	156326311	156326328	0	18	153	3973	153	3955	0.0	0.038685208596713025
chr2	ERMN	157325130	157325236	0	107	3309	4361	3309	4254	0.0	0.7778561354019746
chr2	ERMN	157324146	157324269	0	124	3309	4361	3309	4237	0.0	0.7809771064432381
chr2	ERMN	157324117	157324269	0	153	3309	4361	3309	4208	0.0	0.7863593155893536
chr2	CYTIP	157438882	157438963	0	82	5932	3398	5932	3316	0.0	1.7889022919179736
chr2	CYTIP	157443846	157444006	125	161	5932	3398	5807	3237	0.7763975155279503	1.7939450108124806
chr2	CYTIP	157464935	157465027	0	93	5932	3398	5932	3305	0.0	1.794856278366112
chr2	ACVR1C	157556092	157556332	0	241	61	9064	61	8823	0.0	0.006913748158222826
chr2	ACVR1C	157550161	157550392	0	232	61	9064	61	8832	0.0	0.006906702898550725
chr2	ACVR1	157860032	157860179	0	148	0	4499	0	4351	0.0	0.0
chr2	ACVR1	157819402	157819489	0	88	0	4499	0	4411	0.0	0.0
chr2	ACVR1	157826527	157826646	0	120	0	4499	0	4379	0.0	0.0
chr2	ACVR1	157860054	157860179	0	126	0	4499	0	4373	0.0	0.0
chr2	CCDC148	158340241	158340393	0	153	357	3816	357	3663	0.0	0.09746109746109746
chr2	CCDC148	158345214	158345318	0	105	357	3816	357	3711	0.0	0.09620048504446241
chr2	CCDC148	158358448	158358570	0	123	357	3816	357	3693	0.0	0.0966693744922827
chr2	WDSUB1	159248371	159248512	0	142	51	1977	51	1835	0.0	0.02779291553133515
chr2	BAZ2B	159336941	159337077	0	137	22229	18526	22229	18389	0.0	1.2088204905106315
chr2	BAZ2B	159427940	159428042	0	103	22229	18526	22229	18423	0.0	1.206589589100581
chr2	BAZ2B	159430862	159431156	0	295	22229	18526	22229	18231	0.0	1.2192968021501838
chr2	BAZ2B	159453612	159453801	0	190	22229	18526	22229	18336	0.0	1.212314572425829
chr2	BAZ2B	159397073	159397100	0	28	22229	18526	22229	18498	0.0	1.2016974808087362
chr2	BAZ2B	159448241	159448409	0	169	22229	18526	22229	18357	0.0	1.2109277114997004
chr2	CD302	159780004	159780178	0	175	561	4084	561	3909	0.0	0.1435149654643131
chr2	CD302	159783358	159783469	0	112	561	4084	561	3972	0.0	0.14123867069486404
chr2	LY75-CD302	159806972	159807140	0	169	4437	5689	4437	5520	0.0	0.803804347826087
chr2	ITGB6	160199178	160199258	0	81	2040	3902	2040	3821	0.0	0.533891651400157
chr2	ITGB6	160196215	160196420	0	206	2040	3902	2040	3696	0.0	0.551948051948052
chr2	RBMS1	160401967	160402102	0	136	5415	9745	5415	9609	0.0	0.5635341866999688
chr2	AC009299.2	161227048	161227133	0	86	0	2835	0	2749	0.0	0.0
chr2	AC009299.2	161254584	161254680	0	97	0	2835	0	2738	0.0	0.0
chr2	AC009299.2	161246758	161246913	0	156	0	2835	0	2679	0.0	0.0
chr2	DPP4	162039131	162039184	0	54	25698	14461	25698	14407	0.0	1.7837162490456029
chr2	DPP4	162032034	162032265	1801	232	25698	14461	23897	14229	7.762931034482759	1.6794574460608616
chr2	DPP4	162046701	162046805	0	105	25698	14461	25698	14356	0.0	1.7900529395374756
chr2	FAP	162224465	162224540	0	76	27385	6864	27385	6788	0.0	4.034325279905716
chr2	FAP	162226522	162226621	2060	100	27385	6864	25325	6764	20.6	3.7440863394441157
chr2	FAP	162221592	162221712	0	121	27385	6864	27385	6743	0.0	4.061248702358001
chr2	IFIH1	162279995	162280112	0	118	157256	5110	157256	4992	0.0	31.501602564102566
chr2	KCNH7	162512653	162512674	0	22	102	5031	102	5009	0.0	0.020363345977240967
chr2	FIGN	163734902	163735072	0	171	0	9946	0	9775	0.0	0.0
chr2	AC016766.1	163867698	163867794	0	97	68	1126	68	1029	0.0	0.06608357628765792
chr2	GRB14	164494430	164494524	0	95	0	3003	0	2908	0.0	0.0
chr2	COBLL1	164703103	164703220	0	118	40	17102	40	16984	0.0	0.0023551577955723034
chr2	COBLL1	164743686	164743875	0	190	40	17102	40	16912	0.0	0.0023651844843897824
chr2	COBLL1	164727105	164727144	0	40	40	17102	40	17062	0.0	0.0023443910444262105
chr2	COBLL1	164800533	164800554	0	22	40	17102	40	17080	0.0	0.00234192037470726
chr2	COBLL1	164703627	164703671	0	45	40	17102	40	17057	0.0	0.0023450782669871607
chr2	COBLL1	164837427	164837498	40	72	40	17102	0	17030	0.5555555555555556	0.0
chr2	COBLL1	164779654	164779785	0	132	40	17102	40	16970	0.0	0.002357100766057749
chr2	SLC38A11	164915111	164915273	0	163	51	5207	51	5044	0.0	0.010111022997620936
chr2	SLC38A11	164944568	164944634	0	67	51	5207	51	5140	0.0	0.009922178988326848
chr2	SCN3A	165179551	165179691	0	141	102	11548	102	11407	0.0	0.00894187779433681
chr2	GALNT3	165761752	165761792	0	41	102	4440	102	4399	0.0	0.02318708797453967
chr2	GALNT3	165771264	165771383	0	120	102	4440	102	4320	0.0	0.02361111111111111
chr2	TTC21B	165864983	165865077	0	95	0	8712	0	8617	0.0	0.0
chr2	SCN1A	166002471	166002753	0	283	305	18837	305	18554	0.0	0.016438503826668106
chr2	SCN1A	166077709	166077847	0	139	305	18837	305	18698	0.0	0.016311905016579312
chr2	SCN1A	166077709	166077801	0	93	305	18837	305	18744	0.0	0.016271873666239865
chr2	SCN1A	166126923	166127010	0	88	305	18837	305	18749	0.0	0.01626753426849432
chr2	SCN1A	166007229	166007293	0	65	305	18837	305	18772	0.0	0.016247602812699765
chr2	SCN1A	165999050	165999116	0	67	305	18837	305	18770	0.0	0.016249334043686735
chr2	SCN1A	166060639	166060867	0	229	305	18837	305	18608	0.0	0.016390799656061907
chr2	SCN9A	166233339	166233462	0	124	150	13972	150	13848	0.0	0.010831889081455806
chr2	SCN9A	166259205	166259287	0	83	150	13972	150	13889	0.0	0.010799913600691194
chr2	SCN7A	166486855	166486968	0	114	148	9765	148	9651	0.0	0.015335198425033674
chr2	SCN7A	166436346	166436440	0	95	148	9765	148	9670	0.0	0.015305067218200621
chr2	B3GALT1-AS1	167869739	167869980	0	242	0	1368	0	1126	0.0	0.0
chr2	B3GALT1-AS1	167939242	167939297	0	56	0	1368	0	1312	0.0	0.0
chr2	B3GALT1-AS1	167862714	167862850	0	137	0	1368	0	1231	0.0	0.0
chr2	CERS6-AS1	168775195	168775370	0	176	51	4221	51	4045	0.0	0.012608158220024722
chr2	CERS6-AS1	168783954	168784047	0	94	51	4221	51	4127	0.0	0.012357644778289314
chr2	CERS6-AS1	168777812	168777937	0	126	51	4221	51	4095	0.0	0.012454212454212455
chr2	CERS6-AS1	168775195	168775315	0	121	51	4221	51	4100	0.0	0.012439024390243903
chr2	ABCB11	168929291	168929351	0	61	14327	7746	14327	7685	0.0	1.864281067013663
chr2	ABCB11	168932780	168932940	0	161	14327	7746	14327	7585	0.0	1.8888595912986157
chr2	LRP2	169140454	169140545	0	92	171	16189	171	16097	0.0	0.010623097471578555
chr2	LRP2	169270903	169271107	0	205	171	16189	171	15984	0.0	0.010698198198198198
chr2	LRP2	169277744	169277951	0	208	171	16189	171	15981	0.0	0.010700206495213065
chr2	LRP2	169140454	169140508	0	55	171	16189	171	16134	0.0	0.010598735589438453
chr2	FASTKD1	169537226	169537340	0	115	0	5035	0	4920	0.0	0.0
chr2	FASTKD1	169538012	169538141	0	130	0	5035	0	4905	0.0	0.0
chr2	FASTKD1	169569183	169569252	0	70	0	5035	0	4965	0.0	0.0
chr2	CCDC173	169681006	169681233	0	228	0	2218	0	1990	0.0	0.0
chr2	METTL5	169821091	169821273	0	183	0	2425	0	2242	0.0	0.0
chr2	METTL5	169821942	169822057	0	116	0	2425	0	2309	0.0	0.0
chr2	MYO3B-AS1	170334745	170334879	0	135	24637	5707	24637	5572	0.0	4.421572146446518
chr2	MYO3B-AS1	170343458	170343656	2663	199	24637	5707	21974	5508	13.381909547738694	3.9894698620188818
chr2	MYO3B-AS1	170343458	170343558	0	101	24637	5707	24637	5606	0.0	4.394755618979665
chr2	MYO3B-AS1	170343458	170343637	2279	180	24637	5707	22358	5527	12.661111111111111	4.045232495024425
chr2	MYO3B-AS1	170341385	170341429	210	45	24637	5707	24427	5662	4.666666666666667	4.3141999293535855
chr2	MYO3B-AS1	170343494	170343656	2663	163	24637	5707	21974	5544	16.337423312883434	3.9635642135642137
chr2	MYO3B-AS1	170344340	170344352	2737	13	24637	5707	21900	5694	210.53846153846155	3.8461538461538463
chr2	MYO3B-AS1	170344340	170344381	5106	42	24637	5707	19531	5665	121.57142857142857	3.4476610767872904
chr2	MYO3B-AS1	170344340	170344438	5106	99	24637	5707	19531	5608	51.57575757575758	3.482703281027104
chr2	MYO3B-AS1	170344171	170344298	0	128	24637	5707	24637	5579	0.0	4.416024377128518
chr2	MYO3B-AS1	170341329	170341429	210	101	24637	5707	24427	5606	2.0792079207920793	4.357295754548698
chr2	MYO3B-AS1	170344340	170344574	11250	235	24637	5707	13387	5472	47.87234042553192	2.446454678362573
chr2	MYO3B-AS1	170340166	170340417	1496	252	24637	5707	23141	5455	5.936507936507937	4.242163153070577
chr2	MYO3B-AS1	170340166	170340421	1564	256	24637	5707	23073	5451	6.109375	4.232801320858558
chr2	MYO3B-AS1	170341188	170341425	292	238	24637	5707	24345	5469	1.226890756302521	4.451453647833242
chr2	MYO3B-AS1	170341188	170341429	312	242	24637	5707	24325	5465	1.2892561983471074	4.451052150045745
chr2	MYO3B-AS1	170344798	170344933	0	136	24637	5707	24637	5571	0.0	4.422365823012027
chr2	MYO3B-AS1	170343816	170343840	0	25	24637	5707	24637	5682	0.0	4.335973248856036
chr2	MYO3B-AS1	170350461	170350644	0	184	24637	5707	24637	5523	0.0	4.460800289697628
chr2	MYO3B-AS1	170347951	170348125	1122	175	24637	5707	23515	5532	6.411428571428571	4.250723065798987
chr2	MYO3B-AS1	170346177	170346242	0	66	24637	5707	24637	5641	0.0	4.367488034036518
chr2	MYO3B-AS1	170349511	170349634	266	124	24637	5707	24371	5583	2.1451612903225805	4.3652158337811215
chr2	MYO3B-AS1	170344171	170344301	0	131	24637	5707	24637	5576	0.0	4.4184002869440455
chr2	MYO3B-AS1	170345062	170345132	0	71	24637	5707	24637	5636	0.0	4.371362668559262
chr2	MYO3B-AS1	170344798	170345132	0	335	24637	5707	24637	5372	0.0	4.586187639612807
chr2	MYO3B-AS1	170349837	170349851	15	15	24637	5707	24622	5692	1.0	4.325720309205903
chr2	MYO3B-AS1	170346177	170346405	0	229	24637	5707	24637	5478	0.0	4.497444322745528
chr2	MYO3B-AS1	170350317	170350644	2396	328	24637	5707	22241	5379	7.304878048780488	4.134783416992006
chr2	MYO3B-AS1	170345062	170345215	0	154	24637	5707	24637	5553	0.0	4.436700882405907
chr2	MYO3B-AS1	170350461	170350571	0	111	24637	5707	24637	5596	0.0	4.402609006433167
chr2	MYO3B-AS1	170347951	170348099	682	149	24637	5707	23955	5558	4.577181208053691	4.310003598416697
chr2	AC007405.1	170726042	170726089	0	48	1236	6575	1236	6527	0.0	0.1893672437567029
chr2	AC007405.1	170730367	170730997	51	631	1236	6575	1185	5944	0.08082408874801902	0.1993606998654105
chr2	AC007405.1	170740631	170741287	0	657	1236	6575	1236	5918	0.0	0.20885434268333897
chr2	AC007405.1	170733878	170733994	0	117	1236	6575	1236	6458	0.0	0.19139052338185197
chr2	AC007405.1	170728578	170730037	1025	1460	1236	6575	211	5115	0.702054794520548	0.04125122189638319
chr2	TLK1	171059923	171059986	0	64	279	9435	279	9371	0.0	0.02977270301995518
chr2	TLK1	171022871	171023129	0	259	279	9435	279	9176	0.0	0.030405405405405407
chr2	TLK1	171081639	171081708	0	70	279	9435	279	9365	0.0	0.02979177789642285
chr2	METTL8	171326041	171326148	0	108	51	9953	51	9845	0.0	0.005180294565769426
chr2	METTL8	171337452	171337502	0	51	51	9953	51	9902	0.0	0.0051504746515855385
chr2	METTL8	171360421	171360513	0	93	51	9953	51	9860	0.0	0.005172413793103448
chr2	METTL8	171392042	171392197	0	156	51	9953	51	9797	0.0	0.005205675206695928
chr2	METTL8	171414602	171414726	0	125	51	9953	51	9828	0.0	0.005189255189255189
chr2	METTL8	171433025	171433219	0	195	51	9953	51	9758	0.0	0.005226480836236934
chr2	SLC25A12	171855833	171855949	1509	117	4192	6150	2683	6033	12.897435897435898	0.44472070280125975
chr2	SLC25A12	171848172	171848276	327	105	4192	6150	3865	6045	3.1142857142857143	0.6393713813068652
chr2	SLC25A12	171845726	171845858	0	133	4192	6150	4192	6017	0.0	0.6966927040053182
chr2	SLC25A12	171852667	171852688	0	22	4192	6150	4192	6128	0.0	0.6840731070496083
chr2	SLC25A12	171991346	171991442	0	97	4192	6150	4192	6053	0.0	0.6925491491822237
chr2	SLC25A12	171921079	171921231	0	153	4192	6150	4192	5997	0.0	0.6990161747540437
chr2	SP3	173963760	173963883	0	124	32580	9158	32580	9034	0.0	3.606375913216737
chr2	SP3	173934369	173934411	0	43	32580	9158	32580	9115	0.0	3.5743280307185956
chr2	OLA1	174246714	174246815	720	102	54522	6016	53802	5914	7.0588235294117645	9.097396009469056
chr2	GPR155	174466543	174466627	0	85	0	7788	0	7703	0.0	0.0
chr2	GPR155	174482872	174482918	0	47	0	7788	0	7741	0.0	0.0
chr2	GPR155	174483009	174483158	0	150	0	7788	0	7638	0.0	0.0
chr2	CHRNA1	174748579	174748819	0	241	35867	4993	35867	4752	0.0	7.54776936026936
chr2	CHRNA1	174757565	174757675	51	111	35867	4993	35816	4882	0.4594594594594595	7.3363375665710775
chr2	CHRNA1	174764020	174764144	0	125	35867	4993	35867	4868	0.0	7.367912900575185
chr2	CHRNA1	174757945	174758020	0	76	35867	4993	35867	4917	0.0	7.29448850925361
chr2	CHN1	174808904	174809042	180	139	470752	9117	470572	8978	1.2949640287769784	52.41390064602361
chr2	CHN1	174824433	174824518	576	86	470752	9117	470176	9031	6.6976744186046515	52.06245155575241
chr2	CHN1	174846879	174846957	0	79	470752	9117	470752	9038	0.0	52.08585970347422
chr2	CHN1	174877839	174878128	0	290	470752	9117	470752	8827	0.0	53.33091650617424
chr2	CHN1	174944887	174944943	90	57	470752	9117	470662	9060	1.5789473684210527	51.94944812362031
chr2	CHN1	174821728	174821779	0	52	470752	9117	470752	9065	0.0	51.93072255929399
chr2	CHN1	174875787	174875865	0	79	470752	9117	470752	9038	0.0	52.08585970347422
chr2	CHN1	175004893	175005080	0	188	470752	9117	470752	8929	0.0	52.72169335871878
chr2	CHN1	174805524	174805653	0	130	470752	9117	470752	8987	0.0	52.38143985757205
chr2	CHN1	174952163	174952202	0	40	470752	9117	470752	9077	0.0	51.86206896551724
chr2	CHN1	174940815	174940894	300	80	470752	9117	470452	9037	3.75	52.05842646896094
chr2	CHN1	174872019	174872114	0	96	470752	9117	470752	9021	0.0	52.184015075933935
chr2	CHN1	174918533	174918565	0	33	470752	9117	470752	9084	0.0	51.82210479964773
chr2	CHN1	174951742	174951837	75	96	470752	9117	470677	9021	0.78125	52.17570114178029
chr2	CHN1	174917324	174917431	0	108	470752	9117	470752	9009	0.0	52.253524253524255
chr2	CHN1	174945169	174945261	42	93	470752	9117	470710	9024	0.45161290322580644	52.16201241134752
chr2	ATF2	175080659	175080765	390	107	4202	5317	3812	5210	3.6448598130841123	0.7316698656429942
chr2	ATF2	175113993	175114108	0	116	4202	5317	4202	5201	0.0	0.8079215535473947
chr2	ATF2	175117989	175118118	0	130	4202	5317	4202	5187	0.0	0.8101021785232312
chr2	ATF2	175121443	175121540	0	98	4202	5317	4202	5219	0.0	0.8051350833493006
chr2	ATF2	175132694	175132757	0	64	4202	5317	4202	5253	0.0	0.7999238530363602
chr2	ATF2	175092542	175092616	0	75	4202	5317	4202	5242	0.0	0.8016024418161007
chr2	ATF2	175136411	175136486	20	76	4202	5317	4182	5241	0.2631578947368421	0.7979393245563824
chr2	ATF2	175147945	175147980	0	36	4202	5317	4202	5281	0.0	0.7956826358644196
chr2	ATF2	175074999	175075087	0	89	4202	5317	4202	5228	0.0	0.8037490436113236
chr2	ATF2	175114689	175114868	0	180	4202	5317	4202	5137	0.0	0.8179871520342612
chr2	LNPK	175938312	175938383	3280	72	78533	9098	75253	9026	45.55555555555556	8.337358741413693
chr2	LNPK	175940987	175941080	1275	94	78533	9098	77258	9004	13.563829787234043	8.580408707241226
chr2	HAGLR	176177331	176177494	0	164	25	4973	25	4809	0.0	0.0051985859846121855
chr2	HAGLR	176177710	176177856	0	147	25	4973	25	4826	0.0	0.005180273518441774
chr2	HAGLR	176179028	176179098	0	71	25	4973	25	4902	0.0	0.005099959200326397
chr2	HAGLR	176177000	176177070	0	71	25	4973	25	4902	0.0	0.005099959200326397
chr2	HAGLR	176176898	176176939	0	42	25	4973	25	4931	0.0	0.0050699655242344354
chr2	HAGLR	176177710	176177821	0	112	25	4973	25	4861	0.0	0.0051429746965644925
chr2	HAGLR	176177710	176177826	0	117	25	4973	25	4856	0.0	0.00514827018121911
chr2	LINC01116	176633364	176633740	102	377	306	2130	204	1753	0.27055702917771884	0.1163719338277239
chr2	AC092162.2	176782815	176782919	0	105	3332	6240	3332	6135	0.0	0.5431132844335779
chr2	AC073636.1	176847989	176848342	0	354	385	3276	385	2922	0.0	0.13175906913073238
chr2	AC073636.1	176847865	176847941	0	77	385	3276	385	3199	0.0	0.12035010940919037
chr2	AC073636.1	176846527	176846629	0	103	385	3276	385	3173	0.0	0.12133627481878348
chr2	AC073636.1	176848574	176848657	0	84	385	3276	385	3192	0.0	0.1206140350877193
chr2	AC074286.1	177143739	177143836	0	98	3723	6857	3723	6759	0.0	0.550821127385708
chr2	AC074286.1	177097022	177097169	0	148	3723	6857	3723	6709	0.0	0.554926218512446
chr2	AC074286.1	177131061	177131208	0	148	3723	6857	3723	6709	0.0	0.554926218512446
chr2	AC019080.1	177331571	177331656	0	86	0	3664	0	3578	0.0	0.0
chr2	AC019080.1	177348321	177348475	0	155	0	3664	0	3509	0.0	0.0
chr2	AC019080.1	177332141	177332251	0	111	0	3664	0	3553	0.0	0.0
chr2	PDE11A	177669492	177669567	0	76	72	6758	72	6682	0.0	0.010775217000897935
chr2	PDE11A	177816828	177816921	32	94	72	6758	40	6664	0.3404255319148936	0.006002400960384154
chr2	PDE11A	177899504	177899590	0	87	72	6758	72	6671	0.0	0.010792984560035976
chr2	PDE11A	177921730	177921958	0	229	72	6758	72	6529	0.0	0.01102772246898453
chr2	PRKRA	178441609	178441704	0	96	102	10172	102	10076	0.0	0.010123064708217546
chr2	PRKRA	178444421	178444500	0	80	102	10172	102	10092	0.0	0.010107015457788348
chr2	PRKRA	178450241	178450411	0	171	102	10172	102	10001	0.0	0.010198980101989802
chr2	PRKRA	178445425	178445535	0	111	102	10172	102	10061	0.0	0.010138157240830932
chr2	PRKRA	178447504	178447586	0	83	102	10172	102	10089	0.0	0.010110020814748736
chr2	PRKRA	178450365	178450411	0	47	102	10172	102	10125	0.0	0.010074074074074074
chr2	PRKRA	178447455	178447586	0	132	102	10172	102	10040	0.0	0.010159362549800797
chr2	FKBP7	178469651	178469785	0	135	248	3086	248	2951	0.0	0.08403930870891223
chr2	FKBP7	178477061	178477213	44	153	248	3086	204	2933	0.2875816993464052	0.06955335833617457
chr2	FKBP7	178473028	178473142	0	115	248	3086	248	2971	0.0	0.0834735779198923
chr2	FKBP7	178469651	178469782	0	132	248	3086	248	2954	0.0	0.08395396073121192
chr2	TTN	178637368	178637419	0	52	4805	119344	4805	119292	0.0	0.04027931462294203
chr2	TTN	178790707	178790845	0	139	4805	119344	4805	119205	0.0	0.04030871188289082
chr2	TTN	178739140	178741921	0	2782	4805	119344	4805	116562	0.0	0.04122269693382063
chr2	TTN	178789977	178790115	0	139	4805	119344	4805	119205	0.0	0.04030871188289082
chr2	TTN	178665707	178665791	0	85	4805	119344	4805	119259	0.0	0.04029046025876454
chr2	TTN	178675670	178675754	0	85	4805	119344	4805	119259	0.0	0.04029046025876454
chr2	TTN	178677200	178677287	0	88	4805	119344	4805	119256	0.0	0.040291473804253033
chr2	TTN	178756221	178756797	0	577	4805	119344	4805	118767	0.0	0.04045736610337888
chr2	TTN	178757541	178757916	0	376	4805	119344	4805	118968	0.0	0.040389012171340194
chr2	CCDC141	178918712	178918907	0	196	0	13822	0	13626	0.0	0.0
chr2	SESTD1	179123714	179123829	0	116	459	11426	459	11310	0.0	0.040583554376657824
chr2	ZNF385B	179576115	179576267	0	153	3679	5441	3679	5288	0.0	0.6957261724659607
chr2	ZNF385B	179483271	179483434	1020	164	3679	5441	2659	5277	6.219512195121951	0.5038847830206556
chr2	ZNF385B	179544826	179544969	0	144	3679	5441	3679	5297	0.0	0.6945440815555975
chr2	ZNF385B	179522881	179522920	0	40	3679	5441	3679	5401	0.0	0.6811701536752454
chr2	CERKL	181547821	181547847	0	27	0	4691	0	4664	0.0	0.0
chr2	CERKL	181566057	181566121	0	65	0	4691	0	4626	0.0	0.0
chr2	CERKL	181573752	181573884	0	133	0	4691	0	4558	0.0	0.0
chr2	CERKL	181565432	181565510	0	79	0	4691	0	4612	0.0	0.0
chr2	CERKL	181558565	181558708	0	144	0	4691	0	4547	0.0	0.0
chr2	NCKAP1	183024977	183024995	0	19	0	22553	0	22534	0.0	0.0
chr2	LINC01473	186057669	186057906	0	238	0	3606	0	3368	0.0	0.0
chr2	LINC01473	186058756	186058969	0	214	0	3606	0	3392	0.0	0.0
chr2	LINC01473	186178598	186178691	0	94	0	3606	0	3512	0.0	0.0
chr2	LINC01473	186086300	186086370	0	71	0	3606	0	3535	0.0	0.0
chr2	LINC01473	186305161	186305219	0	59	0	3606	0	3547	0.0	0.0
chr2	LINC01473	186099768	186099830	0	63	0	3606	0	3543	0.0	0.0
chr2	LINC01473	186080647	186080777	0	131	0	3606	0	3475	0.0	0.0
chr2	LINC01473	186080647	186080774	0	128	0	3606	0	3478	0.0	0.0
chr2	LINC01473	186215018	186215090	0	73	0	3606	0	3533	0.0	0.0
chr2	CALCRL	187387328	187387493	0	166	696	7327	696	7161	0.0	0.09719312945119397
chr2	CALCRL	187431296	187431364	0	69	696	7327	696	7258	0.0	0.09589418572609534
chr2	CALCRL	187387328	187387465	0	138	696	7327	696	7189	0.0	0.09681457782723606
chr2	TFPI	187488336	187488375	0	40	82942	11727	82942	11687	0.0	7.096945323864123
chr2	TFPI	187513615	187513646	0	32	82942	11727	82942	11695	0.0	7.092090637024369
chr2	TFPI	187520541	187520613	1056	73	82942	11727	81886	11654	14.465753424657533	7.02642869401064
chr2	TFPI	187529363	187529485	1248	123	82942	11727	81694	11604	10.146341463414634	7.04015856601172
chr2	TFPI	187544503	187544637	18083	135	82942	11727	64859	11592	133.94814814814814	5.595151828847481
chr2	OSGEPL1	189752652	189752724	0	73	0	3437	0	3364	0.0	0.0
chr2	ORMDL1	189783013	189783123	0	111	0	4012	0	3901	0.0	0.0
chr2	HIBCH	190208879	190208913	0	35	372	6477	372	6442	0.0	0.05774604160198696
chr2	HIBCH	190261155	190261234	14	80	372	6477	358	6397	0.175	0.055963732999843675
chr2	NEMP2	190516269	190516384	0	116	599	6535	599	6419	0.0	0.09331671599937685
chr2	NEMP2	190525262	190525378	0	117	599	6535	599	6418	0.0	0.09333125584294173
chr2	AC006460.2	190629750	190629825	276	76	90592	7821	90316	7745	3.6315789473684212	11.66120077469335
chr2	AC006460.2	190640950	190641462	0	513	90592	7821	90592	7308	0.0	12.396278051450466
chr2	AC006460.1	190678424	190678537	0	114	5067	5423	5067	5309	0.0	0.9544170276888303
chr2	STAT1	190979771	190979866	0	96	975	9766	975	9670	0.0	0.10082730093071354
chr2	STAT1	190998216	190998308	0	93	975	9766	975	9673	0.0	0.10079603018711879
chr2	STAT1	191001073	191001163	0	91	975	9766	975	9675	0.0	0.10077519379844961
chr2	STAT1	191013524	191013678	0	155	975	9766	975	9611	0.0	0.10144625949432941
chr2	STAT1	190975309	190975388	0	80	975	9766	975	9686	0.0	0.10066074747057609
chr2	STAT1	190975309	190975434	0	126	975	9766	975	9640	0.0	0.10114107883817428
chr2	STAT1	190978527	190978606	0	80	975	9766	975	9686	0.0	0.10066074747057609
chr2	STAT1	191010366	191010449	0	84	975	9766	975	9682	0.0	0.1007023342284652
chr2	STAT4	191068059	191068594	102	536	6816	4634	6714	4098	0.19029850746268656	1.638360175695461
chr2	STAT4	191150946	191151014	0	69	6816	4634	6816	4565	0.0	1.4930996714129243
chr2	STAT4	191150946	191151081	0	136	6816	4634	6816	4498	0.0	1.5153401511783016
chr2	DNAH7	195754336	195754514	0	179	52	21418	52	21239	0.0	0.0024483261923819387
chr2	STK17B	196174248	196174407	0	160	0	6579	0	6419	0.0	0.0
chr2	HECW2	196257822	196257906	0	85	1997	22512	1997	22427	0.0	0.089044455344005
chr2	HECW2	196320338	196320439	0	102	1997	22512	1997	22410	0.0	0.0891120035698349
chr2	HECW2	196493243	196493375	0	133	1997	22512	1997	22379	0.0	0.08923544394298226
chr2	GTF3C3	196773912	196774140	0	229	0	7152	0	6923	0.0	0.0
chr2	GTF3C3	196799239	196799254	0	16	0	7152	0	7136	0.0	0.0
chr2	PGAP1	196842720	196842825	0	106	0	7923	0	7817	0.0	0.0
chr2	PGAP1	196864986	196865080	0	95	0	7923	0	7828	0.0	0.0
chr2	PGAP1	196892345	196892401	0	57	0	7923	0	7866	0.0	0.0
chr2	PGAP1	196922102	196922186	0	85	0	7923	0	7838	0.0	0.0
chr2	ANKRD44	197086679	197086748	0	70	18197	12858	18197	12788	0.0	1.4229746637472631
chr2	ANKRD44	197147026	197147105	0	80	18197	12858	18197	12778	0.0	1.4240882767256222
chr2	SF3B1	197418895	197419640	59	746	561	10241	502	9495	0.07908847184986595	0.052869931542917324
chr2	SF3B1	197418895	197418951	37	57	561	10241	524	10184	0.6491228070175439	0.05145326001571092
chr2	HSPD1	197490196	197490296	0	101	102	6724	102	6623	0.0	0.015400875736071266
chr2	HSPD1	197494656	197494752	0	97	102	6724	102	6627	0.0	0.015391579900407425
chr2	HSPD1	197490526	197490664	0	139	102	6724	102	6585	0.0	0.015489749430523917
chr2	HSPD1	197499166	197499438	0	273	102	6724	102	6451	0.0	0.015811502092698805
chr2	HSPD1	197499141	197499438	0	298	102	6724	102	6426	0.0	0.015873015873015872
chr2	HSPD1	197499258	197499438	0	181	102	6724	102	6543	0.0	0.015589179275561669
chr2	HSPD1	197490937	197491042	51	106	102	6724	51	6618	0.4811320754716981	0.0077062556663644605
chr2	HSPD1	197487287	197487379	0	93	102	6724	102	6631	0.0	0.015382295279746645
chr2	HSPD1	197489729	197489853	0	125	102	6724	102	6599	0.0	0.015456887407182906
chr2	HSPD1	197494662	197494752	0	91	102	6724	102	6633	0.0	0.015377657168701944
chr2	RFTN2	197587991	197588021	41	31	2507	5787	2466	5756	1.3225806451612903	0.42842251563585826
chr2	BOLL	197758941	197759007	0	67	6820	3989	6820	3922	0.0	1.7389087200407956
chr2	SATB2	199433337	199433514	0	178	0	10975	0	10797	0.0	0.0
chr2	FTCDNL1	199844379	199844532	0	154	0	2766	0	2612	0.0	0.0
chr2	AC097717.1	199882440	199882596	0	157	102	6765	102	6608	0.0	0.015435835351089588
chr2	AC097717.1	199894582	199894663	0	82	102	6765	102	6683	0.0	0.0152626066137962
chr2	AC097717.1	199908862	199908994	0	133	102	6765	102	6632	0.0	0.015379975874547648
chr2	AC097717.1	199884326	199884390	0	65	102	6765	102	6700	0.0	0.015223880597014926
chr2	AC097717.1	199879405	199879610	0	206	102	6765	102	6559	0.0	0.015551151090105199
chr2	AC097717.1	199880967	199881060	0	94	102	6765	102	6671	0.0	0.015290061460050967
chr2	AC097717.1	199881893	199881991	0	99	102	6765	102	6666	0.0	0.0153015301530153
chr2	AC097717.1	199879405	199879797	0	393	102	6765	102	6372	0.0	0.0160075329566855
chr2	AC097717.1	199880496	199880598	0	103	102	6765	102	6662	0.0	0.015310717502251577
chr2	AC097717.1	199896504	199896605	0	102	102	6765	102	6663	0.0	0.01530841963079694
chr2	AC097717.1	199908896	199908994	0	99	102	6765	102	6666	0.0	0.0153015301530153
chr2	TYW5	199936404	199936492	0	89	0	9858	0	9769	0.0	0.0
chr2	TYW5	199948317	199948472	0	156	0	9858	0	9702	0.0	0.0
chr2	TYW5	199948336	199948472	0	137	0	9858	0	9721	0.0	0.0
chr2	AC012459.1	200449375	200449468	0	94	306	8989	306	8895	0.0	0.034401349072512646
chr2	LINC01792	200716334	200716417	0	84	17984	3235	17984	3151	0.0	5.70739447794351
chr2	LINC01792	200727060	200727344	0	285	17984	3235	17984	2950	0.0	6.096271186440678
chr2	LINC01792	200727060	200727340	0	281	17984	3235	17984	2954	0.0	6.08801624915369
chr2	CLK1	200855003	200855086	0	84	0	4804	0	4720	0.0	0.0
chr2	CLK1	200860124	200860215	0	92	0	4804	0	4712	0.0	0.0
chr2	CLK1	200861701	200861862	0	162	0	4804	0	4642	0.0	0.0
chr2	PPIL3	200882341	200882435	0	95	0	2472	0	2377	0.0	0.0
chr2	PPIL3	200887612	200887685	0	74	0	2472	0	2398	0.0	0.0
chr2	PPIL3	200885261	200885367	0	107	0	2472	0	2365	0.0	0.0
chr2	PPIL3	200882341	200882382	0	42	0	2472	0	2430	0.0	0.0
chr2	PPIL3	200885261	200885343	0	83	0	2472	0	2389	0.0	0.0
chr2	ORC2	200958029	200958133	0	105	0	5850	0	5745	0.0	0.0
chr2	FAM126B	201045495	201045593	0	99	357	12477	357	12378	0.0	0.028841492971400873
chr2	FAM126B	200987364	200987532	0	169	357	12477	357	12308	0.0	0.029005524861878452
chr2	FAM126B	201022058	201022114	0	57	357	12477	357	12420	0.0	0.028743961352657006
chr2	FAM126B	201052172	201052269	0	98	357	12477	357	12379	0.0	0.028839163098796347
chr2	CFLAR-AS1	201148733	201148871	0	139	102	4158	102	4019	0.0	0.02537944762378701
chr2	CFLAR-AS1	201149330	201149443	0	114	102	4158	102	4044	0.0	0.025222551928783383
chr2	CFLAR-AS1	201147742	201147864	0	123	102	4158	102	4035	0.0	0.025278810408921933
chr2	CFLAR-AS1	201149124	201149200	0	77	102	4158	102	4081	0.0	0.024993874050477823
chr2	CFLAR-AS1	201144135	201144302	0	168	102	4158	102	3990	0.0	0.02556390977443609
chr2	CFLAR-AS1	201150370	201150489	0	120	102	4158	102	4038	0.0	0.02526002971768202
chr2	CFLAR-AS1	201145639	201145690	0	52	102	4158	102	4106	0.0	0.02484169508037019
chr2	CFLAR-AS1	201143346	201143469	0	124	102	4158	102	4034	0.0	0.02528507684680218
chr2	CFLAR-AS1	201144135	201144295	0	161	102	4158	102	3997	0.0	0.02551913935451589
chr2	CFLAR-AS1	201145573	201145690	0	118	102	4158	102	4040	0.0	0.02524752475247525
chr2	FLACC1	201289456	201289566	0	111	9140	2497	9140	2386	0.0	3.8306789606035205
chr2	FLACC1	201330735	201330833	0	99	9140	2497	9140	2398	0.0	3.811509591326105
chr2	FLACC1	201342369	201342431	3586	63	9140	2497	5554	2434	56.92063492063492	2.2818405916187348
chr2	FLACC1	201344169	201344263	32	95	9140	2497	9108	2402	0.3368421052631579	3.7918401332223146
chr2	C2CD6	201491168	201494759	759	3592	22978	6836	22219	3244	0.21130289532293986	6.849260172626387
chr2	TMEM237	201627320	201627414	0	95	40	7126	40	7031	0.0	0.005689091167685962
chr2	TMEM237	201640260	201640265	0	6	40	7126	40	7120	0.0	0.0056179775280898875
chr2	TMEM237	201634803	201634893	0	91	40	7126	40	7035	0.0	0.005685856432125089
chr2	TMEM237	201634386	201634397	0	12	40	7126	40	7114	0.0	0.0056227157717177395
chr2	MPP4	201685918	201686050	204	133	16083	4177	15879	4044	1.5338345864661653	3.9265578635014835
chr2	MPP4	201687290	201687371	8690	82	16083	4177	7393	4095	105.97560975609755	1.8053724053724054
chr2	MPP4	201660331	201660346	0	16	16083	4177	16083	4161	0.0	3.8651766402307137
chr2	MPP4	201664080	201664101	0	22	16083	4177	16083	4155	0.0	3.8707581227436823
chr2	MPP4	201664210	201664336	0	127	16083	4177	16083	4050	0.0	3.971111111111111
chr2	MPP4	201666596	201666721	0	126	16083	4177	16083	4051	0.0	3.9701308318933597
chr2	MPP4	201673528	201673556	0	29	16083	4177	16083	4148	0.0	3.8772902603664416
chr2	ALS2	201727704	201727775	969	72	244171	10478	243202	10406	13.458333333333334	23.37132423601768
chr2	ALS2	201719985	201720128	1245	144	244171	10478	242926	10334	8.645833333333334	23.50745113218502
chr2	ALS2	201778440	201778487	358	48	244171	10478	243813	10430	7.458333333333333	23.37612655800575
chr2	ALS2	201779978	201780083	403	106	244171	10478	243768	10372	3.80188679245283	23.502506748939453
chr2	SUMO1	202210734	202210806	0	73	126	2157	126	2084	0.0	0.060460652591170824
chr2	SUMO1	202220031	202220106	0	76	126	2157	126	2081	0.0	0.06054781355117732
chr2	SUMO1	202207867	202208002	0	136	126	2157	126	2021	0.0	0.06234537357743691
chr2	SUMO1	202210734	202210783	0	50	126	2157	126	2107	0.0	0.059800664451827246
chr2	SUMO1	202233577	202233670	0	94	126	2157	126	2063	0.0	0.06107610276296655
chr2	SUMO1	202231542	202231732	0	191	126	2157	126	1966	0.0	0.06408952187182096
chr2	ICA1L	202870529	202870656	0	128	209	10225	209	10097	0.0	0.020699217589382986
chr2	ICA1L	202786675	202786775	0	101	209	10225	209	10124	0.0	0.020644014223627025
chr2	ICA1L	202869535	202869605	0	71	209	10225	209	10154	0.0	0.020583021469371677
chr2	ICA1L	202860146	202860244	0	99	209	10225	209	10126	0.0	0.02063993679636579
chr2	RAPH1	203470238	203470313	2	76	21	11179	19	11103	0.02631578947368421	0.001711249211924705
chr2	RAPH1	203477075	203477156	0	82	21	11179	21	11097	0.0	0.001892403352257367
chr2	AC009498.1	204230180	204230291	0	112	1530	1074	1530	962	0.0	1.5904365904365905
chr2	AC007362.1	205761427	205761502	0	76	0	1629	0	1553	0.0	0.0
chr2	AC007362.1	205760797	205760911	0	115	0	1629	0	1514	0.0	0.0
chr2	AC007362.1	205761427	205761463	0	37	0	1629	0	1592	0.0	0.0
chr2	AC007362.1	205762387	205762509	0	123	0	1629	0	1506	0.0	0.0
chr2	INO80D	206063568	206063684	0	117	0	14385	0	14268	0.0	0.0
chr2	NDUFS1	206149817	206149925	0	109	153	12182	153	12073	0.0	0.01267290648554626
chr2	NDUFS1	206152418	206152510	0	93	153	12182	153	12089	0.0	0.012656133675241956
chr2	NDUFS1	206153617	206153682	0	66	153	12182	153	12116	0.0	0.012627930009904259
chr2	NDUFS1	206149779	206149925	0	147	153	12182	153	12035	0.0	0.01271292064810968
chr2	GPR1	206217362	206217613	0	252	0	2840	0	2588	0.0	0.0
chr2	GPR1	206203893	206203948	0	56	0	2840	0	2784	0.0	0.0
chr2	DYTN	206698755	206698971	0	217	0	2806	0	2589	0.0	0.0
chr2	MDH1B	206760900	206761013	0	114	0	2903	0	2789	0.0	0.0
chr2	KLF7	207148981	207149200	0	220	102	9124	102	8904	0.0	0.011455525606469003
chr2	AC009226.1	207417600	207417744	0	145	0	1292	0	1147	0.0	0.0
chr2	METTL21A	207621805	207621917	0	113	1324	4067	1324	3954	0.0	0.3348507840161861
chr2	METTL21A	207620640	207620694	0	55	1324	4067	1324	4012	0.0	0.3300099700897308
chr2	PLEKHM3	207929896	207929940	0	45	255	11431	255	11386	0.0	0.02239592481995433
chr2	C2ORF80	208168381	208168495	0	115	0	1402	0	1287	0.0	0.0
chr2	C2ORF80	208170944	208171063	0	120	0	1402	0	1282	0.0	0.0
chr2	C2ORF80	208184950	208185032	0	83	0	1402	0	1319	0.0	0.0
chr2	C2ORF80	208171987	208172075	0	89	0	1402	0	1313	0.0	0.0
chr2	KANSL1L	210031420	210031546	1	127	14893	6250	14892	6123	0.007874015748031496	2.432141107300343
chr2	KANSL1L	210026379	210026402	0	24	14893	6250	14893	6226	0.0	2.3920655316415034
chr2	MYL1	210302487	210302515	0	29	0	1335	0	1306	0.0	0.0
chr2	LANCL1	210437689	210437872	0	184	77	5060	77	4876	0.0	0.01579163248564397
chr2	ERBB4	211387944	211387992	0	49	51	13047	51	12998	0.0	0.00392368056624096
chr2	ERBB4	211657949	211657994	0	46	51	13047	51	13001	0.0	0.003922775171140681
chr2	IKZF2	213013790	213013934	0	145	0	12218	0	12073	0.0	0.0
chr2	IKZF2	213021992	213022130	0	139	0	12218	0	12079	0.0	0.0
chr2	IKZF2	213056910	213057099	0	190	0	12218	0	12028	0.0	0.0
chr2	IKZF2	213097876	213097960	0	85	0	12218	0	12133	0.0	0.0
chr2	IKZF2	213081169	213081238	0	70	0	12218	0	12148	0.0	0.0
chr2	IKZF2	213056565	213056744	0	180	0	12218	0	12038	0.0	0.0
chr2	BARD1	214780559	214781509	0	951	0	7585	0	6634	0.0	0.0
chr2	BARD1	214792296	214792445	0	150	0	7585	0	7435	0.0	0.0
chr2	BARD1	214797060	214797117	0	58	0	7585	0	7527	0.0	0.0
chr2	BARD1	214730234	214730280	0	47	0	7585	0	7538	0.0	0.0
chr2	BARD1	214780967	214781509	0	543	0	7585	0	7042	0.0	0.0
chr2	FN1	215372108	215372300	0	193	51	13933	51	13740	0.0	0.0037117903930131003
chr2	FN1	215372108	215372375	0	268	51	13933	51	13665	0.0	0.0037321624588364435
chr2	FN1	215380810	215381080	0	271	51	13933	51	13662	0.0	0.003732981993851559
chr2	FN1	215392930	215393203	0	274	51	13933	51	13659	0.0	0.0037338018888644848
chr2	LINC00607	215622685	215622761	0	77	4518	6966	4518	6889	0.0	0.6558281318043258
chr2	LINC00607	215740876	215741021	0	146	4518	6966	4518	6820	0.0	0.6624633431085044
chr2	LINC00607	215641230	215641819	816	590	4518	6966	3702	6376	1.383050847457627	0.5806148055207027
chr2	LINC00607	215797359	215797591	0	233	4518	6966	4518	6733	0.0	0.6710233179860389
chr2	LINC00607	215750242	215750417	0	176	4518	6966	4518	6790	0.0	0.6653902798232695
chr2	LINC00607	215701047	215701219	142	173	4518	6966	4376	6793	0.8208092485549133	0.6441925511556014
chr2	PECR	216058894	216058976	0	83	102	3209	102	3126	0.0	0.03262955854126679
chr2	DIRC3	217599611	217600829	0	1219	4903	8277	4903	7058	0.0	0.6946727118163786
chr2	TNS1	217829843	217829882	0	40	58	16327	58	16287	0.0	0.0035611223675323877
chr2	TNS1	217830366	217830390	0	25	58	16327	58	16302	0.0	0.003557845663108821
chr2	TNS1	217901709	217901823	0	115	58	16327	58	16212	0.0	0.0035775968418455466
chr2	TMBIM1	218278514	218278565	0	52	0	5110	0	5058	0.0	0.0
chr2	TMBIM1	218279288	218279353	0	66	0	5110	0	5044	0.0	0.0
chr2	TMBIM1	218281939	218282181	0	243	0	5110	0	4867	0.0	0.0
chr2	TMBIM1	218285762	218285938	0	177	0	5110	0	4933	0.0	0.0
chr2	TMBIM1	218284038	218284136	0	99	0	5110	0	5011	0.0	0.0
chr2	TMBIM1	218285762	218285934	0	173	0	5110	0	4937	0.0	0.0
chr2	TMBIM1	218284038	218284160	0	123	0	5110	0	4987	0.0	0.0
chr2	TMBIM1	218284038	218284266	0	229	0	5110	0	4881	0.0	0.0
chr2	USP37	218479649	218479715	0	67	254	9311	254	9244	0.0	0.02747728256166162
chr2	USP37	218534608	218534706	0	99	254	9311	254	9212	0.0	0.027572731220147632
chr2	USP37	218558497	218558677	0	181	254	9311	254	9130	0.0	0.027820372398685653
chr2	USP37	218558497	218558717	0	221	254	9311	254	9090	0.0	0.027942794279427943
chr2	ZNF142	218651700	218652300	0	601	51	11333	51	10732	0.0	0.004752143123369363
chr2	ZNF142	218658700	218658876	0	177	51	11333	51	11156	0.0	0.00457153101470061
chr2	ZNF142	218651700	218651822	0	123	51	11333	51	11210	0.0	0.004549509366636931
chr2	ZNF142	218658700	218658801	0	102	51	11333	51	11231	0.0	0.004541002582138723
chr2	PRKAG3	218827832	218827878	0	47	102	3347	102	3300	0.0	0.03090909090909091
chr2	CFAP65	219031488	219031658	0	171	145	10236	145	10065	0.0	0.014406358668653751
chr2	CFAP65	219038895	219039050	0	156	145	10236	145	10080	0.0	0.014384920634920634
chr2	CFAP65	219038895	219038944	0	50	145	10236	145	10186	0.0	0.014235224818378167
chr2	CFAP65	219038895	219038942	0	48	145	10236	145	10188	0.0	0.014232430310168825
chr2	NHEJ1	219095273	219095355	735	83	36511	3122	35776	3039	8.855421686746988	11.772293517604474
chr2	SLC23A3	219169308	219169406	0	99	844	3310	844	3211	0.0	0.26284646527561506
chr2	SLC23A3	219165168	219165422	51	255	844	3310	793	3055	0.2	0.25957446808510637
chr2	SLC23A3	219168651	219168833	0	183	844	3310	844	3127	0.0	0.26990725935401344
chr2	SLC23A3	219168647	219168833	0	187	844	3310	844	3123	0.0	0.2702529618956132
chr2	ABCB6	219210933	219211108	24135	176	43902	4486	19767	4310	137.1306818181818	4.58631090487239
chr2	ABCB6	219215996	219216180	0	185	43902	4486	43902	4301	0.0	10.207393629388514
chr2	ABCB6	219216651	219216832	0	182	43902	4486	43902	4304	0.0	10.200278810408921
chr2	ABCB6	219217669	219217807	0	139	43902	4486	43902	4347	0.0	10.099378881987578
chr2	ATG9A	219222049	219222167	0	119	210	4730	210	4611	0.0	0.04554326610279766
chr2	ATG9A	219227921	219228053	0	133	210	4730	210	4597	0.0	0.04568196649989123
chr2	ATG9A	219228433	219228485	0	53	210	4730	210	4677	0.0	0.04490057729313662
chr2	ATG9A	219229009	219229174	0	166	210	4730	210	4564	0.0	0.046012269938650305
chr2	ATG9A	219228433	219228482	0	50	210	4730	210	4680	0.0	0.04487179487179487
chr2	ATG9A	219227921	219228079	0	159	210	4730	210	4571	0.0	0.045941807044410414
chr2	ATG9A	219228423	219228485	0	63	210	4730	210	4667	0.0	0.04499678594386115
chr2	GLB1L	219239919	219240094	0	176	121	3358	121	3182	0.0	0.03802639849151477
chr2	GLB1L	219243778	219243942	0	165	121	3358	121	3193	0.0	0.03789539617914187
chr2	TUBA4A	219252007	219252230	0	224	51	3973	51	3749	0.0	0.013603627634035742
chr2	PTPRN	219290537	219290611	0	75	825	6977	825	6902	0.0	0.11953057084902927
chr2	PTPRN	219299699	219299786	0	88	825	6977	825	6889	0.0	0.11975613296559733
chr2	PTPRN	219308881	219308977	0	97	825	6977	825	6880	0.0	0.11991279069767442
chr2	RESP18	219328923	219329008	0	86	2969	1150	2969	1064	0.0	2.7904135338345863
chr2	RESP18	219329362	219329404	0	43	2969	1150	2969	1107	0.0	2.6820234869015356
chr2	DNPEP	219385423	219385531	0	109	3475	5992	3475	5883	0.0	0.5906850246472888
chr2	DNPEP	219385630	219385706	0	77	3475	5992	3475	5915	0.0	0.5874894336432798
chr2	DNPEP	219399439	219399500	0	62	3475	5992	3475	5930	0.0	0.5860033726812817
chr2	OBSL1	219557342	219557618	5966	277	231043	9151	225077	8874	21.537906137184116	25.363646608068514
chr2	OBSL1	219558183	219558459	1819	277	231043	9151	229224	8874	6.566787003610108	25.830966869506423
chr2	EPHA4	221429957	221430151	0	195	102	7576	102	7381	0.0	0.013819265682156889
chr2	EPHA4	221568717	221568785	0	69	102	7576	102	7507	0.0	0.013587318502730785
chr2	PAX3	222201943	222202190	0	248	3264	7543	3264	7295	0.0	0.44742974640164496
chr2	SCG2	223602141	223602217	0	77	0	2579	0	2502	0.0	0.0
chr2	AP1S3	223775900	223776009	0	110	7778	5957	7778	5847	0.0	1.3302548315375406
chr2	AP1S3	223773312	223773351	0	40	7778	5957	7778	5917	0.0	1.3145174919722833
chr2	AP1S3	223776048	223776158	510	111	7778	5957	7268	5846	4.594594594594595	1.2432432432432432
chr2	AP1S3	223770196	223770325	0	130	7778	5957	7778	5827	0.0	1.3348206624334993
chr2	SERPINE2	224010342	224010386	0	45	0	6288	0	6243	0.0	0.0
chr2	FAM124B	224400380	224400505	0	126	1530	3566	1530	3440	0.0	0.44476744186046513
chr2	CUL3	224481891	224482078	0	188	11944	10494	11944	10306	0.0	1.1589365418202988
chr2	CUL3	224557658	224557856	0	199	11944	10494	11944	10295	0.0	1.1601748421563867
chr2	CUL3	224478199	224478345	0	147	11944	10494	11944	10347	0.0	1.1543442543732483
chr2	CUL3	224556294	224556420	0	127	11944	10494	11944	10367	0.0	1.152117295263818
chr2	CUL3	224556294	224556389	0	96	11944	10494	11944	10398	0.0	1.1486824389305637
chr2	DOCK10	224768871	224768947	0	77	510886	11350	510886	11273	0.0	45.31943582010113
chr2	DOCK10	224784736	224784742	0	7	510886	11350	510886	11343	0.0	45.039760204531426
chr2	MFF-DT	227268352	227268443	0	92	0	11480	0	11388	0.0	0.0
chr2	MFF-DT	227281703	227281789	0	87	0	11480	0	11393	0.0	0.0
chr2	MFF-DT	227305459	227305655	0	197	0	11480	0	11283	0.0	0.0
chr2	MFF-DT	227268627	227268769	0	143	0	11480	0	11337	0.0	0.0
chr2	MFF-DT	227279482	227279578	0	97	0	11480	0	11383	0.0	0.0
chr2	MFF-DT	227301792	227301974	0	183	0	11480	0	11297	0.0	0.0
chr2	MFF-DT	227251115	227251239	0	125	0	11480	0	11355	0.0	0.0
chr2	SLC19A3	227698735	227699564	0	830	46205	5687	46205	4857	0.0	9.513073913938646
chr2	SLC19A3	227702168	227702320	1944	153	46205	5687	44261	5534	12.705882352941176	7.998012287676183
chr2	SLC19A3	227700912	227701108	2714	197	46205	5687	43491	5490	13.776649746192893	7.921857923497268
chr2	SLC19A3	227702591	227702691	257	101	46205	5687	45948	5586	2.5445544554455446	8.225563909774436
chr2	SLC19A3	227698735	227698846	0	112	46205	5687	46205	5575	0.0	8.287892376681615
chr2	SLC19A3	227706552	227706743	0	192	46205	5687	46205	5495	0.0	8.40855323020928
chr2	SLC19A3	227702168	227702691	8142	524	46205	5687	38063	5163	15.538167938931299	7.372264187487895
chr2	SPHKAP	227993533	227993620	0	88	187	7058	187	6970	0.0	0.026829268292682926
chr2	PID1	229155817	229155964	0	148	0	3375	0	3227	0.0	0.0
chr2	PID1	229262682	229262893	0	212	0	3375	0	3163	0.0	0.0
chr2	PID1	229227956	229228063	0	108	0	3375	0	3267	0.0	0.0
chr2	TRIP12	229771518	229771632	0	115	204	12692	204	12577	0.0	0.016220084280830088
chr2	TRIP12	229860405	229860531	0	127	204	12692	204	12565	0.0	0.01623557500994827
chr2	TRIP12	229908964	229909086	0	123	204	12692	204	12569	0.0	0.0162304081470284
chr2	TRIP12	229900736	229900858	0	123	204	12692	204	12569	0.0	0.0162304081470284
chr2	SLC16A14	230067098	230067237	0	140	97	4940	97	4800	0.0	0.02020833333333333
chr2	SP110	230171695	230171767	0	73	1173	8874	1173	8801	0.0	0.1332803090557891
chr2	SP110	230216780	230216928	0	149	1173	8874	1173	8725	0.0	0.13444126074498566
chr2	SP110	230170620	230170761	0	142	1173	8874	1173	8732	0.0	0.13433348602840128
chr2	SP110	230219555	230219673	0	119	1173	8874	1173	8755	0.0	0.13398058252427184
chr2	SP110	230216780	230216821	0	42	1173	8874	1173	8832	0.0	0.1328125
chr2	AC010149.1	230570639	230570715	0	77	0	700	0	623	0.0	0.0
chr2	SPATA3-AS1	230992333	230992402	0	70	306	3752	306	3682	0.0	0.08310700706137969
chr2	SPATA3-AS1	230991768	230991975	0	208	306	3752	306	3544	0.0	0.0863431151241535
chr2	SPATA3-AS1	230989660	230989832	0	173	306	3752	306	3579	0.0	0.08549874266554904
chr2	SPATA3-AS1	230991768	230992036	0	269	306	3752	306	3483	0.0	0.08785529715762273
chr2	SPATA3-AS1	230991768	230992039	0	272	306	3752	306	3480	0.0	0.08793103448275862
chr2	NCL	231455827	231455904	0	78	0	6296	0	6218	0.0	0.0
chr2	NCL	231456009	231456136	0	128	0	6296	0	6168	0.0	0.0
chr2	NCL	231457285	231457357	0	73	0	6296	0	6223	0.0	0.0
chr2	PDE6D	231737186	231737292	0	107	3130	2832	3130	2725	0.0	1.1486238532110091
chr2	ECEL1	232481090	232481156	396	67	1958	2995	1562	2928	5.91044776119403	0.5334699453551912
chr2	AC073254.1	232581983	232582141	0	159	1405	3540	1405	3381	0.0	0.4155575273587696
chr2	AC073254.1	232610731	232610872	28	142	1405	3540	1377	3398	0.19718309859154928	0.40523837551500885
chr2	AC073254.1	232611474	232611654	0	181	1405	3540	1405	3359	0.0	0.41827924977671926
chr2	USP40	233488238	233488304	0	67	569	8632	569	8565	0.0	0.06643315820198482
chr2	USP40	233491031	233491071	0	41	569	8632	569	8591	0.0	0.06623210336398556
chr2	HJURP	233844204	233844283	0	80	3	3831	3	3751	0.0	0.0007997867235403892
chr2	HJURP	233845727	233845820	0	94	3	3831	3	3737	0.0	0.0008027829810008028
chr2	HJURP	233847396	233847461	3	66	3	3831	0	3765	0.045454545454545456	0.0
chr2	HJURP	233849762	233849859	0	98	3	3831	3	3733	0.0	0.0008036431824270024
chr2	AC010148.1	234857334	234857419	0	86	0	4307	0	4221	0.0	0.0
chr2	GBX2	236167137	236167174	0	38	0	2335	0	2297	0.0	0.0
chr2	ASB18	236241279	236241402	0	124	0	5562	0	5438	0.0	0.0
chr2	IQCA1	236419148	236419271	0	124	3476	5992	3476	5868	0.0	0.5923653715064758
chr2	IQCA1	236343701	236343763	0	63	3476	5992	3476	5929	0.0	0.5862708719851577
chr2	AC012063.1	236979929	236980067	0	139	2056	13105	2056	12966	0.0	0.15856856393644916
chr2	AC012063.1	236959770	236959840	47	71	2056	13105	2009	13034	0.6619718309859155	0.15413533834586465
chr2	COL6A3	237378635	237379235	0	601	2637	19510	2637	18909	0.0	0.13945740123750594
chr2	COL6A3	237387581	237388184	0	604	2637	19510	2637	18906	0.0	0.13947953030783877
chr2	COL6A3	237394586	237395204	0	619	2637	19510	2637	18891	0.0	0.13959028108623153
chr2	RAB17	237578003	237578155	51	153	51	4078	0	3925	0.3333333333333333	0.0
chr2	RAB17	237585997	237586157	0	161	51	4078	51	3917	0.0	0.013020168496298187
chr2	RAB17	237586041	237586157	0	117	51	4078	51	3961	0.0	0.012875536480686695
chr2	RAB17	237586063	237586157	0	95	51	4078	51	3983	0.0	0.012804418779814211
chr2	ILKAP	238185180	238185287	0	108	2407	4683	2407	4575	0.0	0.526120218579235
chr2	LINC02610	238229315	238229668	0	354	0	3731	0	3377	0.0	0.0
chr2	HES6	238239660	238239747	0	88	2652	1138	2652	1050	0.0	2.525714285714286
chr2	PER2	238262951	238263058	0	108	10346	6896	10346	6788	0.0	1.524160282852092
chr2	NDUFA10	240005209	240005295	0	87	58376	18589	58376	18502	0.0	3.155118365582099
chr2	NDUFA10	240011616	240014860	10883	3245	58376	18589	47493	15344	3.3537750385208014	3.0952163712200207
chr2	NDUFA10	240022171	240022340	102	170	58376	18589	58274	18419	0.6	3.163798251805201
chr2	NDUFA10	239990073	239990182	210	110	58376	18589	58166	18479	1.9090909090909092	3.1476811515774665
chr2	NDUFA10	239961022	239961186	0	165	58376	18589	58376	18424	0.0	3.1684759009986974
chr2	NDUFA10	240021770	240021860	0	91	58376	18589	58376	18498	0.0	3.155800627094821
chr2	NDUFA10	240017814	240017905	0	92	58376	18589	58376	18497	0.0	3.155971238579229
chr2	NDUFA10	240000182	240000387	892	206	58376	18589	57484	18383	4.330097087378641	3.1270195289125824
chr2	NDUFA10	239960954	239961186	0	233	58376	18589	58376	18356	0.0	3.1802135541512313
chr2	NDUFA10	239982114	239982219	1173	106	58376	18589	57203	18483	11.066037735849056	3.094898014391603
chr2	NDUFA10	240012486	240012534	13	49	58376	18589	58363	18540	0.2653061224489796	3.147950377562028
chr2	NDUFA10	239987515	239987578	0	64	58376	18589	58376	18525	0.0	3.1512010796221324
chr2	NDUFA10	239964182	239964261	0	80	58376	18589	58376	18509	0.0	3.1539251175104
chr2	ANKMY1	240482182	240482261	0	80	0	7366	0	7286	0.0	0.0
chr2	ANKMY1	240557189	240557352	0	164	0	7366	0	7202	0.0	0.0
chr2	ANKMY1	240509347	240509455	0	109	0	7366	0	7257	0.0	0.0
chr2	ANKMY1	240511860	240512001	0	142	0	7366	0	7224	0.0	0.0
chr2	ANKMY1	240526228	240526445	0	218	0	7366	0	7148	0.0	0.0
chr2	ANKMY1	240529036	240529509	0	474	0	7366	0	6892	0.0	0.0
chr2	ANKMY1	240507559	240507691	0	133	0	7366	0	7233	0.0	0.0
chr2	ANKMY1	240558303	240558619	0	317	0	7366	0	7049	0.0	0.0
chr2	AQP12B	240677598	240679781	0	2184	0	1584	0	-600	0.0	-0.0
chr2	KIF1A	240757318	240757594	0	277	667	16333	667	16056	0.0	0.04154210264075735
chr2	KIF1A	240772569	240772596	0	28	667	16333	667	16305	0.0	0.040907697025452314
chr2	KIF1A	240728388	240728412	0	25	667	16333	667	16308	0.0	0.04090017169487368
chr2	KIF1A	240734718	240734745	0	28	667	16333	667	16305	0.0	0.040907697025452314
chr2	KIF1A	240739555	240739669	0	115	667	16333	667	16218	0.0	0.04112714268097176
chr2	KIF1A	240720224	240720389	0	166	667	16333	667	16167	0.0	0.04125688130141646
chr2	KIF1A	240744256	240744334	0	79	667	16333	667	16254	0.0	0.04103605266395964
chr2	KIF1A	240775041	240775167	0	127	667	16333	667	16206	0.0	0.0411575959521165
chr2	KIF1A	240788379	240788508	0	130	667	16333	667	16203	0.0	0.04116521631796581
chr2	KIF1A	240796959	240797047	0	89	667	16333	667	16244	0.0	0.04106131494705738
chr2	MTERF4	241094276	241094432	0	157	53932	9722	53932	9565	0.0	5.638473601672765
chr2	MTERF4	241095129	241096438	0	1310	53932	9722	53932	8412	0.0	6.4113171659534
chr2	MTERF4	241099395	241099894	0	500	53932	9722	53932	9222	0.0	5.848189112990674
chr2	MTERF4	241097242	241097427	0	186	53932	9722	53932	9536	0.0	5.655620805369128
chr2	MTERF4	241090277	241090449	0	173	53932	9722	53932	9549	0.0	5.6479212482982515
chr2	MTERF4	241096392	241096438	0	47	53932	9722	53932	9675	0.0	5.5743669250645995
chr2	MTERF4	241101163	241101221	0	59	53932	9722	53932	9663	0.0	5.581289454620718
chr2	PASK	241142836	241143074	0	239	0	10561	0	10322	0.0	0.0
chr2	PASK	241145749	241145860	0	112	0	10561	0	10449	0.0	0.0
chr2	HDLBP	241255373	241255580	0	208	0	11245	0	11037	0.0	0.0
chr2	HDLBP	241267577	241267708	0	132	0	11245	0	11113	0.0	0.0
chr2	HDLBP	241255373	241255511	0	139	0	11245	0	11106	0.0	0.0
chr2	HDLBP	241268953	241269105	0	153	0	11245	0	11092	0.0	0.0
chr2	HDLBP	241268953	241269295	0	343	0	11245	0	10902	0.0	0.0
chr2	HDLBP	241268828	241268953	0	126	0	11245	0	11119	0.0	0.0
chr2	HDLBP	241269200	241269295	0	96	0	11245	0	11149	0.0	0.0
chr2	HDLBP	241266536	241266627	0	92	0	11245	0	11153	0.0	0.0
chr2	HDLBP	241267591	241267708	0	118	0	11245	0	11127	0.0	0.0
chr2	HDLBP	241268957	241269295	0	339	0	11245	0	10906	0.0	0.0
chr2	HDLBP	241268828	241269295	0	468	0	11245	0	10777	0.0	0.0
chr2	STK25	241498234	241498349	0	116	60500	5262	60500	5146	0.0	11.756704236300038
chr2	STK25	241501477	241501708	5667	232	60500	5262	54833	5030	24.426724137931036	10.901192842942345
chr2	STK25	241508005	241508135	5009	131	60500	5262	55491	5131	38.23664122137404	10.81485090625609
chr2	STK25	241500739	241500796	1271	58	60500	5262	59229	5204	21.913793103448278	11.381437355880092
chr2	STK25	241501477	241501799	6937	323	60500	5262	53563	4939	21.476780185758514	10.844907876088277
chr2	STK25	241504037	241504096	51	60	60500	5262	60449	5202	0.85	11.620338331410995
chr2	DTYMK	241680228	241680319	0	92	51	2407	51	2315	0.0	0.022030237580993522
chr2	DTYMK	241684715	241684749	0	35	51	2407	51	2372	0.0	0.021500843170320406
chr2	DTYMK	241681918	241682333	0	416	51	2407	51	1991	0.0	0.025615268709191362
chr2	DTYMK	241682798	241682915	0	118	51	2407	51	2289	0.0	0.022280471821756225
chr2	PDCD1	241852197	241852353	0	157	51	2102	51	1945	0.0	0.02622107969151671
chr2	LINC01880	242059119	242059193	51	75	28668	1573	28617	1498	0.68	19.10347129506008
chr2	AC079779.1	199743	199901	0	159	0	4340	0	4181	0.0	0.0
chr2	AC079779.1	202915	202988	0	74	0	4340	0	4266	0.0	0.0
chr2	ACP1	269300	269347	0	48	758753	3562	758753	3514	0.0	215.9228799089357
chr2	ACP1	275139	275201	36987	63	758753	3562	721766	3499	587.0952380952381	206.2777936553301
chr2	ACP1	272036	272065	6660	30	758753	3562	752093	3532	222.0	212.93686296715742
chr2	AC093326.1	558733	558990	0	258	0	2562	0	2304	0.0	0.0
chr2	SNTG2	1237887	1238017	0	131	0	4516	0	4385	0.0	0.0
chr2	SNTG2	1103404	1103442	0	39	0	4516	0	4477	0.0	0.0
chr2	TPO	1503947	1504079	0	133	32	6780	32	6647	0.0	0.004814201895591996
chr2	TPO	1477085	1477604	0	520	32	6780	32	6260	0.0	0.005111821086261981
chr2	TPO	1487820	1487991	0	172	32	6780	32	6608	0.0	0.004842615012106538
chr2	TPO	1540593	1540723	0	131	32	6780	32	6649	0.0	0.004812753797563543
chr2	TRAPPC12	3477694	3477795	1177	102	41955	8700	40778	8598	11.53921568627451	4.742730867643638
chr2	TRAPPC12	3421699	3421786	42	88	41955	8700	41913	8612	0.4772727272727273	4.866813748258244
chr2	TRAPPC12	3457149	3457229	1241	81	41955	8700	40714	8619	15.320987654320987	4.723749854971574
chr2	TRAPPC12	3477691	3477795	1303	105	41955	8700	40652	8595	12.40952380952381	4.729726585223967
chr2	TRAPPC12	3462857	3463071	486	215	41955	8700	41469	8485	2.26046511627907	4.88733058338244
chr2	RNASEH1-AS1	3559447	3559729	0	283	0	4380	0	4097	0.0	0.0
chr2	RNASEH1-AS1	3559403	3559729	0	327	0	4380	0	4053	0.0	0.0
chr2	COLEC11	3613310	3613382	120	73	47562	2791	47442	2718	1.643835616438356	17.454746136865342
chr2	COLEC11	3637532	3637604	0	73	47562	2791	47562	2718	0.0	17.49889624724062
chr2	COLEC11	3626013	3626092	1215	80	47562	2791	46347	2711	15.1875	17.095905569900406
chr2	COLEC11	3641239	3641432	152	194	47562	2791	47410	2597	0.7835051546391752	18.2556796303427
chr2	AC010729.1	5728086	5728152	0	67	0	2024	0	1957	0.0	0.0
chr2	SILC1	5969329	5969486	0	158	255	19776	255	19618	0.0	0.012998266897746967
chr2	SILC1	5982297	5982857	0	561	255	19776	255	19215	0.0	0.01327088212334114
chr2	SILC1	5982772	5982857	0	86	255	19776	255	19690	0.0	0.012950736414423566
chr2	SILC1	5942600	5942768	0	169	255	19776	255	19607	0.0	0.013005559239047278
chr2	AC013460.1	7421684	7421843	0	160	0	5222	0	5062	0.0	0.0
chr2	AC013460.1	7422572	7424012	0	1441	0	5222	0	3781	0.0	0.0
chr2	AC013460.1	7426850	7427019	0	170	0	5222	0	5052	0.0	0.0
chr2	AC013460.1	7436004	7436097	0	94	0	5222	0	5128	0.0	0.0
chr2	AC013460.1	7428542	7429872	0	1331	0	5222	0	3891	0.0	0.0
chr2	AC013460.1	7430179	7430293	0	115	0	5222	0	5107	0.0	0.0
chr2	AC013460.1	7422572	7423035	0	464	0	5222	0	4758	0.0	0.0
chr2	AC013460.1	7429695	7429872	0	178	0	5222	0	5044	0.0	0.0
chr2	AC013460.1	7428542	7429273	0	732	0	5222	0	4490	0.0	0.0
chr2	AC013460.1	7428542	7428894	0	353	0	5222	0	4869	0.0	0.0
chr2	AC013460.1	7449752	7449780	0	29	0	5222	0	5193	0.0	0.0
chr2	U91324.1	8141784	8141883	0	100	0	1720	0	1620	0.0	0.0
chr2	ASAP2	9391061	9391196	51	136	806	7286	755	7150	0.375	0.1055944055944056
chr2	ASAP2	9336035	9336044	0	10	806	7286	806	7276	0.0	0.11077515118196811
chr2	IAH1	9475986	9476039	0	54	64994	5393	64994	5339	0.0	12.173440719235812
chr2	AC080162.1	9506786	9507015	1581	230	2052	572	471	342	6.873913043478261	1.3771929824561404
chr2	AC082651.1	9639051	9639254	1499	204	25389	2967	23890	2763	7.348039215686274	8.64639884183858
chr2	AC082651.1	9648851	9649003	1382	153	25389	2967	24007	2814	9.032679738562091	8.531272210376688
chr2	TAF1B	9875864	9876018	0	155	226	3995	226	3840	0.0	0.058854166666666666
chr2	TAF1B	9846056	9846186	177	131	226	3995	49	3864	1.3511450381679388	0.012681159420289856
chr2	GRHL1	9962454	9962531	0	78	2042	4949	2042	4871	0.0	0.41921576678300143
chr2	GRHL1	9952906	9953060	0	155	2042	4949	2042	4794	0.0	0.4259491030454735
chr2	HPCAL1	10406264	10406361	0	98	1085	4816	1085	4718	0.0	0.22997032640949555
chr2	HPCAL1	10408561	10408734	0	174	1085	4816	1085	4642	0.0	0.23373545885394226
chr2	HPCAL1	10424524	10424613	0	90	1085	4816	1085	4726	0.0	0.22958104104951332
chr2	ODC1-DT	10455245	10455268	0	24	7826	3663	7826	3639	0.0	2.150590821654301
chr2	ATP6V1C2	10777584	10777722	480	139	8060	3434	7580	3295	3.4532374100719423	2.300455235204856
chr2	ATP6V1C2	10757426	10757456	176	31	8060	3434	7884	3403	5.67741935483871	2.316779312371437
chr2	SLC66A3	11172750	11172824	0	75	0	2280	0	2205	0.0	0.0
chr2	SLC66A3	11171924	11172045	0	122	0	2280	0	2158	0.0	0.0
chr2	SLC66A3	11174967	11175009	0	43	0	2280	0	2237	0.0	0.0
chr2	LINC00570	11400371	11400457	0	87	663	2182	663	2095	0.0	0.3164677804295943
chr2	LINC00570	11399671	11399774	0	104	663	2182	663	2078	0.0	0.3190567853705486
chr2	LPIN1	11776085	11776193	0	109	102	11894	102	11785	0.0	0.008655070004242682
chr2	LPIN1	11763022	11763286	0	265	102	11894	102	11629	0.0	0.008771175509502106
chr2	LPIN1	11764203	11764289	0	87	102	11894	102	11807	0.0	0.008638942999915305
chr2	LPIN1	11791707	11791785	0	79	102	11894	102	11815	0.0	0.008633093525179856
chr2	MIR3681HG	12106455	12106684	0	230	3315	8436	3315	8206	0.0	0.40397270290031684
chr2	MIR3681HG	12416088	12416286	0	199	3315	8436	3315	8237	0.0	0.4024523491562462
chr2	MIR3681HG	12340217	12340301	0	85	3315	8436	3315	8351	0.0	0.3969584480900491
chr2	MIR3681HG	12397521	12398370	0	850	3315	8436	3315	7586	0.0	0.4369891906142895
chr2	AC011897.1	14628602	14628684	0	83	51	349	51	266	0.0	0.19172932330827067
chr2	LRATD1	14633585	14633828	0	244	544	7141	544	6897	0.0	0.07887487313324634
chr2	DDX1	15613223	15613284	0	62	561	8850	561	8788	0.0	0.06383705052344106
chr2	DDX1	15621064	15621116	0	53	561	8850	561	8797	0.0	0.06377174036603388
chr2	DDX1	15628444	15628839	0	396	561	8850	561	8454	0.0	0.06635911994322215
chr2	LINC01804	15708345	15708446	0	102	258	2232	258	2130	0.0	0.12112676056338029
chr2	MYCN	15941947	15942854	0	908	0	2619	0	1711	0.0	0.0
chr2	GACAT3	16034145	16034305	0	161	0	3700	0	3539	0.0	0.0
chr2	GACAT3	16074166	16074373	0	208	0	3700	0	3492	0.0	0.0
chr2	GACAT3	16074021	16074373	0	353	0	3700	0	3347	0.0	0.0
chr2	AC010745.2	16278526	16278609	44	84	95	5384	51	5300	0.5238095238095238	0.009622641509433962
chr2	AC010880.1	16431730	16431807	0	78	0	482	0	404	0.0	0.0
chr2	AC104623.1	16524854	16525037	0	184	0	1466	0	1282	0.0	0.0
chr2	AC104623.1	16524692	16525037	0	346	0	1466	0	1120	0.0	0.0
chr2	AC008164.1	16765011	16765125	0	115	0	2725	0	2610	0.0	0.0
chr2	VSNL1	17546002	17546023	0	22	5865	3799	5865	3777	0.0	1.5528196981731532
chr2	LINC01808	19479223	19479284	0	62	1938	3067	1938	3005	0.0	0.6449251247920134
chr2	LINC01808	19479096	19479284	0	189	1938	3067	1938	2878	0.0	0.6733842946490618
chr2	LINC01808	19487311	19487515	0	205	1938	3067	1938	2862	0.0	0.6771488469601677
chr2	LINC01808	19479096	19479142	0	47	1938	3067	1938	3020	0.0	0.6417218543046358
chr2	LINC00954	19870424	19870546	0	123	0	6418	0	6295	0.0	0.0
chr2	LINC00954	19870401	19870546	0	146	0	6418	0	6272	0.0	0.0
chr2	LINC00954	19869074	19869156	0	83	0	6418	0	6335	0.0	0.0
chr2	AC018742.1	21258769	21258899	0	131	0	1026	0	895	0.0	0.0
chr2	AC011752.1	21356576	21356847	0	272	0	3336	0	3064	0.0	0.0
chr2	AC011752.1	21396254	21396364	0	111	0	3336	0	3225	0.0	0.0
chr2	LINC01884	22518300	22518391	0	92	0	1354	0	1262	0.0	0.0
chr2	LINC01884	22539739	22539803	0	65	0	1354	0	1289	0.0	0.0
chr2	LINC01884	22543431	22543555	0	125	0	1354	0	1229	0.0	0.0
chr2	UBXN2A	23939539	23939662	0	124	1020	6848	1020	6724	0.0	0.15169541939321832
chr2	MFSD2B	24017285	24017364	0	80	1473	4542	1473	4462	0.0	0.33012102196324516
chr2	MFSD2B	24020001	24020085	0	85	1473	4542	1473	4457	0.0	0.33049136190262507
chr2	FKBP1B	24054103	24054192	0	90	0	1249	0	1159	0.0	0.0
chr2	FKBP1B	24054472	24054540	0	69	0	1249	0	1180	0.0	0.0
chr2	FAM228B	24095140	24095229	0	90	1191	4946	1191	4856	0.0	0.24526359143327842
chr2	FAM228B	24161505	24161613	126	109	1191	4946	1065	4837	1.1559633027522935	0.2201777961546413
chr2	FAM228B	24167626	24167683	0	58	1191	4946	1191	4888	0.0	0.24365793780687398
chr2	FAM228B	24137908	24138100	0	193	1191	4946	1191	4753	0.0	0.25057858194824323
chr2	FAM228B	24165372	24165500	0	129	1191	4946	1191	4817	0.0	0.2472493253062072
chr2	FAM228A	24179110	24179297	0	188	0	2289	0	2101	0.0	0.0
chr2	FAM228A	24179110	24179227	0	118	0	2289	0	2171	0.0	0.0
chr2	AC009228.1	24220772	24220962	37	191	14678	5047	14641	4856	0.193717277486911	3.01503294892916
chr2	NCOA1	24584475	24584560	0	86	531	8659	531	8573	0.0	0.061938644581826664
chr2	NCOA1	24665748	24665915	0	168	531	8659	531	8491	0.0	0.06253680367447886
chr2	NCOA1	24554388	24554573	204	186	531	8659	327	8473	1.096774193548387	0.0385931783311696
chr2	NCOA1	24768078	24768135	76	58	531	8659	455	8601	1.3103448275862069	0.05290082548540867
chr2	CENPO	24793851	24793965	0	115	51	5526	51	5411	0.0	0.009425244871557938
chr2	DNAJC27-AS1	25004066	25004110	0	45	128132	5744	128132	5699	0.0	22.48324267415336
chr2	DNAJC27-AS1	25001414	25001545	0	132	128132	5744	128132	5612	0.0	22.831789023521026
chr2	DNAJC27-AS1	25027310	25027517	0	208	128132	5744	128132	5536	0.0	23.145231213872833
chr2	DNAJC27-AS1	25003984	25004110	0	127	128132	5744	128132	5617	0.0	22.81146519494392
chr2	DNAJC27-AS1	25028548	25028640	0	93	128132	5744	128132	5651	0.0	22.674216952751724
chr2	EFR3B	25139058	25139190	0	133	160564	10668	160564	10535	0.0	15.241006169909824
chr2	RAB10	26109767	26109906	0	140	0	3661	0	3521	0.0	0.0
chr2	GAREM2	26186188	26186358	0	171	1421	5694	1421	5523	0.0	0.2572877059569075
chr2	HADHB	26269952	26269997	440	46	1022	3812	582	3766	9.565217391304348	0.15454062665958576
chr2	DRC1	26424270	26424454	0	185	56480	2931	56480	2746	0.0	20.568099053168243
chr2	DRC1	26440377	26440517	0	141	56480	2931	56480	2790	0.0	20.24372759856631
chr2	FAM166C	26572115	26572151	22	37	487	923	465	886	0.5945945945945946	0.5248306997742663
chr2	FAM166C	26578776	26578853	0	78	487	923	487	845	0.0	0.5763313609467455
chr2	SLC35F6	26775043	26775215	0	173	0	3908	0	3735	0.0	0.0
chr2	SLC35F6	26776371	26776482	0	112	0	3908	0	3796	0.0	0.0
chr2	SLC35F6	26774250	26774323	0	74	0	3908	0	3834	0.0	0.0
chr2	CENPA	26792755	26792833	0	79	0	1956	0	1877	0.0	0.0
chr2	CENPA	26792501	26792833	0	333	0	1956	0	1623	0.0	0.0
chr2	MAPRE3	27021370	27021530	153	161	67149	3639	66996	3478	0.9503105590062112	19.26279470960322
chr2	TMEM214	27035593	27035728	0	136	141	4115	141	3979	0.0	0.03543603920583061
chr2	TMEM214	27037789	27037892	76	104	141	4115	65	4011	0.7307692307692307	0.016205435053602592
chr2	TMEM214	27039740	27039837	0	98	141	4115	141	4017	0.0	0.0351008215085885
chr2	TMEM214	27037814	27037892	67	79	141	4115	74	4036	0.8481012658227848	0.018334985133795837
chr2	AGBL5	27069047	27069094	0	48	459	5304	459	5256	0.0	0.08732876712328767
chr2	AGBL5	27052332	27052543	0	212	459	5304	459	5092	0.0	0.0901413982717989
chr2	KHK	27094476	27094611	0	136	51	3023	51	2887	0.0	0.01766539660547281
chr2	KHK	27094799	27094934	0	136	51	3023	51	2887	0.0	0.01766539660547281
chr2	ABHD1	27128440	27128601	0	162	51	4565	51	4403	0.0	0.011583011583011582
chr2	ABHD1	27129315	27129361	0	47	51	4565	51	4518	0.0	0.011288180610889775
chr2	CAD	27226130	27226319	0	190	2366	8190	2366	8000	0.0	0.29575
chr2	CAD	27240566	27240617	0	52	2366	8190	2366	8138	0.0	0.29073482428115016
chr2	DNAJC5G	27277753	27278015	14922	263	132647	2173	117725	1910	56.73764258555133	61.63612565445026
chr2	DNAJC5G	27277801	27278015	14922	215	132647	2173	117725	1958	69.4046511627907	60.125127681307454
chr2	TRIM54	27299529	27299655	0	127	575	2338	575	2211	0.0	0.2600633197648123
chr2	GTF3C2-AS1	27340265	27340373	22	109	21231	3294	21209	3185	0.2018348623853211	6.659026687598116
chr2	SNX17	27372622	27372740	0	119	0	3482	0	3363	0.0	0.0
chr2	SNX17	27374688	27374758	0	71	0	3482	0	3411	0.0	0.0
chr2	SNX17	27371268	27371343	0	76	0	3482	0	3406	0.0	0.0
chr2	SNX17	27371268	27371468	0	201	0	3482	0	3281	0.0	0.0
chr2	SNX17	27373039	27373113	0	75	0	3482	0	3407	0.0	0.0
chr2	NRBP1	27435722	27435746	36	25	548314	5119	548278	5094	1.44	107.63211621515508
chr2	KRTCAP3	27442578	27442763	0	186	19432	1409	19432	1223	0.0	15.888798037612428
chr2	GCKR	27499141	27499208	0	68	0	2962	0	2894	0.0	0.0
chr2	ZNF512	27583425	27583526	0	102	146167	4272	146167	4170	0.0	35.052038369304555
chr2	ZNF512	27599969	27600053	22189	85	146167	4272	123978	4187	261.0470588235294	29.61022211607356
chr2	ZNF512	27600690	27600815	10604	126	146167	4272	135563	4146	84.15873015873017	32.69729860106126
chr2	ZNF512	27583657	27583716	986	60	146167	4272	145181	4212	16.433333333333334	34.468423551756885
chr2	GPN1	27629374	27629442	29	69	1770	3765	1741	3696	0.42028985507246375	0.47104978354978355
chr2	SLC4A1AP	27668636	27668750	5938	115	106701	4778	100763	4663	51.63478260869565	21.60904996783187
chr2	MRPL33	27774423	27774530	0	108	1834	1541	1834	1433	0.0	1.2798325191905093
chr2	BABAM2	27894532	27894684	0	153	11807	3409	11807	3256	0.0	3.626228501228501
chr2	BABAM2	28327273	28327447	0	175	11807	3409	11807	3234	0.0	3.6508967223252937
chr2	BABAM2	27892382	27892448	0	67	11807	3409	11807	3342	0.0	3.532914422501496
chr2	BABAM2	28310081	28310153	0	73	11807	3409	11807	3336	0.0	3.5392685851318944
chr2	PLB1	28582067	28582133	0	67	39334	8664	39334	8597	0.0	4.575316971036408
chr2	PLB1	28640926	28641001	646	76	39334	8664	38688	8588	8.5	4.504890544946437
chr2	PPP1CB	28752037	28752176	0	140	624	5733	624	5593	0.0	0.11156803146790631
chr2	PPP1CB	28778350	28778589	0	240	624	5733	624	5493	0.0	0.113599126160568
chr2	SPDYA	28840171	28840469	0	299	290	3497	290	3198	0.0	0.0906816760475297
chr2	SPDYA	28814612	28814686	0	75	290	3497	290	3422	0.0	0.0847457627118644
chr2	CLIP4	29121373	29121521	0	149	4367	6993	4367	6844	0.0	0.6380771478667446
chr2	CLIP4	29132151	29132245	27	95	4367	6993	4340	6898	0.28421052631578947	0.6291678747463033
chr2	YPEL5	30148244	30148541	0	298	0	3132	0	2834	0.0	0.0
chr2	YPEL5	30155849	30155910	0	62	0	3132	0	3070	0.0	0.0
chr2	YPEL5	30148244	30148305	0	62	0	3132	0	3070	0.0	0.0
chr2	LBH	30256701	30256803	0	103	0	4538	0	4435	0.0	0.0
chr2	LCLAT1	30525586	30525755	0	170	22	7528	22	7358	0.0	0.002989942919271541
chr2	LCLAT1	30459551	30459722	0	172	22	7528	22	7356	0.0	0.002990755845568244
chr2	LCLAT1	30562145	30562292	0	148	22	7528	22	7380	0.0	0.002981029810298103
chr2	LCLAT1	30489159	30489240	0	82	22	7528	22	7446	0.0	0.0029546065001343
chr2	LCLAT1	30476576	30476635	0	60	22	7528	22	7468	0.0	0.0029459025174076057
chr2	LCLAT1	30476401	30476635	0	235	22	7528	22	7293	0.0	0.0030165912518853697
chr2	SPAST	32098795	32098891	0	97	3624	9360	3624	9263	0.0	0.391233941487639
chr2	SPAST	32114637	32114825	0	189	3624	9360	3624	9171	0.0	0.39515865227347075
chr2	SPAST	32126947	32127022	0	76	3624	9360	3624	9284	0.0	0.3903489875053856
chr2	SPAST	32136876	32136968	0	93	3624	9360	3624	9267	0.0	0.39106506960181286
chr2	SPAST	32144936	32145007	0	72	3624	9360	3624	9288	0.0	0.39018087855297157
chr2	SPAST	32077828	32077943	25	116	3624	9360	3599	9244	0.21551724137931033	0.3893336218087408
chr2	SPAST	32098800	32098891	0	92	3624	9360	3624	9268	0.0	0.3910228744065602
chr2	SPAST	32128407	32128479	0	73	3624	9360	3624	9287	0.0	0.39022289221492407
chr2	SPAST	32136562	32136638	0	77	3624	9360	3624	9283	0.0	0.3903910373801573
chr2	SLC30A6	32175318	32175361	0	44	3156	5426	3156	5382	0.0	0.5863991081382386
chr2	SLC30A6	32197343	32197392	0	50	3156	5426	3156	5376	0.0	0.5870535714285714
chr2	SLC30A6	32209492	32209561	0	70	3156	5426	3156	5356	0.0	0.5892457057505601
chr2	SLC30A6	32171286	32171373	0	88	3156	5426	3156	5338	0.0	0.591232671412514
chr2	SLC30A6	32177476	32177596	0	121	3156	5426	3156	5305	0.0	0.5949104618284637
chr2	SLC30A6	32197317	32197392	0	76	3156	5426	3156	5350	0.0	0.5899065420560747
chr2	SLC30A6	32187151	32187303	0	153	3156	5426	3156	5273	0.0	0.5985207661672672
chr2	YIPF4	32292176	32292348	0	173	10361	11009	10361	10836	0.0	0.9561646363971945
chr2	BIRC6	32435495	32435585	0	91	124063	17804	124063	17713	0.0	7.004064811155648
chr2	BIRC6	32441328	32441462	47	135	124063	17804	124016	17669	0.34814814814814815	7.0188465674344895
chr2	BIRC6	32521661	32521757	105	97	124063	17804	123958	17707	1.0824742268041236	7.000508273564127
chr2	TTC27	32766467	32766549	0	83	538	3468	538	3385	0.0	0.15893648449039882
chr2	TTC27	32780053	32780112	0	60	538	3468	538	3408	0.0	0.15786384976525822
chr2	LINC00486	32841012	32841233	0	222	5408	7058	5408	6836	0.0	0.7911059098888239
chr2	LINC00486	32882698	32882826	0	129	5408	7058	5408	6929	0.0	0.7804878048780488
chr2	LINC00486	32928031	32928123	0	93	5408	7058	5408	6965	0.0	0.7764536970567121
chr2	LTBP1	33293159	33293282	0	124	544	7385	544	7261	0.0	0.07492080980581187
chr2	LTBP1	33342837	33342963	0	127	544	7385	544	7258	0.0	0.074951777349132
chr2	RASGRP3	33481182	33481304	0	123	21165	10165	21165	10042	0.0	2.1076478789085837
chr2	RASGRP3	33493053	33493172	0	120	21165	10165	21165	10045	0.0	2.107018417122947
chr2	LINC01320	33886371	33886474	0	104	264	10145	264	10041	0.0	0.026292201971915147
chr2	LINC01320	34721998	34722121	102	124	264	10145	162	10021	0.8225806451612904	0.0161660512922862
chr2	LINC01320	34732447	34732557	0	111	264	10145	264	10034	0.0	0.026310544149890373
chr2	LINC01320	34710451	34710513	0	63	264	10145	264	10082	0.0	0.026185280698274152
chr2	LINC01320	34735646	34735686	0	41	264	10145	264	10104	0.0	0.026128266033254157
chr2	LINC01320	34691590	34691669	0	80	264	10145	264	10065	0.0	0.02622950819672131
chr2	LINC01320	34721998	34722438	102	441	264	10145	162	9704	0.23129251700680273	0.01669414674361088
chr2	LINC01320	34731454	34731538	0	85	264	10145	264	10060	0.0	0.026242544731610338
chr2	LINC01320	34731365	34731538	0	174	264	10145	264	9971	0.0	0.026476782669742252
chr2	LINC01320	34721998	34722074	102	77	264	10145	162	10068	1.3246753246753247	0.016090584028605484
chr2	AC012593.1	35159546	35159628	0	83	80	4225	80	4142	0.0	0.01931434089811685
chr2	AC012593.1	35164119	35164242	0	124	80	4225	80	4101	0.0	0.01950743721043648
chr2	AC012593.1	35170177	35170349	0	173	80	4225	80	4052	0.0	0.019743336623889437
chr2	AC012593.1	35003083	35003126	29	44	80	4225	51	4181	0.6590909090909091	0.012198038746711314
chr2	AC012593.1	35164127	35164242	0	116	80	4225	80	4109	0.0	0.019469457288878073
chr2	AC012593.1	35162930	35163059	0	130	80	4225	80	4095	0.0	0.019536019536019536
chr2	CRIM1	36396613	36396787	0	175	204	7291	204	7116	0.0	0.02866779089376054
chr2	VIT	36729425	36729491	0	67	47697	3727	47697	3660	0.0	13.031967213114754
chr2	VIT	36781726	36781771	286	46	47697	3727	47411	3681	6.217391304347826	12.879923933713664
chr2	VIT	36775001	36775067	450	67	47697	3727	47247	3660	6.7164179104477615	12.909016393442624
chr2	VIT	36783339	36783402	75	64	47697	3727	47622	3663	1.171875	13.000819000819002
chr2	CEBPZOS	37198493	37198672	51	180	1734	3317	1683	3137	0.2833333333333333	0.5364998406120497
chr2	NDUFAF7	37232105	37232266	83	162	83	3663	0	3501	0.5123456790123457	0.0
chr2	NDUFAF7	37236095	37236176	0	82	83	3663	83	3581	0.0	0.02317788327282882
chr2	NDUFAF7	37242634	37242693	0	60	83	3663	83	3603	0.0	0.023036358590063834
chr2	QPCT	37352788	37352935	102	148	2812	2577	2710	2429	0.6891891891891891	1.1156854672704817
chr2	RMDN2	37950510	37950595	0	86	102	6031	102	5945	0.0	0.017157275021026073
chr2	RMDN2	37951232	37952201	0	970	102	6031	102	5061	0.0	0.02015411973918198
chr2	RMDN2	38012602	38012649	0	48	102	6031	102	5983	0.0	0.017048303526658867
chr2	CYP1B1-AS1	38100923	38101066	0	144	0	8859	0	8715	0.0	0.0
chr2	CYP1B1-AS1	38121984	38122225	0	242	0	8859	0	8617	0.0	0.0
chr2	CYP1B1-AS1	38130919	38131190	0	272	0	8859	0	8587	0.0	0.0
chr2	CYP1B1-AS1	38083995	38084110	0	116	0	8859	0	8743	0.0	0.0
chr2	CYP1B1-AS1	38113360	38113507	0	148	0	8859	0	8711	0.0	0.0
chr2	GALM	38698365	38698436	0	72	23	2626	23	2554	0.0	0.009005481597494126
chr2	GEMIN6	38779257	38779325	99	69	4133	4369	4034	4300	1.434782608695652	0.9381395348837209
chr2	GEMIN6	38779257	38779441	459	185	4133	4369	3674	4184	2.481081081081081	0.8781070745697896
chr2	MORN2	38880178	38880229	0	52	0	1374	0	1322	0.0	0.0
chr2	MORN2	38881441	38881578	0	138	0	1374	0	1236	0.0	0.0
chr2	MORN2	38881475	38881578	0	104	0	1374	0	1270	0.0	0.0
chr2	ARHGEF33	38959840	38960648	970	809	259460	5091	258490	4282	1.1990111248454882	60.36665109761793
chr2	MAP4K3-DT	39518582	39518710	0	129	3188	10725	3188	10596	0.0	0.3008682521706304
chr2	MAP4K3-DT	39587015	39587034	0	20	3188	10725	3188	10705	0.0	0.2978047641289117
chr2	MAP4K3-DT	39588448	39588567	0	120	3188	10725	3188	10605	0.0	0.3006129184347006
chr2	MAP4K3-DT	39584604	39587353	0	2750	3188	10725	3188	7975	0.0	0.39974921630094046
chr2	MAP4K3-DT	39557981	39558046	0	66	3188	10725	3188	10659	0.0	0.2990899709165963
chr2	MAP4K3-DT	39588485	39588567	0	83	3188	10725	3188	10642	0.0	0.29956775042285283
chr2	MAP4K3-DT	39474526	39474627	0	102	3188	10725	3188	10623	0.0	0.30010354890332297
chr2	MAP4K3-DT	39584604	39584810	0	207	3188	10725	3188	10518	0.0	0.3030994485643658
chr2	TMEM178A	39707048	39707186	0	139	48	2430	48	2291	0.0	0.020951549541684853
chr2	SLC8A1-AS1	40223629	40223751	0	123	159	8515	159	8392	0.0	0.01894661582459485
chr2	SLC8A1-AS1	39922848	39922889	0	42	159	8515	159	8473	0.0	0.018765490381210906
chr2	SLC8A1-AS1	40209966	40210024	0	59	159	8515	159	8456	0.0	0.01880321665089877
chr2	SLC8A1-AS1	40101160	40101257	0	98	159	8515	159	8417	0.0	0.018890340976594987
chr2	SLC8A1-AS1	40114001	40114103	0	103	159	8515	159	8412	0.0	0.018901569186875893
chr2	SLC8A1-AS1	40208374	40208451	0	78	159	8515	159	8437	0.0	0.018845561218442573
chr2	SLC8A1-AS1	40110944	40111009	0	66	159	8515	159	8449	0.0	0.018818795123683275
chr2	SLC8A1-AS1	40120703	40120800	0	98	159	8515	159	8417	0.0	0.018890340976594987
chr2	SLC8A1-AS1	40213108	40213218	0	111	159	8515	159	8404	0.0	0.01891956211327939
chr2	SLC8A1-AS1	40213168	40213218	0	51	159	8515	159	8464	0.0	0.018785444234404536
chr2	SLC8A1-AS1	40213168	40213479	0	312	159	8515	159	8203	0.0	0.01938315250518103
chr2	SLC8A1-AS1	40250298	40250509	0	212	159	8515	159	8303	0.0	0.019149704925930388
chr2	LINC01913	41877649	41877778	0	130	51	5091	51	4961	0.0	0.010280185446482563
chr2	LINC01913	41890350	41890418	0	69	51	5091	51	5022	0.0	0.01015531660692951
chr2	EML4	42261120	42261294	0	175	782	8380	782	8205	0.0	0.09530773918342474
chr2	EML4	42264918	42264951	0	34	782	8380	782	8346	0.0	0.09369757967888809
chr2	MTA3	42579106	42579200	111	95	20274	10362	20163	10267	1.168421052631579	1.9638648095841045
chr2	MTA3	42609457	42609584	0	128	20274	10362	20274	10234	0.0	1.9810435802227868
chr2	MTA3	42640172	42640236	0	65	20274	10362	20274	10297	0.0	1.968922987277848
chr2	MTA3	42704196	42704318	0	123	20274	10362	20274	10239	0.0	1.9800761793143862
chr2	MTA3	42704193	42704318	0	126	20274	10362	20274	10236	0.0	1.9806565064478312
chr2	MTA3	42752233	42752307	0	75	20274	10362	20274	10287	0.0	1.9708369787109945
chr2	MTA3	42581784	42581908	4	125	20274	10362	20270	10237	0.032	1.9800722868027743
chr2	PLEKHH2	43757118	43757264	0	147	147	9879	147	9732	0.0	0.015104808877928484
chr2	PLEKHH2	43679516	43679638	0	123	147	9879	147	9756	0.0	0.015067650676506766
chr2	DYNC2LI1	43787180	43787250	0	71	4912	2824	4912	2753	0.0	1.7842353795859063
chr2	DYNC2LI1	43781627	43781764	0	138	4912	2824	4912	2686	0.0	1.8287416232315712
chr2	DYNC2LI1	43775708	43775788	0	81	4912	2824	4912	2743	0.0	1.7907400656215822
chr2	PPM1B	44201185	44202045	64464	861	71333	7115	6869	6254	74.87108013937282	1.0983370642788615
chr2	PPM1B	44209209	44209327	0	119	71333	7115	71333	6996	0.0	10.196255002858777
chr2	SLC3A1	44301002	44301127	0	126	0	6140	0	6014	0.0	0.0
chr2	LINC02583	46430175	46430203	0	29	0	1489	0	1460	0.0	0.0
chr2	RHOQ	46543753	46543812	0	60	113150	6433	113150	6373	0.0	17.754589675192218
chr2	RHOQ	46560523	46560689	0	167	113150	6433	113150	6266	0.0	18.057772103415257
chr2	RHOQ	46572727	46572786	0	60	113150	6433	113150	6373	0.0	17.754589675192218
chr2	LINC01118	46817369	46817433	62	65	28098	3369	28036	3304	0.9538461538461539	8.48547215496368
chr2	LINC01118	46817247	46817433	1186	187	28098	3369	26912	3182	6.342245989304812	8.45757385292269
chr2	TTC7A	46994356	46994514	0	159	0	7210	0	7051	0.0	0.0
chr2	TTC7A	47021861	47021979	0	119	0	7210	0	7091	0.0	0.0
chr2	TTC7A	47023407	47023465	0	59	0	7210	0	7151	0.0	0.0
chr2	TTC7A	47046314	47046431	0	118	0	7210	0	7092	0.0	0.0
chr2	TTC7A	46958494	46958552	0	59	0	7210	0	7151	0.0	0.0
chr2	TTC7A	47047265	47047337	0	73	0	7210	0	7137	0.0	0.0
chr2	TTC7A	46951601	46951733	0	133	0	7210	0	7077	0.0	0.0
chr2	MSH2	47607391	47607581	0	191	22329	13680	22329	13489	0.0	1.6553488027281489
chr2	MSH6	47795893	47796063	0	171	37216	10902	37216	10731	0.0	3.4680831236604233
chr2	MSH6	47790926	47791123	0	198	37216	10902	37216	10704	0.0	3.476831091180867
chr2	FOXN2	48328560	48328702	0	143	0	5473	0	5330	0.0	0.0
chr2	PPP1R21	48495678	48495771	0	94	51	3984	51	3890	0.0	0.013110539845758355
chr2	PPP1R21	48505563	48505596	0	34	51	3984	51	3950	0.0	0.012911392405063291
chr2	PPP1R21	48479483	48479556	0	74	51	3984	51	3910	0.0	0.013043478260869565
chr2	STON1	48530712	48530829	0	118	8726	7055	8726	6937	0.0	1.2578924607178896
chr2	GTF2A1L	48620850	48620952	0	103	6840	2063	6840	1960	0.0	3.489795918367347
chr2	ERLEC1	53808298	53808460	0	163	51	2607	51	2444	0.0	0.020867430441898527
chr2	ERLEC1	53814542	53814620	0	79	51	2607	51	2528	0.0	0.020174050632911392
chr2	ACYP2	54267295	54267365	54	71	431	4979	377	4908	0.7605633802816901	0.07681336593317033
chr2	ACYP2	54222996	54223083	0	88	431	4979	431	4891	0.0	0.08812103864240442
chr2	C2ORF73	54358958	54359074	0	117	0	2412	0	2295	0.0	0.0
chr2	C2ORF73	54334816	54335024	0	209	0	2412	0	2203	0.0	0.0
chr2	C2ORF73	54334816	54334850	0	35	0	2412	0	2377	0.0	0.0
chr2	C2ORF73	54343719	54343873	0	155	0	2412	0	2257	0.0	0.0
chr2	C2ORF73	54360202	54360271	0	70	0	2412	0	2342	0.0	0.0
chr2	C2ORF73	54360843	54360942	0	100	0	2412	0	2312	0.0	0.0
chr2	EML6	54966999	54967103	0	105	180440	16043	180440	15938	0.0	11.32137030995106
chr2	EML6	54946659	54948014	1122	1356	180440	16043	179318	14687	0.827433628318584	12.209300742152925
chr2	EML6	54902420	54902541	0	122	180440	16043	180440	15921	0.0	11.333458953583317
chr2	EML6	54901940	54902141	0	202	180440	16043	180440	15841	0.0	11.3906950318793
chr2	EML6	54900696	54900896	0	201	180440	16043	180440	15842	0.0	11.389976013129655
chr2	EML6	54902424	54902541	0	118	180440	16043	180440	15925	0.0	11.33061224489796
chr2	EML6	54953295	54953316	260	22	180440	16043	180180	16021	11.818181818181818	11.246488983209538
chr2	AC012358.2	55329421	55329519	0	99	15	4927	15	4828	0.0	0.0031068765534382767
chr2	AC012358.2	55338975	55339269	0	295	15	4927	15	4632	0.0	0.003238341968911917
chr2	AC012358.2	55329421	55329713	0	293	15	4927	15	4634	0.0	0.0032369443245576176
chr2	AC012358.2	55332138	55332261	0	124	15	4927	15	4803	0.0	0.003123048094940662
chr2	AC012358.2	55329567	55329713	0	147	15	4927	15	4780	0.0	0.0031380753138075313
chr2	AC012358.2	55320828	55320928	0	101	15	4927	15	4826	0.0	0.0031081641110650643
chr2	AC012358.2	55317744	55317809	0	66	15	4927	15	4861	0.0	0.0030857848179386958
chr2	AC012358.2	55339149	55339269	0	121	15	4927	15	4806	0.0	0.003121098626716604
chr2	AC012358.2	55339850	55339974	0	125	15	4927	15	4802	0.0	0.003123698458975427
chr2	CFAP36	55520404	55520479	0	76	5617	2573	5617	2497	0.0	2.249499399279135
chr2	VRK2	58018015	58018086	0	72	0	3484	0	3412	0.0	0.0
chr2	VRK2	58026743	58026861	0	119	0	3484	0	3365	0.0	0.0
chr2	VRK2	58028297	58028398	0	102	0	3484	0	3382	0.0	0.0
chr2	VRK2	58084880	58084950	0	71	0	3484	0	3413	0.0	0.0
chr2	VRK2	58154758	58154802	0	45	0	3484	0	3439	0.0	0.0
chr2	VRK2	58154753	58154802	0	50	0	3484	0	3434	0.0	0.0
chr2	VRK2	58058351	58058488	0	138	0	3484	0	3346	0.0	0.0
chr2	LINC01795	58294518	58294562	0	45	6058	1525	6058	1480	0.0	4.0932432432432435
chr2	LINC01795	58279549	58279598	0	50	6058	1525	6058	1475	0.0	4.107118644067796
chr2	LINC01122	58656649	58656711	0	63	0	11565	0	11502	0.0	0.0
chr2	LINC01122	58912718	58912746	0	29	0	11565	0	11536	0.0	0.0
chr2	LINC01122	58915679	58915902	0	224	0	11565	0	11341	0.0	0.0
chr2	LINC01122	58461777	58461845	0	69	0	11565	0	11496	0.0	0.0
chr2	LINC01122	58728357	58728475	0	119	0	11565	0	11446	0.0	0.0
chr2	LINC01122	58918695	58918853	0	159	0	11565	0	11406	0.0	0.0
chr2	LINC01122	59033169	59033215	0	47	0	11565	0	11518	0.0	0.0
chr2	LINC01122	58671433	58671462	0	30	0	11565	0	11535	0.0	0.0
chr2	LINC01122	58461058	58461125	0	68	0	11565	0	11497	0.0	0.0
chr2	LINC01122	59024835	59024990	0	156	0	11565	0	11409	0.0	0.0
chr2	LINC01122	58929608	58929753	0	146	0	11565	0	11419	0.0	0.0
chr2	AC007179.1	59437898	59438059	0	162	0	1185	0	1023	0.0	0.0
chr2	PAPOLG	60780706	60780779	0	74	0	7983	0	7909	0.0	0.0
chr2	PAPOLG	60787510	60787620	0	111	0	7983	0	7872	0.0	0.0
chr2	PAPOLG	60771518	60771630	0	113	0	7983	0	7870	0.0	0.0
chr2	PAPOLG	60794709	60794775	0	67	0	7983	0	7916	0.0	0.0
chr2	PAPOLG	60795289	60795336	0	48	0	7983	0	7935	0.0	0.0
chr2	REL	60920382	60920478	0	97	333	13184	333	13087	0.0	0.025445098189042562
chr2	REL	60898969	60900884	0	1916	333	13184	333	11268	0.0	0.029552715654952075
chr2	KIAA1841	61073457	61073551	0	95	4197	7719	4197	7624	0.0	0.550498426023085
chr2	C2ORF74	61162841	61162955	0	115	4743	1523	4743	1408	0.0	3.3686079545454546
chr2	C2ORF74	61157861	61158012	703	152	4743	1523	4040	1371	4.625	2.9467541940189643
chr2	C2ORF74	61159317	61159439	30	123	4743	1523	4713	1400	0.24390243902439024	3.3664285714285715
chr2	AHSA2P	61183546	61183662	0	117	960	8068	960	7951	0.0	0.12073952961891586
chr2	AHSA2P	61185979	61186081	0	103	960	8068	960	7965	0.0	0.12052730696798493
chr2	AHSA2P	61185838	61185865	0	28	960	8068	960	8040	0.0	0.11940298507462686
chr2	AC016727.1	61480299	61480583	918	285	1785	2338	867	2053	3.221052631578947	0.42230881636629325
chr2	COMMD1	61968968	61969130	0	163	3264	2400	3264	2237	0.0	1.4590970049173
chr2	EHBP1	62706896	62707295	0	400	663	8254	663	7854	0.0	0.08441558441558442
chr2	EHBP1	62955516	62955660	0	145	663	8254	663	8109	0.0	0.08176100628930817
chr2	EHBP1	62858405	62858510	0	106	663	8254	663	8148	0.0	0.08136966126656849
chr2	EHBP1	62987930	62988038	0	109	663	8254	663	8145	0.0	0.08139963167587477
chr2	EHBP1	62949093	62949162	0	70	663	8254	663	8184	0.0	0.08101173020527859
chr2	MDH1	63595422	63595519	0	98	505	5003	505	4905	0.0	0.10295616717635066
chr2	MDH1	63593123	63593628	0	506	505	5003	505	4497	0.0	0.11229708694685346
chr2	MDH1	63599169	63599292	0	124	505	5003	505	4879	0.0	0.10350481656077065
chr2	MDH1	63589960	63590084	0	125	505	5003	505	4878	0.0	0.1035260352603526
chr2	MDH1	63593439	63593628	0	190	505	5003	505	4813	0.0	0.10492416372324953
chr2	UGP2	63857549	63857718	0	170	0	6812	0	6642	0.0	0.0
chr2	UGP2	63842058	63842204	0	147	0	6812	0	6665	0.0	0.0
chr2	UGP2	63854883	63854936	0	54	0	6812	0	6758	0.0	0.0
chr2	UGP2	63842538	63842599	0	62	0	6812	0	6750	0.0	0.0
chr2	UGP2	63862840	63862928	0	89	0	6812	0	6723	0.0	0.0
chr2	UGP2	63855566	63855643	0	78	0	6812	0	6734	0.0	0.0
chr2	UGP2	63856787	63856882	0	96	0	6812	0	6716	0.0	0.0
chr2	UGP2	63857549	63857642	0	94	0	6812	0	6718	0.0	0.0
chr2	UGP2	63859179	63859391	0	213	0	6812	0	6599	0.0	0.0
chr2	UGP2	63883059	63883275	0	217	0	6812	0	6595	0.0	0.0
chr2	UGP2	63856305	63856433	0	129	0	6812	0	6683	0.0	0.0
chr2	UGP2	63856963	63857002	0	40	0	6812	0	6772	0.0	0.0
chr2	AC012368.1	64214466	64214534	0	69	15209	7851	15209	7782	0.0	1.9543819069647905
chr2	AC012368.1	64188457	64188562	0	106	15209	7851	15209	7745	0.0	1.963718528082634
chr2	AC012368.1	64214128	64214254	0	127	15209	7851	15209	7724	0.0	1.9690574831693424
chr2	AC012368.1	64206974	64207045	0	72	15209	7851	15209	7779	0.0	1.9551356215451858
chr2	AC012368.1	64248323	64248538	0	216	15209	7851	15209	7635	0.0	1.9920104780615586
chr2	AC012368.1	64189224	64189583	12458	360	15209	7851	2751	7491	34.605555555555554	0.3672406888265919
chr2	AC012368.1	64206971	64207045	0	75	15209	7851	15209	7776	0.0	1.9558899176954732
chr2	AC012368.1	64227860	64227988	0	129	15209	7851	15209	7722	0.0	1.9695674695674696
chr2	AC012368.1	64229170	64229288	0	119	15209	7851	15209	7732	0.0	1.9670201758923953
chr2	LGALSL	64456287	64456465	0	179	0	3939	0	3760	0.0	0.0
chr2	LGALSL	64456267	64456465	0	199	0	3939	0	3740	0.0	0.0
chr2	AFTPH	64581189	64581273	0	85	0	5776	0	5691	0.0	0.0
chr2	AFTPH	64579485	64579546	0	62	0	5776	0	5714	0.0	0.0
chr2	SLC1A4	65016439	65016673	0	235	0	6951	0	6716	0.0	0.0
chr2	CEP68	65073935	65074149	0	215	102	6951	102	6736	0.0	0.015142517814726841
chr2	ACTR2	65241971	65242063	0	93	7316	4324	7316	4231	0.0	1.7291420467974474
chr2	ACTR2	65246184	65246307	324	124	7316	4324	6992	4200	2.6129032258064515	1.6647619047619047
chr2	ACTR2	65242048	65242063	0	16	7316	4324	7316	4308	0.0	1.6982358402971216
chr2	AC007389.1	66081289	66081402	0	114	1416	12371	1416	12257	0.0	0.11552582197927715
chr2	MEIS1	66439842	66439984	0	143	101	8573	101	8430	0.0	0.011981020166073547
chr2	MEIS1	66512148	66512294	0	147	101	8573	101	8426	0.0	0.011986707809162117
chr2	MEIS1	66569049	66569145	0	97	101	8573	101	8476	0.0	0.01191599811231713
chr2	LINC01798	66697447	66697503	0	57	51	3925	51	3868	0.0	0.013185108583247156
chr2	LINC01799	66934902	66934972	0	71	0	1685	0	1614	0.0	0.0
chr2	LINC01799	66933102	66933249	0	148	0	1685	0	1537	0.0	0.0
chr2	LINC01828	67264996	67265192	0	197	0	8104	0	7907	0.0	0.0
chr2	LINC01828	67287755	67287818	0	64	0	8104	0	8040	0.0	0.0
chr2	LINC01828	67283388	67283519	0	132	0	8104	0	7972	0.0	0.0
chr2	LINC01828	67287755	67287823	0	69	0	8104	0	8035	0.0	0.0
chr2	ETAA1	67399549	67399626	0	78	102	7483	102	7405	0.0	0.013774476704929102
chr2	LINC02831	67566775	67566972	0	198	0	3252	0	3054	0.0	0.0
chr2	LINC02831	67568007	67568156	0	150	0	3252	0	3102	0.0	0.0
chr2	LINC02831	67564802	67564886	0	85	0	3252	0	3167	0.0	0.0
chr2	LINC02831	67566775	67566884	0	110	0	3252	0	3142	0.0	0.0
chr2	LINC02831	67570735	67570788	0	54	0	3252	0	3198	0.0	0.0
chr2	LINC02831	67566779	67566884	0	106	0	3252	0	3146	0.0	0.0
chr2	LINC02831	67564802	67565423	0	622	0	3252	0	2630	0.0	0.0
chr2	LINC02831	67600078	67600140	0	63	0	3252	0	3189	0.0	0.0
chr2	LINC02831	67616088	67616195	0	108	0	3252	0	3144	0.0	0.0
chr2	PNO1	68161214	68161362	0	149	0	2638	0	2489	0.0	0.0
chr2	APLF	68490189	68490261	0	73	2649	7146	2649	7073	0.0	0.37452283330976954
chr2	APLF	68535282	68535383	0	102	2649	7146	2649	7044	0.0	0.3760647359454855
chr2	ARHGAP25	68787839	68787956	0	118	194	5449	194	5331	0.0	0.036390921027949726
chr2	ARHGAP25	68782232	68782320	51	89	194	5449	143	5360	0.5730337078651685	0.02667910447761194
chr2	SNRNP27	69903180	69903245	0	66	51	1819	51	1753	0.0	0.029092983456930975
chr2	MXD1	69921735	69921765	0	31	408	6360	408	6329	0.0	0.06446516037288672
chr2	VAX2	70963161	70963312	0	152	94	2993	94	2841	0.0	0.03308694121788103
chr2	VAX2	70963161	70963261	0	101	94	2993	94	2892	0.0	0.03250345781466114
chr2	ATP6V1B1	70964069	70964111	0	43	23	2671	23	2628	0.0	0.008751902587519025
chr2	ANKRD53	70981935	70982100	0	166	0	2282	0	2116	0.0	0.0
chr2	ANKRD53	70984122	70984249	0	128	0	2282	0	2154	0.0	0.0
chr2	ANKRD53	70979660	70979860	0	201	0	2282	0	2081	0.0	0.0
chr2	NAGK	71070501	71070586	0	86	306	6678	306	6592	0.0	0.04641990291262136
chr2	NAGK	71071685	71071827	0	143	306	6678	306	6535	0.0	0.0468247895944912
chr2	NAGK	71072640	71072751	0	112	306	6678	306	6566	0.0	0.046603716113310996
chr2	NAGK	71070740	71070839	0	100	306	6678	306	6578	0.0	0.046518698692611736
chr2	ZNF638	71355718	71355780	0	63	41996	11438	41996	11375	0.0	3.691956043956044
chr2	ZNF638	71348752	71350271	9690	1520	41996	11438	32306	9918	6.375	3.257309941520468
chr2	ZNF638	71361644	71361695	0	52	41996	11438	41996	11386	0.0	3.6883892499560864
chr2	ZNF638	71348426	71350271	13979	1846	41996	11438	28017	9592	7.5725893824485375	2.9208715596330275
chr2	ZNF638	71422813	71424038	0	1226	41996	11438	41996	10212	0.0	4.1124167645906775
chr2	ZNF638	71428546	71428651	0	106	41996	11438	41996	11332	0.0	3.705965407695023
chr2	ZNF638	71334500	71334596	0	97	41996	11438	41996	11341	0.0	3.703024424653911
chr2	ZNF638	71433475	71433535	0	61	41996	11438	41996	11377	0.0	3.691307022941021
chr2	DYSF	71513239	71513332	0	94	7899	8451	7899	8357	0.0	0.9451956443699893
chr2	DYSF	71620546	71620609	408	64	7899	8451	7491	8387	6.375	0.8931679980922856
chr2	DYSF	71549349	71549391	0	43	7899	8451	7899	8408	0.0	0.9394624167459562
chr2	CCT7	73235549	73235645	58	97	5710	3397	5652	3300	0.5979381443298969	1.7127272727272727
chr2	ALMS1	73489633	73491498	19896	1866	234997	14807	215101	12941	10.662379421221864	16.621667568194113
chr2	ALMS1	73534823	73534949	0	127	234997	14807	234997	14680	0.0	16.007970027247957
chr2	ALMS1	73550266	73550437	0	172	234997	14807	234997	14635	0.0	16.057191663819612
chr2	ALMS1	73601194	73601436	0	243	234997	14807	234997	14564	0.0	16.135471024443834
chr2	ALMS1	73408621	73408747	0	127	234997	14807	234997	14680	0.0	16.007970027247957
chr2	ALMS1	73489633	73490158	654	526	234997	14807	234343	14281	1.2433460076045628	16.409425110286396
chr2	STAMBP	73829404	73829510	3776	107	8812	7527	5036	7420	35.28971962616822	0.6787061994609165
chr2	ACTG2	73902359	73902488	51	130	51	3822	0	3692	0.3923076923076923	0.0
chr2	ACTG2	73896751	73897314	0	564	51	3822	51	3258	0.0	0.01565377532228361
chr2	DGUOK	73957124	73957240	21495	117	24394	1463	2899	1346	183.71794871794873	2.153789004457652
chr2	DGUOK	73938909	73939022	0	114	24394	1463	24394	1349	0.0	18.083024462564865
chr2	DGUOK	73950600	73950732	0	133	24394	1463	24394	1330	0.0	18.341353383458646
chr2	DGUOK	73950626	73950732	0	107	24394	1463	24394	1356	0.0	17.98967551622419
chr2	MTHFD2	74207703	74207826	0	124	4569	11414	4569	11290	0.0	0.40469441984056687
chr2	MTHFD2	74209941	74210049	0	109	4569	11414	4569	11305	0.0	0.40415745245466606
chr2	MTHFD2	74211740	74211866	0	127	4569	11414	4569	11287	0.0	0.4048019845840347
chr2	MTHFD2	74201381	74201479	0	99	4569	11414	4569	11315	0.0	0.40380026513477685
chr2	MTHFD2	74205704	74205889	0	186	4569	11414	4569	11228	0.0	0.4069291058069113
chr2	MTHFD2	74205981	74206088	0	108	4569	11414	4569	11306	0.0	0.404121705289227
chr2	DCTN1-AS1	74391158	74391243	0	86	55934	4344	55934	4258	0.0	13.13621418506341
chr2	DCTN1-AS1	74391477	74391615	210	139	55934	4344	55724	4205	1.5107913669064748	13.251843043995244
chr2	WDR54	74424874	74424975	0	102	3252	2855	3252	2753	0.0	1.181256810751907
chr2	WDR54	74422152	74422375	0	224	3252	2855	3252	2631	0.0	1.2360319270239453
chr2	INO80B	74455405	74455598	38	194	2333	1446	2295	1252	0.1958762886597938	1.8330670926517572
chr2	INO80B	74455390	74455598	38	209	2333	1446	2295	1237	0.18181818181818182	1.8552950687146321
chr2	WBP1	74458996	74459098	0	103	2032	1671	2032	1568	0.0	1.2959183673469388
chr2	WBP1	74458831	74458919	0	89	2032	1671	2032	1582	0.0	1.284450063211125
chr2	WBP1	74458831	74459117	0	287	2032	1671	2032	1384	0.0	1.4682080924855492
chr2	TTC31	74490024	74490127	0	104	3002	4040	3002	3936	0.0	0.7627032520325203
chr2	TLX2	74515021	74515206	0	186	0	2815	0	2629	0.0	0.0
chr2	HTRA2	74530444	74530512	0	69	510	2623	510	2554	0.0	0.19968676585747847
chr2	HTRA2	74530910	74531105	31	196	510	2623	479	2427	0.15816326530612246	0.19736299958796868
chr2	HTRA2	74532618	74532714	0	97	510	2623	510	2526	0.0	0.20190023752969122
chr2	HTRA2	74530460	74530512	0	53	510	2623	510	2570	0.0	0.19844357976653695
chr2	DOK1	74555574	74555668	0	95	1848	2957	1848	2862	0.0	0.6457023060796646
chr2	DOK1	74555893	74556078	1	186	1848	2957	1847	2771	0.005376344086021506	0.6665463731504871
chr2	SEMA4F	74656533	74656685	0	153	198860	6242	198860	6089	0.0	32.65889308589259
chr2	SEMA4F	74662731	74662825	596	95	198860	6242	198264	6147	6.273684210526316	32.25378233284529
chr2	SEMA4F	74673676	74673828	0	153	198860	6242	198860	6089	0.0	32.65889308589259
chr2	SEMA4F	74675161	74675384	0	224	198860	6242	198860	6018	0.0	33.04420073113992
chr2	SEMA4F	74657852	74657951	1055	100	198860	6242	197805	6142	10.55	32.20530771735591
chr2	SEMA4F	74655266	74655387	3367	122	198860	6242	195493	6120	27.598360655737704	31.943300653594772
chr2	LINC01291	74932198	74932289	0	92	204	4181	204	4089	0.0	0.049889948642699924
chr2	MRPL19	75655063	75655302	0	240	153	8956	153	8716	0.0	0.01755392381826526
chr2	AC073091.1	76385251	76385352	0	102	0	2459	0	2357	0.0	0.0
chr2	AC073091.1	76395687	76395768	0	82	0	2459	0	2377	0.0	0.0
chr2	AC073091.1	76385229	76385352	0	124	0	2459	0	2335	0.0	0.0
chr2	AC012494.2	78095663	78095941	0	279	0	1400	0	1121	0.0	0.0
chr2	AC012494.2	78111899	78112100	0	202	0	1400	0	1198	0.0	0.0
chr2	AC012494.2	78111899	78112130	0	232	0	1400	0	1168	0.0	0.0
chr2	AC012494.2	78093516	78093666	0	151	0	1400	0	1249	0.0	0.0
chr2	AC012494.2	78111928	78112130	0	203	0	1400	0	1197	0.0	0.0
chr2	AC012494.2	78093554	78093666	0	113	0	1400	0	1287	0.0	0.0
chr2	AC012494.2	78111928	78112100	0	173	0	1400	0	1227	0.0	0.0
chr2	REG3G	79027033	79027171	0	139	0	1850	0	1711	0.0	0.0
chr2	CTNNA2	80608183	80608318	0	136	105	7576	105	7440	0.0	0.014112903225806451
chr2	CTNNA2	79633697	79633840	0	144	105	7576	105	7432	0.0	0.014128094725511303
chr2	CTNNA2	80619084	80619228	0	145	105	7576	105	7431	0.0	0.014129995962858296
chr2	DNAH6	84525564	84525738	0	175	60274	13591	60274	13416	0.0	4.492695289206917
chr2	DNAH6	84528903	84529166	0	264	60274	13591	60274	13327	0.0	4.5226982816838
chr2	DNAH6	84685325	84685472	0	148	60274	13591	60274	13443	0.0	4.483671799449527
chr2	KCMF1	85013935	85014053	0	119	97582	7740	97582	7621	0.0	12.804356383676684
chr2	ELMOD3	85355075	85355170	0	96	3486	6400	3486	6304	0.0	0.5529822335025381
chr2	ELMOD3	85355554	85355598	0	45	3486	6400	3486	6355	0.0	0.5485444531864674
chr2	ELMOD3	85363096	85363166	0	71	3486	6400	3486	6329	0.0	0.5507979143624585
chr2	ELMOD3	85371439	85371562	0	124	3486	6400	3486	6276	0.0	0.5554493307839388
chr2	ELMOD3	85387097	85387225	0	129	3486	6400	3486	6271	0.0	0.555892202200606
chr2	ELMOD3	85356601	85356667	0	67	3486	6400	3486	6333	0.0	0.5504500236854571
chr2	ELMOD3	85355554	85355716	0	163	3486	6400	3486	6237	0.0	0.5589225589225589
chr2	ELMOD3	85356966	85357252	0	287	3486	6400	3486	6113	0.0	0.5702601014231965
chr2	ELMOD3	85377343	85377474	0	132	3486	6400	3486	6268	0.0	0.5561582641991065
chr2	ELMOD3	85355554	85355896	0	343	3486	6400	3486	6057	0.0	0.5755324418028727
chr2	ELMOD3	85355554	85355784	0	231	3486	6400	3486	6169	0.0	0.5650834819257579
chr2	SH2D6	85428583	85428697	0	115	83	2703	83	2588	0.0	0.03207109737248841
chr2	SH2D6	85434472	85434497	0	26	83	2703	83	2677	0.0	0.03100485618229361
chr2	SH2D6	85435412	85435496	0	85	83	2703	83	2618	0.0	0.03170359052711994
chr2	SH2D6	85435268	85435496	0	229	83	2703	83	2474	0.0	0.03354890864995958
chr2	SH2D6	85431898	85431959	0	62	83	2703	83	2641	0.0	0.03142748958727755
chr2	VAMP8	85579741	85579874	51	134	35620	900	35569	766	0.3805970149253731	46.43472584856397
chr2	USP39	85621484	85621579	3348	96	41083	3963	37735	3867	34.875	9.758210499094906
chr2	USP39	85630720	85630946	249	227	41083	3963	40834	3736	1.0969162995594715	10.929871520342612
chr2	USP39	85644947	85645083	0	137	41083	3963	41083	3826	0.0	10.73784631468897
chr2	USP39	85647929	85648016	0	88	41083	3963	41083	3875	0.0	10.602064516129031
chr2	GNLY	85694752	85694996	0	245	132	2772	132	2527	0.0	0.05223585278986941
chr2	GNLY	85694752	85694923	0	172	132	2772	132	2600	0.0	0.05076923076923077
chr2	GNLY	85694915	85694996	0	82	132	2772	132	2690	0.0	0.04907063197026022
chr2	GNLY	85698397	85698447	0	51	132	2772	132	2721	0.0	0.04851157662624035
chr2	PTCD3	86107117	86107200	0	84	1586	9976	1586	9892	0.0	0.16033158107561665
chr2	PTCD3	86118920	86119044	0	125	1586	9976	1586	9851	0.0	0.16099888336209522
chr2	PTCD3	86125794	86125880	0	87	1586	9976	1586	9889	0.0	0.16038022044696126
chr2	MRPL35	86207182	86207327	0	146	51	1662	51	1516	0.0	0.033641160949868076
chr2	KDM3A	86441271	86441444	2289	174	9663	8754	7374	8580	13.155172413793103	0.8594405594405594
chr2	AC015971.1	86605242	86605435	0	194	51	2869	51	2675	0.0	0.019065420560747663
chr2	ANAPC1P1	86873839	86874055	0	217	5	2573	5	2356	0.0	0.0021222410865874364
chr2	CYTOR	87583257	87583346	0	90	205	17288	205	17198	0.0	0.011919990696592627
chr2	CYTOR	87503486	87503624	0	139	205	17288	205	17149	0.0	0.011954049798822088
chr2	CYTOR	87480222	87480362	0	141	205	17288	205	17147	0.0	0.011955444101008923
chr2	CYTOR	87585170	87585272	51	103	205	17288	154	17185	0.49514563106796117	0.008961303462321792
chr2	CYTOR	87600068	87600222	0	155	205	17288	205	17133	0.0	0.011965213330998658
chr2	CYTOR	87470149	87470304	0	156	205	17288	205	17132	0.0	0.0119659117441046
chr2	CYTOR	87472739	87472885	0	147	205	17288	205	17141	0.0	0.01195962895980398
chr2	CYTOR	87572898	87573193	0	296	205	17288	205	16992	0.0	0.012064500941619585
chr2	CYTOR	87478121	87478230	0	110	205	17288	205	17178	0.0	0.01193386890208406
chr2	CYTOR	87480222	87480607	0	386	205	17288	205	16902	0.0	0.012128742160691042
chr2	CYTOR	87455751	87455973	0	223	205	17288	205	17065	0.0	0.012012891883973044
chr2	CYTOR	87480222	87480423	0	202	205	17288	205	17086	0.0	0.01199812712162004
chr2	AC133644.2	87705904	87705970	0	67	659	3873	659	3806	0.0	0.17314766158696795
chr2	AC108479.1	88020509	88020601	0	93	729	1216	729	1123	0.0	0.649154051647373
chr2	SMYD1	88093516	88093555	72	40	3300	3317	3228	3277	1.8	0.98504729935917
chr2	THNSL2	88185327	88185479	0	153	51	6615	51	6462	0.0	0.007892293407613741
chr2	THNSL2	88171226	88171307	51	82	51	6615	0	6533	0.6219512195121951	0.0
chr2	THNSL2	88185550	88185724	0	175	51	6615	51	6440	0.0	0.007919254658385094
chr2	ANKRD36BP2	88772972	88773044	0	73	51	4231	51	4158	0.0	0.012265512265512266
chr2	MAL	95047958	95048126	0	169	0	1458	0	1289	0.0	0.0
chr2	MAL	95049580	95049706	0	127	0	1458	0	1331	0.0	0.0
chr2	ZNF2	95180158	95180272	0	115	0	4001	0	3886	0.0	0.0
chr2	ZNF2	95176187	95176259	0	73	0	4001	0	3928	0.0	0.0
chr2	PROM2	95284968	95285115	0	148	0	4716	0	4568	0.0	0.0
chr2	FAHD2A	95405276	95405402	0	127	51	5683	51	5556	0.0	0.0091792656587473
chr2	AC008268.1	95666302	95666403	0	102	0	2062	0	1960	0.0	0.0
chr2	AC008268.1	95666302	95666424	0	123	0	2062	0	1939	0.0	0.0
chr2	STARD7-AS1	96237904	96238099	0	196	0	4416	0	4220	0.0	0.0
chr2	CIAO1	96267320	96267469	0	150	0	4735	0	4585	0.0	0.0
chr2	ITPRIPL1	96325746	96325849	0	104	2856	4337	2856	4233	0.0	0.6746987951807228
chr2	NCAPH	96341641	96341894	0	254	0	6563	0	6309	0.0	0.0
chr2	NCAPH	96341713	96341894	0	182	0	6563	0	6381	0.0	0.0
chr2	NCAPH	96341674	96341894	0	221	0	6563	0	6342	0.0	0.0
chr2	NCAPH	96341391	96341894	0	504	0	6563	0	6059	0.0	0.0
chr2	ARID5A	96549320	96549459	0	140	173	2685	173	2545	0.0	0.06797642436149312
chr2	FER1L5	96647063	96647155	0	93	12131	7511	12131	7418	0.0	1.635346454569965
chr2	FER1L5	96654445	96654496	0	52	12131	7511	12131	7459	0.0	1.6263574205657594
chr2	FER1L5	96695296	96695297	0	2	12131	7511	12131	7509	0.0	1.6155280330270343
chr2	CNNM3	96825057	96825201	0	145	51	5407	51	5262	0.0	0.009692132269099202
chr2	ANKRD36	97164396	97164469	38	74	16956	11362	16918	11288	0.5135135135135135	1.4987597448618002
chr2	AC159540.2	97284877	97285007	0	131	27183	1980	27183	1849	0.0	14.701460248783127
chr2	AC159540.2	97285302	97285523	13997	222	27183	1980	13186	1758	63.049549549549546	7.500568828213879
chr2	AC159540.2	97284877	97285523	44834	647	27183	1980	-17651	1333	69.2952086553323	-13.241560390097524
chr2	C2ORF92	97667963	97668073	0	111	101	6194	101	6083	0.0	0.01660364951504192
chr2	C2ORF92	97688894	97688993	0	100	101	6194	101	6094	0.0	0.016573679028552675
chr2	C2ORF92	97690255	97690327	0	73	101	6194	101	6121	0.0	0.016500571801993137
chr2	C2ORF92	97701153	97701304	0	152	101	6194	101	6042	0.0	0.016716319099635883
chr2	C2ORF92	97674455	97674557	0	103	101	6194	101	6091	0.0	0.016581842062058774
chr2	C2ORF92	97671330	97671499	0	170	101	6194	101	6024	0.0	0.016766268260292164
chr2	C2ORF92	97675630	97675721	0	92	101	6194	101	6102	0.0	0.016551950180268764
chr2	C2ORF92	97671190	97671306	0	117	101	6194	101	6077	0.0	0.016620042784268554
chr2	C2ORF92	97671219	97671306	0	88	101	6194	101	6106	0.0	0.016541107107762857
chr2	C2ORF92	97671193	97671306	0	114	101	6194	101	6080	0.0	0.016611842105263157
chr2	C2ORF92	97674455	97674561	0	107	101	6194	101	6087	0.0	0.016592738623295546
chr2	C2ORF92	97675844	97675928	0	85	101	6194	101	6109	0.0	0.016532984121787525
chr2	C2ORF92	97694446	97694599	0	154	101	6194	101	6040	0.0	0.016721854304635762
chr2	C2ORF92	97671330	97671481	0	152	101	6194	101	6042	0.0	0.016716319099635883
chr2	C2ORF92	97702060	97702167	0	108	101	6194	101	6086	0.0	0.016595465001643116
chr2	VWA3B	98119519	98119763	219	245	27414	8007	27195	7762	0.8938775510204081	3.5036073177016234
chr2	VWA3B	98216754	98216975	0	222	27414	8007	27414	7785	0.0	3.521387283236994
chr2	VWA3B	98228201	98228332	0	132	27414	8007	27414	7875	0.0	3.4811428571428573
chr2	VWA3B	98236389	98236477	0	89	27414	8007	27414	7918	0.0	3.4622379388734528
chr2	VWA3B	98269341	98269491	0	151	27414	8007	27414	7856	0.0	3.489562118126273
chr2	VWA3B	98119512	98119763	219	252	27414	8007	27195	7755	0.8690476190476191	3.506769825918762
chr2	VWA3B	98187974	98188129	0	156	27414	8007	27414	7851	0.0	3.4917844860527323
chr2	VWA3B	98179243	98179317	1225	75	27414	8007	26189	7932	16.333333333333332	3.301689359556228
chr2	VWA3B	98242256	98242298	0	43	27414	8007	27414	7964	0.0	3.4422400803616275
chr2	CNGA3	98383387	98383441	0	55	13635	4353	13635	4298	0.0	3.1724057701256396
chr2	INPP4A	98548954	98548969	0	16	5482	13221	5482	13205	0.0	0.4151457781143506
chr2	UNC50	98616431	98616533	0	103	0	2087	0	1984	0.0	0.0
chr2	C2ORF15	99147026	99147122	75	97	75	2063	0	1966	0.7731958762886598	0.0
chr2	LIPT1	99156300	99156426	0	127	22384	2283	22384	2156	0.0	10.382189239332096
chr2	LIPT1	99155481	99155544	0	64	22384	2283	22384	2219	0.0	10.087426768814781
chr2	MAP4K4	101863820	101864051	0	232	281104	11035	281104	10803	0.0	26.020920114782932
chr2	MAP4K4	101860824	101860986	0	163	281104	11035	281104	10872	0.0	25.855776306107433
chr2	MAP4K4	101871493	101871685	3252	193	281104	11035	277852	10842	16.849740932642487	25.627375023058477
chr2	MAP4K4	101868028	101868037	20	10	281104	11035	281084	11025	2.0	25.49514739229025
chr2	IL1R1	102157718	102157785	1855	68	31712	6249	29857	6181	27.279411764705884	4.830448147548941
chr2	IL1R1	102165114	102165304	0	191	31712	6249	31712	6058	0.0	5.23473093430175
chr2	IL1R1	102156145	102156246	8129	102	31712	6249	23583	6147	79.69607843137256	3.8365056124938994
chr2	IL1RL1	102340665	102340828	0	164	1530	5719	1530	5555	0.0	0.27542754275427545
chr2	IL1RL1	102338115	102338325	255	211	1530	5719	1275	5508	1.2085308056872037	0.23148148148148148
chr2	IL1RL1	102341187	102341357	0	171	1530	5719	1530	5548	0.0	0.27577505407354
chr2	IL18R1	102373936	102373993	0	58	3819	4380	3819	4322	0.0	0.8836186950485886
chr2	IL18RAP	102423810	102424135	0	326	97269	2978	97269	2652	0.0	36.67760180995475
chr2	TMEM182	102757412	102757539	0	128	3509	6001	3509	5873	0.0	0.5974799931891708
chr2	TMEM182	102797862	102798000	0	139	3509	6001	3509	5862	0.0	0.5986011600136473
chr2	TMEM182	102758388	102758473	0	86	3509	6001	3509	5915	0.0	0.5932375316990701
chr2	LINC01965	104072130	104072289	0	160	0	5510	0	5350	0.0	0.0
chr2	AC068535.1	104408221	104408392	0	172	0	2412	0	2240	0.0	0.0
chr2	LINC01102	104434498	104434523	0	26	0	7010	0	6984	0.0	0.0
chr2	LINC01102	104435939	104436119	0	181	0	7010	0	6829	0.0	0.0
chr2	LINC01102	104507964	104508084	0	121	0	7010	0	6889	0.0	0.0
chr2	LINC01102	104531388	104531608	0	221	0	7010	0	6789	0.0	0.0
chr2	LINC01102	104520195	104520657	0	463	0	7010	0	6547	0.0	0.0
chr2	AC018730.1	104853772	104853832	0	61	0	3750	0	3689	0.0	0.0
chr2	AC018730.1	104890351	104890414	0	64	0	3750	0	3686	0.0	0.0
chr2	MRPS9	105091321	105091433	0	113	98	1841	98	1728	0.0	0.056712962962962965
chr2	NCK2	105881327	105882049	87461	723	92485	2982	5024	2259	120.96957123098201	2.223992917220009
chr2	ECRG4	106064280	106064362	0	83	0	1713	0	1630	0.0	0.0
chr2	ECRG4	106070789	106071005	0	217	0	1713	0	1496	0.0	0.0
chr2	LINC01886	107541442	107541489	0	48	0	2587	0	2539	0.0	0.0
chr2	LINC01886	107531548	107531779	0	232	0	2587	0	2355	0.0	0.0
chr2	LINC01886	107531659	107531779	0	121	0	2587	0	2466	0.0	0.0
chr2	LINC01886	107531647	107531779	0	133	0	2587	0	2454	0.0	0.0
chr2	SULT1C2	108298566	108298661	0	96	0	2947	0	2851	0.0	0.0
chr2	SULT1C2	108305414	108305595	0	182	0	2947	0	2765	0.0	0.0
chr2	SULT1C2	108300837	108300935	0	99	0	2947	0	2848	0.0	0.0
chr2	SULT1C2	108300899	108300935	0	37	0	2947	0	2910	0.0	0.0
chr2	SULT1C2	108300795	108300935	0	141	0	2947	0	2806	0.0	0.0
chr2	GCC2	108451027	108451112	0	86	11349	10494	11349	10408	0.0	1.0904112221368178
chr2	LIMS1	108670780	108670847	0	68	0	7791	0	7723	0.0	0.0
chr2	LIMS1	108680968	108681112	0	145	0	7791	0	7646	0.0	0.0
chr2	RANBP2	108730773	108730885	0	113	0	12327	0	12214	0.0	0.0
chr2	CCDC138	108788031	108788089	0	59	0	5316	0	5257	0.0	0.0
chr2	CCDC138	108873450	108873589	0	140	0	5316	0	5176	0.0	0.0
chr2	RGPD5	109801782	109801850	0	69	1778	14092	1778	14023	0.0	0.1267916993510661
chr2	RGPD5	109808749	109808895	0	147	1778	14092	1778	13945	0.0	0.12750089637863032
chr2	RGPD5	109801785	109801850	0	66	1778	14092	1778	14026	0.0	0.12676458006559246
chr2	AC013268.1	109937974	109938072	0	99	0	3474	0	3375	0.0	0.0
chr2	AC013268.1	109963468	109963550	0	83	0	3474	0	3391	0.0	0.0
chr2	AC013268.1	109963459	109963550	0	92	0	3474	0	3382	0.0	0.0
chr2	LINC01123	109993634	109993819	0	186	1671	3299	1671	3113	0.0	0.536781239961452
chr2	AC140479.3	110261431	110261513	6320	83	6320	1957	0	1874	76.144578313253	0.0
chr2	AC140479.3	110262650	110262765	0	116	6320	1957	6320	1841	0.0	3.432916892992939
chr2	ACOXL	110908788	110908905	0	118	6023	8196	6023	8078	0.0	0.7456053478583808
chr2	ACOXL	110963623	110963713	0	91	6023	8196	6023	8105	0.0	0.7431215299198026
chr2	ACOXL	111031626	111031714	0	89	6023	8196	6023	8107	0.0	0.7429382015542124
chr2	ACOXL	111049217	111049288	0	72	6023	8196	6023	8124	0.0	0.7413835548990645
chr2	BCL2L11	111142312	111142391	0	80	1338	6670	1338	6590	0.0	0.20303490136570562
chr2	BCL2L11	111124049	111124139	0	91	1338	6670	1338	6579	0.0	0.20337437300501596
chr2	BCL2L11	111150043	111150147	0	105	1338	6670	1338	6565	0.0	0.20380807311500382
chr2	BCL2L11	111153779	111153904	0	126	1338	6670	1338	6544	0.0	0.20446210268948656
chr2	BCL2L11	111151821	111151893	0	73	1338	6670	1338	6597	0.0	0.2028194633924511
chr2	BCL2L11	111144487	111144520	0	34	1338	6670	1338	6636	0.0	0.20162748643761302
chr2	BCL2L11	111161418	111161550	0	133	1338	6670	1338	6537	0.0	0.20468104635153742
chr2	BCL2L11	111130131	111130247	0	117	1338	6670	1338	6553	0.0	0.20418129101175034
chr2	MERTK	111929119	111929540	0	422	17071	4566	17071	4144	0.0	4.119449806949807
chr2	MERTK	111929119	111929304	0	186	17071	4566	17071	4380	0.0	3.897488584474886
chr2	MERTK	112020603	112020654	0	52	17071	4566	17071	4514	0.0	3.7817899867080196
chr2	TMEM87B	112074911	112074962	0	52	6567	5342	6567	5290	0.0	1.241398865784499
chr2	TMEM87B	112077191	112077282	0	92	6567	5342	6567	5250	0.0	1.250857142857143
chr2	FBLN7	112165000	112165171	0	172	26147	6590	26147	6418	0.0	4.074010595200997
chr2	FBLN7	112181738	112181876	0	139	26147	6590	26147	6451	0.0	4.05317005115486
chr2	POLR1B	112547011	112547179	0	169	32490	8624	32490	8455	0.0	3.842696629213483
chr2	POLR1B	112545830	112545922	1823	93	32490	8624	30667	8531	19.602150537634408	3.5947720079709296
chr2	POLR1B	112547082	112547179	0	98	32490	8624	32490	8526	0.0	3.8106966924700916
chr2	SLC20A1	112652888	112652947	0	60	7451	4934	7451	4874	0.0	1.5287238407878538
chr2	IL37	112913791	112913854	0	64	1417	845	1417	781	0.0	1.8143405889884763
chr2	IL37	112917128	112917248	51	121	1417	845	1366	724	0.4214876033057851	1.8867403314917126
chr2	IL36G	112979220	112979325	225	106	981	1379	756	1273	2.1226415094339623	0.593872741555381
chr2	IL1RN	113121447	113121618	16	172	3724	3112	3708	2940	0.09302325581395349	1.2612244897959184
chr2	IL1RN	113120065	113120128	0	64	3724	3112	3724	3048	0.0	1.2217847769028871
chr2	PSD4	113182345	113183512	102	1168	618	13128	516	11960	0.08732876712328767	0.0431438127090301
chr2	PSD4	113198739	113198884	25	146	618	13128	593	12982	0.17123287671232876	0.045678631951933446
chr2	PAX8-AS1	113216155	113216362	0	208	44812	13369	44812	13161	0.0	3.4049084416077804
chr2	PAX8-AS1	113250766	113250922	0	157	44812	13369	44812	13212	0.0	3.3917650620647897
chr2	PAX8-AS1	113259263	113259584	0	322	44812	13369	44812	13047	0.0	3.4346593086533304
chr2	PAX8-AS1	113238089	113238212	0	124	44812	13369	44812	13245	0.0	3.383314458286146
chr2	PAX8-AS1	113255389	113255549	460	161	44812	13369	44352	13208	2.857142857142857	3.3579648697758935
chr2	PAX8-AS1	113236512	113236622	3	111	44812	13369	44809	13258	0.02702702702702703	3.379770704480314
chr2	PAX8-AS1	113239088	113239424	0	337	44812	13369	44812	13032	0.0	3.4386126457949664
chr2	PAX8-AS1	113236512	113236613	0	102	44812	13369	44812	13267	0.0	3.3777040777869902
chr2	PAX8-AS1	113235791	113236613	0	823	44812	13369	44812	12546	0.0	3.5718157181571817
chr2	PAX8-AS1	113250766	113250906	0	141	44812	13369	44812	13228	0.0	3.387662534018748
chr2	PAX8-AS1	113270200	113270307	0	108	44812	13369	44812	13261	0.0	3.3792323354196516
chr2	CBWD2	113471032	113471089	0	58	44148	6917	44148	6859	0.0	6.436506779413909
chr2	CBWD2	113455555	113455643	0	89	44148	6917	44148	6828	0.0	6.46572934973638
chr2	CBWD2	113439019	113439117	0	99	44148	6917	44148	6818	0.0	6.475212672337929
chr2	CBWD2	113457064	113457209	0	146	44148	6917	44148	6771	0.0	6.520159503766061
chr2	LINC01961	113513746	113513815	9217	70	9319	1904	102	1834	131.67142857142858	0.05561613958560523
chr2	RABL2A	113640893	113641005	0	113	2634	4010	2634	3897	0.0	0.6759045419553503
chr2	RABL2A	113635050	113635130	0	81	2634	4010	2634	3929	0.0	0.6703995927716976
chr2	RABL2A	113627855	113628010	0	156	2634	4010	2634	3854	0.0	0.683445770627919
chr2	ACTR3	113913171	113913227	0	57	22970	11958	22970	11901	0.0	1.9300899084110579
chr2	ACTR3	113916883	113917008	0	126	22970	11958	22970	11832	0.0	1.9413455037187288
chr2	ACTR3	113927344	113927455	0	112	22970	11958	22970	11846	0.0	1.939051156508526
chr2	LINC01191	113980186	113980404	26	219	51736	2946	51710	2727	0.1187214611872146	18.962229556288964
chr2	DPP10	115050147	115050219	0	73	3067	10071	3067	9998	0.0	0.3067613522704541
chr2	DPP10	115309238	115309353	0	116	3067	10071	3067	9955	0.0	0.30808638874937216
chr2	DPP10	115579113	115579266	0	154	3067	10071	3067	9917	0.0	0.30926691539780177
chr2	AC009303.2	118008670	118008954	0	285	0	4017	0	3732	0.0	0.0
chr2	INSIG2	118107089	118107189	0	101	255	3957	255	3856	0.0	0.06613070539419087
chr2	INSIG2	118096418	118096800	0	383	255	3957	255	3574	0.0	0.07134862898712926
chr2	INSIG2	118096418	118096426	0	9	255	3957	255	3948	0.0	0.06458966565349544
chr2	MARCO	118944792	118944925	0	134	0	2097	0	1963	0.0	0.0
chr2	STEAP3	119239362	119239430	0	69	0	4570	0	4501	0.0	0.0
chr2	STEAP3	119230619	119231034	0	416	0	4570	0	4154	0.0	0.0
chr2	STEAP3	119257456	119257688	0	233	0	4570	0	4337	0.0	0.0
chr2	DBI	119367558	119367644	0	87	0	2515	0	2428	0.0	0.0
chr2	DBI	119367402	119367528	0	127	0	2515	0	2388	0.0	0.0
chr2	CFAP221	119549084	119549185	0	102	5606	9690	5606	9588	0.0	0.5846891948268669
chr2	CFAP221	119562013	119562114	985	102	5606	9690	4621	9588	9.656862745098039	0.48195661243220694
chr2	CFAP221	119602617	119602762	0	146	5606	9690	5606	9544	0.0	0.587384744341995
chr2	CFAP221	119608501	119608589	0	89	5606	9690	5606	9601	0.0	0.5838975106759713
chr2	CFAP221	119556036	119556239	0	204	5606	9690	5606	9486	0.0	0.5909761754164031
chr2	CFAP221	119545111	119545273	969	163	5606	9690	4637	9527	5.9447852760736195	0.48672194814737063
chr2	CFAP221	119557007	119557405	0	399	5606	9690	5606	9291	0.0	0.603379614680874
chr2	TMEM177	119680831	119681123	0	293	51	2591	51	2298	0.0	0.022193211488250653
chr2	PTPN4	119885794	119885882	0	89	253150	13306	253150	13217	0.0	19.153363092986307
chr2	PTPN4	119926597	119926666	0	70	253150	13306	253150	13236	0.0	19.12586884255062
chr2	PTPN4	119791154	119791272	0	119	253150	13306	253150	13187	0.0	19.196936376734662
chr2	EPB41L5	120167876	120168007	0	132	20358	9237	20358	9105	0.0	2.2359143327841844
chr2	EPB41L5	120167879	120168007	0	129	20358	9237	20358	9108	0.0	2.2351778656126484
chr2	RALB	120280834	120280907	0	74	0	2870	0	2796	0.0	0.0
chr2	GLI2	120927360	120927466	0	107	47548	7685	47548	7578	0.0	6.27447875428873
chr2	NIFK-AS1	121650300	121650381	0	82	102	4745	102	4663	0.0	0.02187432983058117
chr2	TSN	121763004	121763084	0	81	0	4403	0	4322	0.0	0.0
chr2	TSN	121757239	121757333	0	95	0	4403	0	4308	0.0	0.0
chr2	TSN	121758709	121758806	0	98	0	4403	0	4305	0.0	0.0
chr2	TSN	121757239	121757434	0	196	0	4403	0	4207	0.0	0.0
chr2	LINC01823	121796240	121796720	0	481	0	3336	0	2855	0.0	0.0
chr2	LINC01823	121795549	121795627	0	79	0	3336	0	3257	0.0	0.0
chr2	LINC01823	121796554	121796720	0	167	0	3336	0	3169	0.0	0.0
chr2	LINC01823	121791392	121791503	0	112	0	3336	0	3224	0.0	0.0
chr2	LINC01823	121799481	121799619	0	139	0	3336	0	3197	0.0	0.0
chr2	LINC01823	121791130	121791453	0	324	0	3336	0	3012	0.0	0.0
chr2	GYPC	126690254	126690311	0	58	0	3616	0	3558	0.0	0.0
chr2	GYPC	126685827	126686645	0	819	0	3616	0	2797	0.0	0.0
chr2	TEX51	126899835	126899853	0	19	0	1165	0	1146	0.0	0.0
chr2	TEX51	126899935	126900019	0	85	0	1165	0	1080	0.0	0.0
chr2	TEX51	126901364	126901404	0	41	0	1165	0	1124	0.0	0.0
chr2	TEX51	126899798	126899853	0	56	0	1165	0	1109	0.0	0.0
chr2	AC010976.1	127482827	127482975	0	149	0	5506	0	5357	0.0	0.0
chr2	AC010976.1	127468013	127468126	0	114	0	5506	0	5392	0.0	0.0
chr2	AC010976.1	127467672	127467848	0	177	0	5506	0	5329	0.0	0.0
chr2	AC010976.1	127486419	127486517	0	99	0	5506	0	5407	0.0	0.0
chr2	AC010976.1	127470354	127470455	0	102	0	5506	0	5404	0.0	0.0
chr2	AC010976.1	127487984	127488146	0	163	0	5506	0	5343	0.0	0.0
chr2	AC010976.1	127482880	127482975	0	96	0	5506	0	5410	0.0	0.0
chr2	MYO7B	127612249	127612327	0	79	28	8008	28	7929	0.0	0.0035313406482532475
chr2	GPR17	127648057	127648286	0	230	0	2675	0	2445	0.0	0.0
chr2	GPR17	127650010	127650075	0	66	0	2675	0	2609	0.0	0.0
chr2	UGGT1	128103078	128103145	0	68	11215	11392	11215	11324	0.0	0.9903744259978806
chr2	UGGT1	128156391	128156415	0	25	11215	11392	11215	11367	0.0	0.9866279581243952
chr2	MZT2B	130183786	130183966	0	181	0	1525	0	1344	0.0	0.0
chr2	MZT2B	130182626	130182775	0	150	0	1525	0	1375	0.0	0.0
chr2	IMP4	130345778	130345933	0	156	0	3208	0	3052	0.0	0.0
chr2	PTPN18	130356599	130356655	0	57	0	5060	0	5003	0.0	0.0
chr2	CFC1B	130523168	130523278	0	111	0	1675	0	1564	0.0	0.0
chr2	CFC1B	130522789	130522904	0	116	0	1675	0	1559	0.0	0.0
chr2	PRSS40A	130574276	130574551	0	276	0	4289	0	4013	0.0	0.0
chr2	FAR2P3	130695466	130695591	0	126	255	3745	255	3619	0.0	0.07046145344017685
chr2	FAR2P3	130695894	130696048	0	155	255	3745	255	3590	0.0	0.07103064066852367
chr2	FAR2P3	130695236	130695334	0	99	255	3745	255	3646	0.0	0.06993965990126165
chr2	ARHGEF4	131040260	131040440	0	181	51257	7454	51257	7273	0.0	7.0475732160044
chr2	PLEKHB2	131144407	131144449	0	43	147761	6740	147761	6697	0.0	22.063759892489173
chr2	PLEKHB2	131140169	131140275	307	107	147761	6740	147454	6633	2.869158878504673	22.23036333484095
chr2	PLEKHB2	131140166	131140275	307	110	147761	6740	147454	6630	2.790909090909091	22.240422322775263
chr2	POTEE	131236731	131236802	0	72	0	4207	0	4135	0.0	0.0
chr2	POTEE	131252525	131252570	0	46	0	4207	0	4161	0.0	0.0
chr2	POTEE	131238193	131238238	0	46	0	4207	0	4161	0.0	0.0
chr2	SMPD4BP	131519813	131519942	0	130	83	3933	83	3803	0.0	0.021824875098606363
chr2	CCDC74A	131532588	131532781	0	194	102	3085	102	2891	0.0	0.03528190937391906
chr2	CCDC74A	131528492	131528627	0	136	102	3085	102	2949	0.0	0.03458799593082401
chr2	CCDC74A	131532709	131532781	0	73	102	3085	102	3012	0.0	0.03386454183266932
chr2	C2ORF27A	131733832	131733952	0	121	204	7103	204	6982	0.0	0.0292179891148668
chr2	C2ORF27A	131689138	131689352	0	215	204	7103	204	6888	0.0	0.029616724738675958
chr2	C2ORF27A	131728071	131728210	0	140	204	7103	204	6963	0.0	0.029297716501507972
chr2	C2ORF27A	131736539	131736686	0	148	204	7103	204	6955	0.0	0.029331416247304096
chr2	ZNF806	132307143	132307186	0	44	255	5166	255	5122	0.0	0.04978524014057009
chr2	ACMSD	134861968	134862018	0	51	102	2727	102	2676	0.0	0.03811659192825112
chr2	ACMSD	134844364	134844471	0	108	102	2727	102	2619	0.0	0.038946162657502864
chr2	CCNT2	134945888	134945975	0	88	51	8883	51	8795	0.0	0.00579874928936896
chr2	CCNT2	134942611	134942674	0	64	51	8883	51	8819	0.0	0.005782968590543145
chr2	CCNT2	134945786	134945982	0	197	51	8883	51	8686	0.0	0.005871517384296569
chr2	RAB3GAP1	135167692	135167713	0	22	8053	5651	8053	5629	0.0	1.4306271096109433
chr2	R3HDM1	135565736	135565925	0	190	2870	7930	2870	7740	0.0	0.3708010335917313
chr2	R3HDM1	135604805	135605016	0	212	2870	7930	2870	7718	0.0	0.3718579942990412
chr2	R3HDM1	135622653	135622732	0	80	2870	7930	2870	7850	0.0	0.36560509554140125
chr2	R3HDM1	135715549	135715694	0	146	2870	7930	2870	7784	0.0	0.368705035971223
chr2	R3HDM1	135616151	135616193	0	43	2870	7930	2870	7887	0.0	0.36388994547990366
chr2	R3HDM1	135641535	135641790	0	256	2870	7930	2870	7674	0.0	0.3739900964295022
chr2	R3HDM1	135568757	135568809	0	53	2870	7930	2870	7877	0.0	0.3643519106258728
chr2	R3HDM1	135616667	135616757	0	91	2870	7930	2870	7839	0.0	0.36611812731215715
chr2	R3HDM1	135641535	135641604	0	70	2870	7930	2870	7860	0.0	0.3651399491094148
chr2	R3HDM1	135649901	135650003	0	103	2870	7930	2870	7827	0.0	0.3666794429538776
chr2	UBXN4	135747657	135747765	0	109	102	4422	102	4313	0.0	0.02364943194991885
chr2	UBXN4	135761817	135761911	0	95	102	4422	102	4327	0.0	0.023572914259302056
chr2	UBXN4	135753538	135754277	0	740	102	4422	102	3682	0.0	0.027702335687126562
chr2	DARS-AS1	136008866	136009073	45	208	3342	5976	3297	5768	0.21634615384615385	0.5716019417475728
chr2	DARS-AS1	135997122	135997242	0	121	3342	5976	3342	5855	0.0	0.570794192997438
chr2	DARS-AS1	135996191	135996408	0	218	3342	5976	3342	5758	0.0	0.5804098645362973
chr2	DARS-AS1	136002000	136002126	0	127	3342	5976	3342	5849	0.0	0.5713797230295777
chr2	DARS-AS1	136003269	136003367	0	99	3342	5976	3342	5877	0.0	0.5686574783052578
chr2	DARS-AS1	136003742	136003822	0	81	3342	5976	3342	5895	0.0	0.5669211195928753
chr2	DARS-AS1	136007195	136007583	1530	389	3342	5976	1812	5587	3.9331619537275064	0.32432432432432434
chr2	DARS-AS1	136014655	136014762	0	108	3342	5976	3342	5868	0.0	0.5695296523517382
chr2	DARS-AS1	136016266	136016346	0	81	3342	5976	3342	5895	0.0	0.5669211195928753
chr2	DARS-AS1	136012849	136012982	0	134	3342	5976	3342	5842	0.0	0.5720643615200274
chr2	DARS-AS1	136003244	136003367	0	124	3342	5976	3342	5852	0.0	0.5710868079289132
chr2	DARS-AS1	136014048	136014134	0	87	3342	5976	3342	5889	0.0	0.5674987264391238
chr2	THSD7B	136906447	136906566	0	120	102	6794	102	6674	0.0	0.015283188492658075
chr2	HNMT	137970164	137970217	0	54	0	4769	0	4715	0.0	0.0
chr2	SPOPL	138554438	138554535	0	98	0	6511	0	6413	0.0	0.0
chr2	KYNU	142918608	142918729	0	122	0	17465	0	17343	0.0	0.0
chr2	KYNU	142881344	142881430	0	87	0	17465	0	17378	0.0	0.0
chr2	KYNU	142879462	142879666	0	205	0	17465	0	17260	0.0	0.0
chr2	KYNU	142954021	142954067	0	47	0	17465	0	17418	0.0	0.0
chr2	ARHGAP15	143587685	143587817	0	133	131	6138	131	6005	0.0	0.021815154038301414
chr2	ZEB2-AS1	144519958	144520110	0	153	0	2254	0	2101	0.0	0.0
chr2	ZEB2-AS1	144519835	144520110	0	276	0	2254	0	1978	0.0	0.0
chr2	ZEB2-AS1	144518751	144518861	0	111	0	2254	0	2143	0.0	0.0
chr2	ZEB2-AS1	144519510	144520110	0	601	0	2254	0	1653	0.0	0.0
chr2	TEX41	144766369	144766530	0	162	5870	26381	5870	26219	0.0	0.22388344330447385
chr2	TEX41	144691038	144691110	0	73	5870	26381	5870	26308	0.0	0.22312604530941157
chr2	TEX41	144903665	144903803	0	139	5870	26381	5870	26242	0.0	0.22368721896196936
chr2	TEX41	145171997	145172131	0	135	5870	26381	5870	26246	0.0	0.22365312809570984
chr2	TEX41	145057650	145057728	0	79	5870	26381	5870	26302	0.0	0.22317694471903277
chr2	TEX41	144763396	144763528	0	133	5870	26381	5870	26248	0.0	0.22363608655897593
chr2	TEX41	144780973	144781258	0	286	5870	26381	5870	26095	0.0	0.22494730791339337
chr2	TEX41	144809307	144809414	0	108	5870	26381	5870	26273	0.0	0.2234232862634644
chr2	TEX41	144753114	144753205	0	92	5870	26381	5870	26289	0.0	0.2232873064779946
chr2	TEX41	144851044	144851158	0	115	5870	26381	5870	26266	0.0	0.22348282951343942
chr2	TEX41	144671606	144671664	0	59	5870	26381	5870	26322	0.0	0.22300737026061848
chr2	TEX41	144863944	144863998	0	55	5870	26381	5870	26326	0.0	0.22297348628732053
chr2	TEX41	144940857	144940945	0	89	5870	26381	5870	26292	0.0	0.2232618286931386
chr2	TEX41	145070819	145070941	0	123	5870	26381	5870	26258	0.0	0.2235509178155229
chr2	TEX41	144768097	144768280	0	184	5870	26381	5870	26197	0.0	0.22407145856395771
chr2	TEX41	145113220	145113443	0	224	5870	26381	5870	26157	0.0	0.2244141147685132
chr2	TEX41	145164172	145164312	0	141	5870	26381	5870	26240	0.0	0.22370426829268292
chr2	TEX41	145181009	145181112	0	104	5870	26381	5870	26277	0.0	0.22338927579251816
chr2	TEX41	145016367	145016523	0	157	5870	26381	5870	26224	0.0	0.22384075655887736
chr2	TEX41	145171997	145172088	0	92	5870	26381	5870	26289	0.0	0.2232873064779946
chr2	TEX41	145117555	145117653	0	99	5870	26381	5870	26282	0.0	0.22334677726200441
chr2	TEX41	144671601	144671664	0	64	5870	26381	5870	26317	0.0	0.22304973971197325
chr2	TEX41	145182045	145182093	0	49	5870	26381	5870	26332	0.0	0.2229226796293483
chr2	TEX41	144935343	144935483	0	141	5870	26381	5870	26240	0.0	0.22370426829268292
chr2	TEX41	144953174	144953292	0	119	5870	26381	5870	26262	0.0	0.22351686847917143
chr2	TEX41	144673486	144673605	0	120	5870	26381	5870	26261	0.0	0.2235253798408286
chr2	TEX41	144865394	144865460	0	67	5870	26381	5870	26314	0.0	0.22307516911149958
chr2	TEX41	145017531	145017611	0	81	5870	26381	5870	26300	0.0	0.2231939163498099
chr2	TEX41	145043886	145044067	0	182	5870	26381	5870	26199	0.0	0.22405435321958853
chr2	TEX41	145178876	145178967	0	92	5870	26381	5870	26289	0.0	0.2232873064779946
chr2	TEX41	145174889	145174996	0	108	5870	26381	5870	26273	0.0	0.2234232862634644
chr2	TEX41	145116412	145116821	0	410	5870	26381	5870	25971	0.0	0.22602133148511802
chr2	TEX41	145174889	145174992	0	104	5870	26381	5870	26277	0.0	0.22338927579251816
chr2	TEX41	145072523	145072823	0	301	5870	26381	5870	26080	0.0	0.22507668711656442
chr2	TEX41	145174886	145174992	0	107	5870	26381	5870	26274	0.0	0.22341478267488774
chr2	TEX41	145090830	145090903	0	74	5870	26381	5870	26307	0.0	0.2231345269319953
chr2	TEX41	145116412	145116510	0	99	5870	26381	5870	26282	0.0	0.22334677726200441
chr2	TEX41	145043886	145044011	0	126	5870	26381	5870	26255	0.0	0.2235764616263569
chr2	TEX41	145034793	145034885	0	93	5870	26381	5870	26288	0.0	0.22329580036518565
chr2	TEX41	145043625	145043775	0	151	5870	26381	5870	26230	0.0	0.22378955394586353
chr2	TEX41	145044365	145044463	0	99	5870	26381	5870	26282	0.0	0.22334677726200441
chr2	TEX41	145143033	145143181	1407	149	5870	26381	4463	26232	9.442953020134228	0.1701357121073498
chr2	TEX41	145178732	145178967	0	236	5870	26381	5870	26145	0.0	0.22451711608338115
chr2	TEX41	145072523	145072646	0	124	5870	26381	5870	26257	0.0	0.22355943177057547
chr2	TEX41	145181196	145181293	0	98	5870	26381	5870	26283	0.0	0.22333827949625232
chr2	TEX41	145224886	145224972	0	87	5870	26381	5870	26294	0.0	0.223244846733095
chr2	LINC01911	146838630	146838745	0	116	0	3576	0	3460	0.0	0.0
chr2	LINC01911	146846628	146846818	0	191	0	3576	0	3385	0.0	0.0
chr2	LINC01911	146848248	146848411	0	164	0	3576	0	3412	0.0	0.0
chr2	LINC01911	146858511	146858644	0	134	0	3576	0	3442	0.0	0.0
chr2	LINC01911	146846751	146846818	0	68	0	3576	0	3508	0.0	0.0
chr2	LINC01911	146856647	146856807	0	161	0	3576	0	3415	0.0	0.0
chr2	LINC01911	146859537	146859601	0	65	0	3576	0	3511	0.0	0.0
chr2	LINC01911	146857978	146858111	0	134	0	3576	0	3442	0.0	0.0
chr2	LINC01911	146853870	146853954	0	85	0	3576	0	3491	0.0	0.0
chr2	ACVR2A	147845073	147845207	0	135	0	6398	0	6263	0.0	0.0
chr2	MBD5	148021647	148021684	0	38	357	23435	357	23397	0.0	0.015258366457238107
chr2	MBD5	148233244	148233395	0	152	357	23435	357	23283	0.0	0.015333075634583172
chr2	MBD5	148489385	148490594	204	1210	357	23435	153	22225	0.16859504132231404	0.006884139482564679
chr2	MBD5	148447566	148447740	0	175	357	23435	357	23260	0.0	0.01534823731728289
chr2	MBD5	148489385	148489500	0	116	357	23435	357	23319	0.0	0.015309404348385437
chr2	MBD5	148489385	148490787	204	1403	357	23435	153	22032	0.14540270848182466	0.006944444444444444
chr2	KIF5C	148978921	148978990	0	70	3699	31919	3699	31849	0.0	0.11614179409086628
chr2	KIF5C	148997263	148997340	0	78	3699	31919	3699	31841	0.0	0.11617097452969442
chr2	KIF5C	149005392	149005464	0	73	3699	31919	3699	31846	0.0	0.11615273503736732
chr2	KIF5C	149008471	149008661	0	191	3699	31919	3699	31728	0.0	0.11658472012102875
chr2	KIF5C	149020175	149020382	0	208	3699	31919	3699	31711	0.0	0.11664722020749897
chr2	KIF5C	148952497	148952558	0	62	3699	31919	3699	31857	0.0	0.11611262830775027
chr2	LYPD6B	149160763	149160835	0	73	612	3562	612	3489	0.0	0.17540842648323302
chr2	LYPD6B	149206018	149206195	0	178	612	3562	612	3384	0.0	0.18085106382978725
chr2	LYPD6	149464163	149464475	0	313	634	4983	634	4670	0.0	0.13576017130620985
chr2	LYPD6	149370519	149370617	0	99	634	4983	634	4884	0.0	0.1298116298116298
chr2	LINC01818	150326192	150326354	0	163	22	1773	22	1610	0.0	0.013664596273291925
chr2	LINC02612	150629639	150629714	0	76	0	3285	0	3209	0.0	0.0
chr2	LINC02612	150629430	150629582	0	153	0	3285	0	3132	0.0	0.0
chr2	RIF1	151410413	151410527	0	115	459	13734	459	13619	0.0	0.0337029150451575
chr2	RIF1	151468473	151468551	0	79	459	13734	459	13655	0.0	0.03361406078359575
chr2	FMNL2	152622536	152622557	0	22	11591	6602	11591	6580	0.0	1.761550151975684
chr2	FMNL2	152643418	152643544	0	127	11591	6602	11591	6475	0.0	1.7901158301158302
chr2	ARL6IP6	152732530	152732580	0	51	0	3875	0	3824	0.0	0.0
chr2	ARL6IP6	152719897	152720004	0	108	0	3875	0	3767	0.0	0.0
chr2	GALNT13	154408983	154409082	0	100	102	6628	102	6528	0.0	0.015625
chr2	GALNT13	153926287	153926339	0	53	102	6628	102	6575	0.0	0.015513307984790874
chr2	GALNT13	154446597	154446765	0	169	102	6628	102	6459	0.0	0.01579191825359963
chr2	GALNT13	154236045	154236180	0	136	102	6628	102	6492	0.0	0.015711645101663587
chr2	GALNT13	154446567	154446765	0	199	102	6628	102	6429	0.0	0.015865608959402706
chr2	KCNJ3	154709602	154709819	0	218	51	4912	51	4694	0.0	0.010864933958244567
chr2	AC073225.1	155544224	155544329	0	106	51	17123	51	17017	0.0	0.002997002997002997
chr2	AC073225.1	155560440	155560542	0	103	51	17123	51	17020	0.0	0.0029964747356051704
chr2	AC073225.1	155626640	155626788	0	149	51	17123	51	16974	0.0	0.003004595263343938
chr2	AC073225.1	155541659	155541739	0	81	51	17123	51	17042	0.0	0.002992606501584321
chr2	AC073225.1	155588816	155588966	0	151	51	17123	51	16972	0.0	0.0030049493283054443
chr2	AC073225.1	155608214	155608419	0	206	51	17123	51	16917	0.0	0.0030147189217946445
chr2	AC073225.1	155608251	155608419	0	169	51	17123	51	16954	0.0	0.0030081396720537928
chr2	AC073225.1	155547296	155547356	0	61	51	17123	51	17062	0.0	0.0029890985816434183
chr2	GPD2	156495561	156495691	0	131	0	7188	0	7057	0.0	0.0
chr2	PKP4	158577270	158577383	0	114	3397	8907	3397	8793	0.0	0.38633003525531673
chr2	PKP4	158676738	158676867	0	130	3397	8907	3397	8777	0.0	0.38703429417796514
chr2	PKP4	158533437	158533534	0	98	3397	8907	3397	8809	0.0	0.3856283346577364
chr2	PKP4	158533179	158533316	0	138	3397	8907	3397	8769	0.0	0.38738738738738737
chr2	DAPL1	158807671	158807790	0	120	0	1333	0	1213	0.0	0.0
chr2	AC008277.1	159396476	159396536	0	61	0	1519	0	1458	0.0	0.0
chr2	MARCHF7	159745769	159745937	0	169	663	6301	663	6132	0.0	0.10812133072407044
chr2	MARCHF7	159747804	159748903	0	1100	663	6301	663	5201	0.0	0.12747548548356086
chr2	MARCHF7	159764625	159764674	0	50	663	6301	663	6251	0.0	0.10606302991521356
chr2	MARCHF7	159715680	159715766	0	87	663	6301	663	6214	0.0	0.10669456066945607
chr2	TANK	161230970	161231551	0	582	3472	5607	3472	5025	0.0	0.6909452736318408
chr2	TANK	161161284	161161412	51	129	3472	5607	3421	5478	0.3953488372093023	0.6244979919678715
chr2	TANK	161202862	161202979	0	118	3472	5607	3472	5489	0.0	0.6325378028784843
chr2	TANK	161216388	161216442	0	55	3472	5607	3472	5552	0.0	0.6253602305475504
chr2	TANK	161232732	161232809	0	78	3472	5607	3472	5529	0.0	0.6279616567191174
chr2	TANK	161232794	161232897	0	104	3472	5607	3472	5503	0.0	0.6309285844085044
chr2	TANK	161232755	161232809	0	55	3472	5607	3472	5552	0.0	0.6253602305475504
chr2	LINC01806	161245423	161245467	39	45	39	2493	0	2448	0.8666666666666667	0.0
chr2	SLC4A10	161452122	161452193	0	72	114	7588	114	7516	0.0	0.01516764236295902
chr2	SLC4A10	161622228	161622371	0	144	114	7588	114	7444	0.0	0.015314347125201504
chr2	SLC4A10	161708693	161708829	26	137	114	7588	88	7451	0.1897810218978102	0.011810495235538853
chr2	SLC4A10	161977721	161977760	0	40	114	7588	114	7548	0.0	0.015103338632750398
chr2	SLC4A10	161873915	161874005	0	91	114	7588	114	7497	0.0	0.01520608243297319
chr2	SLC4A10	161902027	161902164	0	138	114	7588	114	7450	0.0	0.015302013422818792
chr2	GCA	162346581	162346665	0	85	56552	5335	56552	5250	0.0	10.771809523809523
chr2	AC019197.1	164912313	164912435	0	123	0	10285	0	10162	0.0	0.0
chr2	AC019197.1	164959054	164959143	0	90	0	10285	0	10195	0.0	0.0
chr2	AC019197.1	164956764	164956795	0	32	0	10285	0	10253	0.0	0.0
chr2	AC019197.1	164922077	164922288	0	212	0	10285	0	10073	0.0	0.0
chr2	SCN2A	165308665	165308794	0	130	51	23956	51	23826	0.0	0.002140518761017376
chr2	SCN2A	165327154	165327202	0	49	51	23956	51	23907	0.0	0.0021332664073283976
chr2	SCN2A	165245329	165245448	0	120	51	23956	51	23836	0.0	0.0021396207417351903
chr2	SCN2A	165290629	165290785	0	157	51	23956	51	23799	0.0	0.0021429471826547334
chr2	SCN2A	165320239	165320364	0	126	51	23956	51	23830	0.0	0.002140159462861939
chr2	SCN2A	165328403	165328538	0	136	51	23956	51	23820	0.0	0.0021410579345088163
chr2	SCN2A	165357773	165357857	0	85	51	23956	51	23871	0.0	0.002136483599346487
chr2	SCN2A	165349900	165350208	0	309	51	23956	51	23647	0.0	0.002156721782890007
chr2	SCN2A	165350081	165350208	0	128	51	23956	51	23828	0.0	0.002140339096860836
chr2	TTC21B-AS1	165934733	165934789	0	57	0	2563	0	2506	0.0	0.0
chr2	SCN1A-AS1	166104246	166104348	0	103	0	18935	0	18832	0.0	0.0
chr2	SCN1A-AS1	166109490	166109602	0	113	0	18935	0	18822	0.0	0.0
chr2	SCN1A-AS1	166027116	166027229	0	114	0	18935	0	18821	0.0	0.0
chr2	SCN1A-AS1	166036065	166036130	0	66	0	18935	0	18869	0.0	0.0
chr2	SCN1A-AS1	166249342	166249384	0	43	0	18935	0	18892	0.0	0.0
chr2	SCN1A-AS1	166277087	166277247	0	161	0	18935	0	18774	0.0	0.0
chr2	SCN1A-AS1	166012840	166012966	0	127	0	18935	0	18808	0.0	0.0
chr2	SCN1A-AS1	165984616	165984776	0	161	0	18935	0	18774	0.0	0.0
chr2	SCN1A-AS1	166059402	166059524	0	123	0	18935	0	18812	0.0	0.0
chr2	SCN1A-AS1	166137542	166137635	0	94	0	18935	0	18841	0.0	0.0
chr2	SCN1A-AS1	166133821	166133908	0	88	0	18935	0	18847	0.0	0.0
chr2	SCN1A-AS1	166171386	166171558	0	173	0	18935	0	18762	0.0	0.0
chr2	SCN1A-AS1	166263711	166263806	0	96	0	18935	0	18839	0.0	0.0
chr2	XIRP2	167242568	167251947	102	9380	0	7238	-102	-2142	0.010874200426439232	0.047619047619047616
chr2	XIRP2	167184541	167184640	0	100	0	7238	0	7138	0.0	0.0
chr2	CERS6	168766321	168766345	0	25	66	6862	66	6837	0.0	0.009653356735410267
chr2	NOSTRIN	168811566	168811652	3194	87	41781	4668	38587	4581	36.71264367816092	8.423270028378083
chr2	NOSTRIN	168824633	168824717	0	85	41781	4668	41781	4583	0.0	9.116517564913812
chr2	NOSTRIN	168850835	168851006	0	172	41781	4668	41781	4496	0.0	9.292927046263346
chr2	NOSTRIN	168818171	168818296	0	126	41781	4668	41781	4542	0.0	9.198811096433289
chr2	NOSTRIN	168855885	168856210	0	326	41781	4668	41781	4342	0.0	9.622524182404423
chr2	G6PC2	168902444	168902554	0	111	153	3080	153	2969	0.0	0.051532502526103065
chr2	G6PC2	168906663	168906779	153	117	153	3080	0	2963	1.3076923076923077	0.0
chr2	DHRS9	169069452	169069717	0	266	0	3762	0	3496	0.0	0.0
chr2	DHRS9	169081050	169081152	0	103	0	3762	0	3659	0.0	0.0
chr2	DHRS9	169072574	169072685	0	112	0	3762	0	3650	0.0	0.0
chr2	DHRS9	169074254	169074466	0	213	0	3762	0	3549	0.0	0.0
chr2	BBS5	169497626	169497689	0	64	558	4221	558	4157	0.0	0.13423141688717824
chr2	PPIG	169607103	169607148	0	46	26866	10326	26866	10280	0.0	2.6134241245136187
chr2	PPIG	169603641	169603694	0	54	26866	10326	26866	10272	0.0	2.6154595015576323
chr2	PPIG	169631598	169631647	5979	50	26866	10326	20887	10276	119.58	2.032600233553912
chr2	PHOSPHO2	169697864	169697982	0	119	1235	1494	1235	1375	0.0	0.8981818181818182
chr2	PHOSPHO2	169697360	169697531	1235	172	1235	1494	0	1322	7.180232558139535	0.0
chr2	PHOSPHO2	169697892	169697982	0	91	1235	1494	1235	1403	0.0	0.880256593014968
chr2	KLHL23	169735012	169736227	102	1216	24760	5523	24658	4307	0.08388157894736842	5.725098676573021
chr2	SSB	169800951	169801026	0	76	0	4642	0	4566	0.0	0.0
chr2	SSB	169805997	169806113	0	117	0	4642	0	4525	0.0	0.0
chr2	UBR3	170055459	170055584	0	126	0	9972	0	9846	0.0	0.0
chr2	UBR3	170014814	170014865	0	52	0	9972	0	9920	0.0	0.0
chr2	UBR3	170016832	170016919	0	88	0	9972	0	9884	0.0	0.0
chr2	UBR3	170013840	170013972	0	133	0	9972	0	9839	0.0	0.0
chr2	MYO3B	170214728	170214828	0	101	30999	8275	30999	8174	0.0	3.7923905064839736
chr2	MYO3B	170501784	170501865	0	82	30999	8275	30999	8193	0.0	3.783595752471622
chr2	MYO3B	170646908	170646939	0	32	30999	8275	30999	8243	0.0	3.760645396093655
chr2	AC007405.3	170777146	170777177	0	32	1249	2602	1249	2570	0.0	0.4859922178988327
chr2	AC007405.3	170777376	170777425	0	50	1249	2602	1249	2552	0.0	0.48942006269592475
chr2	AC007405.3	170775652	170775719	0	68	1249	2602	1249	2534	0.0	0.4928966061562747
chr2	GAD1	170844044	170844157	0	114	397	7161	397	7047	0.0	0.05633602951610615
chr2	GAD1	170848682	170848794	0	113	397	7161	397	7048	0.0	0.056328036322360955
chr2	GAD1	170842568	170842648	0	81	397	7161	397	7080	0.0	0.056073446327683615
chr2	GORASP2	170929816	170929941	108	126	414	4718	306	4592	0.8571428571428571	0.0666376306620209
chr2	GORASP2	170929740	170929941	108	202	414	4718	306	4516	0.5346534653465347	0.06775907883082374
chr2	GORASP2	170936623	170936727	0	105	414	4718	414	4613	0.0	0.0897463689572946
chr2	DCAF17	171457970	171458075	188	106	374	7673	186	7567	1.7735849056603774	0.024580414959693406
chr2	DCAF17	171435082	171435186	0	105	374	7673	374	7568	0.0	0.04941860465116279
chr2	DCAF17	171458371	171458477	0	107	374	7673	374	7566	0.0	0.04943166798836902
chr2	DCAF17	171447385	171447503	0	119	374	7673	374	7554	0.0	0.049510193275086045
chr2	CYBRD1	171541584	171541793	0	210	0	5181	0	4971	0.0	0.0
chr2	DYNC1I2	171712766	171712826	0	61	8244	5857	8244	5796	0.0	1.4223602484472049
chr2	DYNC1I2	171707286	171707377	0	92	8244	5857	8244	5765	0.0	1.4300086730268864
chr2	DYNC1I2	171706546	171706564	0	19	8244	5857	8244	5838	0.0	1.4121274409044193
chr2	DYNC1I2	171707232	171707377	0	146	8244	5857	8244	5711	0.0	1.443530029767116
chr2	DYNC1I2	171688470	171688648	0	179	8244	5857	8244	5678	0.0	1.4519196900317013
chr2	HAT1	171946707	171946783	20	77	122	5990	102	5913	0.2597402597402597	0.017250126839167934
chr2	HAT1	171952880	171953001	0	122	122	5990	122	5868	0.0	0.020790729379686436
chr2	METAP1D	172065603	172065752	0	150	0	4501	0	4351	0.0	0.0
chr2	DLX1	172086653	172086853	0	201	0	3575	0	3374	0.0	0.0
chr2	ITGA6	172489484	172489658	0	175	51	6738	51	6563	0.0	0.007770836507694652
chr2	ITGA6	172501771	172501901	0	131	51	6738	51	6607	0.0	0.007719085818071742
chr2	ITGA6	172470973	172471105	0	133	51	6738	51	6605	0.0	0.007721423164269493
chr2	ITGA6	172472773	172472890	0	118	51	6738	51	6620	0.0	0.00770392749244713
chr2	PDK1	172562219	172562291	102	73	163986	13131	163884	13058	1.3972602739726028	12.55046714657681
chr2	PDK1	172564502	172564687	0	186	163986	13131	163986	12945	0.0	12.667902665121668
chr2	PDK1	172564051	172564130	0	80	163986	13131	163986	13051	0.0	12.565014175158991
chr2	PDK1	172562740	172562800	0	61	163986	13131	163986	13070	0.0	12.546748278500383
chr2	PDK1	172568740	172568817	0	78	163986	13131	163986	13053	0.0	12.563088945070099
chr2	RAPGEF4	172960759	172960813	0	55	34363	6589	34363	6534	0.0	5.259106213651668
chr2	MAP3K20	173090997	173091190	0	194	164	13829	164	13635	0.0	0.012027869453612028
chr2	CDCA7	173358711	173358837	0	127	81333	3208	81333	3081	0.0	26.398247322297955
chr2	CDCA7	173366282	173366432	1494	151	81333	3208	79839	3057	9.894039735099337	26.116781157998037
chr2	CDCA7	173359386	173359491	129	106	81333	3208	81204	3102	1.2169811320754718	26.177949709864603
chr2	CDCA7	173359254	173359491	153	238	81333	3208	81180	2970	0.6428571428571429	27.333333333333332
chr2	CDCA7	173359342	173359491	153	150	81333	3208	81180	3058	1.02	26.546762589928058
chr2	CDCA7	173363999	173364161	130	163	81333	3208	81203	3045	0.7975460122699386	26.667651888341542
chr2	SCRN3	174398274	174398442	0	169	236	4074	236	3905	0.0	0.060435339308578744
chr2	SCRN3	174400989	174401189	0	201	236	4074	236	3873	0.0	0.06093467596178673
chr2	SCRN3	174397335	174397404	32	70	236	4074	204	4004	0.45714285714285713	0.05094905094905095
chr2	SCRN3	174398365	174398442	0	78	236	4074	236	3996	0.0	0.05905905905905906
chr2	SCRN3	174422884	174423047	0	164	236	4074	236	3910	0.0	0.06035805626598466
chr2	AC093459.1	175291392	175291501	0	110	0	1580	0	1470	0.0	0.0
chr2	AC093459.1	175442447	175442981	0	535	0	1580	0	1045	0.0	0.0
chr2	AC093459.1	175454607	175454684	0	78	0	1580	0	1502	0.0	0.0
chr2	HOXD10	176111382	176111516	0	135	102	2492	102	2357	0.0	0.04327535002121341
chr2	MTX2	176270215	176270419	0	205	0	1729	0	1524	0.0	0.0
chr2	MTX2	176304240	176304365	0	126	0	1729	0	1603	0.0	0.0
chr2	HNRNPA3	177216502	177216592	0	91	51	6245	51	6154	0.0	0.008287292817679558
chr2	HNRNPA3	177217704	177217845	0	142	51	6245	51	6103	0.0	0.008356545961002786
chr2	HNRNPA3	177219407	177221976	0	2570	51	6245	51	3675	0.0	0.013877551020408163
chr2	AGPS	177551362	177551582	0	221	36	8861	36	8640	0.0	0.004166666666666667
chr2	PDE11A-AS1	177701093	177701228	0	136	51	1847	51	1711	0.0	0.029807130333138514
chr2	OSBPL6	178344285	178344360	0	76	16524	11517	16524	11441	0.0	1.4442793462109955
chr2	OSBPL6	178372125	178372233	0	109	16524	11517	16524	11408	0.0	1.4484572230014026
chr2	OSBPL6	178339671	178339764	0	94	16524	11517	16524	11423	0.0	1.4465551956578833
chr2	CHROMR	178426365	178426661	51	297	13808	7002	13757	6705	0.1717171717171717	2.051752423564504
chr2	CHROMR	178426365	178426680	51	316	13808	7002	13757	6686	0.16139240506329114	2.0575830092731078
chr2	CHROMR	178426365	178426505	51	141	13808	7002	13757	6861	0.3617021276595745	2.005101297186999
chr2	CHROMR	178415817	178415963	3712	147	13808	7002	10096	6855	25.25170068027211	1.4727935813274982
chr2	CHROMR	178426365	178426703	51	339	13808	7002	13757	6663	0.1504424778761062	2.064685577067387
chr2	PJVK	178454104	178454205	0	102	0	3976	0	3874	0.0	0.0
chr2	PJVK	178458509	178458627	0	119	0	3976	0	3857	0.0	0.0
chr2	PJVK	178460347	178460446	0	100	0	3976	0	3876	0.0	0.0
chr2	PJVK	178452457	178452569	0	113	0	3976	0	3863	0.0	0.0
chr2	PJVK	178459192	178459269	0	78	0	3976	0	3898	0.0	0.0
chr2	PJVK	178460347	178460420	0	74	0	3976	0	3902	0.0	0.0
chr2	PLEKHA3	178488967	178489014	0	48	8828	14216	8828	14168	0.0	0.6230942970073405
chr2	PLEKHA3	178502335	178502483	0	149	8828	14216	8828	14067	0.0	0.6275680671074145
chr2	TTN-AS1	178538697	178539890	0	1194	1173	21966	1173	20772	0.0	0.056470248411322935
chr2	TTN-AS1	178582990	178583181	0	192	1173	21966	1173	21774	0.0	0.05387158996968862
chr2	TTN-AS1	178591138	178591314	1122	177	1173	21966	51	21789	6.338983050847458	0.0023406305934186977
chr2	TTN-AS1	178598555	178598673	0	119	1173	21966	1173	21847	0.0	0.053691582368288554
chr2	TTN-AS1	178528723	178528813	0	91	1173	21966	1173	21875	0.0	0.053622857142857146
chr2	TTN-AS1	178531313	178531578	0	266	1173	21966	1173	21700	0.0	0.05405529953917051
chr2	TTN-AS1	178599593	178599750	0	158	1173	21966	1173	21808	0.0	0.05378760088041086
chr2	TTN-AS1	178535731	178535828	0	98	1173	21966	1173	21868	0.0	0.05364002194988111
chr2	TTN-AS1	178756265	178756322	0	58	1173	21966	1173	21908	0.0	0.053542085083074675
chr2	TTN-AS1	178571299	178571449	0	151	1173	21966	1173	21815	0.0	0.0537703415081366
chr2	TTN-AS1	178537603	178537691	0	89	1173	21966	1173	21877	0.0	0.05361795492983499
chr2	TTN-AS1	178737321	178737443	0	123	1173	21966	1173	21843	0.0	0.05370141464084604
chr2	TTN-AS1	178778711	178778755	0	45	1173	21966	1173	21921	0.0	0.05351033255782127
chr2	TTN-AS1	178583712	178583921	0	210	1173	21966	1173	21756	0.0	0.053916161059018204
chr2	TTN-AS1	178584572	178584993	0	422	1173	21966	1173	21544	0.0	0.05444671370219086
chr2	TTN-AS1	178600557	178600667	0	111	1173	21966	1173	21855	0.0	0.05367192862045299
chr2	TTN-AS1	178675992	178676105	0	114	1173	21966	1173	21852	0.0	0.05367929708951126
chr2	TTN-AS1	178777857	178778755	0	899	1173	21966	1173	21067	0.0	0.055679498742108514
chr2	TTN-AS1	178524086	178524223	0	138	1173	21966	1173	21828	0.0	0.053738317757009345
chr2	TTN-AS1	178536333	178536462	0	130	1173	21966	1173	21836	0.0	0.05371862978567503
chr2	TTN-AS1	178537360	178537447	0	88	1173	21966	1173	21878	0.0	0.05361550415942956
chr2	TTN-AS1	178529284	178529336	0	53	1173	21966	1173	21913	0.0	0.05352986811481769
chr2	TTN-AS1	178536878	178537228	0	351	1173	21966	1173	21615	0.0	0.05426786953504511
chr2	TTN-AS1	178538229	178538359	0	131	1173	21966	1173	21835	0.0	0.05372108999313029
chr2	TTN-AS1	178583523	178583648	0	126	1173	21966	1173	21840	0.0	0.053708791208791205
chr2	TTN-AS1	178636573	178636698	51	126	1173	21966	1122	21840	0.40476190476190477	0.05137362637362637
chr2	TTN-AS1	178641300	178641444	0	145	1173	21966	1173	21821	0.0	0.053755556573942535
chr2	TTN-AS1	178586610	178586841	0	232	1173	21966	1173	21734	0.0	0.053970737093954176
chr2	TTN-AS1	178608166	178608266	0	101	1173	21966	1173	21865	0.0	0.05364738166018752
chr2	TTN-AS1	178644298	178644501	0	204	1173	21966	1173	21762	0.0	0.05390129583677971
chr2	TTN-AS1	178675101	178675277	0	177	1173	21966	1173	21789	0.0	0.053834503648630044
chr2	TTN-AS1	178613211	178613311	0	101	1173	21966	1173	21865	0.0	0.05364738166018752
chr2	TTN-AS1	178758990	178759044	0	55	1173	21966	1173	21911	0.0	0.05353475423303364
chr2	TTN-AS1	178777857	178778003	0	147	1173	21966	1173	21819	0.0	0.05376048398185068
chr2	AC092640.1	178997935	178998000	1030	66	1387	2646	357	2580	15.606060606060606	0.13837209302325582
chr2	AC092640.1	178998723	178998809	357	87	1387	2646	1030	2559	4.103448275862069	0.4025009769441188
chr2	UBE2E3	180980941	180980973	0	33	0	2985	0	2952	0.0	0.0
chr2	UBE2E3	180987337	180987394	0	58	0	2985	0	2927	0.0	0.0
chr2	UBE2E3	181075495	181075528	0	34	0	2985	0	2951	0.0	0.0
chr2	LINC01934	181225003	181225047	0	45	153	15079	153	15034	0.0	0.01017693228681655
chr2	LINC01934	181283176	181283400	0	225	153	15079	153	14854	0.0	0.010300255823347246
chr2	LINC01934	181238250	181238450	0	201	153	15079	153	14878	0.0	0.010283640274230408
chr2	LINC01934	181208032	181208262	0	231	153	15079	153	14848	0.0	0.010304418103448275
chr2	LINC01934	181341045	181341129	0	85	153	15079	153	14994	0.0	0.01020408163265306
chr2	LINC01934	181262828	181262977	0	150	153	15079	153	14929	0.0	0.010248509612164244
chr2	LINC01934	181354207	181354343	0	137	153	15079	153	14942	0.0	0.01023959309329407
chr2	LINC01934	181256222	181256292	0	71	153	15079	153	15008	0.0	0.01019456289978678
chr2	LINC01934	181363297	181363337	0	41	153	15079	153	15038	0.0	0.01017422529591701
chr2	ITGA4	181475158	181475288	0	131	0	10591	0	10460	0.0	0.0
chr2	ITPRID2	181896029	181896079	0	51	2135	7648	2135	7597	0.0	0.2810319863103857
chr2	ITPRID2	181920596	181920662	5	67	2135	7648	2130	7581	0.07462686567164178	0.2809655718242976
chr2	ITPRID2	181928160	181928278	0	119	2135	7648	2135	7529	0.0	0.28357019524505245
chr2	ITPRID2	181928160	181928199	0	40	2135	7648	2135	7608	0.0	0.28062565720294425
chr2	PPP1R1C	181962133	181962196	0	64	0	4899	0	4835	0.0	0.0
chr2	PPP1R1C	181987838	181987899	0	62	0	4899	0	4837	0.0	0.0
chr2	PPP1R1C	182117206	182117301	0	96	0	4899	0	4803	0.0	0.0
chr2	PPP1R1C	182117206	182117468	0	263	0	4899	0	4636	0.0	0.0
chr2	DNAJC10	182732498	182732542	0	45	301170	21606	301170	21561	0.0	13.968276053986365
chr2	DNAJC10	182736248	182736386	0	139	301170	21606	301170	21467	0.0	14.02944053663763
chr2	DNAJC10	182735555	182735593	0	39	301170	21606	301170	21567	0.0	13.964390040339408
chr2	DNAJC10	182752548	182752623	0	76	301170	21606	301170	21530	0.0	13.988388295401766
chr2	DNAJC10	182739544	182739709	0	166	301170	21606	301170	21440	0.0	14.047108208955224
chr2	DUSP19	183087039	183087192	0	154	84	5383	84	5229	0.0	0.01606425702811245
chr2	DUSP19	183087157	183087192	0	36	84	5383	84	5347	0.0	0.015709743781559753
chr2	NUP35	183118590	183118742	0	153	0	2638	0	2485	0.0	0.0
chr2	NUP35	183120005	183120114	0	110	0	2638	0	2528	0.0	0.0
chr2	NUP35	183151507	183151649	0	143	0	2638	0	2495	0.0	0.0
chr2	NUP35	183118326	183118408	0	83	0	2638	0	2555	0.0	0.0
chr2	NUP35	183130994	183131352	0	359	0	2638	0	2279	0.0	0.0
chr2	AC009315.1	185483033	185483091	0	59	0	3548	0	3489	0.0	0.0
chr2	FSIP2	185799696	185809133	3519	9438	49	17095	-3470	7657	0.37285441830896376	-0.4531800966435941
chr2	ZC3H15	186502495	186502587	0	93	0	3040	0	2947	0.0	0.0
chr2	ZC3H15	186499618	186499662	0	45	0	3040	0	2995	0.0	0.0
chr2	ZC3H15	186501272	186501425	0	154	0	3040	0	2886	0.0	0.0
chr2	ZC3H15	186502495	186502552	0	58	0	3040	0	2982	0.0	0.0
chr2	ZC3H15	186507394	186507474	0	81	0	3040	0	2959	0.0	0.0
chr2	GULP1	188541180	188541318	0	139	51	5838	51	5699	0.0	0.008948938410247412
chr2	GULP1	188589739	188589750	0	12	51	5838	51	5826	0.0	0.008753861997940269
chr2	GULP1	188582340	188582565	0	226	51	5838	51	5612	0.0	0.009087669280114041
chr2	COL3A1	188993360	188993459	51	100	125	6807	74	6707	0.51	0.01103324884449083
chr2	WDR75	189448800	189448834	0	35	14153	3312	14153	3277	0.0	4.318889227952395
chr2	ASNSD1	189663900	189663954	0	55	0	2491	0	2436	0.0	0.0
chr2	ANKAR	189705022	189705224	0	203	51	5784	51	5581	0.0	0.009138147285432718
chr2	ANKAR	189711048	189711153	0	106	51	5784	51	5678	0.0	0.008982035928143712
chr2	ANKAR	189743274	189743474	0	201	51	5784	51	5583	0.0	0.009134873723804407
chr2	ANKAR	189728659	189728821	0	163	51	5784	51	5621	0.0	0.009073118662159757
chr2	PMS1	189795768	189795951	0	184	83096	4376	83096	4192	0.0	19.822519083969464
chr2	PMS1	189805651	189805754	0	104	83096	4376	83096	4272	0.0	19.45131086142322
chr2	PMS1	189843963	189844080	0	118	83096	4376	83096	4258	0.0	19.51526538280883
chr2	PMS1	189863742	189864228	40835	487	83096	4376	42261	3889	83.85010266940452	10.866803805605555
chr2	PMS1	189785345	189785471	0	127	83096	4376	83096	4249	0.0	19.55660155330666
chr2	PMS1	189863742	189863974	0	233	83096	4376	83096	4143	0.0	20.056963552980932
chr2	PMS1	189867798	189867929	0	132	83096	4376	83096	4244	0.0	19.579641847313855
chr2	INPP1	190362626	190362687	0	62	0	3107	0	3045	0.0	0.0
chr2	INPP1	190348887	190349031	0	145	0	3107	0	2962	0.0	0.0
chr2	INPP1	190359645	190359698	0	54	0	3107	0	3053	0.0	0.0
chr2	MFSD6	190433326	190433392	0	67	0	5964	0	5897	0.0	0.0
chr2	MFSD6	190415291	190415413	0	123	0	5964	0	5841	0.0	0.0
chr2	MFSD6	190499831	190499856	0	26	0	5964	0	5938	0.0	0.0
chr2	NAB1	190649830	190649982	359	153	43655	4801	43296	4648	2.34640522875817	9.314974182444063
chr2	NAB1	190683737	190683827	0	91	43655	4801	43655	4710	0.0	9.268577494692144
chr2	NAB1	190655976	190656153	0	178	43655	4801	43655	4623	0.0	9.44300237940731
chr2	GLS	190954754	190954818	0	65	9	9139	9	9074	0.0	0.0009918448313863788
chr2	MYO1B	191400748	191400835	0	88	11032	9318	11032	9230	0.0	1.1952329360780065
chr2	MYO1B	191402631	191402718	0	88	11032	9318	11032	9230	0.0	1.1952329360780065
chr2	MYO1B	191379266	191379272	136	7	11032	9318	10896	9311	19.428571428571427	1.1702287616797336
chr2	NABP1	191682491	191682595	0	105	459	17438	459	17333	0.0	0.026481278486124735
chr2	CAVIN2-AS1	192031331	192031603	0	273	1581	4592	1581	4319	0.0	0.3660569576290808
chr2	CAVIN2-AS1	192031331	192031491	0	161	1581	4592	1581	4431	0.0	0.35680433310765064
chr2	CAVIN2-AS1	192032570	192032638	0	69	1581	4592	1581	4523	0.0	0.34954676099933674
chr2	CAVIN2-AS1	192036131	192036365	0	235	1581	4592	1581	4357	0.0	0.3628643562084003
chr2	CAVIN2-AS1	192035205	192035407	0	203	1581	4592	1581	4389	0.0	0.36021872863978127
chr2	PCGEM1	192753723	192753845	0	123	0	1716	0	1593	0.0	0.0
chr2	LINC01821	194374135	194374262	0	128	0	5214	0	5086	0.0	0.0
chr2	LINC01821	194416195	194416418	0	224	0	5214	0	4990	0.0	0.0
chr2	LINC01821	194365412	194365555	0	144	0	5214	0	5070	0.0	0.0
chr2	LINC01821	194368840	194369072	0	233	0	5214	0	4981	0.0	0.0
chr2	LINC01821	194350667	194350753	0	87	0	5214	0	5127	0.0	0.0
chr2	LINC01821	194537431	194537473	0	43	0	5214	0	5171	0.0	0.0
chr2	SLC39A10	195671656	195671720	0	65	0	6933	0	6868	0.0	0.0
chr2	CCDC150	196712144	196712252	0	109	0	9384	0	9275	0.0	0.0
chr2	CCDC150	196646340	196646504	0	165	0	9384	0	9219	0.0	0.0
chr2	CCDC150	196712676	196712739	0	64	0	9384	0	9320	0.0	0.0
chr2	CCDC150	196720173	196720234	0	62	0	9384	0	9322	0.0	0.0
chr2	COQ10B	197459931	197460081	0	151	0	2698	0	2547	0.0	0.0
chr2	HSPE1	197501073	197501238	0	166	171	1592	171	1426	0.0	0.11991584852734923
chr2	MOB4	197535529	197535630	0	102	1247	4091	1247	3989	0.0	0.31260967661067934
chr2	MOB4	197548335	197548415	0	81	1247	4091	1247	4010	0.0	0.3109725685785536
chr2	MOB4	197523623	197523686	1196	64	1247	4091	51	4027	18.6875	0.012664514526943133
chr2	MOB4	197535529	197535605	0	77	1247	4091	1247	4014	0.0	0.3106626806178376
chr2	PLCL1	198001951	198002008	0	58	41384	5694	41384	5636	0.0	7.3427963094393185
chr2	LINC01877	199624531	199624596	0	66	0	9864	0	9798	0.0	0.0
chr2	LINC01877	199608232	199608335	0	104	0	9864	0	9760	0.0	0.0
chr2	LINC01877	199647673	199647856	0	184	0	9864	0	9680	0.0	0.0
chr2	LINC01877	199647053	199647179	0	127	0	9864	0	9737	0.0	0.0
chr2	MAIP1	199961780	199961928	0	149	0	1632	0	1483	0.0	0.0
chr2	SPATS2L	200389222	200389283	0	62	51	10302	51	10240	0.0	0.00498046875
chr2	SPATS2L	200439121	200439328	0	208	51	10302	51	10094	0.0	0.005052506439468992
chr2	SPATS2L	200329430	200329480	0	51	51	10302	51	10251	0.0	0.004975124378109453
chr2	SPATS2L	200372108	200372251	0	144	51	10302	51	10158	0.0	0.005020673360897815
chr2	SPATS2L	200308886	200309090	0	205	51	10302	51	10097	0.0	0.005051005249083886
chr2	SPATS2L	200378140	200378371	0	232	51	10302	51	10070	0.0	0.00506454816285998
chr2	SPATS2L	200383866	200384017	0	152	51	10302	51	10150	0.0	0.005024630541871921
chr2	AOX1	200611383	200611493	0	111	4521	5447	4521	5336	0.0	0.847263868065967
chr2	AOX1	200620649	200620819	0	171	4521	5447	4521	5276	0.0	0.8568991660348749
chr2	AOX3P	200728556	200728700	0	145	5593	4333	5593	4188	0.0	1.335482330468004
chr2	AOX2P	200769819	200769949	0	131	5650	3864	5650	3733	0.0	1.5135279935708545
chr2	NIF3L1	200891735	200891789	0	55	0	2001	0	1946	0.0	0.0
chr2	NIF3L1	200897075	200897214	0	140	0	2001	0	1861	0.0	0.0
chr2	NIF3L1	200890522	200890585	0	64	0	2001	0	1937	0.0	0.0
chr2	NDUFB3	201072338	201072361	0	24	5	846	5	822	0.0	0.006082725060827251
chr2	NDUFB3	201072278	201072361	0	84	5	846	5	762	0.0	0.006561679790026247
chr2	CFLAR	201129728	201130146	0	419	11729	22046	11729	21627	0.0	0.5423313450779119
chr2	CFLAR	201142644	201142762	0	119	11729	22046	11729	21927	0.0	0.5349112965749988
chr2	CFLAR	201149001	201149052	0	52	11729	22046	11729	21994	0.0	0.5332818041283987
chr2	CASP10	201187705	201187799	150	95	1150	7593	1000	7498	1.5789473684210527	0.13336889837289945
chr2	CASP10	201203729	201203766	0	38	1150	7593	1150	7555	0.0	0.15221707478491064
chr2	CASP10	201208074	201208183	0	110	1150	7593	1150	7483	0.0	0.1536816784712014
chr2	CASP10	201205881	201205973	0	93	1150	7593	1150	7500	0.0	0.15333333333333332
chr2	CASP8	201266460	201266791	0	332	12967	7205	12967	6873	0.0	1.8866579368543577
chr2	CASP8	201274888	201274953	0	66	12967	7205	12967	7139	0.0	1.8163608348508193
chr2	CASP8	201266486	201266791	0	306	12967	7205	12967	6899	0.0	1.8795477605450066
chr2	CASP8	201272897	201272942	0	46	12967	7205	12967	7159	0.0	1.8112864925268892
chr2	CASP8	201269509	201269605	0	97	12967	7205	12967	7108	0.0	1.8242824985931345
chr2	STRADB	201469952	201470052	0	101	4251	3141	4251	3040	0.0	1.3983552631578948
chr2	CDK15	201800783	201800901	0	119	16037	6191	16037	6072	0.0	2.6411396574440054
chr2	CDK15	201823664	201823727	0	64	16037	6191	16037	6127	0.0	2.617431042924759
chr2	CDK15	201872277	201872326	0	50	16037	6191	16037	6141	0.0	2.6114639309558703
chr2	KIAA2012	202076931	202077099	0	169	72629	7680	72629	7511	0.0	9.669684462787911
chr2	NOP58	202275112	202275189	0	78	2448	3274	2448	3196	0.0	0.7659574468085106
chr2	NOP58	202278211	202278329	0	119	2448	3274	2448	3155	0.0	0.7759112519809825
chr2	NOP58	202287659	202287724	0	66	2448	3274	2448	3208	0.0	0.7630922693266833
chr2	NOP58	202295673	202295837	0	165	2448	3274	2448	3109	0.0	0.7873914441942746
chr2	BMPR2	202555251	202556531	51	1281	111222	12523	111171	11242	0.03981264637002342	9.888898772460417
chr2	CARF	202941859	202941980	0	122	1905	10132	1905	10010	0.0	0.1903096903096903
chr2	CARF	202942739	202942967	0	229	1905	10132	1905	9903	0.0	0.1923659497122084
chr2	CARF	202961236	202961426	0	191	1905	10132	1905	9941	0.0	0.19163062066190525
chr2	CARF	202913033	202913114	51	82	1905	10132	1854	10050	0.6219512195121951	0.18447761194029852
chr2	CARF	202938273	202938395	69	123	1905	10132	1836	10009	0.5609756097560976	0.18343490858227596
chr2	CARF	202924356	202924415	0	60	1905	10132	1905	10072	0.0	0.18913820492454328
chr2	CARF	202913033	202913102	51	70	1905	10132	1854	10062	0.7285714285714285	0.18425760286225404
chr2	CARF	202924296	202924415	0	120	1905	10132	1905	10012	0.0	0.19027167399121056
chr2	CARF	202973481	202973584	0	104	1905	10132	1905	10028	0.0	0.1899680893498205
chr2	CARF	202934501	202934599	0	99	1905	10132	1905	10033	0.0	0.189873417721519
chr2	CARF	202942762	202942967	0	206	1905	10132	1905	9926	0.0	0.19192020955067499
chr2	NBEAL1	203171927	203172023	0	97	29923	16436	29923	16339	0.0	1.8313850296835792
chr2	CYP20A1	203246754	203246921	0	168	3642	3471	3642	3303	0.0	1.1026339691189828
chr2	CYP20A1	203278572	203278688	255	117	3642	3471	3387	3354	2.1794871794871793	1.0098389982110911
chr2	CYP20A1	203272669	203272748	0	80	3642	3471	3642	3391	0.0	1.0740194632851665
chr2	CYP20A1	203272645	203272748	0	104	3642	3471	3642	3367	0.0	1.0816750816750818
chr2	CYP20A1	203245845	203245895	41	51	3642	3471	3601	3420	0.803921568627451	1.052923976608187
chr2	ABI2	203394699	203394846	0	148	140233	18798	140233	18650	0.0	7.519195710455764
chr2	ABI2	203395655	203395780	0	126	140233	18798	140233	18672	0.0	7.510336332476435
chr2	ABI2	203411284	203411371	0	88	140233	18798	140233	18710	0.0	7.495082843399252
chr2	ABI2	203351554	203351678	288	125	140233	18798	139945	18673	2.304	7.494510790981631
chr2	ABI2	203396784	203396967	51	184	140233	18798	140182	18614	0.27717391304347827	7.530998173417857
chr2	ABI2	203355153	203355324	51	172	140233	18798	140182	18626	0.29651162790697677	7.52614624718136
chr2	ABI2	203382188	203382206	0	19	140233	18798	140233	18779	0.0	7.467543532669471
chr2	ABI2	203342196	203342230	30	35	140233	18798	140203	18763	0.8571428571428571	7.472312529979215
chr2	ABI2	203374819	203374852	0	34	140233	18798	140233	18764	0.0	7.473513110211043
chr2	ABI2	203396883	203396967	51	85	140233	18798	140182	18713	0.6	7.491155880938385
chr2	ABI2	203375931	203376132	105	202	140233	18798	140128	18596	0.5198019801980198	7.535383953538395
chr2	ABI2	203376056	203376132	0	77	140233	18798	140233	18721	0.0	7.490678916724534
chr2	ABI2	203395658	203395780	0	123	140233	18798	140233	18675	0.0	7.50912985274431
chr2	CD28	203726632	203726989	1938	358	10501	4840	8563	4482	5.41340782122905	1.9105310129406514
chr2	CTLA4	203871377	203871487	336	111	421	2145	85	2034	3.027027027027027	0.04178957718780728
chr2	CTLA4	203870585	203870933	0	349	421	2145	421	1796	0.0	0.2344097995545657
chr2	CTLA4	203870585	203870648	0	64	421	2145	421	2081	0.0	0.20230658337337817
chr2	ICOS	203957798	203957883	0	86	4739	2635	4739	2549	0.0	1.8591604550804237
chr2	PARD3B	205158721	205158907	0	187	412	10729	412	10542	0.0	0.0390817681654335
chr2	PARD3B	205300529	205300736	0	208	412	10729	412	10521	0.0	0.03915977568672179
chr2	PARD3B	205440369	205440672	0	304	412	10729	412	10425	0.0	0.039520383693045565
chr2	NRP2	205792234	205792285	0	52	51	13919	51	13867	0.0	0.0036777962068219516
chr2	EEF1B2	206160886	206161132	0	247	0	1648	0	1401	0.0	0.0
chr2	GPR1-AS	206240442	206240588	0	147	204	3051	204	2904	0.0	0.07024793388429752
chr2	ZDBF2	206280549	206280593	0	45	153	10892	153	10847	0.0	0.01410528256660828
chr2	ZDBF2	206292010	206292116	0	107	153	10892	153	10785	0.0	0.014186369958275382
chr2	ZDBF2	206292013	206292116	0	104	153	10892	153	10788	0.0	0.01418242491657397
chr2	ADAM23	206609909	206610000	0	92	15012	6452	15012	6360	0.0	2.360377358490566
chr2	ADAM23	206605789	206605880	0	92	15012	6452	15012	6360	0.0	2.360377358490566
chr2	AC008269.1	206842992	206843212	0	221	9041	5561	9041	5340	0.0	1.693071161048689
chr2	CREB1	207575271	207575454	0	184	3519	10644	3519	10460	0.0	0.3364244741873805
chr2	CREB1	207555627	207555749	0	123	3519	10644	3519	10521	0.0	0.33447390932420873
chr2	CREB1	207561118	207561160	0	43	3519	10644	3519	10601	0.0	0.33194981605508916
chr2	CREB1	207534601	207534683	0	83	3519	10644	3519	10561	0.0	0.33320708266262666
chr2	CREB1	207577109	207577224	0	116	3519	10644	3519	10528	0.0	0.3342515197568389
chr2	CCNYL1	207733946	207734047	0	102	0	4720	0	4618	0.0	0.0
chr2	CCNYL1	207740654	207740706	0	53	0	4720	0	4667	0.0	0.0
chr2	PIKFYVE	208277536	208277708	0	173	182	10883	182	10710	0.0	0.01699346405228758
chr2	PIKFYVE	208304845	208305013	0	169	182	10883	182	10714	0.0	0.016987119656524174
chr2	PIKFYVE	208276711	208276830	0	120	182	10883	182	10763	0.0	0.016909783517606615
chr2	PIKFYVE	208274020	208274053	0	34	182	10883	182	10849	0.0	0.016775739699511474
chr2	PIKFYVE	208274017	208274053	0	37	182	10883	182	10846	0.0	0.016780379863544165
chr2	MAP2	209704449	209704620	0	172	51	11629	51	11457	0.0	0.004451427075150563
chr2	MAP2	209723594	209723687	0	94	51	11629	51	11535	0.0	0.004421326397919376
chr2	MAP2	209692624	209696350	0	3727	51	11629	51	7902	0.0	0.006454062262718299
chr2	MAP2	209696916	209697051	0	136	51	11629	51	11493	0.0	0.004437483685721744
chr2	MAP2	209690602	209690848	0	247	51	11629	51	11382	0.0	0.0044807590933052185
chr2	MAP2	209687718	209687961	0	244	51	11629	51	11385	0.0	0.0044795783926218705
chr2	MAP2	209692636	209696350	0	3715	51	11629	51	7914	0.0	0.006444275966641395
chr2	MAP2	209703986	209704034	0	49	51	11629	51	11580	0.0	0.004404145077720207
chr2	UNC80	209894162	209894366	0	205	561	17565	561	17360	0.0	0.03231566820276498
chr2	UNC80	209984855	209984912	0	58	561	17565	561	17507	0.0	0.03204432512709202
chr2	RPE	210009656	210009736	0	81	35	3448	35	3367	0.0	0.010395010395010396
chr2	RPE	210016203	210016257	0	55	35	3448	35	3393	0.0	0.01031535514294135
chr2	RPE	210017472	210017559	0	88	35	3448	35	3360	0.0	0.010416666666666666
chr2	RPE	210009638	210009736	0	99	35	3448	35	3349	0.0	0.010450880859958196
chr2	RPE	210003437	210003468	0	32	35	3448	35	3416	0.0	0.010245901639344262
chr2	RPE	210018152	210018221	0	70	35	3448	35	3378	0.0	0.010361160449970397
chr2	RPE	210017789	210017887	0	99	35	3448	35	3349	0.0	0.010450880859958196
chr2	AC006994.1	210218471	210218564	444	94	444	4465	0	4371	4.723404255319149	0.0
chr2	LANCL1-AS1	210442541	210442699	0	159	0	1675	0	1516	0.0	0.0
chr2	CPS1	210519550	210519670	0	121	10307	11064	10307	10943	0.0	0.9418806542995523
chr2	CPS1	210519550	210519784	0	235	10307	11064	10307	10829	0.0	0.9517961030566072
chr2	CPS1	210653736	210653879	0	144	10307	11064	10307	10920	0.0	0.9438644688644688
chr2	SPAG16	213310058	213310177	0	120	6354	8280	6354	8160	0.0	0.7786764705882353
chr2	SPAG16	213350527	213350645	0	119	6354	8280	6354	8161	0.0	0.7785810562431075
chr2	SPAG16	213297021	213297139	0	119	6354	8280	6354	8161	0.0	0.7785810562431075
chr2	SPAG16	213929959	213930145	0	187	6354	8280	6354	8093	0.0	0.7851229457555913
chr2	SPAG16	213317218	213317356	0	139	6354	8280	6354	8141	0.0	0.7804937968308562
chr2	VWC2L	214436628	214436758	0	131	102	5262	102	5131	0.0	0.01987916585460924
chr2	SNHG31	214960392	214960590	0	199	51	2559	51	2360	0.0	0.021610169491525423
chr2	SNHG31	214842736	214842832	0	97	51	2559	51	2462	0.0	0.020714865962632008
chr2	SNHG31	214947824	214947947	0	124	51	2559	51	2435	0.0	0.020944558521560575
chr2	AC072062.1	215038942	215039041	0	100	0	3513	0	3413	0.0	0.0
chr2	AC072062.1	215025318	215025492	0	175	0	3513	0	3338	0.0	0.0
chr2	AC072062.1	215032374	215032601	0	228	0	3513	0	3285	0.0	0.0
chr2	ATIC	215319664	215319731	0	68	0	3806	0	3738	0.0	0.0
chr2	ATIC	215326821	215326978	0	158	0	3806	0	3648	0.0	0.0
chr2	AC012462.1	215456044	215456222	0	179	0	1648	0	1469	0.0	0.0
chr2	AC012668.3	215681497	215681589	0	93	39	3073	39	2980	0.0	0.013087248322147652
chr2	AC012668.3	215683341	215683461	0	121	39	3073	39	2952	0.0	0.013211382113821139
chr2	AC012668.3	215688387	215688595	0	209	39	3073	39	2864	0.0	0.01361731843575419
chr2	TMEM169	216082146	216082232	0	87	12	3631	12	3544	0.0	0.003386004514672686
chr2	XRCC5	216110466	216110551	0	86	4848	5487	4848	5401	0.0	0.897611553416034
chr2	SMARCAL1	216423632	216423683	0	52	144	5114	144	5062	0.0	0.028447254049782694
chr2	SMARCAL1	216438419	216438485	0	67	144	5114	144	5047	0.0	0.02853180106994254
chr2	SMARCAL1	216446661	216446718	0	58	144	5114	144	5056	0.0	0.028481012658227847
chr2	RPL37A	216499831	216499866	0	36	0	5245	0	5209	0.0	0.0
chr2	RPL37A	216519331	216519390	0	60	0	5245	0	5185	0.0	0.0
chr2	RPL37A	216520713	216520774	0	62	0	5245	0	5183	0.0	0.0
chr2	AC073321.1	216598627	216598807	0	181	0	951	0	770	0.0	0.0
chr2	DIRC3-AS1	217296631	217296770	279	140	11129	8041	10850	7901	1.9928571428571429	1.3732438931780788
chr2	DIRC3-AS1	217303601	217303861	0	261	11129	8041	11129	7780	0.0	1.4304627249357327
chr2	DIRC3-AS1	217295903	217295987	0	85	11129	8041	11129	7956	0.0	1.3988185017596781
chr2	RUFY4	218035316	218035394	0	79	28	3777	28	3698	0.0	0.0075716603569497025
chr2	RUFY4	218073815	218073885	0	71	28	3777	28	3706	0.0	0.007555315704263357
chr2	RUFY4	218072778	218072885	0	108	28	3777	28	3669	0.0	0.007631507222676479
chr2	RUFY4	218073815	218073945	0	131	28	3777	28	3646	0.0	0.007679648930334613
chr2	ARPC2	218217371	218217544	0	174	28	6079	28	5905	0.0	0.004741744284504657
chr2	ARPC2	218217462	218217544	0	83	28	6079	28	5996	0.0	0.004669779853235491
chr2	ARPC2	218234848	218235044	28	197	28	6079	0	5882	0.14213197969543148	0.0
chr2	ARPC2	218234351	218234397	0	47	28	6079	28	6032	0.0	0.004641909814323607
chr2	ARPC2	218226995	218227097	0	103	28	6079	28	5976	0.0	0.004685408299866131
chr2	ARPC2	218252944	218253032	0	89	28	6079	28	5990	0.0	0.004674457429048414
chr2	SLC11A1	218384318	218384365	0	48	0	7083	0	7035	0.0	0.0
chr2	SLC11A1	218385411	218385485	0	75	0	7083	0	7008	0.0	0.0
chr2	SLC11A1	218382959	218383102	0	144	0	7083	0	6939	0.0	0.0
chr2	SLC11A1	218384242	218384365	0	124	0	7083	0	6959	0.0	0.0
chr2	CNOT9	218587304	218587400	0	97	0	5267	0	5170	0.0	0.0
chr2	CNOT9	218573994	218574233	0	240	0	5267	0	5027	0.0	0.0
chr2	CNOT9	218580994	218581114	0	121	0	5267	0	5146	0.0	0.0
chr2	PLCD4	218615903	218616062	0	160	0	5717	0	5557	0.0	0.0
chr2	PLCD4	218615903	218615959	0	57	0	5717	0	5660	0.0	0.0
chr2	PLCD4	218630649	218630802	0	154	0	5717	0	5563	0.0	0.0
chr2	PLCD4	218633604	218633761	0	158	0	5717	0	5559	0.0	0.0
chr2	PLCD4	218633385	218633481	0	97	0	5717	0	5620	0.0	0.0
chr2	BCS1L	218660306	218660421	0	116	0	2642	0	2526	0.0	0.0
chr2	BCS1L	218660938	218661307	0	370	0	2642	0	2272	0.0	0.0
chr2	BCS1L	218662509	218662679	0	171	0	2642	0	2471	0.0	0.0
chr2	BCS1L	218660036	218660245	0	210	0	2642	0	2432	0.0	0.0
chr2	BCS1L	218660036	218660218	0	183	0	2642	0	2459	0.0	0.0
chr2	BCS1L	218660036	218660166	0	131	0	2642	0	2511	0.0	0.0
chr2	BCS1L	218660306	218660482	0	177	0	2642	0	2465	0.0	0.0
chr2	BCS1L	218662514	218662679	0	166	0	2642	0	2476	0.0	0.0
chr2	STK36	218688390	218688493	0	104	187	6432	187	6328	0.0	0.029551201011378002
chr2	TTLL4	218727268	218727347	0	80	50	7190	50	7110	0.0	0.007032348804500703
chr2	TTLL4	218747002	218747194	50	193	50	7190	0	6997	0.25906735751295334	0.0
chr2	TTLL4	218747289	218747372	0	84	50	7190	50	7106	0.0	0.007036307345904869
chr2	TTLL4	218748104	218748227	0	124	50	7190	50	7066	0.0	0.007076139258420606
chr2	TTLL4	218728024	218728067	0	44	50	7190	50	7146	0.0	0.006996921354603974
chr2	TTLL4	218736311	218736376	0	66	50	7190	50	7124	0.0	0.007018528916339135
chr2	TTLL4	218747596	218747725	0	130	50	7190	50	7060	0.0	0.007082152974504249
chr2	TTLL4	218747029	218747194	50	166	50	7190	0	7024	0.30120481927710846	0.0
chr2	CYP27A1	218809576	218809767	0	192	0	2496	0	2304	0.0	0.0
chr2	WNT6	218871026	218871247	0	222	0	1723	0	1501	0.0	0.0
chr2	WNT10A	218889983	218890363	0	381	0	2853	0	2472	0.0	0.0
chr2	LINC00608	218977138	218977398	0	261	0	2164	0	1903	0.0	0.0
chr2	RETREG2	219178921	219179028	0	108	2091	5682	2091	5574	0.0	0.3751345532831001
chr2	ZFAND2B	219207647	219207779	0	133	11050	2754	11050	2621	0.0	4.21594811140786
chr2	ZFAND2B	219207886	219208038	0	153	11050	2754	11050	2601	0.0	4.248366013071895
chr2	ZFAND2B	219208976	219209049	0	74	11050	2754	11050	2680	0.0	4.123134328358209
chr2	ZFAND2B	219207647	219207774	0	128	11050	2754	11050	2626	0.0	4.207920792079208
chr2	ANKZF1	219230227	219230405	0	179	204	4424	204	4245	0.0	0.0480565371024735
chr2	ANKZF1	219231927	219232040	0	114	204	4424	204	4310	0.0	0.047331786542923436
chr2	ANKZF1	219230227	219230350	0	124	204	4424	204	4300	0.0	0.04744186046511628
chr2	STK16	219246656	219246876	0	221	51	4345	51	4124	0.0	0.012366634335596509
chr2	STK16	219247112	219247246	0	135	51	4345	51	4210	0.0	0.012114014251781473
chr2	STK16	219247661	219247757	0	97	51	4345	51	4248	0.0	0.012005649717514125
chr2	STK16	219246521	219246876	0	356	51	4345	51	3989	0.0	0.012785159187766357
chr2	DNAJB2	219282836	219282929	0	94	751	5248	751	5154	0.0	0.14571206829646877
chr2	SPEG	219447973	219449271	10098	1299	83704	14929	73606	13630	7.773672055427252	5.400293470286133
chr2	SPEG	219444024	219444059	238	36	83704	14929	83466	14893	6.611111111111111	5.604377895655677
chr2	SPEG	219444029	219444059	153	31	83704	14929	83551	14898	4.935483870967742	5.608202443280978
chr2	ASIC4	219532882	219532939	0	58	78072	4359	78072	4301	0.0	18.152057661009067
chr2	SLC4A3	219634419	219634604	21	186	9090	4977	9069	4791	0.11290322580645161	1.8929242329367564
chr2	ACSL3	222887829	222887888	0	60	6	7252	6	7192	0.0	0.0008342602892102336
chr2	ACSL3	222900673	222900780	0	108	6	7252	6	7144	0.0	0.0008398656215005599
chr2	RHBDD1	226838072	226838154	0	83	39	6916	39	6833	0.0	0.005707595492463047
chr2	RHBDD1	226839408	226839627	0	220	39	6916	39	6696	0.0	0.005824372759856631
chr2	COL4A3	227308898	227309076	0	179	0	9119	0	8940	0.0	0.0
chr2	COL4A3	227310775	227310948	0	174	0	9119	0	8945	0.0	0.0
chr2	MFF	227329605	227329659	0	55	0	4113	0	4058	0.0	0.0
chr2	MFF	227329605	227329783	0	179	0	4113	0	3934	0.0	0.0
chr2	MFF	227342744	227342819	0	76	0	4113	0	4037	0.0	0.0
chr2	MFF	227352513	227352573	0	61	0	4113	0	4052	0.0	0.0
chr2	MFF	227328677	227328789	0	113	0	4113	0	4000	0.0	0.0
chr2	MFF	227347225	227347384	0	160	0	4113	0	3953	0.0	0.0
chr2	MFF	227330625	227330846	0	222	0	4113	0	3891	0.0	0.0
chr2	MFF	227329605	227329697	0	93	0	4113	0	4020	0.0	0.0
chr2	AGFG1	227532137	227532209	0	73	51	9341	51	9268	0.0	0.00550280535174795
chr2	AGFG1	227531090	227531210	0	121	51	9341	51	9220	0.0	0.005531453362255965
chr2	AGFG1	227550058	227550106	0	49	51	9341	51	9292	0.0	0.005488592337494619
chr2	DAW1	227912253	227912469	0	217	0	2951	0	2734	0.0	0.0
chr2	DAW1	227872148	227872399	0	252	0	2951	0	2699	0.0	0.0
chr2	DAW1	227876442	227876494	0	53	0	2951	0	2898	0.0	0.0
chr2	FBXO36	229932770	229932886	0	117	0	3960	0	3843	0.0	0.0
chr2	AC009950.1	230140067	230140146	0	80	134	5424	134	5344	0.0	0.025074850299401198
chr2	AC009950.1	230172424	230172515	0	92	134	5424	134	5332	0.0	0.025131282820705175
chr2	AC009950.1	230167296	230167652	0	357	134	5424	134	5067	0.0	0.0264456285770673
chr2	AC009950.1	230172569	230172802	32	234	134	5424	102	5190	0.13675213675213677	0.019653179190751446
chr2	SP140	230245862	230245940	0	79	306	5515	306	5436	0.0	0.056291390728476824
chr2	SP140	230247915	230248065	0	151	306	5515	306	5364	0.0	0.05704697986577181
chr2	SP140	230253315	230253417	0	103	306	5515	306	5412	0.0	0.0565410199556541
chr2	SP140	230255451	230255532	0	82	306	5515	306	5433	0.0	0.05632247377139702
chr2	SP140	230250980	230251061	0	82	306	5515	306	5433	0.0	0.05632247377139702
chr2	SP140L	230328756	230328831	0	76	55	5249	55	5173	0.0	0.010632128358786004
chr2	SP140L	230389918	230390023	0	106	55	5249	55	5143	0.0	0.010694147384794867
chr2	SP140L	230400333	230400413	0	81	55	5249	55	5168	0.0	0.010642414860681114
chr2	SP100	230417590	230417665	0	76	2500	14166	2500	14090	0.0	0.177430801987225
chr2	SP100	230464066	230464150	0	85	2500	14166	2500	14081	0.0	0.17754420850791847
chr2	SP100	230507992	230508031	0	40	2500	14166	2500	14126	0.0	0.1769786209825853
chr2	SP100	230440475	230440557	0	83	2500	14166	2500	14083	0.0	0.17751899453241496
chr2	ITM2C	230864949	230865145	0	197	12364	2579	12364	2382	0.0	5.190596137699412
chr2	ITM2C	230873416	230873557	0	142	12364	2579	12364	2437	0.0	5.07345096430037
chr2	ITM2C	230876856	230876967	569	112	12364	2579	11795	2467	5.080357142857143	4.781110660721524
chr2	GCSIR	230895457	230895605	0	149	1938	4145	1938	3996	0.0	0.484984984984985
chr2	SPATA3	231000365	231000537	0	173	348	2820	348	2647	0.0	0.1314695882130714
chr2	SPATA3	231006697	231006835	0	139	348	2820	348	2681	0.0	0.1298023125699366
chr2	SPATA3	231004038	231004118	0	81	348	2820	348	2739	0.0	0.12705366922234393
chr2	PSMD1	231062505	231062675	102	171	7528	14058	7426	13887	0.5964912280701754	0.5347447252826384
chr2	PSMD1	231075510	231075571	0	62	7528	14058	7528	13996	0.0	0.5378679622749357
chr2	PSMD1	231078658	231078747	0	90	7528	14058	7528	13968	0.0	0.5389461626575028
chr2	PSMD1	231087116	231087181	0	66	7528	14058	7528	13992	0.0	0.538021726700972
chr2	PSMD1	231146239	231146356	0	118	7528	14058	7528	13940	0.0	0.5400286944045911
chr2	PSMD1	231163634	231163727	0	94	7528	14058	7528	13964	0.0	0.53910054425666
chr2	PSMD1	231165199	231165286	0	88	7528	14058	7528	13970	0.0	0.5388690050107373
chr2	PSMD1	231170578	231170721	0	144	7528	14058	7528	13914	0.0	0.541037803650999
chr2	PSMD1	231166380	231166491	0	112	7528	14058	7528	13946	0.0	0.5397963573784598
chr2	PSMD1	231170565	231170721	0	157	7528	14058	7528	13901	0.0	0.5415437738292209
chr2	PSMD1	231163587	231163727	0	141	7528	14058	7528	13917	0.0	0.5409211755407056
chr2	PSMD1	231152716	231152811	0	96	7528	14058	7528	13962	0.0	0.5391777682280475
chr2	PSMD1	231138735	231138850	0	116	7528	14058	7528	13942	0.0	0.5399512265098264
chr2	PSMD1	231062505	231062693	102	189	7528	14058	7426	13869	0.5396825396825397	0.5354387482875478
chr2	ARMC9	231239942	231240041	0	100	9411	11701	9411	11601	0.0	0.8112231704163434
chr2	ARMC9	231270981	231271072	0	92	9411	11701	9411	11609	0.0	0.8106641398914635
chr2	ARMC9	231288659	231288721	0	63	9411	11701	9411	11638	0.0	0.8086440969238701
chr2	PTMA	231708713	231708751	8	39	161	2703	153	2664	0.20512820512820512	0.057432432432432436
chr2	COPS7B	231788554	231788732	0	179	0	4651	0	4472	0.0	0.0
chr2	COPS7B	231791732	231791808	0	77	0	4651	0	4574	0.0	0.0
chr2	COPS7B	231794262	231794351	0	90	0	4651	0	4561	0.0	0.0
chr2	COPS7B	231790921	231791173	0	253	0	4651	0	4398	0.0	0.0
chr2	COPS7B	231790950	231791173	0	224	0	4651	0	4427	0.0	0.0
chr2	COPS7B	231790946	231791173	0	228	0	4651	0	4423	0.0	0.0
chr2	COPS7B	231801139	231801207	0	69	0	4651	0	4582	0.0	0.0
chr2	COPS7B	231801154	231801207	0	54	0	4651	0	4597	0.0	0.0
chr2	COPS7B	231792053	231792278	0	226	0	4651	0	4425	0.0	0.0
chr2	DIS3L2	232111196	232111255	0	60	138111	10198	138111	10138	0.0	13.623101203393174
chr2	DIS3L2	232198526	232198776	1264	251	138111	10198	136847	9947	5.035856573705179	13.757615361415501
chr2	DIS3L2	232259840	232260685	0	846	138111	10198	138111	9352	0.0	14.768071000855432
chr2	DIS3L2	232331669	232331926	867	258	138111	10198	137244	9940	3.36046511627907	13.807243460764587
chr2	CHRND	232527400	232527445	0	46	153	3144	153	3098	0.0	0.04938670109748225
chr2	CHRND	232529938	232530139	0	202	153	3144	153	2942	0.0	0.05200543847722638
chr2	CHRND	232528861	232528971	0	111	153	3144	153	3033	0.0	0.050445103857566766
chr2	CHRNG	232541373	232541529	51	157	357	4374	306	4217	0.3248407643312102	0.07256343372065449
chr2	EIF4E2	232557883	232558018	0	136	6122	6569	6122	6433	0.0	0.951655526193067
chr2	EIF4E2	232574262	232574341	384	80	6122	6569	5738	6489	4.8	0.8842656803821852
chr2	EFHD1	232638405	232638484	0	80	14666	2673	14666	2593	0.0	5.655996914770536
chr2	GIGYF2	232703423	232703489	0	67	333	15277	333	15210	0.0	0.021893491124260357
chr2	GIGYF2	232734416	232734486	0	71	333	15277	333	15206	0.0	0.021899250295935816
chr2	GIGYF2	232700584	232700654	0	71	333	15277	333	15206	0.0	0.021899250295935816
chr2	GIGYF2	232722553	232722658	0	106	333	15277	333	15171	0.0	0.021949772592446116
chr2	GIGYF2	232776411	232776477	0	67	333	15277	333	15210	0.0	0.021893491124260357
chr2	GIGYF2	232724573	232724691	0	119	333	15277	333	15158	0.0	0.021968597440295553
chr2	GIGYF2	232731121	232731234	0	114	333	15277	333	15163	0.0	0.021961353294202995
chr2	GIGYF2	232719037	232719128	0	92	333	15277	333	15185	0.0	0.02192953572604544
chr2	GIGYF2	232731121	232731258	0	138	333	15277	333	15139	0.0	0.021996168835458088
chr2	GIGYF2	232698268	232698307	0	40	333	15277	333	15237	0.0	0.021854695806261076
chr2	GIGYF2	232765891	232765979	0	89	333	15277	333	15188	0.0	0.021925204108506714
chr2	INPP5D	233204125	233204717	5024	593	33899	8587	28875	7994	8.472175379426645	3.6120840630472855
chr2	ATG16L1	233273990	233274041	0	52	1036	4235	1036	4183	0.0	0.24766913698302653
chr2	ATG16L1	233273720	233273777	0	58	1036	4235	1036	4177	0.0	0.2480248982523342
chr2	ATG16L1	233264891	233265143	0	253	1036	4235	1036	3982	0.0	0.26017076845806125
chr2	SAG	233309112	233309264	0	153	51	10539	51	10386	0.0	0.004910456383593298
chr2	SAG	233316074	233316135	0	62	51	10539	51	10477	0.0	0.0048678056695618975
chr2	SAG	233320629	233320823	0	195	51	10539	51	10344	0.0	0.004930394431554524
chr2	SAG	233309161	233309264	0	104	51	10539	51	10435	0.0	0.0048873981792046
chr2	SAG	233320702	233320823	0	122	51	10539	51	10417	0.0	0.004895843333013344
chr2	DGKD	233454356	233454464	0	109	75809	9821	75809	9712	0.0	7.80570428336079
chr2	UGT1A6	233769530	233769664	0	135	6307	5052	6307	4917	0.0	1.2826926988000813
chr2	UGT1A6	233717792	233718032	0	241	6307	5052	6307	4811	0.0	1.3109540636042403
chr2	MROH2A	233779344	233779452	0	109	366	5773	366	5664	0.0	0.0646186440677966
chr2	MROH2A	233779346	233779452	0	107	366	5773	366	5666	0.0	0.0645958348040946
chr2	TRPM8	234014561	234014654	0	94	133	7914	133	7820	0.0	0.0170076726342711
chr2	TRPM8	233947325	233947582	0	258	133	7914	133	7656	0.0	0.01737199582027168
chr2	SPP2	234050970	234051095	0	126	0	1094	0	968	0.0	0.0
chr2	SH3BP4	234995302	234995376	0	75	79	7085	79	7010	0.0	0.011269614835948644
chr2	AGAP1	235930764	235930923	0	160	168	13980	168	13820	0.0	0.01215629522431259
chr2	AGAP1	236014804	236014879	0	76	168	13980	168	13904	0.0	0.012082853855005753
chr2	COPS8	237086731	237086796	0	66	0	3426	0	3360	0.0	0.0
chr2	COPS8	237094089	237094197	0	109	0	3426	0	3317	0.0	0.0
chr2	COPS8	237087463	237087563	0	101	0	3426	0	3325	0.0	0.0
chr2	MLPH	237487397	237487437	0	41	1214	6657	1214	6616	0.0	0.18349455864570738
chr2	MLPH	237540801	237540957	0	157	1214	6657	1214	6500	0.0	0.18676923076923077
chr2	MLPH	237519909	237520029	0	121	1214	6657	1214	6536	0.0	0.1857405140758874
chr2	MLPH	237527376	237527516	0	141	1214	6657	1214	6516	0.0	0.18631062001227747
chr2	MLPH	237534563	237534647	0	85	1214	6657	1214	6572	0.0	0.18472306755934267
chr2	MLPH	237553096	237553231	0	136	1214	6657	1214	6521	0.0	0.18616776568011043
chr2	AC104667.2	237591565	237591771	0	207	0	1660	0	1453	0.0	0.0
chr2	LRRFIP1	237723547	237723586	0	40	140	13249	140	13209	0.0	0.010598834128245893
chr2	LRRFIP1	237751199	237751271	0	73	140	13249	140	13176	0.0	0.010625379477838493
chr2	LRRFIP1	237727875	237727935	0	61	140	13249	140	13188	0.0	0.010615711252653927
chr2	RAMP1	237874644	237874705	0	62	0	1153	0	1091	0.0	0.0
chr2	UBE2F	237986161	237986292	0	132	1692	3471	1692	3339	0.0	0.5067385444743935
chr2	UBE2F	238025341	238025412	0	72	1692	3471	1692	3399	0.0	0.4977934686672551
chr2	UBE2F	238030555	238030613	0	59	1692	3471	1692	3412	0.0	0.4958968347010551
chr2	UBE2F	237973091	237973225	0	135	1692	3471	1692	3336	0.0	0.5071942446043165
chr2	UBE2F	237987962	237987992	0	31	1692	3471	1692	3440	0.0	0.49186046511627907
chr2	UBE2F	238035877	238035940	0	64	1692	3471	1692	3407	0.0	0.4966245964191371
chr2	UBE2F	238003367	238003527	312	161	1692	3471	1380	3310	1.937888198757764	0.4169184290030212
chr2	UBE2F	238016532	238016633	0	102	1692	3471	1692	3369	0.0	0.5022261798753339
chr2	UBE2F	237994743	237994809	1321	67	1692	3471	371	3404	19.71641791044776	0.10898942420681551
chr2	UBE2F	238016565	238016633	0	69	1692	3471	1692	3402	0.0	0.4973544973544973
chr2	SCLY	238083247	238083354	0	108	207	5749	207	5641	0.0	0.03669562134373338
chr2	SCLY	238093860	238093944	0	85	207	5749	207	5664	0.0	0.036546610169491525
chr2	UBE2F	237973648	237973747	0	100	1692	3471	1692	3371	0.0	0.5019282112132898
chr2	UBE2F	237990423	237990552	0	130	1692	3471	1692	3341	0.0	0.5064351990422029
chr2	UBE2F	238032221	238032254	8	34	1692	3471	1684	3437	0.23529411764705882	0.48996217631655514
chr2	SCLY	238073782	238073847	0	66	207	5749	207	5683	0.0	0.03642442371986627
chr2	ESPNL	238116902	238117034	0	133	0	5189	0	5056	0.0	0.0
chr2	ERFE	238164074	238164183	0	110	0	3590	0	3480	0.0	0.0
chr2	ASB1	238435710	238436013	307	304	18686	2402	18379	2098	1.0098684210526316	8.760247855100095
chr2	ASB1	238433553	238433695	55	143	18686	2402	18631	2259	0.38461538461538464	8.247454625940682
chr2	CAPN10	240596680	240596942	0	263	0	6540	0	6277	0.0	0.0
chr2	CAPN10	240598351	240598397	0	47	0	6540	0	6493	0.0	0.0
chr2	CAPN10	240596318	240596521	0	204	0	6540	0	6336	0.0	0.0
chr2	CAPN10	240595933	240596152	0	220	0	6540	0	6320	0.0	0.0
chr2	CAPN10	240596849	240596942	0	94	0	6540	0	6446	0.0	0.0
chr2	AGXT	240873977	240874062	0	86	2103	4125	2103	4039	0.0	0.5206734340183213
chr2	SNED1	241073265	241073364	7742	100	41165	11991	33423	11891	77.42	2.81078126314019
chr2	SNED1	241087391	241087475	0	85	41165	11991	41165	11906	0.0	3.4575004199563244
chr2	PPP1R7	241153475	241153604	0	130	0	3700	0	3570	0.0	0.0
chr2	PPP1R7	241150258	241150547	0	290	0	3700	0	3410	0.0	0.0
chr2	PPP1R7	241153482	241153604	0	123	0	3700	0	3577	0.0	0.0
chr2	SEPTIN2	241324215	241324241	0	27	12	6771	12	6744	0.0	0.0017793594306049821
chr2	SEPTIN2	241325992	241326113	12	122	12	6771	0	6649	0.09836065573770492	0.0
chr2	SEPTIN2	241335974	241336098	0	125	12	6771	12	6646	0.0	0.0018055973517905506
chr2	SEPTIN2	241346165	241346249	0	85	12	6771	12	6686	0.0	0.0017947950942267424
chr2	SEPTIN2	241317498	241317599	0	102	12	6771	12	6669	0.0	0.001799370220422852
chr2	SEPTIN2	241316421	241316540	0	120	12	6771	12	6651	0.0	0.0018042399639152007
chr2	SEPTIN2	241320202	241320287	0	86	12	6771	12	6685	0.0	0.0017950635751682873
chr2	SEPTIN2	241335958	241336098	0	141	12	6771	12	6630	0.0	0.0018099547511312218
chr2	SEPTIN2	241316421	241316555	0	135	12	6771	12	6636	0.0	0.0018083182640144665
chr2	SEPTIN2	241318236	241318344	0	109	12	6771	12	6662	0.0	0.0018012608826178324
chr2	SEPTIN2	241335321	241335351	0	31	12	6771	12	6740	0.0	0.0017804154302670622
chr2	SEPTIN2	241316429	241316540	0	112	12	6771	12	6659	0.0	0.0018020723832407267
chr2	SEPTIN2	241324408	241324662	0	255	12	6771	12	6516	0.0	0.001841620626151013
chr2	SEPTIN2	241325966	241326113	168	148	12	6771	-156	6623	1.135135135135135	-0.02355428053752076
chr2	FARP2	241493292	241493444	489	153	68256	13898	67767	13745	3.196078431372549	4.930301927973809
chr2	FARP2	241404798	241404841	0	44	68256	13898	68256	13854	0.0	4.9268081420528365
chr2	ATG4B	241651263	241651335	0	73	16	6287	16	6214	0.0	0.002574831026713872
chr2	ATG4B	241655270	241655343	16	74	16	6287	0	6213	0.21621621621621623	0.0
chr2	ATG4B	241659107	241659187	0	81	16	6287	16	6206	0.0	0.002578150177247825
chr2	ATG4B	241651883	241651974	0	92	16	6287	16	6195	0.0	0.00258272800645682
chr2	ATG4B	241653306	241653369	0	64	16	6287	16	6223	0.0	0.0025711071830306926
chr2	ATG4B	241638260	241638370	0	111	16	6287	16	6176	0.0	0.0025906735751295338
chr2	D2HGDH	241735132	241735516	0	385	0	4764	0	4379	0.0	0.0
chr2	D2HGDH	241748864	241749929	102	1066	0	4764	-102	3698	0.09568480300187618	-0.027582477014602487
chr2	D2HGDH	241749298	241749399	0	102	0	4764	0	4662	0.0	0.0
chr2	D2HGDH	241749293	241749399	0	107	0	4764	0	4657	0.0	0.0
chr2	NEU4	241814891	241815147	0	257	0	2880	0	2623	0.0	0.0
chr2	NEU4	241809781	241809925	0	145	0	2880	0	2735	0.0	0.0
chr2	NEU4	241813332	241813513	0	182	0	2880	0	2698	0.0	0.0
chr2	NEU4	241813332	241813669	0	338	0	2880	0	2542	0.0	0.0
chr2	RTP5	241870990	241871171	0	182	7812	2609	7812	2427	0.0	3.218788627935723
chr2	LINC01237	241934073	241934210	145	138	1726	1604	1581	1466	1.0507246376811594	1.0784447476125512
chr2	LINC01881	242116182	242116232	0	51	40968	1821	40968	1770	0.0	23.145762711864407
chr2	LINC01881	242114638	242114741	767	104	40968	1821	40201	1717	7.375	23.413511939429238
chr2	LINC01881	242130654	242130866	0	213	40968	1821	40968	1608	0.0	25.47761194029851
chr3	LINC01986	14770	14831	0	62	0	2024	0	1962	0.0	0.0
chr3	LINC01986	20556	20597	0	42	0	2024	0	1982	0.0	0.0
chr3	CHL1	244612	244692	0	81	102	11729	102	11648	0.0	0.008756868131868132
chr3	CHL1	342983	343031	0	49	102	11729	102	11680	0.0	0.008732876712328768
chr3	CHL1	398226	398385	0	160	102	11729	102	11569	0.0	0.008816665226035093
chr3	LINC01266	749857	749942	0	86	0	11866	0	11780	0.0	0.0
chr3	LINC01266	840714	840810	0	97	0	11866	0	11769	0.0	0.0
chr3	LINC01266	798148	798265	0	118	0	11866	0	11748	0.0	0.0
chr3	LINC01266	827006	827133	0	128	0	11866	0	11738	0.0	0.0
chr3	CNTN6	1128266	1128377	0	112	0	5532	0	5420	0.0	0.0
chr3	CNTN6	1173203	1173318	0	116	0	5532	0	5416	0.0	0.0
chr3	CNTN6	1147926	1148063	0	138	0	5532	0	5394	0.0	0.0
chr3	CNTN4	2099273	2099649	0	377	4	8815	4	8438	0.0	0.00047404598246029864
chr3	CNTN4	2100557	2100639	0	83	4	8815	4	8732	0.0	0.0004580852038479157
chr3	CNTN4	2883144	2883247	0	104	4	8815	4	8711	0.0	0.0004591895304787051
chr3	CNTN4	2262345	2262430	0	86	4	8815	4	8729	0.0	0.0004582426394776034
chr3	CNTN4	2629525	2629579	0	55	4	8815	4	8760	0.0	0.00045662100456621003
chr3	TRNT1	3136675	3136797	0	123	51	5803	51	5680	0.0	0.00897887323943662
chr3	TRNT1	3140509	3140648	0	140	51	5803	51	5663	0.0	0.00900582730001766
chr3	TRNT1	3129013	3129188	0	176	51	5803	51	5627	0.0	0.00906344410876133
chr3	TRNT1	3137259	3137453	0	195	51	5803	51	5608	0.0	0.009094151212553496
chr3	TRNT1	3146429	3146623	0	195	51	5803	51	5608	0.0	0.009094151212553496
chr3	TRNT1	3139588	3139710	0	123	51	5803	51	5680	0.0	0.00897887323943662
chr3	TRNT1	3146429	3146563	0	135	51	5803	51	5668	0.0	0.00899788285109386
chr3	TRNT1	3127945	3128018	0	74	51	5803	51	5729	0.0	0.008902077151335312
chr3	TRNT1	3146415	3146623	0	209	51	5803	51	5594	0.0	0.009116910976045764
chr3	TRNT1	3140509	3140578	0	70	51	5803	51	5733	0.0	0.008895866038723181
chr3	TRNT1	3142893	3143058	0	166	51	5803	51	5637	0.0	0.009047365620010643
chr3	AC023480.1	4030037	4030125	0	89	0	2206	0	2117	0.0	0.0
chr3	SETMAR	4312897	4313229	0	333	258	3571	258	3238	0.0	0.07967881408276714
chr3	SETMAR	4313646	4313761	0	116	258	3571	258	3455	0.0	0.07467438494934878
chr3	ITPR1	4653841	4653886	0	46	11318	30866	11318	30820	0.0	0.36722907203114863
chr3	ITPR1	4795064	4795187	0	124	11318	30866	11318	30742	0.0	0.36816082232776004
chr3	ITPR1	4727125	4727173	0	49	11318	30866	11318	30817	0.0	0.3672648213648311
chr3	ITPR1	4727122	4727173	0	52	11318	30866	11318	30814	0.0	0.3673005776595054
chr3	ITPR1	4799354	4799387	0	34	11318	30866	11318	30832	0.0	0.36708614426569797
chr3	ITPR1	4709691	4709729	0	39	11318	30866	11318	30827	0.0	0.3671456839783307
chr3	ARL8B	5128459	5128584	0	126	2191	3554	2191	3428	0.0	0.6391481913652275
chr3	EDEM1	5199591	5199695	0	105	82797	6752	82797	6647	0.0	12.45629607341658
chr3	AC069277.1	6710452	6710543	0	92	408	6372	408	6280	0.0	0.06496815286624204
chr3	AC069277.1	6578044	6578137	0	94	408	6372	408	6278	0.0	0.06498884995221409
chr3	AC069277.1	6697831	6697947	0	117	408	6372	408	6255	0.0	0.06522781774580336
chr3	AC069277.1	6706635	6706728	0	94	408	6372	408	6278	0.0	0.06498884995221409
chr3	AC069277.1	6694776	6694877	0	102	408	6372	408	6270	0.0	0.06507177033492823
chr3	AC069277.1	6720086	6720271	0	186	408	6372	408	6186	0.0	0.06595538312318137
chr3	AC069277.1	6694724	6694877	0	154	408	6372	408	6218	0.0	0.06561595368285622
chr3	AC069277.1	6697395	6697511	0	117	408	6372	408	6255	0.0	0.06522781774580336
chr3	AC069277.1	6734498	6734648	0	151	408	6372	408	6221	0.0	0.0655843112039865
chr3	AC069277.1	6695284	6695461	0	178	408	6372	408	6194	0.0	0.06587019696480464
chr3	AC069277.1	6697782	6697947	0	166	408	6372	408	6206	0.0	0.06574282951981952
chr3	GRM7	6786591	6786686	0	96	0	8241	0	8145	0.0	0.0
chr3	GRM7	6884219	6884306	0	88	0	8241	0	8153	0.0	0.0
chr3	GRM7	7686356	7686448	0	93	0	8241	0	8148	0.0	0.0
chr3	GRM7	7691209	7691328	0	120	0	8241	0	8121	0.0	0.0
chr3	GRM7	7691038	7691106	0	69	0	8241	0	8172	0.0	0.0
chr3	AC018832.1	8089903	8090157	0	255	0	1329	0	1074	0.0	0.0
chr3	LMCD1	8532736	8532825	0	90	543	9033	543	8943	0.0	0.06071787990607179
chr3	LMCD1	8537184	8537440	0	257	543	9033	543	8776	0.0	0.061873290793072015
chr3	LMCD1	8514924	8514995	0	72	543	9033	543	8961	0.0	0.060595915634415805
chr3	SRGAP3-AS2	9193428	9193490	0	63	0	1442	0	1379	0.0	0.0
chr3	SRGAP3-AS2	9193282	9193490	0	209	0	1442	0	1233	0.0	0.0
chr3	SRGAP3-AS2	9193317	9193490	0	174	0	1442	0	1268	0.0	0.0
chr3	SRGAP3-AS2	9193374	9193490	0	117	0	1442	0	1325	0.0	0.0
chr3	THUMPD3	9363834	9364038	1071	205	5659	5167	4588	4962	5.224390243902439	0.924627166465135
chr3	SETD5	9424466	9424526	1911	61	382706	12159	380795	12098	31.327868852459016	31.475863779137047
chr3	SETD5	9429826	9430051	4069	226	382706	12159	378637	11933	18.004424778761063	31.73024386156038
chr3	SETD5	9433369	9433562	59716	194	382706	12159	322990	11965	307.8144329896907	26.99456748850815
chr3	SETD5	9434589	9434630	50	42	382706	12159	382656	12117	1.1904761904761905	31.580094082693737
chr3	SETD5	9436849	9436888	346	40	382706	12159	382360	12119	8.65	31.55045795857744
chr3	SETD5	9422722	9423257	18545	536	382706	12159	364161	11623	34.598880597014926	31.331067710573862
chr3	SETD5	9436067	9436140	2548	74	382706	12159	380158	12085	34.432432432432435	31.457012825817127
chr3	SETD5	9434044	9434181	1291	138	382706	12159	381415	12021	9.355072463768115	31.72905748273854
chr3	SETD5	9468518	9468575	0	58	382706	12159	382706	12101	0.0	31.625981323857534
chr3	MTMR14	9668718	9668794	0	77	1857	3678	1857	3601	0.0	0.515690086087198
chr3	MTMR14	9687820	9687891	0	72	1857	3678	1857	3606	0.0	0.5149750415973378
chr3	MTMR14	9689963	9690143	0	181	1857	3678	1857	3497	0.0	0.5310265942236202
chr3	MTMR14	9697710	9697866	306	157	1857	3678	1551	3521	1.9490445859872612	0.44049985799488783
chr3	MTMR14	9650327	9650529	51	203	1857	3678	1806	3475	0.2512315270935961	0.5197122302158274
chr3	CPNE9	9715973	9716035	0	63	113059	2337	113059	2274	0.0	49.71811785400176
chr3	BRPF1	9744223	9744508	51	286	313869	6082	313818	5796	0.17832167832167833	54.143892339544514
chr3	BRPF1	9733172	9733370	2363	199	313869	6082	311506	5883	11.874371859296483	52.95019547849736
chr3	BRPF1	9742351	9742541	112	191	313869	6082	313757	5891	0.5863874345549738	53.26039721609234
chr3	OGG1	9750944	9751192	0	249	40413	7070	40413	6821	0.0	5.924791086350975
chr3	OGG1	9754703	9754885	0	183	40413	7070	40413	6887	0.0	5.868012196892696
chr3	OGG1	9759233	9759286	0	54	40413	7070	40413	7016	0.0	5.760119726339795
chr3	OGG1	9759186	9759286	0	101	40413	7070	40413	6969	0.0	5.79896685320706
chr3	OGG1	9756470	9756621	0	152	40413	7070	40413	6918	0.0	5.841717259323504
chr3	ARPC4	9801660	9801756	88	97	196242	3616	196154	3519	0.9072164948453608	55.74140380789997
chr3	ARPC4	9799878	9800067	9095	190	196242	3616	187147	3426	47.86842105263158	54.625510799766495
chr3	TTLL3	9810620	9810709	0	90	460783	7028	460783	6938	0.0	66.41438454886135
chr3	ARPC4	9803535	9803707	9154	173	196242	3616	187088	3443	52.91329479768786	54.33865814696485
chr3	ARPC4	9800184	9800296	7999	113	196242	3616	188243	3503	70.78761061946902	53.73765343990865
chr3	TTLL3	9816073	9816202	0	130	460783	7028	460783	6898	0.0	66.79950710350826
chr3	TTLL3	9817644	9817759	0	116	460783	7028	460783	6912	0.0	66.66420717592592
chr3	TTLL3	9818554	9818920	0	367	460783	7028	460783	6661	0.0	69.17624981234049
chr3	TTLL3	9818821	9818920	0	100	460783	7028	460783	6928	0.0	66.51024826789839
chr3	TTLL3	9833103	9833245	45810	143	460783	7028	414973	6885	320.34965034965035	60.2720406681191
chr3	TTLL3	9825799	9825948	77145	150	460783	7028	383638	6878	514.3	55.77755161384123
chr3	TTLL3	9834680	9834907	14472	228	460783	7028	446311	6800	63.473684210526315	65.6339705882353
chr3	TTLL3	9834426	9834503	1099	78	460783	7028	459684	6950	14.08974358974359	66.14158273381295
chr3	TTLL3	9827214	9827240	570	27	460783	7028	460213	7001	21.11111111111111	65.73532352521069
chr3	IL17RE	9903396	9903412	0	17	51	4690	51	4673	0.0	0.01091375989728226
chr3	IL17RE	9904031	9904151	0	121	51	4690	51	4569	0.0	0.011162179908076166
chr3	IL17RE	9909216	9909283	0	68	51	4690	51	4622	0.0	0.011034184335785374
chr3	IL17RE	9906363	9906461	0	99	51	4690	51	4591	0.0	0.011108690917011544
chr3	IL17RC	9918334	9918409	0	76	11328	3519	11328	3443	0.0	3.2901539355213476
chr3	IL17RC	9920924	9920969	0	46	11328	3519	11328	3473	0.0	3.2617333717247337
chr3	IL17RC	9930027	9930149	0	123	11328	3519	11328	3396	0.0	3.335689045936396
chr3	IL17RC	9930399	9930459	0	61	11328	3519	11328	3458	0.0	3.275882012724118
chr3	IL17RC	9928579	9928630	0	52	11328	3519	11328	3467	0.0	3.2673781367176233
chr3	IL17RC	9932819	9932858	1190	40	11328	3519	10138	3479	29.75	2.9140557631503308
chr3	IL17RC	9918499	9918609	0	111	11328	3519	11328	3408	0.0	3.323943661971831
chr3	IL17RC	9918534	9918609	0	76	11328	3519	11328	3443	0.0	3.2901539355213476
chr3	IL17RC	9917518	9917633	0	116	11328	3519	11328	3403	0.0	3.328827505142521
chr3	CRELD1	9934419	9934612	4399	194	146828	3805	142429	3611	22.675257731958762	39.44309055663251
chr3	CRELD1	9938014	9938106	28	93	146828	3805	146800	3712	0.3010752688172043	39.547413793103445
chr3	CRELD1	9942812	9942896	357	85	146828	3805	146471	3720	4.2	39.3739247311828
chr3	CRELD1	9937561	9937672	14	112	146828	3805	146814	3693	0.125	39.75467099918765
chr3	CRELD1	9943993	9944095	99	103	146828	3805	146729	3702	0.9611650485436893	39.63506212857914
chr3	CRELD1	9943901	9944095	111	195	146828	3805	146717	3610	0.5692307692307692	40.641828254847645
chr3	EMC3-AS1	9988371	9988477	2029	107	283119	2562	281090	2455	18.962616822429908	114.4969450101833
chr3	FANCD2	10052386	10052497	0	112	196644	7736	196644	7624	0.0	25.792759706190974
chr3	FANCD2	10067208	10067317	663	110	196644	7736	195981	7626	6.027272727272727	25.699055861526357
chr3	FANCD2	10090291	10090385	0	95	196644	7736	196644	7641	0.0	25.735374950922655
chr3	FANCD2	10094288	10094363	0	76	196644	7736	196644	7660	0.0	25.67154046997389
chr3	FANCD2	10032298	10032423	738	126	196644	7736	195906	7610	5.857142857142857	25.74323258869908
chr3	VHL	10146513	10146636	0	124	11830	4894	11830	4770	0.0	2.480083857442348
chr3	TATDN2	10279220	10279927	204	708	100650	5581	100446	4873	0.288135593220339	20.612764210958343
chr3	SLC6A1	11018597	11018698	0	102	15	12472	15	12370	0.0	0.0012126111560226355
chr3	SLC6A1	11020212	11020322	0	111	15	12472	15	12361	0.0	0.001213494053879136
chr3	SLC6A1	11015671	11015733	0	63	15	12472	15	12409	0.0	0.0012088000644693369
chr3	SLC6A1	11017842	11017974	0	133	15	12472	15	12339	0.0	0.0012156576707999028
chr3	SLC6A1	11012598	11012762	0	165	15	12472	15	12307	0.0	0.0012188185585439181
chr3	SLC6A1	11008311	11008363	0	53	15	12472	15	12419	0.0	0.0012078267171269827
chr3	SLC6A1	11013994	11014184	0	191	15	12472	15	12281	0.0	0.0012213989088836414
chr3	SLC6A1	11014717	11014874	0	158	15	12472	15	12314	0.0	0.001218125710573331
chr3	SLC6A1	11014065	11014184	0	120	15	12472	15	12352	0.0	0.0012143782383419689
chr3	SLC6A1	11014031	11014184	0	154	15	12472	15	12318	0.0	0.0012177301509985387
chr3	SLC6A1	11015671	11015790	0	120	15	12472	15	12352	0.0	0.0012143782383419689
chr3	SLC6A1	11019207	11019269	0	63	15	12472	15	12409	0.0	0.0012088000644693369
chr3	SLC6A1	11011286	11011325	0	40	15	12472	15	12432	0.0	0.0012065637065637065
chr3	ATG7	11281036	11281102	0	67	114598	8862	114598	8795	0.0	13.02990335417851
chr3	ATG7	11306942	11307060	447	119	114598	8862	114151	8743	3.7563025210084033	13.056273590300812
chr3	ATG7	11280993	11281102	0	110	114598	8862	114598	8752	0.0	13.093921389396709
chr3	ATG7	11282192	11282438	0	247	114598	8862	114598	8615	0.0	13.302147417295416
chr3	ATG7	11313303	11313420	0	118	114598	8862	114598	8744	0.0	13.105901189387009
chr3	ATG7	11332971	11333093	51	123	114598	8862	114547	8739	0.4146341463414634	13.107563794484495
chr3	ATG7	11379971	11380052	35	82	114598	8862	114563	8780	0.4268292682926829	13.048177676537586
chr3	ATG7	11426803	11426926	0	124	114598	8862	114598	8738	0.0	13.114900434882124
chr3	PPARG	12312379	12312453	0	75	3213	4552	3213	4477	0.0	0.7176680813044449
chr3	PPARG	12379703	12379931	0	229	3213	4552	3213	4323	0.0	0.7432338653712699
chr3	PPARG	12416703	12417154	0	452	3213	4552	3213	4100	0.0	0.7836585365853659
chr3	PPARG	12344806	12344894	0	89	3213	4552	3213	4463	0.0	0.7199193367689894
chr3	PPARG	12301520	12301849	0	330	3213	4552	3213	4222	0.0	0.761013737565135
chr3	PPARG	12297868	12297940	0	73	3213	4552	3213	4479	0.0	0.7173476222371065
chr3	PPARG	12371850	12372111	0	262	3213	4552	3213	4290	0.0	0.7489510489510489
chr3	PPARG	12399347	12399490	0	144	3213	4552	3213	4408	0.0	0.7289019963702359
chr3	TSEN2	12505153	12505231	0	79	49652	4706	49652	4627	0.0	10.730927166630646
chr3	TSEN2	12532661	12532773	0	113	49652	4706	49652	4593	0.0	10.810363596777705
chr3	MKRN2	12568874	12569003	207	130	133690	8723	133483	8593	1.5923076923076922	15.533922960549285
chr3	MKRN2	12570324	12570583	12722	260	133690	8723	120968	8463	48.93076923076923	14.293749261491197
chr3	MKRN2	12568874	12568997	207	124	133690	8723	133483	8599	1.6693548387096775	15.523084079544134
chr3	CAND2	12806388	12806496	0	109	688	5586	688	5477	0.0	0.12561621325543182
chr3	HDAC11	13496735	13496852	0	118	153	5097	153	4979	0.0	0.03072906206065475
chr3	HDAC11	13483463	13483564	0	102	153	5097	153	4995	0.0	0.03063063063063063
chr3	HDAC11	13501870	13501933	0	64	153	5097	153	5033	0.0	0.03039936419630439
chr3	HDAC11	13498512	13498555	0	44	153	5097	153	5053	0.0	0.030279042153176332
chr3	HDAC11	13500712	13500789	0	78	153	5097	153	5019	0.0	0.030484160191273164
chr3	HDAC11	13502883	13502980	0	98	153	5097	153	4999	0.0	0.03060612122424485
chr3	FBLN2	13621774	13621915	97	142	4726	4777	4629	4635	0.6830985915492958	0.998705501618123
chr3	LINC00620	13715945	13715968	0	24	0	1052	0	1028	0.0	0.0
chr3	TPRXL	13955205	13955316	0	112	51	3521	51	3409	0.0	0.01496039894397184
chr3	TPRXL	14028275	14028384	0	110	51	3521	51	3411	0.0	0.014951627088830254
chr3	TPRXL	13955561	13955654	0	94	51	3521	51	3427	0.0	0.014881820834549168
chr3	TPRXL	14063378	14063508	0	131	51	3521	51	3390	0.0	0.01504424778761062
chr3	TPRXL	14057137	14057184	0	48	51	3521	51	3473	0.0	0.01468471062482004
chr3	TMEM43	14128854	14129085	0	232	284	3511	284	3279	0.0	0.08661177188167124
chr3	XPC-AS1	14147954	14148701	0	748	663	4026	663	3278	0.0	0.2022574740695546
chr3	XPC-AS1	14151363	14151441	0	79	663	4026	663	3947	0.0	0.16797567772992145
chr3	XPC-AS1	14149506	14149602	0	97	663	4026	663	3929	0.0	0.16874522779333165
chr3	SLC6A6	14443623	14443863	1416	241	28091	8272	26675	8031	5.875518672199171	3.321504171336073
chr3	SLC6A6	14468087	14468212	459	126	28091	8272	27632	8146	3.642857142857143	3.3920942794009328
chr3	SLC6A6	14443627	14443863	1326	237	28091	8272	26765	8035	5.594936708860759	3.33105164903547
chr3	SLC6A6	14444737	14444866	44	130	28091	8272	28047	8142	0.3384615384615385	3.444731024318349
chr3	FGD5	14926069	14926198	0	130	51	8116	51	7986	0.0	0.006386175807663411
chr3	NR2C2	15004556	15004613	960	58	22568	11841	21608	11783	16.551724137931036	1.8338283968429092
chr3	CAPN7	15210801	15210922	0	122	304	5619	304	5497	0.0	0.05530289248681099
chr3	CAPN7	15212103	15212212	0	110	304	5619	304	5509	0.0	0.05518242875294972
chr3	CAPN7	15241452	15241588	0	137	304	5619	304	5482	0.0	0.055454213790587376
chr3	CAPN7	15232110	15232158	0	49	304	5619	304	5570	0.0	0.05457809694793537
chr3	SH3BP5-AS1	15258108	15258183	0	76	20751	6880	20751	6804	0.0	3.0498236331569664
chr3	EAF1	15432086	15432223	1071	138	16177	3557	15106	3419	7.760869565217392	4.418250950570342
chr3	BTD	15632590	15632866	204	277	316162	13089	315958	12812	0.7364620938628159	24.66109896971589
chr3	BTD	15631426	15631495	0	70	316162	13089	316162	13019	0.0	24.284660880251938
chr3	BTD	15630001	15630120	0	120	316162	13089	316162	12969	0.0	24.378286683630193
chr3	BTD	15602136	15602310	9462	175	316162	13089	306700	12914	54.06857142857143	23.749419234938827
chr3	BTD	15644315	15644931	742	617	316162	13089	315420	12472	1.2025931928687197	25.290250160359204
chr3	OXNAD1	16271658	16271722	0	65	33675	6108	33675	6043	0.0	5.572563296375972
chr3	OXNAD1	16272144	16272321	0	178	33675	6108	33675	5930	0.0	5.678752107925801
chr3	LINC00690	16525430	16525585	0	156	0	3568	0	3412	0.0	0.0
chr3	LINC00690	16536552	16536666	0	115	0	3568	0	3453	0.0	0.0
chr3	LINC00690	16536588	16536666	0	79	0	3568	0	3489	0.0	0.0
chr3	LINC00690	16536767	16536982	0	216	0	3568	0	3352	0.0	0.0
chr3	SATB1-AS1	18465293	18465358	46	66	46	12779	0	12713	0.696969696969697	0.0
chr3	SATB1-AS1	18473711	18473858	0	148	46	12779	46	12631	0.0	0.0036418335840392685
chr3	SATB1-AS1	18472361	18472459	0	99	46	12779	46	12680	0.0	0.0036277602523659305
chr3	SATB1-AS1	18527950	18528139	0	190	46	12779	46	12589	0.0	0.003653983636508063
chr3	SATB1-AS1	18528075	18528139	0	65	46	12779	46	12714	0.0	0.0036180588327827594
chr3	SATB1-AS1	18516044	18516178	0	135	46	12779	46	12644	0.0	0.0036380892122745965
chr3	SATB1-AS1	18529980	18530185	0	206	46	12779	46	12573	0.0	0.0036586335798934225
chr3	SATB1-AS1	18585386	18585442	0	57	46	12779	46	12722	0.0	0.003615783681811036
chr3	SATB1-AS1	18511531	18511628	0	98	46	12779	46	12681	0.0	0.0036274741739610442
chr3	SATB1-AS1	18548063	18548193	0	131	46	12779	46	12648	0.0	0.0036369386464263124
chr3	SATB1-AS1	18586869	18586908	0	40	46	12779	46	12739	0.0	0.003610958473977549
chr3	SATB1-AS1	18546790	18546952	0	163	46	12779	46	12616	0.0	0.003646163601775523
chr3	SATB1-AS1	18529980	18530326	0	347	46	12779	46	12432	0.0	0.0037001287001287003
chr3	SATB1-AS1	18665839	18665895	0	57	46	12779	46	12722	0.0	0.003615783681811036
chr3	SATB1-AS1	18568106	18568154	0	49	46	12779	46	12730	0.0	0.0036135113904163393
chr3	SATB1-AS1	18527784	18528139	0	356	46	12779	46	12423	0.0	0.003702809305320776
chr3	SATB1-AS1	18843135	18843176	0	42	46	12779	46	12737	0.0	0.003611525476956897
chr3	SATB1-AS1	18585619	18585762	0	144	46	12779	46	12635	0.0	0.0036406806489908982
chr3	SATB1-AS1	18530938	18531039	0	102	46	12779	46	12677	0.0	0.0036286187583813205
chr3	SATB1-AS1	18584916	18585043	0	128	46	12779	46	12651	0.0	0.00363607619950992
chr3	KCNH8	19346651	19346734	0	84	0	6105	0	6021	0.0	0.0
chr3	RAB5A	19970547	19970717	0	171	204	3774	204	3603	0.0	0.05661948376353039
chr3	SGO1-AS1	20177216	20177250	0	35	2361	6600	2361	6565	0.0	0.35963442498095965
chr3	UBE2E2	23499607	23499740	0	134	0	3250	0	3116	0.0	0.0
chr3	UBE2E2	23323514	23323586	0	73	0	3250	0	3177	0.0	0.0
chr3	UBE2E1	23811459	23811510	0	52	5983	3357	5983	3305	0.0	1.810287443267776
chr3	UBE2E1	23888237	23888261	0	25	5983	3357	5983	3332	0.0	1.7956182472989195
chr3	RPL15	23917532	23917665	74	134	23156	6231	23082	6097	0.5522388059701493	3.7857962932589797
chr3	NR1D2	23963223	23963330	0	108	859031	5803	859031	5695	0.0	150.8395083406497
chr3	THRB-AS1	24496663	24496818	0	156	92	7672	92	7516	0.0	0.012240553485896753
chr3	THRB-AS1	24499231	24499374	0	144	92	7672	92	7528	0.0	0.012221041445270989
chr3	RARB	25569757	25569918	0	162	0	3708	0	3546	0.0	0.0
chr3	RARB	25593502	25593707	0	206	0	3708	0	3502	0.0	0.0
chr3	RARB	25593640	25593707	0	68	0	3708	0	3640	0.0	0.0
chr3	LINC01980	27802113	27802218	0	106	51	4756	51	4650	0.0	0.01096774193548387
chr3	LINC01980	27848700	27848764	0	65	51	4756	51	4691	0.0	0.010871882327861864
chr3	LINC01980	27806531	27806622	0	92	51	4756	51	4664	0.0	0.010934819897084048
chr3	LINC01980	27840278	27840387	0	110	51	4756	51	4646	0.0	0.010977184674989237
chr3	LINC01980	27802763	27802850	0	88	51	4756	51	4668	0.0	0.010925449871465296
chr3	LINC01980	27826057	27826211	0	155	51	4756	51	4601	0.0	0.01108454683764399
chr3	LINC01980	27802113	27802370	0	258	51	4756	51	4498	0.0	0.01133837261004891
chr3	LINC01980	27807952	27808008	0	57	51	4756	51	4699	0.0	0.010853373058097467
chr3	LINC01980	27802113	27802850	0	738	51	4756	51	4018	0.0	0.012692882030861125
chr3	LINC01980	27806453	27806622	0	170	51	4756	51	4586	0.0	0.011120802442215439
chr3	LINC01980	27806451	27806622	0	172	51	4756	51	4584	0.0	0.01112565445026178
chr3	LINC01980	27841727	27841925	0	199	51	4756	51	4557	0.0	0.01119157340355497
chr3	LINC01980	27826057	27826164	0	108	51	4756	51	4648	0.0	0.010972461273666093
chr3	LINC01980	27823528	27823617	0	90	51	4756	51	4666	0.0	0.01093013287612516
chr3	LINC01980	27841727	27841823	0	97	51	4756	51	4659	0.0	0.010946555054732776
chr3	CMC1	28263290	28263380	0	91	9497	7283	9497	7192	0.0	1.3204949944382647
chr3	ZCWPW2	28390497	28390617	306	121	353	4551	47	4430	2.5289256198347108	0.010609480812641084
chr3	ZCWPW2	28478813	28478931	0	119	353	4551	353	4432	0.0	0.0796480144404332
chr3	ZCWPW2	28351573	28351623	0	51	353	4551	353	4500	0.0	0.07844444444444444
chr3	ZCWPW2	28398037	28398232	0	196	353	4551	353	4355	0.0	0.08105625717566016
chr3	ZCWPW2	28478288	28478387	0	100	353	4551	353	4451	0.0	0.07930802066951247
chr3	RBMS3	29899704	29899755	0	52	36	18380	36	18328	0.0	0.001964207769532955
chr3	RBMS3	29944206	29944254	0	49	36	18380	36	18331	0.0	0.001963886312803448
chr3	RBMS3	28898483	28898562	0	80	36	18380	36	18300	0.0	0.0019672131147540984
chr3	RBMS3	29880778	29880817	0	40	36	18380	36	18340	0.0	0.0019629225736095966
chr3	TGFBR2	30623198	30623273	0	76	122540	6861	122540	6785	0.0	18.060427413411936
chr3	OSBPL10-AS1	31718778	31718924	0	147	306	2319	306	2172	0.0	0.1408839779005525
chr3	OSBPL10-AS1	31718745	31718924	0	180	306	2319	306	2139	0.0	0.14305750350631136
chr3	GPD1L	32138586	32138727	0	142	0	4164	0	4022	0.0	0.0
chr3	GPD1L	32128075	32128253	0	179	0	4164	0	3985	0.0	0.0
chr3	CMTM8	32357372	32357546	0	175	0	1174	0	999	0.0	0.0
chr3	CMTM7	32452391	32452473	0	83	120	3730	120	3647	0.0	0.03290375651220181
chr3	CMTM7	32449453	32449552	0	100	120	3730	120	3630	0.0	0.03305785123966942
chr3	CNOT10	32704810	32704972	0	163	43110	4488	43110	4325	0.0	9.967630057803468
chr3	CNOT10	32713226	32713369	0	144	43110	4488	43110	4344	0.0	9.92403314917127
chr3	CNOT10	32720113	32720231	0	119	43110	4488	43110	4369	0.0	9.867246509498742
chr3	CNOT10	32764454	32764490	0	37	43110	4488	43110	4451	0.0	9.685463940687486
chr3	CNOT10	32737409	32737490	1300	82	43110	4488	41810	4406	15.853658536585366	9.489332728098049
chr3	CRTAP	33129938	33130067	4137	130	84819	6668	80682	6538	31.823076923076922	12.340471092077088
chr3	FBXL2	33297868	33297962	0	95	8054	7427	8054	7332	0.0	1.0984724495362794
chr3	FBXL2	33358966	33359021	0	56	8054	7427	8054	7371	0.0	1.0926604259937593
chr3	FBXL2	33317476	33317613	96	138	8054	7427	7958	7289	0.6956521739130435	1.0917821374674166
chr3	FBXL2	33359282	33359357	0	76	8054	7427	8054	7351	0.0	1.0956332471772547
chr3	FBXL2	33364624	33364719	0	96	8054	7427	8054	7331	0.0	1.0986222889101078
chr3	PDCD6IP	33812071	33812126	0	56	257688	8689	257688	8633	0.0	29.849183366153135
chr3	PDCD6IP	33821954	33822082	0	129	257688	8689	257688	8560	0.0	30.10373831775701
chr3	PDCD6IP	33841896	33842074	2478	179	257688	8689	255210	8510	13.843575418994414	29.98942420681551
chr3	PDCD6IP	33827621	33827739	0	119	257688	8689	257688	8570	0.0	30.068611435239205
chr3	PDCD6IP	33811096	33811191	0	96	257688	8689	257688	8593	0.0	29.988129873152566
chr3	PDCD6IP	33835253	33835318	0	66	257688	8689	257688	8623	0.0	29.88379914182999
chr3	LINC01811	34170844	34170920	0	77	51	7983	51	7906	0.0	0.006450796863141917
chr3	LINC01811	34298852	34298919	0	68	51	7983	51	7915	0.0	0.006443461781427669
chr3	LINC01811	34346221	34346289	0	69	51	7983	51	7914	0.0	0.006444275966641395
chr3	LINC01811	34409260	34409349	0	90	51	7983	51	7893	0.0	0.006461421512732801
chr3	LINC01811	34386890	34387077	0	188	51	7983	51	7795	0.0	0.006542655548428479
chr3	LINC01811	34323347	34323598	0	252	51	7983	51	7731	0.0	0.006596818005432673
chr3	LINC01811	34367379	34367468	0	90	51	7983	51	7893	0.0	0.006461421512732801
chr3	LINC01811	34409260	34409361	0	102	51	7983	51	7881	0.0	0.006471259992386753
chr3	LINC01811	34435292	34435456	0	165	51	7983	51	7818	0.0	0.006523407521105142
chr3	LINC01811	34559178	34559369	0	192	51	7983	51	7791	0.0	0.006546014632268001
chr3	LINC01811	34300690	34300841	0	152	51	7983	51	7831	0.0	0.006512578214787384
chr3	LINC01811	34551885	34551988	0	104	51	7983	51	7879	0.0	0.006472902652620891
chr3	LINC01811	34551406	34551570	0	165	51	7983	51	7818	0.0	0.006523407521105142
chr3	ARPP21	35680825	35680917	0	93	0	9631	0	9538	0.0	0.0
chr3	ARPP21	35687738	35687883	0	146	0	9631	0	9485	0.0	0.0
chr3	ARPP21	35706973	35707082	0	110	0	9631	0	9521	0.0	0.0
chr3	ARPP21	35738213	35738318	0	106	0	9631	0	9525	0.0	0.0
chr3	ARPP21	35708968	35709070	0	103	0	9631	0	9528	0.0	0.0
chr3	ARPP21	35717297	35717357	0	61	0	9631	0	9570	0.0	0.0
chr3	ARPP21	35707450	35707541	0	92	0	9631	0	9539	0.0	0.0
chr3	ARPP21	35717297	35717361	0	65	0	9631	0	9566	0.0	0.0
chr3	STAC	36443363	36443640	0	278	39507	4410	39507	4132	0.0	9.561229428848016
chr3	MLH1	37004400	37004474	30	75	53840	6920	53810	6845	0.4	7.861212563915267
chr3	MLH1	37008813	37008905	0	93	53840	6920	53840	6827	0.0	7.88633367511352
chr3	MLH1	37017505	37017599	22	95	53840	6920	53818	6825	0.23157894736842105	7.885421245421245
chr3	MLH1	37020309	37020463	0	155	53840	6920	53840	6765	0.0	7.958610495195861
chr3	MLH1	37042267	37042331	44	65	53840	6920	53796	6855	0.676923076923077	7.847702407002188
chr3	MLH1	37047518	37047683	102	166	53840	6920	53738	6754	0.6144578313253012	7.956470239857862
chr3	MLH1	37048516	37048609	8480	94	53840	6920	45360	6826	90.2127659574468	6.64518019337826
chr3	MLH1	36996618	36996709	0	92	53840	6920	53840	6828	0.0	7.885178676039836
chr3	MLH1	37000954	37001053	0	100	53840	6920	53840	6820	0.0	7.894428152492669
chr3	MLH1	36996623	36996709	0	87	53840	6920	53840	6833	0.0	7.879408751646422
chr3	MLH1	37000954	37001048	0	95	53840	6920	53840	6825	0.0	7.888644688644689
chr3	MLH1	36995388	36995645	0	258	53840	6920	53840	6662	0.0	8.081657160012009
chr3	MLH1	36994829	36994953	0	125	53840	6920	53840	6795	0.0	7.923473142016189
chr3	MLH1	36997155	36997300	0	146	53840	6920	53840	6774	0.0	7.948036610569826
chr3	MLH1	37014431	37014544	0	114	53840	6920	53840	6806	0.0	7.910667058477814
chr3	MLH1	36994829	36994903	0	75	53840	6920	53840	6845	0.0	7.865595325054785
chr3	MLH1	37048903	37049017	0	115	53840	6920	53840	6805	0.0	7.91182953710507
chr3	MLH1	37040185	37040294	0	110	53840	6920	53840	6810	0.0	7.906020558002937
chr3	GOLGA4	37286013	37286061	0	49	133844	10768	133844	10719	0.0	12.486612557141525
chr3	GOLGA4	37337142	37337163	0	22	133844	10768	133844	10746	0.0	12.455239158756747
chr3	GOLGA4	37361242	37361305	74	64	133844	10768	133770	10704	1.15625	12.497197309417041
chr3	GOLGA4	37273535	37273601	0	67	133844	10768	133844	10701	0.0	12.507616110643864
chr3	GOLGA4	37266841	37266940	50	100	133844	10768	133794	10668	0.5	12.541619797525309
chr3	C3ORF35	37399476	37399659	51	184	9312	7262	9261	7078	0.27717391304347827	1.3084204577564285
chr3	C3ORF35	37412369	37412488	0	120	9312	7262	9312	7142	0.0	1.303836460375245
chr3	ITGA9	37803822	37803942	0	121	202	8298	202	8177	0.0	0.02470343646814235
chr3	CTDSPL	37957110	37957143	0	34	102	3408	102	3374	0.0	0.03023117960877297
chr3	CTDSPL	37911672	37911827	0	156	102	3408	102	3252	0.0	0.03136531365313653
chr3	VILL	38000921	38001000	0	80	1409	5326	1409	5246	0.0	0.26858558902020585
chr3	DLEC1	38085273	38085447	0	175	7488	7451	7488	7276	0.0	1.0291368884002199
chr3	DLEC1	38092789	38092880	0	92	7488	7451	7488	7359	0.0	1.0175295556461477
chr3	DLEC1	38094878	38095071	0	194	7488	7451	7488	7257	0.0	1.0318313352625053
chr3	DLEC1	38122070	38122194	0	125	7488	7451	7488	7326	0.0	1.0221130221130221
chr3	MYD88	38139863	38139998	0	136	0	3206	0	3070	0.0	0.0
chr3	MYD88	38140387	38140568	0	182	0	3206	0	3024	0.0	0.0
chr3	MYD88	38140387	38140549	0	163	0	3206	0	3043	0.0	0.0
chr3	MYD88	38140387	38140592	0	206	0	3206	0	3000	0.0	0.0
chr3	OXSR1	38193281	38193418	0	138	40019	6090	40019	5952	0.0	6.723622311827957
chr3	SLC22A13	38274603	38274758	0	156	73605	3007	73605	2851	0.0	25.817257102770956
chr3	SLC22A13	38276286	38276395	126	110	73605	3007	73479	2897	1.1454545454545455	25.36382464618571
chr3	XYLB	38362936	38363017	0	82	33909	6350	33909	6268	0.0	5.409859604339502
chr3	XYLB	38360338	38360408	0	71	33909	6350	33909	6279	0.0	5.400382226469183
chr3	XYLB	38373114	38373279	0	166	33909	6350	33909	6184	0.0	5.483344113842174
chr3	EXOG	38496842	38496929	0	88	42283	4763	42283	4675	0.0	9.044491978609626
chr3	EXOG	38498925	38498989	0	65	42283	4763	42283	4698	0.0	9.000212856534695
chr3	EXOG	38497628	38497778	1734	151	42283	4763	40549	4612	11.483443708609272	8.79206418039896
chr3	EXOG	38499680	38499747	0	68	42283	4763	42283	4695	0.0	9.005963791267305
chr3	EXOG	38500089	38500164	0	76	42283	4763	42283	4687	0.0	9.02133560913164
chr3	EXOG	38497628	38497684	392	57	42283	4763	41891	4706	6.87719298245614	8.90161495962601
chr3	EXOG	38513749	38513868	0	120	42283	4763	42283	4643	0.0	9.106827482231315
chr3	EXOG	38519261	38519377	574	117	42283	4763	41709	4646	4.905982905982906	8.977399913904433
chr3	WDR48	39065810	39065889	0	80	102	4856	102	4776	0.0	0.02135678391959799
chr3	WDR48	39066726	39066875	0	150	102	4856	102	4706	0.0	0.021674458138546536
chr3	WDR48	39066745	39066875	0	131	102	4856	102	4725	0.0	0.02158730158730159
chr3	WDR48	39065790	39065889	0	100	102	4856	102	4756	0.0	0.02144659377628259
chr3	TTC21A	39110028	39110139	1530	112	331604	7452	330074	7340	13.660714285714286	44.969209809264306
chr3	TTC21A	39112457	39112580	36	124	331604	7452	331568	7328	0.2903225806451613	45.2467248908297
chr3	TTC21A	39110850	39111017	0	168	331604	7452	331604	7284	0.0	45.524986271279516
chr3	TTC21A	39110028	39110233	2478	206	331604	7452	329126	7246	12.029126213592233	45.42174993099641
chr3	SLC25A38	39391440	39391620	0	181	255	2674	255	2493	0.0	0.1022864019253911
chr3	SLC25A38	39389361	39389389	0	29	255	2674	255	2645	0.0	0.09640831758034027
chr3	MOBP	39480039	39480123	0	85	4246	9245	4246	9160	0.0	0.46353711790393015
chr3	MOBP	39499466	39499532	0	67	4246	9245	4246	9178	0.0	0.46262802353453913
chr3	MOBP	39502534	39502914	0	381	4246	9245	4246	8864	0.0	0.4790162454873646
chr3	MOBP	39499866	39500067	0	202	4246	9245	4246	9043	0.0	0.4695344465332301
chr3	MOBP	39502462	39502876	0	415	4246	9245	4246	8830	0.0	0.48086070215175536
chr3	MOBP	39502534	39502876	0	343	4246	9245	4246	8902	0.0	0.4769714670860481
chr3	MYRIP	40151047	40151184	0	138	2244	5889	2244	5751	0.0	0.3901930099113198
chr3	MYRIP	40233858	40234053	0	196	2244	5889	2244	5693	0.0	0.3941682768311962
chr3	MYRIP	40233895	40234053	0	159	2244	5889	2244	5730	0.0	0.39162303664921466
chr3	ENTPD3	40394629	40394753	0	125	93	3600	93	3475	0.0	0.026762589928057554
chr3	ENTPD3	40394308	40394431	0	124	93	3600	93	3476	0.0	0.026754890678941313
chr3	ZNF619	40481862	40482016	0	155	38773	5338	38773	5183	0.0	7.480802623962956
chr3	ZNF619	40483673	40483723	0	51	38773	5338	38773	5287	0.0	7.333648571968981
chr3	ZNF619	40483652	40483723	0	72	38773	5338	38773	5266	0.0	7.362894037219902
chr3	ZNF619	40482229	40482349	0	121	38773	5338	38773	5217	0.0	7.432049070346943
chr3	ZNF620	40507842	40507941	0	100	19106	3791	19106	3691	0.0	5.176374966133839
chr3	ZNF619	40482199	40482349	0	151	38773	5338	38773	5187	0.0	7.475033738191633
chr3	ZNF620	40508655	40508774	47	120	19106	3791	19059	3671	0.39166666666666666	5.191773358757832
chr3	ZNF621	40529318	40529445	9262	128	74930	8951	65668	8823	72.359375	7.442819902527485
chr3	CTNNB1	41235723	41235843	0	121	7901	9254	7901	9133	0.0	0.8651045658600679
chr3	CTNNB1	41224189	41224321	0	133	7901	9254	7901	9121	0.0	0.8662427365420459
chr3	CTNNB1	41224020	41224081	0	62	7901	9254	7901	9192	0.0	0.8595517841601392
chr3	CTNNB1	41224953	41224991	0	39	7901	9254	7901	9215	0.0	0.8574064026044492
chr3	CTNNB1	41238370	41238445	0	76	7901	9254	7901	9178	0.0	0.8608629331008935
chr3	CTNNB1	41222333	41222345	0	13	7901	9254	7901	9241	0.0	0.8549940482631749
chr3	CTNNB1	41235726	41235843	0	118	7901	9254	7901	9136	0.0	0.8648204903677759
chr3	TRAK1	42193823	42193898	0	76	51	10821	51	10745	0.0	0.0047463936714751045
chr3	TRAK1	42220498	42220591	0	94	51	10821	51	10727	0.0	0.004754358161648178
chr3	TRAK1	42151334	42151432	0	99	51	10821	51	10722	0.0	0.004756575265808618
chr3	VIPR1	42512750	42512949	0	200	0	7402	0	7202	0.0	0.0
chr3	VIPR1	42527990	42528123	0	134	0	7402	0	7268	0.0	0.0
chr3	VIPR1	42530778	42530932	0	155	0	7402	0	7247	0.0	0.0
chr3	VIPR1	42513748	42513854	0	107	0	7402	0	7295	0.0	0.0
chr3	VIPR1	42527392	42527496	0	105	0	7402	0	7297	0.0	0.0
chr3	NKTR	42620015	42620043	0	29	246350	17018	246350	16989	0.0	14.50055918535523
chr3	NKTR	42627199	42627227	1670	29	246350	17018	244680	16989	57.58620689655172	14.402260286067456
chr3	CCDC13-AS1	42740974	42741087	0	114	102	2374	102	2260	0.0	0.04513274336283186
chr3	ACKR2	42819630	42819711	0	82	20800	5475	20800	5393	0.0	3.8568514741331357
chr3	ACKR2	42839093	42839279	284	187	20800	5475	20516	5288	1.518716577540107	3.879727685325265
chr3	ACKR2	42851295	42851454	0	160	20800	5475	20800	5315	0.0	3.9134524929444967
chr3	ACKR2	42864465	42864859	1479	395	20800	5475	19321	5080	3.7443037974683544	3.8033464566929136
chr3	ZNF662	42908792	42908909	1428	118	4641	5905	3213	5787	12.101694915254237	0.5552099533437014
chr3	ZNF662	42913200	42913302	0	103	4641	5905	4641	5802	0.0	0.7998965873836608
chr3	GASK1A	43032266	43033553	0	1288	0	4402	0	3114	0.0	0.0
chr3	SNRK	43289739	43289789	0	51	255	6991	255	6940	0.0	0.03674351585014409
chr3	SNRK	43303097	43303792	0	696	255	6991	255	6295	0.0	0.04050833995234313
chr3	SNRK	43299753	43299815	0	63	255	6991	255	6928	0.0	0.03680715935334873
chr3	ABHD5	43714946	43715058	0	113	3973	7414	3973	7301	0.0	0.5441720312285988
chr3	ABHD5	43717670	43717857	0	188	3973	7414	3973	7226	0.0	0.5498200941046222
chr3	ABHD5	43690380	43690710	0	331	3973	7414	3973	7083	0.0	0.5609205139065367
chr3	ABHD5	43702214	43702587	0	374	3973	7414	3973	7040	0.0	0.5643465909090909
chr3	ABHD5	43733879	43733963	280	85	3973	7414	3693	7329	3.2941176470588234	0.5038886614817847
chr3	ABHD5	43694902	43695153	0	252	3973	7414	3973	7162	0.0	0.5547333147165596
chr3	ABHD5	43702386	43702587	0	202	3973	7414	3973	7212	0.0	0.5508874098724348
chr3	ABHD5	43717765	43717857	0	93	3973	7414	3973	7321	0.0	0.5426854254883212
chr3	TCAIM	44357740	44357876	0	137	161404	8758	161404	8621	0.0	18.72219000115996
chr3	TCAIM	44391207	44391331	255	125	161404	8758	161149	8633	2.04	18.666628055137263
chr3	ZKSCAN7	44556929	44557470	0	542	54	4213	54	3671	0.0	0.01470988831381095
chr3	ZKSCAN7	44567911	44568003	0	93	54	4213	54	4120	0.0	0.013106796116504855
chr3	ZKSCAN7	44569924	44570665	0	742	54	4213	54	3471	0.0	0.015557476231633534
chr3	ZNF660	44587129	44587250	51	122	11679	6518	11628	6396	0.4180327868852459	1.8180112570356473
chr3	ZNF197	44630813	44630946	0	134	3405	6691	3405	6557	0.0	0.5192923593106603
chr3	ZNF35	44652556	44652701	1380	146	2784	2653	1404	2507	9.452054794520548	0.5600319106501795
chr3	ZNF502	44714590	44714688	0	99	32313	3260	32313	3161	0.0	10.222397975324265
chr3	KIF15	44774394	44774437	371	44	24555	5319	24184	5275	8.431818181818182	4.584644549763033
chr3	KIF15	44826995	44827193	0	199	24555	5319	24555	5120	0.0	4.7958984375
chr3	TGM4	44887688	44887795	9	108	148719	5458	148710	5350	0.08333333333333333	27.796261682242992
chr3	LARS2	45400244	45400373	0	130	12796	12201	12796	12071	0.0	1.0600613039516196
chr3	LARS2	45391582	45391648	0	67	12796	12201	12796	12134	0.0	1.0545574418987969
chr3	LARS2	45500026	45500144	0	119	12796	12201	12796	12082	0.0	1.05909617612978
chr3	LARS2	45509414	45509495	0	82	12796	12201	12796	12119	0.0	1.0558626949418268
chr3	LARS2	45399563	45399692	0	130	12796	12201	12796	12071	0.0	1.0600613039516196
chr3	LARS2	45389032	45389106	0	75	12796	12201	12796	12126	0.0	1.0552531749958767
chr3	LARS2	45519692	45519790	153	99	12796	12201	12643	12102	1.5454545454545454	1.0447033548173856
chr3	SACM1L	45706779	45706907	51	129	95271	7303	95220	7174	0.3953488372093023	13.272930025090606
chr3	SACM1L	45690347	45690387	0	41	95271	7303	95271	7262	0.0	13.119113191958139
chr3	CCR9	45897560	45897646	0	87	0	2811	0	2724	0.0	0.0
chr3	CCR9	45894905	45894954	0	50	0	2811	0	2761	0.0	0.0
chr3	CCR3	46264386	46264455	0	70	102	2535	102	2465	0.0	0.041379310344827586
chr3	CCR3	46264386	46264446	0	61	102	2535	102	2474	0.0	0.041228779304769606
chr3	CCR2	46354861	46354956	0	96	0	3009	0	2913	0.0	0.0
chr3	CCRL2	46407755	46407781	0	27	0	2751	0	2724	0.0	0.0
chr3	PTH1R	46901024	46901085	0	62	992	2734	992	2672	0.0	0.3712574850299401
chr3	PTH1R	46902900	46902951	0	52	992	2734	992	2682	0.0	0.3698732289336316
chr3	NBEAL2	46992474	46992555	0	82	17863	10192	17863	10110	0.0	1.766864490603363
chr3	NBEAL2	46998958	46999117	0	160	17863	10192	17863	10032	0.0	1.7806020733652312
chr3	NBEAL2	47004971	47005096	151	126	17863	10192	17712	10066	1.1984126984126984	1.759586727597854
chr3	NBEAL2	47007065	47007155	0	91	17863	10192	17863	10101	0.0	1.7684387684387683
chr3	NBEAL2	47007524	47007697	30	174	17863	10192	17833	10018	0.1724137931034483	1.7800958275104812
chr3	NBEAL2	47007240	47007350	459	111	17863	10192	17404	10081	4.135135135135135	1.7264160301557385
chr3	NRADDP	47012622	47012765	1632	144	7536	1732	5904	1588	11.333333333333334	3.717884130982368
chr3	KLHL18	47297561	47297672	59	112	22496	7076	22437	6964	0.5267857142857143	3.2218552556002296
chr3	KLHL18	47319652	47319783	0	132	22496	7076	22496	6944	0.0	3.23963133640553
chr3	PTPN23	47396142	47396217	0	76	2332	5900	2332	5824	0.0	0.40041208791208793
chr3	PTPN23	47404651	47404779	0	129	2332	5900	2332	5771	0.0	0.4040894125801421
chr3	DHX30	47822096	47822231	194	136	18816	7768	18622	7632	1.4264705882352942	2.4399895178197064
chr3	DHX30	47819235	47819264	0	30	18816	7768	18816	7738	0.0	2.4316360816748515
chr3	DHX30	47815962	47816128	36	167	18816	7768	18780	7601	0.2155688622754491	2.470727535850546
chr3	ZNF589	48267917	48268160	0	244	153	5529	153	5285	0.0	0.028949858088930937
chr3	ZNF589	48267914	48270969	102	3056	153	5529	51	2473	0.03337696335078534	0.020622725434694702
chr3	FBXW12	48372683	48372857	0	175	0	3503	0	3328	0.0	0.0
chr3	FBXW12	48378316	48378526	0	211	0	3503	0	3292	0.0	0.0
chr3	FBXW12	48372656	48372857	0	202	0	3503	0	3301	0.0	0.0
chr3	FBXW12	48378382	48378526	0	145	0	3503	0	3358	0.0	0.0
chr3	ATRIP	48457258	48457416	0	159	107889	5446	107889	5287	0.0	20.40646869680348
chr3	ATRIP	48450492	48450575	0	84	107889	5446	107889	5362	0.0	20.121036926519956
chr3	ATRIP	48464581	48464662	0	82	107889	5446	107889	5364	0.0	20.113534675615213
chr3	ATRIP	48461360	48461445	2776	86	107889	5446	105113	5360	32.27906976744186	19.61063432835821
chr3	TREX1	48466629	48466641	18	13	15886	1427	15868	1414	1.3846153846153846	11.222065063649222
chr3	ARIH2	48927461	48927813	0	353	80206	7097	80206	6744	0.0	11.8929418742586
chr3	ARIH2	48922747	48922811	0	65	80206	7097	80206	7032	0.0	11.405858930602959
chr3	ARIH2	48945135	48945181	0	47	80206	7097	80206	7050	0.0	11.376737588652482
chr3	ARIH2	48961611	48961679	1419	69	80206	7097	78787	7028	20.565217391304348	11.210443938531588
chr3	ARIH2	48924717	48924839	0	123	80206	7097	80206	6974	0.0	11.500716948666476
chr3	ARIH2	48924717	48924971	0	255	80206	7097	80206	6842	0.0	11.722595732242034
chr3	ARIH2	48922348	48922468	0	121	80206	7097	80206	6976	0.0	11.497419724770642
chr3	ARIH2	48921479	48921576	9204	98	80206	7097	71002	6999	93.91836734693878	10.144592084583511
chr3	WDR6	49008926	49009024	2419	99	137893	4997	135474	4898	24.434343434343436	27.659044507962435
chr3	WDR6	49011420	49011516	153	97	137893	4997	137740	4900	1.577319587628866	28.110204081632652
chr3	KLHDC8B	49175061	49175163	72	103	305	2082	233	1979	0.6990291262135923	0.11773623041940375
chr3	IHO1	49244403	49244452	0	50	7936	4346	7936	4296	0.0	1.8472998137802608
chr3	DAG1	49476848	49476905	0	58	5155	6735	5155	6677	0.0	0.7720533173580949
chr3	DAG1	49492822	49492973	0	152	5155	6735	5155	6583	0.0	0.7830776241835029
chr3	DAG1	49470964	49471049	0	86	5155	6735	5155	6649	0.0	0.7753045570762521
chr3	DAG1	49487253	49487415	0	163	5155	6735	5155	6572	0.0	0.784388314059647
chr3	DAG1	49476848	49476900	0	53	5155	6735	5155	6682	0.0	0.7714756061059563
chr3	DAG1	49488625	49488745	0	121	5155	6735	5155	6614	0.0	0.7794073178107046
chr3	DAG1	49492826	49492973	0	148	5155	6735	5155	6587	0.0	0.7826020950356763
chr3	APEH	49676055	49676219	0	165	2820	4242	2820	4077	0.0	0.6916850625459897
chr3	APEH	49676377	49676515	0	139	2820	4242	2820	4103	0.0	0.687301974165245
chr3	APEH	49675182	49675309	0	128	2820	4242	2820	4114	0.0	0.6854642683519689
chr3	APEH	49674488	49674621	0	134	2820	4242	2820	4108	0.0	0.6864654333008764
chr3	RNF123	49713737	49713825	17251	89	575779	6716	558528	6627	193.8314606741573	84.2806699864192
chr3	RBM6	50048244	50048319	65	76	56121	7225	56056	7149	0.8552631578947368	7.841096656875087
chr3	RBM6	49967197	49968748	687	1552	56121	7225	55434	5673	0.4426546391752577	9.771549444738234
chr3	RBM6	49999439	49999513	14	75	56121	7225	56107	7150	0.18666666666666668	7.847132867132867
chr3	RBM6	49967469	49968748	160	1280	56121	7225	55961	5945	0.125	9.413120269133726
chr3	RBM6	50060800	50060835	0	36	56121	7225	56121	7189	0.0	7.806509945750452
chr3	RBM5	50100531	50100605	72	75	76129	8339	76057	8264	0.96	9.2034123910939
chr3	RBM5	50104247	50104308	0	62	76129	8339	76129	8277	0.0	9.197656155611936
chr3	RBM5	50110378	50110463	2684	86	76129	8339	73445	8253	31.209302325581394	8.899188173997334
chr3	RBM5	50092978	50093042	128	65	76129	8339	76001	8274	1.9692307692307693	9.185520908871162
chr3	SEMA3F	50175095	50175188	0	94	33572	4840	33572	4746	0.0	7.073746312684365
chr3	SLC38A3	50207335	50207477	0	143	58564	3688	58564	3545	0.0	16.520169252468264
chr3	SLC38A3	50215385	50215459	175	75	58564	3688	58389	3613	2.3333333333333335	16.1608081926377
chr3	GNAI2	50251619	50251743	20	125	2124	6852	2104	6727	0.16	0.31276943659878104
chr3	GNAI2	50252099	50252142	0	44	2124	6852	2124	6808	0.0	0.3119858989424207
chr3	SEMA3B	50275301	50275459	0	159	36176	5099	36176	4940	0.0	7.323076923076923
chr3	CYB561D2	50352008	50352046	10	39	20931	1930	20921	1891	0.2564102564102564	11.063458487572714
chr3	HEMK1	50572114	50572208	0	95	25305	17946	25305	17851	0.0	1.4175676432692845
chr3	MAPKAPK3	50647122	50647203	14	82	32564	3892	32550	3810	0.17073170731707318	8.543307086614174
chr3	MANF	51386908	51387046	0	139	153	2143	153	2004	0.0	0.07634730538922156
chr3	RAD54L2	51630271	51630388	0	118	50906	11508	50906	11390	0.0	4.46935908691835
chr3	TEX264	51672340	51672392	672	53	55355	2470	54683	2417	12.679245283018869	22.624327678940837
chr3	TEX264	51684412	51684634	2244	223	55355	2470	53111	2247	10.062780269058296	23.63640409434802
chr3	TEX264	51672209	51672301	6799	93	55355	2470	48556	2377	73.10752688172043	20.42742953302482
chr3	TEX264	51674270	51674562	0	293	55355	2470	55355	2177	0.0	25.42719338539274
chr3	GRM2	51713963	51714121	4032	159	199821	4215	195789	4056	25.358490566037737	48.271449704142015
chr3	IQCF4P	51818208	51818471	0	264	0	1177	0	913	0.0	0.0
chr3	PARP3	51942929	51943046	0	118	0	2938	0	2820	0.0	0.0
chr3	ABHD14A-ACY1	51984046	51984158	0	113	22537	4173	22537	4060	0.0	5.5509852216748765
chr3	ABHD14A-ACY1	51985360	51985465	0	106	22537	4173	22537	4067	0.0	5.541431030243423
chr3	ABHD14A-ACY1	51985851	51985946	0	96	22537	4173	22537	4077	0.0	5.527839097375521
chr3	ABHD14A-ACY1	51986414	51986504	588	91	22537	4173	21949	4082	6.461538461538462	5.377021068103871
chr3	ABHD14A-ACY1	51977870	51978082	2127	213	22537	4173	20410	3960	9.985915492957746	5.154040404040404
chr3	ABHD14A-ACY1	51985206	51985271	0	66	22537	4173	22537	4107	0.0	5.48746043340638
chr3	ABHD14A-ACY1	51988523	51988603	756	81	22537	4173	21781	4092	9.333333333333334	5.322825024437928
chr3	ABHD14A-ACY1	51978258	51978374	0	117	22537	4173	22537	4056	0.0	5.556459566074951
chr3	ABHD14A-ACY1	51980392	51980628	209	237	22537	4173	22328	3936	0.8818565400843882	5.6727642276422765
chr3	ABHD14A-ACY1	51986987	51987196	3061	210	22537	4173	19476	3963	14.576190476190476	4.914458743376231
chr3	ABHD14A-ACY1	51984060	51984158	0	99	22537	4173	22537	4074	0.0	5.531909671084929
chr3	ABHD14A-ACY1	51985400	51985465	0	66	22537	4173	22537	4107	0.0	5.48746043340638
chr3	ALAS1	52208082	52208247	0	166	0	2548	0	2382	0.0	0.0
chr3	ALAS1	52198671	52198848	0	178	0	2548	0	2370	0.0	0.0
chr3	PPM1M	52246973	52247228	376	256	172785	3294	172409	3038	1.46875	56.75082290980909
chr3	PPM1M	52248636	52248700	0	65	172785	3294	172785	3229	0.0	53.510374729018274
chr3	GLYCTK	52291746	52291922	75	177	921265	4647	921190	4470	0.423728813559322	206.082774049217
chr3	GLYCTK	52290303	52290719	272476	417	921265	4647	648789	4230	653.4196642685852	153.37801418439716
chr3	GLYCTK	52291744	52291922	75	179	921265	4647	921190	4468	0.41899441340782123	206.17502238137868
chr3	DNAH1	52361660	52361766	0	107	39016	13950	39016	13843	0.0	2.8184642057357507
chr3	DNAH1	52389460	52389586	28	127	39016	13950	38988	13823	0.2204724409448819	2.820516530420314
chr3	DNAH1	52398031	52398162	1020	132	39016	13950	37996	13818	7.7272727272727275	2.7497467071935158
chr3	PHF7	52422221	52422338	2539	118	9997	2348	7458	2230	21.516949152542374	3.3443946188340807
chr3	PHF7	52422759	52422881	642	123	9997	2348	9355	2225	5.219512195121951	4.204494382022472
chr3	NISCH	52490074	52490231	0	158	125322	8309	125322	8151	0.0	15.375046006624954
chr3	NISCH	52480878	52481037	0	160	125322	8309	125322	8149	0.0	15.378819487053626
chr3	NISCH	52480878	52481109	0	232	125322	8309	125322	8077	0.0	15.515909372291693
chr3	STAB1	52523651	52523756	39052	106	788007	10045	748955	9939	368.41509433962267	75.35516651574605
chr3	GNL3	52686768	52686827	0	60	2570	3110	2570	3050	0.0	0.8426229508196721
chr3	ITIH3	52805807	52805840	0	34	44708	4810	44708	4776	0.0	9.360971524288107
chr3	PRKCD	53165103	53165215	0	113	22011	3643	22011	3530	0.0	6.235410764872522
chr3	PRKCD	53173492	53173608	0	117	22011	3643	22011	3526	0.0	6.242484401588202
chr3	PRKCD	53173526	53173608	0	83	22011	3643	22011	3560	0.0	6.182865168539326
chr3	CACNA1D	53732814	53732962	0	149	918	18895	918	18746	0.0	0.04897044702869945
chr3	CACNA1D	53761997	53762081	0	85	918	18895	918	18810	0.0	0.04880382775119617
chr3	CACNA1D	53802146	53802173	0	28	918	18895	918	18867	0.0	0.04865638416282398
chr3	CACNA1D	53718681	53718741	0	61	918	18895	918	18834	0.0	0.04874163746416056
chr3	CACNA1D	53769972	53770017	0	46	918	18895	918	18849	0.0	0.048702848957504374
chr3	CACNA1D	53762550	53762634	0	85	918	18895	918	18810	0.0	0.04880382775119617
chr3	CACNA1D	53710394	53710478	0	85	918	18895	918	18810	0.0	0.04880382775119617
chr3	CACNA1D	53732817	53732962	0	146	918	18895	918	18749	0.0	0.04896261133927143
chr3	CACNA1D	53770423	53770552	0	130	918	18895	918	18765	0.0	0.04892086330935252
chr3	IL17RB	53855293	53855341	0	49	710	3054	710	3005	0.0	0.23627287853577372
chr3	CACNA2D3	54503491	54503654	0	164	300	4759	300	4595	0.0	0.06528835690968444
chr3	CACNA2D3	54816852	54816870	0	19	300	4759	300	4740	0.0	0.06329113924050633
chr3	CACNA2D3	54879349	54879411	0	63	300	4759	300	4696	0.0	0.06388415672913117
chr3	CCDC66	56559568	56559594	0	27	7515	7437	7515	7410	0.0	1.01417004048583
chr3	CCDC66	56560861	56561012	0	152	7515	7437	7515	7285	0.0	1.0315717227179135
chr3	CCDC66	56571180	56571302	0	123	7515	7437	7515	7314	0.0	1.0274815422477441
chr3	CCDC66	56592969	56593101	984	133	7515	7437	6531	7304	7.398496240601504	0.8941675794085433
chr3	CCDC66	56565133	56565204	0	72	7515	7437	7515	7365	0.0	1.0203665987780042
chr3	CCDC66	56572336	56572428	0	93	7515	7437	7515	7344	0.0	1.0232843137254901
chr3	CCDC66	56561256	56561378	0	123	7515	7437	7515	7314	0.0	1.0274815422477441
chr3	APPL1	57238044	57238116	0	73	39243	7541	39243	7468	0.0	5.254820567755758
chr3	APPL1	57230713	57230767	0	55	39243	7541	39243	7486	0.0	5.242185412770505
chr3	ARF4-AS1	57600058	57600169	0	112	0	668	0	556	0.0	0.0
chr3	SLMAP	57871635	57871698	0	64	104029	15102	104029	15038	0.0	6.917741720973534
chr3	SLMAP	57907883	57908006	765	124	104029	15102	103264	14978	6.169354838709677	6.894378421685138
chr3	SLMAP	57896246	57896371	1326	126	104029	15102	102703	14976	10.523809523809524	6.8578392094017095
chr3	SLMAP	57909075	57909150	0	76	104029	15102	104029	15026	0.0	6.923266338346865
chr3	SLMAP	57922888	57923023	0	136	104029	15102	104029	14966	0.0	6.951022317252439
chr3	SLMAP	57925844	57925934	0	91	104029	15102	104029	15011	0.0	6.930184531343682
chr3	SLMAP	57864806	57864857	0	52	104029	15102	104029	15050	0.0	6.9122259136212625
chr3	SLMAP	57865241	57865292	0	52	104029	15102	104029	15050	0.0	6.9122259136212625
chr3	SLMAP	57908167	57908227	0	61	104029	15102	104029	15041	0.0	6.9163619440196795
chr3	SLMAP	57856559	57856648	0	90	104029	15102	104029	15012	0.0	6.929722888355982
chr3	SLMAP	57890040	57890100	0	61	104029	15102	104029	15041	0.0	6.9163619440196795
chr3	SLMAP	57820612	57820705	0	94	104029	15102	104029	15008	0.0	6.931569829424307
chr3	SLMAP	57883960	57884026	0	67	104029	15102	104029	15035	0.0	6.919122048553375
chr3	FLNB	58131926	58132019	196	94	581746	14001	581550	13907	2.0851063829787235	41.81707054001582
chr3	FLNB	58141857	58141929	780	73	581746	14001	580966	13928	10.684931506849315	41.71209075244113
chr3	FLNB	58150104	58150227	311	124	581746	14001	581435	13877	2.5080645161290325	41.89918570296174
chr3	FLNB	58141857	58141896	648	40	581746	14001	581098	13961	16.2	41.62294964544087
chr3	FLNB	58152707	58152854	1861	148	581746	14001	579885	13853	12.574324324324325	41.85988594528261
chr3	ABHD6	58249877	58249942	0	66	12346	2874	12346	2808	0.0	4.396723646723647
chr3	ABHD6	58258402	58258624	0	223	12346	2874	12346	2651	0.0	4.657110524330442
chr3	HTD2	58315721	58315819	50	99	9611	3707	9561	3608	0.5050505050505051	2.6499445676274944
chr3	HTD2	58310506	58310591	0	86	9611	3707	9611	3621	0.0	2.6542391604529136
chr3	PXK	58365873	58365924	0	52	468021	5376	468021	5324	0.0	87.90777610818932
chr3	PXK	58412900	58412963	0	64	468021	5376	468021	5312	0.0	88.10636295180723
chr3	PXK	58420535	58420568	0	34	468021	5376	468021	5342	0.0	87.6115687008611
chr3	PXK	58382513	58382700	0	188	468021	5376	468021	5188	0.0	90.21222050886662
chr3	PXK	58369430	58369478	355	49	468021	5376	467666	5327	7.244897959183674	87.7916275577248
chr3	PXK	58423460	58423494	0	35	468021	5376	468021	5341	0.0	87.62797228983337
chr3	KCTD6	58494152	58494408	0	257	0	3063	0	2806	0.0	0.0
chr3	KCTD6	58500310	58500403	0	94	0	3063	0	2969	0.0	0.0
chr3	CFAP20DC-AS1	58914872	58914931	0	60	276	3986	276	3926	0.0	0.07030056036678553
chr3	CFAP20DC-AS1	58866541	58866636	276	96	276	3986	0	3890	2.875	0.0
chr3	CFAP20DC-AS1	58970357	58970568	0	212	276	3986	276	3774	0.0	0.07313195548489666
chr3	AC126121.3	59090332	59090385	0	54	2845	3768	2845	3714	0.0	0.7660204631125471
chr3	AC126121.3	59071504	59071706	0	203	2845	3768	2845	3565	0.0	0.7980364656381487
chr3	PTPRG	62231224	62231311	0	88	28829	14657	28829	14569	0.0	1.978790582744183
chr3	C3ORF14	62319720	62319832	459	113	114112	4396	113653	4283	4.061946902654867	26.535839364931125
chr3	C3ORF14	62319282	62319411	10970	130	114112	4396	103142	4266	84.38461538461539	24.177684013127053
chr3	LINC00698	63122255	63122319	0	65	81	2757	81	2692	0.0	0.030089153046062408
chr3	LINC00698	62953706	62953780	0	75	81	2757	81	2682	0.0	0.030201342281879196
chr3	LINC00698	63102691	63102799	0	109	81	2757	81	2648	0.0	0.030589123867069485
chr3	SYNPR	63480831	63480956	0	126	0	4059	0	3933	0.0	0.0
chr3	SYNPR	63556542	63556741	0	200	0	4059	0	3859	0.0	0.0
chr3	SYNPR	63609124	63609316	0	193	0	4059	0	3866	0.0	0.0
chr3	SYNPR	63452072	63452115	0	44	0	4059	0	4015	0.0	0.0
chr3	SYNPR	63610473	63610553	0	81	0	4059	0	3978	0.0	0.0
chr3	SYNPR	63445543	63445576	0	34	0	4059	0	4025	0.0	0.0
chr3	SNTN	63663696	63663786	0	91	0	5141	0	5050	0.0	0.0
chr3	ATXN7	63864897	63864999	54	103	341953	14346	341899	14243	0.5242718446601942	24.00470406515481
chr3	ATXN7	63873748	63873846	0	99	341953	14346	341953	14247	0.0	24.0017547553871
chr3	ATXN7	63997620	63997687	84	68	341953	14346	341869	14278	1.2352941176470589	23.943759630200308
chr3	ADAMTS9-AS1	64582517	64582646	0	130	663	6303	663	6173	0.0	0.10740320751660457
chr3	ADAMTS9-AS1	64583272	64583511	0	240	663	6303	663	6063	0.0	0.10935180603661554
chr3	ADAMTS9-AS1	64568658	64569071	0	414	663	6303	663	5889	0.0	0.11258278145695365
chr3	ADAMTS9-AS1	64568658	64569059	0	402	663	6303	663	5901	0.0	0.11235383833248602
chr3	ADAMTS9-AS1	64565404	64565561	0	158	663	6303	663	6145	0.0	0.10789259560618389
chr3	ADAMTS9-AS1	64583965	64584101	0	137	663	6303	663	6166	0.0	0.10752513785274084
chr3	LINC02040	65188705	65188896	102	192	102	858	0	666	0.53125	0.0
chr3	SLC25A26	66236543	66236700	0	158	5005	5541	5005	5383	0.0	0.929778933680104
chr3	SLC25A26	66362859	66362929	0	71	5005	5541	5005	5470	0.0	0.9149908592321755
chr3	SLC25A26	66356030	66356084	64	55	5005	5541	4941	5486	1.1636363636363636	0.9006562158220927
chr3	SLC25A26	66371201	66371413	171	213	5005	5541	4834	5328	0.8028169014084507	0.9072822822822822
chr3	SLC25A26	66304452	66304537	0	86	5005	5541	5005	5455	0.0	0.9175068744271311
chr3	KBTBD8	66998980	66999191	0	212	0	4740	0	4528	0.0	0.0
chr3	SUCLG2-AS1	67670959	67671004	0	46	3165	11137	3165	11091	0.0	0.2853665133892345
chr3	SUCLG2-AS1	67670881	67671004	0	124	3165	11137	3165	11013	0.0	0.2873876327976028
chr3	SUCLG2-AS1	67669815	67669909	0	95	3165	11137	3165	11042	0.0	0.28663285636660024
chr3	SUCLG2-AS1	67670828	67671004	0	177	3165	11137	3165	10960	0.0	0.2887773722627737
chr3	SUCLG2-AS1	67693548	67693682	0	135	3165	11137	3165	11002	0.0	0.28767496818760224
chr3	AC109587.1	69029864	69029994	1678	131	5256	3711	3578	3580	12.80916030534351	0.9994413407821229
chr3	AC109587.1	69014137	69014201	0	65	5256	3711	5256	3646	0.0	1.4415798134942404
chr3	AC109587.1	69034974	69035150	0	177	5256	3711	5256	3534	0.0	1.4872665534804754
chr3	AC109587.1	69033849	69033956	0	108	5256	3711	5256	3603	0.0	1.4587843463780183
chr3	AC109587.1	69040374	69040457	45	84	5256	3711	5211	3627	0.5357142857142857	1.4367245657568237
chr3	ARL6IP5	69099971	69100069	836	99	156215	2213	155379	2114	8.444444444444445	73.5
chr3	ARL6IP5	69089811	69089960	0	150	156215	2213	156215	2063	0.0	75.72224915172079
chr3	SAMMSON	70084725	70084829	0	105	38635	15618	38635	15513	0.0	2.4904918455488945
chr3	SAMMSON	70065245	70065318	0	74	38635	15618	38635	15544	0.0	2.485524961399897
chr3	SAMMSON	70137595	70137667	0	73	38635	15618	38635	15545	0.0	2.485365069154069
chr3	SAMMSON	70009123	70009285	0	163	38635	15618	38635	15455	0.0	2.4998382400517634
chr3	AC105265.2	72061895	72061965	0	71	0	501	0	430	0.0	0.0
chr3	LINC00870	72159868	72160102	0	235	2856	8768	2856	8533	0.0	0.33470057424118127
chr3	PPP4R2	73047185	73047356	4707	172	8645	5957	3938	5785	27.36627906976744	0.6807260155574762
chr3	PPP4R2	73063672	73063747	0	76	8645	5957	8645	5881	0.0	1.4699880972623705
chr3	LINC02018	75436218	75436352	0	135	372	6501	372	6366	0.0	0.058435438265786996
chr3	LINC02018	75447086	75447296	0	211	372	6501	372	6290	0.0	0.059141494435612084
chr3	LINC02018	75451209	75451402	51	194	372	6501	321	6307	0.26288659793814434	0.05089583003012526
chr3	LINC02018	75439784	75439846	0	63	372	6501	372	6438	0.0	0.05778191985088537
chr3	LINC02018	75448357	75448476	0	120	372	6501	372	6381	0.0	0.05829807240244476
chr3	LINC02018	75437249	75437275	0	27	372	6501	372	6474	0.0	0.057460611677479144
chr3	LINC02018	75446467	75446535	0	69	372	6501	372	6432	0.0	0.05783582089552239
chr3	LINC02018	75451068	75451402	51	335	372	6501	321	6166	0.15223880597014924	0.0520596821277976
chr3	LINC02018	75436130	75436352	0	223	372	6501	372	6278	0.0	0.05925453966231284
chr3	LINC02018	75436162	75436352	0	191	372	6501	372	6310	0.0	0.0589540412044374
chr3	LINC02018	75437103	75437275	0	173	372	6501	372	6328	0.0	0.058786346396965866
chr3	LINC02018	75451379	75451402	0	24	372	6501	372	6477	0.0	0.05743399722093562
chr3	LINC02018	75437055	75437275	0	221	372	6501	372	6280	0.0	0.05923566878980892
chr3	LINC02018	75439753	75439846	0	94	372	6501	372	6407	0.0	0.058061495239581706
chr3	LINC00960	75673846	75674006	2803	161	9398	6551	6595	6390	17.40993788819876	1.0320813771517996
chr3	LINC00960	75675967	75676128	978	162	9398	6551	8420	6389	6.037037037037037	1.3178901236500236
chr3	LINC00960	75673193	75673238	0	46	9398	6551	9398	6505	0.0	1.4447348193697156
chr3	ROBO2	77527402	77527414	0	13	51	13345	51	13332	0.0	0.003825382538253825
chr3	ROBO2	77632473	77632656	0	184	51	13345	51	13161	0.0	0.0038750854798267607
chr3	ROBO2	77564449	77564588	0	140	51	13345	51	13205	0.0	0.0038621734191594094
chr3	ROBO2	77602934	77603060	0	127	51	13345	51	13218	0.0	0.003858374943259192
chr3	ROBO2	77642670	77642943	0	274	51	13345	51	13071	0.0	0.0039017672710580675
chr3	AC117461.1	79438821	79438931	0	111	0	2074	0	1963	0.0	0.0
chr3	AC117461.1	79432116	79432236	0	121	0	2074	0	1953	0.0	0.0
chr3	LINC02050	80784040	80784117	0	78	0	1266	0	1188	0.0	0.0
chr3	LINC02050	80771369	80771470	0	102	0	1266	0	1164	0.0	0.0
chr3	LINC02050	80780092	80780245	0	154	0	1266	0	1112	0.0	0.0
chr3	LINC02027	81045363	81045462	0	100	0	3715	0	3615	0.0	0.0
chr3	LINC02027	81094632	81094764	0	133	0	3715	0	3582	0.0	0.0
chr3	LINC02027	81041615	81041679	0	65	0	3715	0	3650	0.0	0.0
chr3	AC129807.1	81857089	81857231	0	143	74	2464	74	2321	0.0	0.03188280913399397
chr3	AC129807.1	81859673	81859849	0	177	74	2464	74	2287	0.0	0.03235679930039353
chr3	AC129807.1	81921573	81921733	0	161	74	2464	74	2303	0.0	0.03213200173686496
chr3	AC129807.1	81851114	81851178	0	65	74	2464	74	2399	0.0	0.030846185910796166
chr3	AC129807.1	81860424	81860534	74	111	74	2464	0	2353	0.6666666666666666	0.0
chr3	AC129807.1	81921670	81921733	0	64	74	2464	74	2400	0.0	0.030833333333333334
chr3	LINC02008	82042724	82042790	0	67	0	4761	0	4694	0.0	0.0
chr3	LINC02008	82058927	82059052	0	126	0	4761	0	4635	0.0	0.0
chr3	LINC02008	82070812	82070866	0	55	0	4761	0	4706	0.0	0.0
chr3	LINC02008	82204463	82204642	0	180	0	4761	0	4581	0.0	0.0
chr3	CADM2	85726521	85726548	0	28	255	9898	255	9870	0.0	0.025835866261398176
chr3	CADM2	85979163	85979283	0	121	255	9898	255	9777	0.0	0.026081620128873887
chr3	LINC00506	87136184	87136324	0	141	2322	9734	2322	9593	0.0	0.24205149588241426
chr3	CHMP2B	87240698	87240790	0	93	0	8249	0	8156	0.0	0.0
chr3	CHMP2B	87240322	87240453	0	132	0	8249	0	8117	0.0	0.0
chr3	CHMP2B	87240326	87240453	0	128	0	8249	0	8121	0.0	0.0
chr3	ARL13B	94003658	94003908	0	251	0	4021	0	3770	0.0	0.0
chr3	ARL13B	93995873	93995944	0	72	0	4021	0	3949	0.0	0.0
chr3	ARL13B	93996562	93996684	0	123	0	4021	0	3898	0.0	0.0
chr3	ARL13B	93995877	93995944	0	68	0	4021	0	3953	0.0	0.0
chr3	ARL13B	94035330	94035436	0	107	0	4021	0	3914	0.0	0.0
chr3	LINC00879	94971270	94971354	0	85	51	6020	51	5935	0.0	0.008593091828138163
chr3	LINC00879	94962898	94963096	0	199	51	6020	51	5821	0.0	0.008761381205978355
chr3	LINC00879	94962931	94963096	0	166	51	6020	51	5854	0.0	0.008711991800478306
chr3	LINC00879	94962936	94963096	0	161	51	6020	51	5859	0.0	0.008704557091653867
chr3	LINC00879	94962931	94963006	0	76	51	6020	51	5944	0.0	0.008580080753701211
chr3	LINC00879	94969669	94969797	0	129	51	6020	51	5891	0.0	0.00865727380750297
chr3	LINC00879	95024514	95024636	0	123	51	6020	51	5897	0.0	0.008648465321349838
chr3	LINC00879	95088157	95088294	0	138	51	6020	51	5882	0.0	0.008670520231213872
chr3	LINC00879	94938640	94938675	0	36	51	6020	51	5984	0.0	0.008522727272727272
chr3	LINC00879	94960979	94961030	0	52	51	6020	51	5968	0.0	0.008545576407506703
chr3	LINC00879	94980369	94980539	0	171	51	6020	51	5849	0.0	0.008719439220379552
chr3	LINC00879	94962901	94963096	0	196	51	6020	51	5824	0.0	0.008756868131868132
chr3	LINC00879	95047261	95047427	0	167	51	6020	51	5853	0.0	0.008713480266529985
chr3	LINC00879	95097590	95097658	0	69	51	6020	51	5951	0.0	0.008569988237271047
chr3	EPHA6	97592611	97592737	297	127	537	6325	240	6198	2.338582677165354	0.03872216844143272
chr3	EPHA6	97466418	97466482	0	65	537	6325	537	6260	0.0	0.08578274760383386
chr3	EPHA6	97606159	97606248	0	90	537	6325	537	6235	0.0	0.08612670408981556
chr3	EPHA6	97745358	97745563	0	206	537	6325	537	6119	0.0	0.08775943781663671
chr3	EPHA6	97646118	97646310	0	193	537	6325	537	6132	0.0	0.087573385518591
chr3	EPHA6	97612377	97612475	0	99	537	6325	537	6226	0.0	0.08625120462576293
chr3	EPHA6	97447717	97447833	0	117	537	6325	537	6208	0.0	0.08650128865979381
chr3	ARL6	97765990	97766089	0	100	0	2345	0	2245	0.0	0.0
chr3	ARL6	97791770	97791826	0	57	0	2345	0	2288	0.0	0.0
chr3	ARL6	97766631	97766690	0	60	0	2345	0	2285	0.0	0.0
chr3	ARL6	97791952	97791965	0	14	0	2345	0	2331	0.0	0.0
chr3	ST3GAL6	98756368	98756540	0	173	0	6312	0	6139	0.0	0.0
chr3	ST3GAL6	98768429	98768529	0	101	0	6312	0	6211	0.0	0.0
chr3	ST3GAL6	98771120	98771190	0	71	0	6312	0	6241	0.0	0.0
chr3	ST3GAL6	98773919	98773983	0	65	0	6312	0	6247	0.0	0.0
chr3	ST3GAL6	98784944	98785040	0	97	0	6312	0	6215	0.0	0.0
chr3	COL8A1	99675659	99675721	0	63	738	9418	738	9355	0.0	0.07888829502939604
chr3	COL8A1	99691398	99691568	0	171	738	9418	738	9247	0.0	0.07980966800043257
chr3	CMSS1	100051231	100051306	0	76	10171	7224	10171	7148	0.0	1.4229155008393957
chr3	CMSS1	100141529	100141645	0	117	10171	7224	10171	7107	0.0	1.431124243703391
chr3	TBC1D23	100283606	100283811	0	206	4791	5196	4791	4990	0.0	0.9601202404809619
chr3	TBC1D23	100311832	100311877	0	46	4791	5196	4791	5150	0.0	0.9302912621359223
chr3	NIT2	100345584	100345678	0	95	51	9224	51	9129	0.0	0.00558659217877095
chr3	TMEM45A	100519532	100519608	58	77	21451	5900	21393	5823	0.7532467532467533	3.6738794435857804
chr3	TFG	100747413	100747454	0	42	2007	6506	2007	6464	0.0	0.3104888613861386
chr3	TFG	100747360	100747454	0	95	2007	6506	2007	6411	0.0	0.3130556855404773
chr3	TFG	100742155	100742200	0	46	2007	6506	2007	6460	0.0	0.3106811145510836
chr3	TFG	100747245	100747308	0	64	2007	6506	2007	6442	0.0	0.3115492083203974
chr3	TFG	100731741	100731895	0	155	2007	6506	2007	6351	0.0	0.3160132262635805
chr3	TFG	100710970	100711068	1665	99	2007	6506	342	6407	16.818181818181817	0.05337911659122834
chr3	TFG	100739360	100739485	0	126	2007	6506	2007	6380	0.0	0.314576802507837
chr3	PCNP	101579789	101580004	4109	216	49318	3051	45209	2835	19.02314814814815	15.94673721340388
chr3	PCNP	101579588	101580004	27544	417	49318	3051	21774	2634	66.05275779376498	8.266514806378131
chr3	PCNP	101579841	101580004	402	164	49318	3051	48916	2887	2.451219512195122	16.943540006927606
chr3	PCNP	101585436	101585511	0	76	49318	3051	49318	2975	0.0	16.57747899159664
chr3	CEP97	101728835	101728937	0	103	1667	8894	1667	8791	0.0	0.18962575361164827
chr3	CEP97	101728813	101728937	0	125	1667	8894	1667	8769	0.0	0.19010149389896225
chr3	CEP97	101763108	101763186	0	79	1667	8894	1667	8815	0.0	0.18910947249007373
chr3	NXPE3	101779733	101779900	0	168	0	9079	0	8911	0.0	0.0
chr3	NXPE3	101779733	101779934	0	202	0	9079	0	8877	0.0	0.0
chr3	NFKBIZ	101848891	101849917	0	1027	0	5643	0	4616	0.0	0.0
chr3	NFKBIZ	101857072	101857183	0	112	0	5643	0	5531	0.0	0.0
chr3	NFKBIZ	101829612	101829688	0	77	0	5643	0	5566	0.0	0.0
chr3	ZPLD1	102436859	102436973	0	115	120	5153	120	5038	0.0	0.023818975784041286
chr3	ALCAM	105552143	105552182	0	40	156	6612	156	6572	0.0	0.023737066342057214
chr3	DUBR	107246007	107248831	0	2825	4208	13361	4208	10536	0.0	0.39939255884586183
chr3	DUBR	107247063	107247088	0	26	4208	13361	4208	13335	0.0	0.3155605549306337
chr3	DUBR	107246007	107246052	0	46	4208	13361	4208	13315	0.0	0.3160345475028164
chr3	DUBR	107246007	107246137	0	131	4208	13361	4208	13230	0.0	0.3180650037792895
chr3	DUBR	107248577	107248831	0	255	4208	13361	4208	13106	0.0	0.3210743171066687
chr3	DUBR	107325606	107325691	0	86	4208	13361	4208	13275	0.0	0.31698681732580036
chr3	DUBR	107285319	107285531	0	213	4208	13361	4208	13148	0.0	0.3200486766048068
chr3	DUBR	107246007	107247088	0	1082	4208	13361	4208	12279	0.0	0.34269891684990633
chr3	DUBR	107246994	107247088	0	95	4208	13361	4208	13266	0.0	0.3172018694406754
chr3	DUBR	107245137	107245218	1033	82	4208	13361	3175	13279	12.597560975609756	0.2390993297688079
chr3	DUBR	107246007	107246209	0	203	4208	13361	4208	13158	0.0	0.31980544155646756
chr3	DUBR	107285319	107286177	0	859	4208	13361	4208	12502	0.0	0.3365861462166053
chr3	DUBR	107286014	107286177	0	164	4208	13361	4208	13197	0.0	0.31886034704857164
chr3	LINC01990	107433064	107433203	0	140	5151	1872	5151	1732	0.0	2.974018475750577
chr3	LINC01990	107460672	107460790	0	119	5151	1872	5151	1753	0.0	2.9383913291500283
chr3	LINC01990	107461187	107461390	0	204	5151	1872	5151	1668	0.0	3.088129496402878
chr3	BBX	107772627	107773636	33689	1010	182956	11767	149267	10757	33.355445544554456	13.876266617086548
chr3	BBX	107791239	107791299	0	61	182956	11767	182956	11706	0.0	15.629249957286861
chr3	BBX	107661827	107661944	0	118	182956	11767	182956	11649	0.0	15.705725813374539
chr3	BBX	107789786	107789876	0	91	182956	11767	182956	11676	0.0	15.669407331277835
chr3	BBX	107711274	107711364	0	91	182956	11767	182956	11676	0.0	15.669407331277835
chr3	BBX	107657061	107657172	0	112	182956	11767	182956	11655	0.0	15.697640497640498
chr3	BBX	107677426	107677470	0	45	182956	11767	182956	11722	0.0	15.607916737758062
chr3	BBX	107659567	107659770	0	204	182956	11767	182956	11563	0.0	15.822537403787944
chr3	HHLA2	108310654	108310741	0	88	1867	2940	1867	2852	0.0	0.6546283309957924
chr3	HHLA2	108328269	108328347	0	79	1867	2940	1867	2861	0.0	0.6525690318070605
chr3	HHLA2	108351787	108351877	123	91	1867	2940	1744	2849	1.3516483516483517	0.6121446121446121
chr3	HHLA2	108375749	108375800	0	52	1867	2940	1867	2888	0.0	0.6464681440443213
chr3	HHLA2	108302655	108302794	510	140	1867	2940	1357	2800	3.642857142857143	0.48464285714285715
chr3	DZIP3	108605334	108605438	0	105	58	6978	58	6873	0.0	0.008438818565400843
chr3	DZIP3	108686444	108686584	0	141	58	6978	58	6837	0.0	0.008483252888693872
chr3	DZIP3	108603018	108603234	0	217	58	6978	58	6761	0.0	0.008578612631267564
chr3	TRAT1	108830669	108830780	0	112	0	2462	0	2350	0.0	0.0
chr3	TRAT1	108838933	108838967	0	35	0	2462	0	2427	0.0	0.0
chr3	C3ORF85	109148252	109148386	0	135	0	2477	0	2342	0.0	0.0
chr3	LINC01205	109459882	109459928	0	47	263	6613	263	6566	0.0	0.04005482790130978
chr3	LINC01205	109562231	109562259	0	29	263	6613	263	6584	0.0	0.0399453219927096
chr3	NECTIN3	111118655	111118952	0	298	0	7708	0	7410	0.0	0.0
chr3	CD96	111577501	111577549	392	49	20730	5571	20338	5522	8.0	3.6830858384643244
chr3	PLCXD2	111732618	111732703	0	86	10151	8983	10151	8897	0.0	1.1409463864223897
chr3	PHLDB2	111932268	111932397	0	130	467	12336	467	12206	0.0	0.038259872194002946
chr3	PHLDB2	111949701	111949890	0	190	467	12336	467	12146	0.0	0.038448872056644164
chr3	PHLDB2	111958274	111958295	0	22	467	12336	467	12314	0.0	0.037924313789183046
chr3	PHLDB2	111957235	111957250	0	16	467	12336	467	12320	0.0	0.03790584415584416
chr3	PHLDB2	111960144	111960180	0	37	467	12336	467	12299	0.0	0.03797056671274087
chr3	ABHD10	111986263	111986375	0	113	0	3032	0	2919	0.0	0.0
chr3	ABHD10	111981783	111981967	0	185	0	3032	0	2847	0.0	0.0
chr3	ABHD10	111990699	111990751	0	53	0	3032	0	2979	0.0	0.0
chr3	TAGLN3	112011762	112011865	0	104	51	1722	51	1618	0.0	0.0315203955500618
chr3	TMPRSS7	112046973	112047012	0	40	33801	3071	33801	3031	0.0	11.151765094028374
chr3	TMPRSS7	112047407	112047520	0	114	33801	3071	33801	2957	0.0	11.430842069665202
chr3	CD200	112340901	112340983	0	83	3877	2999	3877	2916	0.0	1.3295610425240054
chr3	CD200	112335942	112336017	0	76	3877	2999	3877	2923	0.0	1.3263770099213137
chr3	SLC35A5	112570539	112570670	0	132	0	4736	0	4604	0.0	0.0
chr3	GTPBP8	112993025	112993124	0	100	510	3804	510	3704	0.0	0.1376889848812095
chr3	GTPBP8	112995134	112995265	0	132	510	3804	510	3672	0.0	0.1388888888888889
chr3	GTPBP8	112995136	112995265	0	130	510	3804	510	3674	0.0	0.13881328252585737
chr3	AC078785.1	113061786	113062010	0	225	1275	6852	1275	6627	0.0	0.1923947487550928
chr3	BOC	113285371	113285565	0	195	1479	8933	1479	8738	0.0	0.16926070038910507
chr3	BOC	113285438	113285565	0	128	1479	8933	1479	8805	0.0	0.16797274275979557
chr3	SIDT1	113607040	113607114	1450	75	19596	7503	18146	7428	19.333333333333332	2.4429186860527734
chr3	SIDT1	113615062	113615077	0	16	19596	7503	19596	7487	0.0	2.6173367169760917
chr3	ATP6V1A	113780731	113780783	0	53	40516	5135	40516	5082	0.0	7.972451790633609
chr3	GRAMD1C	113876164	113876260	0	97	0	5906	0	5809	0.0	0.0
chr3	GRAMD1C	113844502	113844649	0	148	0	5906	0	5758	0.0	0.0
chr3	QTRT2	114067986	114068063	0	78	531	8066	531	7988	0.0	0.06647471206810215
chr3	QTRT2	114070625	114070838	75	214	531	8066	456	7852	0.35046728971962615	0.058074375955170655
chr3	QTRT2	114056998	114057106	0	109	531	8066	531	7957	0.0	0.06673369360311675
chr3	QTRT2	114082962	114083003	0	42	531	8066	531	8024	0.0	0.0661764705882353
chr3	ZBTB20-AS1	114366695	114366881	0	187	12	5834	12	5647	0.0	0.0021250221356472463
chr3	ZBTB20-AS1	114357167	114357227	0	61	12	5834	12	5773	0.0	0.0020786419539234368
chr3	ZBTB20-AS1	114359348	114359508	0	161	12	5834	12	5673	0.0	0.0021152829190904283
chr3	ZBTB20-AS1	114367131	114367221	0	91	12	5834	12	5743	0.0	0.0020895002611875328
chr3	ZBTB20-AS1	114367134	114367221	0	88	12	5834	12	5746	0.0	0.002088409328228333
chr3	ZBTB20-AS1	114387670	114387775	12	106	12	5834	0	5728	0.11320754716981132	0.0
chr3	ZBTB20-AS1	114375793	114375836	0	44	12	5834	12	5790	0.0	0.002072538860103627
chr3	AC026341.1	115190887	115191009	0	123	0	4777	0	4654	0.0	0.0
chr3	AC026341.1	115205240	115205317	0	78	0	4777	0	4699	0.0	0.0
chr3	GAP43	115663520	115663916	0	397	0	1905	0	1508	0.0	0.0
chr3	TUSC7	116710203	116710421	0	219	51	2806	51	2587	0.0	0.019713954387321223
chr3	AC092691.3	117790622	117790847	0	226	0	1974	0	1748	0.0	0.0
chr3	IGSF11-AS1	118945867	118946035	7789	169	13521	1608	5732	1439	46.0887573964497	3.9833217512161223
chr3	TEX55	119148179	119148323	138	145	5481	1965	5343	1820	0.9517241379310345	2.9357142857142855
chr3	UPK1B	119186713	119186810	103	98	22416	2265	22313	2167	1.0510204081632653	10.29672358098754
chr3	UPK1B	119175997	119176109	0	113	22416	2265	22416	2152	0.0	10.41635687732342
chr3	UPK1B	119186678	119186810	103	133	22416	2265	22313	2132	0.7744360902255639	10.465759849906192
chr3	POGLUT1	119478333	119478474	0	142	840	4635	840	4493	0.0	0.1869574894279991
chr3	TIMMDC1	119500694	119500860	0	167	102	2722	102	2555	0.0	0.039921722113502936
chr3	TIMMDC1	119503531	119503620	0	90	102	2722	102	2632	0.0	0.03875379939209726
chr3	TIMMDC1	119513640	119513719	0	80	102	2722	102	2642	0.0	0.03860711582134747
chr3	TIMMDC1	119503953	119504021	0	69	102	2722	102	2653	0.0	0.038447041085563516
chr3	ADPRH	119580484	119580636	0	153	14329	4454	14329	4301	0.0	3.3315508021390374
chr3	ADPRH	119582133	119582467	13768	335	14329	4454	561	4119	41.09850746268657	0.13619810633648943
chr3	ADPRH	119580550	119580636	0	87	14329	4454	14329	4367	0.0	3.2811999084039387
chr3	PLA1A	119606773	119606975	0	203	51	2183	51	1980	0.0	0.025757575757575757
chr3	AC023494.1	119668260	119668316	0	57	0	939	0	882	0.0	0.0
chr3	CFAP91	119706808	119706885	0	78	4649	6291	4649	6213	0.0	0.7482697569612103
chr3	CFAP91	119707403	119707561	0	159	4649	6291	4649	6132	0.0	0.7581539465101109
chr3	NDUFB4	120601110	120601257	0	148	0	1312	0	1164	0.0	0.0
chr3	GTF2E1	120749744	120749951	0	208	0	3376	0	3168	0.0	0.0
chr3	GTF2E1	120749847	120749951	0	105	0	3376	0	3271	0.0	0.0
chr3	GTF2E1	120750522	120751000	0	479	0	3376	0	2897	0.0	0.0
chr3	STXBP5L	121282265	121282337	0	73	6898	11115	6898	11042	0.0	0.6247056692628147
chr3	STXBP5L	121378715	121378886	0	172	6898	11115	6898	10943	0.0	0.6303573060403911
chr3	STXBP5L	121324492	121324585	0	94	6898	11115	6898	11021	0.0	0.6258960166953997
chr3	EAF2	121854686	121854823	0	138	0	1780	0	1642	0.0	0.0
chr3	EAF2	121836644	121836794	0	151	0	1780	0	1629	0.0	0.0
chr3	SLC15A2	121911573	121911666	0	94	0	5879	0	5785	0.0	0.0
chr3	CD86	122091600	122091650	36	51	5610	3432	5574	3381	0.7058823529411765	1.6486246672582077
chr3	CD86	122103511	122103847	0	337	5610	3432	5610	3095	0.0	1.812600969305331
chr3	CD86	122109264	122109408	0	145	5610	3432	5610	3287	0.0	1.7067234560389413
chr3	CASR	122275811	122276042	1506	232	381462	12030	379956	11798	6.491379310344827	32.20511951178166
chr3	FAM162A	122401375	122401535	816	161	15547	3799	14731	3638	5.068322981366459	4.049202858713579
chr3	DTX3L	122568488	122570024	867	1537	20228	5773	19361	4236	0.5640858815875082	4.5705854579792256
chr3	PARP15	122626826	122627033	0	208	8123	5496	8123	5288	0.0	1.5361195158850227
chr3	PARP14	122692300	122692543	0	244	74	9853	74	9609	0.0	0.007701113539390155
chr3	PARP14	122699389	122701635	0	2247	74	9853	74	7606	0.0	0.009729161188535366
chr3	SLC49A4	122806856	122806950	0	95	319328	3331	319328	3236	0.0	98.67985166872683
chr3	PDIA5	123130479	123130616	0	138	1888	3918	1888	3780	0.0	0.49947089947089945
chr3	SEC22A	123204715	123204813	0	99	1888	4714	1888	4615	0.0	0.40910075839653304
chr3	SEC22A	123204715	123204784	0	70	1888	4714	1888	4644	0.0	0.40654608096468564
chr3	KALRN	124637207	124637303	0	97	54659	24411	54659	24314	0.0	2.248046393024595
chr3	UMPS	124731505	124731604	5406	100	25440	7521	20034	7421	54.06	2.6996361676323946
chr3	UMPS	124735092	124735246	0	155	25440	7521	25440	7366	0.0	3.4537062177572633
chr3	FAM86JP	125918863	125918926	0	64	0	2527	0	2463	0.0	0.0
chr3	FAM86JP	125924965	125925115	0	151	0	2527	0	2376	0.0	0.0
chr3	ROPN1B	125971116	125971162	0	47	0	3137	0	3090	0.0	0.0
chr3	ROPN1B	125970038	125970151	0	114	0	3137	0	3023	0.0	0.0
chr3	AC079848.2	126215417	126215697	0	281	0	3126	0	2845	0.0	0.0
chr3	AC079848.2	126246463	126246617	0	155	0	3126	0	2971	0.0	0.0
chr3	AC079848.2	126245401	126245475	0	75	0	3126	0	3051	0.0	0.0
chr3	AC016924.1	126288012	126288123	0	112	4692	5692	4692	5580	0.0	0.8408602150537634
chr3	NUP210P1	126666220	126666301	0	82	2005	1202	2005	1120	0.0	1.7901785714285714
chr3	CHCHD6	126780339	126780430	0	92	28679	2771	28679	2679	0.0	10.705113848450914
chr3	MCM2	127617968	127618081	0	114	72	4732	72	4618	0.0	0.015591165006496318
chr3	MCM2	127610778	127610985	0	208	72	4732	72	4524	0.0	0.015915119363395226
chr3	ABTB1	127679572	127679679	0	108	816	3340	816	3232	0.0	0.2524752475247525
chr3	KBTBD12	127922949	127924131	0	1183	1275	5361	1275	4178	0.0	0.3051699377692676
chr3	KBTBD12	127927763	127928034	969	272	1275	5361	306	5089	3.5625	0.06012969149145215
chr3	SEC61A1	128052834	128052902	0	69	60053	4631	60053	4562	0.0	13.16374397194213
chr3	EEFSEC	128264616	128264781	0	166	44367	2402	44367	2236	0.0	19.842128801431127
chr3	EEFSEC	128358216	128358373	0	158	44367	2402	44367	2244	0.0	19.77139037433155
chr3	EEFSEC	128262127	128262224	0	98	44367	2402	44367	2304	0.0	19.256510416666668
chr3	RAB7A	128806371	128806590	7963	220	20331	6281	12368	6061	36.195454545454545	2.0405873618214816
chr3	RAB7A	128795359	128795420	0	62	20331	6281	20331	6219	0.0	3.26917510853835
chr3	RAB7A	128811145	128811257	102	113	20331	6281	20229	6168	0.9026548672566371	3.279669260700389
chr3	RAB7A	128788913	128789070	0	158	20331	6281	20331	6123	0.0	3.320431161195492
chr3	RAB7A	128806371	128806449	967	79	20331	6281	19364	6202	12.240506329113924	3.1222186391486617
chr3	RAB7A	128807542	128807671	1170	130	20331	6281	19161	6151	9.0	3.1151032352463015
chr3	RAB7A	128799271	128799430	0	160	20331	6281	20331	6121	0.0	3.321516092141807
chr3	ACAD9	128884656	128884746	0	91	49134	4320	49134	4229	0.0	11.618349491605581
chr3	ACAD9	128884674	128884746	0	73	49134	4320	49134	4247	0.0	11.569107605368496
chr3	ACAD9	128884652	128884746	0	95	49134	4320	49134	4225	0.0	11.629349112426036
chr3	COPG1	129274063	129274136	51	74	3618	4374	3567	4300	0.6891891891891891	0.8295348837209302
chr3	HMCES	129290678	129290804	0	127	4774	2754	4774	2627	0.0	1.8172820708031976
chr3	HMCES	129288853	129288997	0	145	4774	2754	4774	2609	0.0	1.829819854350326
chr3	H1-10-AS1	129323889	129323997	0	109	4528	3254	4528	3145	0.0	1.4397456279809222
chr3	IFT122	129456113	129456264	0	152	2034	9056	2034	8904	0.0	0.2284366576819407
chr3	IFT122	129461227	129461304	0	78	2034	9056	2034	8978	0.0	0.22655379817331253
chr3	IFT122	129466889	129467066	0	178	2034	9056	2034	8878	0.0	0.22910565442667266
chr3	IFT122	129492140	129492194	0	55	2034	9056	2034	9001	0.0	0.22597489167870236
chr3	IFT122	129495445	129495607	255	163	2034	9056	1779	8893	1.5644171779141105	0.20004497919712133
chr3	IFT122	129464634	129464781	0	148	2034	9056	2034	8908	0.0	0.22833408172429276
chr3	IFT122	129451913	129451998	0	86	2034	9056	2034	8970	0.0	0.22675585284280936
chr3	IFT122	129458598	129458677	0	80	2034	9056	2034	8976	0.0	0.2266042780748663
chr3	IFT122	129460853	129461006	0	154	2034	9056	2034	8902	0.0	0.22848798022916197
chr3	IFT122	129459314	129459451	0	138	2034	9056	2034	8918	0.0	0.22807804440457502
chr3	IFT122	129457921	129458015	0	95	2034	9056	2034	8961	0.0	0.22698359558085035
chr3	IFT122	129463559	129463626	186	68	2034	9056	1848	8988	2.735294117647059	0.205607476635514
chr3	LINC02021	130116836	130117092	8	257	48	4061	40	3804	0.0311284046692607	0.010515247108307046
chr3	LINC02021	130150380	130150484	0	105	48	4061	48	3956	0.0	0.012133468149646108
chr3	COL6A4P2	130231445	130231508	0	64	255	3954	255	3890	0.0	0.06555269922879177
chr3	COL6A4P2	130247036	130247072	0	37	255	3954	255	3917	0.0	0.06510084248149094
chr3	COL6A4P2	130248616	130248751	0	136	255	3954	255	3818	0.0	0.06678889470927186
chr3	COL6A5	130477036	130477139	0	104	26922	9473	26922	9369	0.0	2.8735190521934038
chr3	COL6A5	130471681	130471926	0	246	26922	9473	26922	9227	0.0	2.9177414110761895
chr3	COL6A6	130649068	130649562	20344	495	25788	9757	5444	9262	41.0989898989899	0.5877780177067587
chr3	COL6A6	130589973	130590036	0	64	25788	9757	25788	9693	0.0	2.6604766326214793
chr3	ATP2C1	130932021	130932138	0	118	302	8544	302	8426	0.0	0.035841443152148114
chr3	ATP2C1	130979248	130979419	0	172	302	8544	302	8372	0.0	0.03607262302914477
chr3	ATP2C1	131001219	131001344	0	126	302	8544	302	8418	0.0	0.035875504870515565
chr3	ATP2C1	131001219	131001314	0	96	302	8544	302	8448	0.0	0.035748106060606064
chr3	ATP2C1	130894707	130894775	0	69	302	8544	302	8475	0.0	0.03563421828908554
chr3	ATP2C1	130894589	130894775	0	187	302	8544	302	8357	0.0	0.03613736986957042
chr3	ATP2C1	130894730	130894775	0	46	302	8544	302	8498	0.0	0.03553777359378677
chr3	NEK11	131080422	131080588	0	167	1109	5196	1109	5029	0.0	0.22052097832571088
chr3	NEK11	131168829	131168937	0	109	1109	5196	1109	5087	0.0	0.21800668370355808
chr3	NEK11	131273477	131273574	0	98	1109	5196	1109	5098	0.0	0.21753628874068262
chr3	NEK11	131027929	131028002	0	74	1109	5196	1109	5122	0.0	0.21651698555251855
chr3	NEK11	131133276	131133355	0	80	1109	5196	1109	5116	0.0	0.21677091477716967
chr3	AC107027.1	131508780	131508901	0	122	0	1234	0	1112	0.0	0.0
chr3	AC107027.1	131518561	131518668	0	108	0	1234	0	1126	0.0	0.0
chr3	ACP3	132337455	132337554	10158	100	19600	2760	9442	2660	101.58	3.549624060150376
chr3	ACP3	132331646	132331733	70	88	19600	2760	19530	2672	0.7954545454545454	7.309131736526946
chr3	DNAJC13	132484362	132484488	51	127	3886	9689	3835	9562	0.4015748031496063	0.40106672244300356
chr3	DNAJC13	132484362	132484493	51	132	3886	9689	3835	9557	0.38636363636363635	0.4012765512190018
chr3	DNAJC13	132537157	132537266	0	110	3886	9689	3886	9579	0.0	0.40567908967533145
chr3	UBA5	132675816	132675923	0	108	173	7275	173	7167	0.0	0.02413841216687596
chr3	UBA5	132660898	132661048	0	151	173	7275	173	7124	0.0	0.02428411005053341
chr3	NPHP3-AS1	132726360	132726426	0	67	204	5228	204	5161	0.0	0.039527223406316606
chr3	TMEM108	133379751	133381161	9959	1411	10748	8388	789	6977	7.058114812189936	0.11308585351870432
chr3	TMEM108	133378341	133378556	51	216	10748	8388	10697	8172	0.2361111111111111	1.3089818893783651
chr3	TMEM108	133074314	133074358	0	45	10748	8388	10748	8343	0.0	1.2882656118902074
chr3	TMEM108	133303203	133303337	330	135	10748	8388	10418	8253	2.4444444444444446	1.2623288501151098
chr3	TF	133748411	133748584	339	174	5952	22311	5613	22137	1.9482758620689655	0.2535573926006234
chr3	TF	133748411	133748669	3351	259	5952	22311	2601	22052	12.938223938223938	0.11794848539814982
chr3	TF	133774878	133774939	0	62	5952	22311	5952	22249	0.0	0.26751764124230304
chr3	CEP63	134546384	134546501	0	118	51	8593	51	8475	0.0	0.006017699115044248
chr3	CEP63	134547334	134547472	0	139	51	8593	51	8454	0.0	0.00603264726756565
chr3	CEP63	134488018	134488090	0	73	51	8593	51	8520	0.0	0.005985915492957746
chr3	EPHB1	134977965	134978077	49	113	98	6987	49	6874	0.4336283185840708	0.007128309572301426
chr3	PPP2R3A	136001058	136003493	37430	2436	40800	7802	3370	5366	15.36535303776683	0.6280283265001864
chr3	PPP2R3A	136079149	136079283	0	135	40800	7802	40800	7667	0.0	5.321507760532151
chr3	PCCB	136256554	136256623	0	70	258	7380	258	7310	0.0	0.03529411764705882
chr3	PCCB	136260478	136260535	0	58	258	7380	258	7322	0.0	0.03523627424201038
chr3	PCCB	136327154	136327255	0	102	258	7380	258	7278	0.0	0.03544929925803792
chr3	PCCB	136326325	136326385	0	61	258	7380	258	7319	0.0	0.03525071731110808
chr3	PCCB	136260262	136260355	0	94	258	7380	258	7286	0.0	0.035410376063683774
chr3	PCCB	136261951	136262065	0	115	258	7380	258	7265	0.0	0.035512732278045425
chr3	PCCB	136259175	136259235	0	61	258	7380	258	7319	0.0	0.03525071731110808
chr3	PCCB	136252302	136252389	0	88	258	7380	258	7292	0.0	0.035381239714755895
chr3	NCK1	136867430	136867525	0	96	15	5120	15	5024	0.0	0.0029856687898089174
chr3	NCK1	136889078	136889301	0	224	15	5120	15	4896	0.0	0.0030637254901960784
chr3	IL20RB	136991937	136992088	0	152	0	2453	0	2301	0.0	0.0
chr3	IL20RB	136986693	136986784	0	92	0	2453	0	2361	0.0	0.0
chr3	LINC01210	137774527	137774614	0	88	5676	3221	5676	3133	0.0	1.8116820938397702
chr3	LINC01210	137774523	137774614	0	92	5676	3221	5676	3129	0.0	1.8139980824544584
chr3	CLDN18	138024606	138024724	0	119	14	3721	14	3602	0.0	0.003886729594669628
chr3	ARMC8	138209816	138209893	28	78	2985	9550	2957	9472	0.358974358974359	0.31218327702702703
chr3	ARMC8	138237481	138237572	0	92	2985	9550	2985	9458	0.0	0.3156058363290336
chr3	ARMC8	138241782	138241983	735	202	2985	9550	2250	9348	3.6386138613861387	0.24069319640564826
chr3	ARMC8	138188454	138188530	0	77	2985	9550	2985	9473	0.0	0.3151060909954608
chr3	ARMC8	138228917	138229010	0	94	2985	9550	2985	9456	0.0	0.31567258883248733
chr3	ARMC8	138188400	138188530	0	131	2985	9550	2985	9419	0.0	0.3169126234207453
chr3	MRAS	138372865	138373076	7486	212	51747	6268	44261	6056	35.31132075471698	7.308619550858652
chr3	FAIM	138610603	138611037	0	435	1128	4080	1128	3645	0.0	0.3094650205761317
chr3	FAIM	138619710	138619770	0	61	1128	4080	1128	4019	0.0	0.2806668325454093
chr3	MRPS22	139349327	139349434	0	108	3049	5370	3049	5262	0.0	0.5794374762447738
chr3	AC046134.2	139419556	139419680	0	125	12	9175	12	9050	0.0	0.0013259668508287293
chr3	AC046134.2	139561652	139561748	0	97	12	9175	12	9078	0.0	0.0013218770654329147
chr3	AC046134.2	139459930	139459985	0	56	12	9175	12	9119	0.0	0.0013159337646671784
chr3	SLC25A36	140959462	140959540	0	79	16648	9584	16648	9505	0.0	1.7514992109416097
chr3	SLC25A36	140968682	140968730	0	49	16648	9584	16648	9535	0.0	1.7459884635553224
chr3	SLC25A36	140966999	140967036	0	38	16648	9584	16648	9546	0.0	1.743976534674209
chr3	SLC25A36	140966347	140966434	0	88	16648	9584	16648	9496	0.0	1.7531592249368155
chr3	SLC25A36	140966933	140967036	0	104	16648	9584	16648	9480	0.0	1.7561181434599156
chr3	SPSB4	141132188	141132310	0	123	102	3802	102	3679	0.0	0.02772492525142702
chr3	PXYLP1	141305755	141307776	85	2022	42579	13365	42494	11343	0.0420375865479723	3.7462752358282643
chr3	PXYLP1	141262242	141262340	1275	99	42579	13365	41304	13266	12.878787878787879	3.1135232926277703
chr3	PXYLP1	141234885	141234956	0	72	42579	13365	42579	13293	0.0	3.2031144211239
chr3	PXYLP1	141234215	141234318	0	104	42579	13365	42579	13261	0.0	3.2108438277656286
chr3	PXYLP1	141232332	141232435	0	104	42579	13365	42579	13261	0.0	3.2108438277656286
chr3	ZBTB38	141396258	141396503	0	246	153	12786	153	12540	0.0	0.012200956937799042
chr3	ZBTB38	141427633	141427821	0	189	153	12786	153	12597	0.0	0.012145748987854251
chr3	ZBTB38	141438242	141438365	0	124	153	12786	153	12662	0.0	0.012083399147054178
chr3	ZBTB38	141438267	141438365	0	99	153	12786	153	12687	0.0	0.012059588555214
chr3	RNF7	141743508	141743556	0	49	4080	2786	4080	2737	0.0	1.4906832298136645
chr3	RNF7	141742643	141742907	0	265	4080	2786	4080	2521	0.0	1.618405394684649
chr3	ATP1B3	141902135	141902227	0	93	14687	2630	14687	2537	0.0	5.789121009065826
chr3	ATP1B3	141916554	141916574	0	21	14687	2630	14687	2609	0.0	5.629359908010732
chr3	ATP1B3	141916375	141916440	0	66	14687	2630	14687	2564	0.0	5.728159126365054
chr3	PLS1	142664201	142664307	0	107	7727	5310	7727	5203	0.0	1.4851047472611956
chr3	PLS1	142627815	142627908	0	94	7727	5310	7727	5216	0.0	1.4814033742331287
chr3	PLS1	142645295	142645580	0	286	7727	5310	7727	5024	0.0	1.538017515923567
chr3	PLS1	142619452	142619638	0	187	7727	5310	7727	5123	0.0	1.5082959203591646
chr3	PLS1	142597236	142597348	21	113	7727	5310	7706	5197	0.18584070796460178	1.4827785260727342
chr3	TRPC1	142743484	142743586	4747	103	7737	4420	2990	4317	46.0873786407767	0.6926106092193653
chr3	TRPC1	142736378	142736533	706	156	7737	4420	7031	4264	4.5256410256410255	1.648921200750469
chr3	AC021074.3	142938474	142938653	0	180	51	5484	51	5304	0.0	0.009615384615384616
chr3	AC021074.3	142936422	142936646	0	225	51	5484	51	5259	0.0	0.009697661152310326
chr3	AC021074.3	142936603	142936646	0	44	51	5484	51	5440	0.0	0.009375
chr3	AC021074.3	142935840	142935898	0	59	51	5484	51	5425	0.0	0.009400921658986176
chr3	AC021074.3	142937825	142938264	51	440	51	5484	0	5044	0.1159090909090909	0.0
chr3	AC021074.3	142941081	142941101	0	21	51	5484	51	5463	0.0	0.009335529928610654
chr3	AC021074.3	142938242	142938264	0	23	51	5484	51	5461	0.0	0.00933894891045596
chr3	PAQR9-AS1	142990014	142990137	0	124	0	4326	0	4202	0.0	0.0
chr3	U2SURP	143054942	143055119	0	178	51	10970	51	10792	0.0	0.004725722757598221
chr3	U2SURP	143023974	143024018	0	45	51	10970	51	10925	0.0	0.004668192219679634
chr3	U2SURP	143024483	143024548	0	66	51	10970	51	10904	0.0	0.004677182685253118
chr3	AC055758.2	145946403	145946621	0	219	51	1122	51	903	0.0	0.05647840531561462
chr3	LINC02010	146923300	146923324	0	25	0	4235	0	4210	0.0	0.0
chr3	AC092958.1	147959787	147959841	0	55	0	3684	0	3629	0.0	0.0
chr3	AC092958.1	147940558	147940619	0	62	0	3684	0	3622	0.0	0.0
chr3	LINC02032	148079375	148079643	0	269	0	2478	0	2209	0.0	0.0
chr3	LINC02032	148079034	148079643	0	610	0	2478	0	1868	0.0	0.0
chr3	LINC02046	148312110	148312252	0	143	51	3775	51	3632	0.0	0.014041850220264317
chr3	LINC02046	148360131	148360177	0	47	51	3775	51	3728	0.0	0.013680257510729614
chr3	LINC02046	148341254	148341337	0	84	51	3775	51	3691	0.0	0.013817393660254673
chr3	LINC02046	148398678	148398776	0	99	51	3775	51	3676	0.0	0.013873775843307944
chr3	LINC02046	148361079	148361150	0	72	51	3775	51	3703	0.0	0.013772616797191467
chr3	LINC02046	148362197	148362301	0	105	51	3775	51	3670	0.0	0.013896457765667575
chr3	AGTR1	148707943	148708027	0	85	117902	3461	117902	3376	0.0	34.92357819905213
chr3	AGTR1	148731190	148731316	1596	127	117902	3461	116306	3334	12.566929133858268	34.88482303539292
chr3	AGTR1	148730337	148730509	0	173	117902	3461	117902	3288	0.0	35.85827250608273
chr3	CPB1	148840873	148840975	0	103	3701	3615	3701	3512	0.0	1.0538154897494305
chr3	GYG1	149024052	149024272	141	221	1722	7100	1581	6879	0.6380090497737556	0.22982991713911904
chr3	GYG1	149026451	149026502	0	52	1722	7100	1722	7048	0.0	0.24432463110102157
chr3	GYG1	148992657	148992772	0	116	1722	7100	1722	6984	0.0	0.24656357388316152
chr3	GYG1	149009275	149009402	0	128	1722	7100	1722	6972	0.0	0.2469879518072289
chr3	HPS3	149140003	149140498	0	496	410	5964	410	5468	0.0	0.07498171177761521
chr3	HPS3	149170470	149170573	0	104	410	5964	410	5860	0.0	0.06996587030716724
chr3	TM4SF1-AS1	149384992	149385169	0	178	357	2333	357	2155	0.0	0.165661252900232
chr3	TM4SF4	149475822	149475912	0	91	0	1535	0	1444	0.0	0.0
chr3	RNF13	149813924	149814026	0	103	0	3524	0	3421	0.0	0.0
chr3	RNF13	149960055	149960136	0	82	0	3524	0	3442	0.0	0.0
chr3	RNF13	149822517	149822573	0	57	0	3524	0	3467	0.0	0.0
chr3	RNF13	149852515	149852596	0	82	0	3524	0	3442	0.0	0.0
chr3	RNF13	149902071	149902162	0	92	0	3524	0	3432	0.0	0.0
chr3	RNF13	149846010	149846140	0	131	0	3524	0	3393	0.0	0.0
chr3	TSC22D2	150423048	150423120	0	73	252354	11682	252354	11609	0.0	21.737789645964337
chr3	TSC22D2	150457075	150457127	0	53	252354	11682	252354	11629	0.0	21.70040416200877
chr3	TSC22D2	150438197	150438354	737	158	252354	11682	251617	11524	4.6645569620253164	21.834172162443597
chr3	EIF2A	150567692	150567766	0	75	0	5921	0	5846	0.0	0.0
chr3	EIF2A	150575648	150575762	0	115	0	5921	0	5806	0.0	0.0
chr3	EIF2A	150581617	150581746	0	130	0	5921	0	5791	0.0	0.0
chr3	EIF2A	150558387	150558462	0	76	0	5921	0	5845	0.0	0.0
chr3	EIF2A	150562541	150562660	0	120	0	5921	0	5801	0.0	0.0
chr3	EIF2A	150565190	150565226	0	37	0	5921	0	5884	0.0	0.0
chr3	EIF2A	150562556	150562660	0	105	0	5921	0	5816	0.0	0.0
chr3	EIF2A	150557584	150557678	0	95	0	5921	0	5826	0.0	0.0
chr3	SELENOT	150618708	150618928	90	221	90	4144	0	3923	0.4072398190045249	0.0
chr3	SELENOT	150618708	150618803	9	96	90	4144	81	4048	0.09375	0.0200098814229249
chr3	ERICH6-AS1	150719446	150719548	0	103	51	5697	51	5594	0.0	0.009116910976045764
chr3	CLRN1-AS1	151075110	151075252	154	143	154	3071	0	2928	1.0769230769230769	0.0
chr3	MED12L	151192549	151192654	0	106	102	12667	102	12561	0.0	0.008120372581800811
chr3	MED12L	151416311	151416422	0	112	102	12667	102	12555	0.0	0.008124253285543608
chr3	AADACL2	151740645	151740868	0	224	51	5076	51	4852	0.0	0.010511129431162407
chr3	AADACP1	151775694	151775764	456	71	456	2017	0	1946	6.422535211267606	0.0
chr3	AADACP1	151773429	151773652	0	224	456	2017	456	1793	0.0	0.2543223647518126
chr3	AADACP1	151776803	151776975	0	173	456	2017	456	1844	0.0	0.2472885032537961
chr3	MBNL1	152299404	152300367	0	964	51	8493	51	7529	0.0	0.006773807942621862
chr3	MBNL1	152432716	152432920	0	205	51	8493	51	8288	0.0	0.006153474903474903
chr3	MBNL1	152446703	152446757	0	55	51	8493	51	8438	0.0	0.006044086276368808
chr3	MBNL1	152456266	152456361	0	96	51	8493	51	8397	0.0	0.006073597713469096
chr3	MBNL1	152455541	152455577	0	37	51	8493	51	8456	0.0	0.0060312204351939454
chr3	MBNL1	152447619	152447773	0	155	51	8493	51	8338	0.0	0.0061165747181578314
chr3	MBNL1	152396166	152396224	0	59	51	8493	51	8434	0.0	0.006046952810054541
chr3	MBNL1	152458129	152458193	0	65	51	8493	51	8428	0.0	0.00605125771238728
chr3	MBNL1	152447724	152447773	0	50	51	8493	51	8443	0.0	0.006040506928816771
chr3	MME	155156979	155157069	0	91	0	9595	0	9504	0.0	0.0
chr3	LINC01487	155255438	155255574	0	137	51	1600	51	1463	0.0	0.034859876965140126
chr3	LINC01487	155242900	155243015	0	116	51	1600	51	1484	0.0	0.03436657681940701
chr3	KCNAB1	156474733	156474820	0	88	11112	6763	11112	6675	0.0	1.6647191011235956
chr3	KCNAB1	156421615	156421659	0	45	11112	6763	11112	6718	0.0	1.6540637094373325
chr3	LEKR1	156852767	156852982	0	216	0	5318	0	5102	0.0	0.0
chr3	LEKR1	156927428	156927604	0	177	0	5318	0	5141	0.0	0.0
chr3	LINC02029	157086903	157087021	0	119	96	2326	96	2207	0.0	0.04349796103307658
chr3	AC092944.1	157213543	157213775	0	233	1530	8586	1530	8353	0.0	0.18316772417095653
chr3	AC092944.1	157284977	157286341	0	1365	1530	8586	1530	7221	0.0	0.211882010801828
chr3	AC092944.1	157286271	157286341	0	71	1530	8586	1530	8515	0.0	0.17968291250733998
chr3	SLC66A1L	157571954	157572043	0	90	0	3154	0	3064	0.0	0.0
chr3	SLC66A1L	157553229	157553340	0	112	0	3154	0	3042	0.0	0.0
chr3	RSRC1	158203071	158203245	51	175	67288	5081	67237	4906	0.2914285714285714	13.705055034651448
chr3	RSRC1	158543334	158543487	3925	154	67288	5081	63363	4927	25.48701298701299	12.860361274609296
chr3	RSRC1	158225656	158225733	0	78	67288	5081	67288	5003	0.0	13.449530281830901
chr3	RSRC1	158132085	158132263	0	179	67288	5081	67288	4902	0.0	13.726642186862506
chr3	MLF1	158598079	158598208	0	130	20	3749	20	3619	0.0	0.005526388505111909
chr3	MLF1	158602806	158602939	0	134	20	3749	20	3615	0.0	0.005532503457814661
chr3	MLF1	158592433	158592581	0	149	20	3749	20	3600	0.0	0.005555555555555556
chr3	MLF1	158588851	158588924	20	74	20	3749	0	3675	0.2702702702702703	0.0
chr3	MLF1	158588859	158588924	12	66	20	3749	8	3683	0.18181818181818182	0.0021721422753190334
chr3	MLF1	158593381	158593426	0	46	20	3749	20	3703	0.0	0.0054010261949770455
chr3	MLF1	158598128	158598208	0	81	20	3749	20	3668	0.0	0.0054525627044711015
chr3	MLF1	158582655	158582929	0	275	20	3749	20	3474	0.0	0.0057570523891767415
chr3	MLF1	158593381	158593421	0	41	20	3749	20	3708	0.0	0.005393743257820928
chr3	MLF1	158596348	158596423	0	76	20	3749	20	3673	0.0	0.005445140212360468
chr3	MLF1	158573297	158573433	0	137	20	3749	20	3612	0.0	0.005537098560354375
chr3	MLF1	158572975	158573039	0	65	20	3749	20	3684	0.0	0.0054288816503800215
chr3	GFM1	158690162	158690323	0	162	204	10963	204	10801	0.0	0.018887140079622257
chr3	GFM1	158650004	158650061	0	58	204	10963	204	10905	0.0	0.018707015130674003
chr3	MFSD1	158805361	158805474	19	114	27	3754	8	3640	0.16666666666666666	0.002197802197802198
chr3	AC080013.1	158733950	158734037	0	88	0	4565	0	4477	0.0	0.0
chr3	AC080013.1	158742371	158742481	0	111	0	4565	0	4454	0.0	0.0
chr3	MFSD1	158821596	158821653	0	58	27	3754	27	3696	0.0	0.007305194805194805
chr3	MFSD1	158825177	158825301	0	125	27	3754	27	3629	0.0	0.0074400661339211905
chr3	MFSD1	158805340	158805474	19	135	27	3754	8	3619	0.14074074074074075	0.0022105554020447637
chr3	IQCJ-SCHIP1	159252726	159252799	0	74	1453	4426	1453	4352	0.0	0.33386948529411764
chr3	IQCJ-SCHIP1	159252726	159252807	0	82	1453	4426	1453	4344	0.0	0.3344843462246777
chr3	IQCJ-SCHIP1	159764442	159765138	538	697	1453	4426	915	3729	0.7718794835007173	0.24537409493161705
chr3	IQCJ-SCHIP1	159764442	159765099	538	658	1453	4426	915	3768	0.817629179331307	0.2428343949044586
chr3	IL12A	159993011	159993125	0	115	7725	1635	7725	1520	0.0	5.082236842105263
chr3	IL12A	159993450	159993492	0	43	7725	1635	7725	1592	0.0	4.852386934673367
chr3	SMC4	160400821	160400965	0	145	306	7681	306	7536	0.0	0.04060509554140127
chr3	SMC4	160400599	160400965	0	367	306	7681	306	7314	0.0	0.04183757178014766
chr3	SMC4	160401989	160402093	0	105	306	7681	306	7576	0.0	0.04039070749736008
chr3	SMC4	160431031	160431205	16	175	306	7681	290	7506	0.09142857142857143	0.03863575806021849
chr3	SMC4	160400627	160400965	0	339	306	7681	306	7342	0.0	0.041678016889131024
chr3	SMC4	160401914	160402093	0	180	306	7681	306	7501	0.0	0.040794560725236635
chr3	SMC4	160412325	160412453	0	129	306	7681	306	7552	0.0	0.04051906779661017
chr3	PPM1L	160939655	160939755	0	101	1173	12452	1173	12351	0.0	0.09497206703910614
chr3	LINC01322	165374258	165374424	0	167	0	14499	0	14332	0.0	0.0
chr3	LINC01322	165460538	165460632	0	95	0	14499	0	14404	0.0	0.0
chr3	LINC01322	165491195	165491266	0	72	0	14499	0	14427	0.0	0.0
chr3	LINC01322	165460451	165460632	0	182	0	14499	0	14317	0.0	0.0
chr3	LINC01322	165345471	165345525	0	55	0	14499	0	14444	0.0	0.0
chr3	LINC01322	165511510	165511651	0	142	0	14499	0	14357	0.0	0.0
chr3	LINC01322	165446042	165446263	0	222	0	14499	0	14277	0.0	0.0
chr3	LINC01322	165495220	165495290	0	71	0	14499	0	14428	0.0	0.0
chr3	LINC01322	165495220	165495266	0	47	0	14499	0	14452	0.0	0.0
chr3	LINC01322	165389888	165390111	0	224	0	14499	0	14275	0.0	0.0
chr3	LINC01322	165300499	165300634	0	136	0	14499	0	14363	0.0	0.0
chr3	LINC01322	165474079	165474241	0	163	0	14499	0	14336	0.0	0.0
chr3	LINC01322	165258405	165258523	0	119	0	14499	0	14380	0.0	0.0
chr3	LINC01322	165474079	165474237	0	159	0	14499	0	14340	0.0	0.0
chr3	LINC01322	165602439	165602552	0	114	0	14499	0	14385	0.0	0.0
chr3	LRRC77P	167914826	167914970	0	145	0	5364	0	5219	0.0	0.0
chr3	LRRC77P	167920564	167920791	0	228	0	5364	0	5136	0.0	0.0
chr3	LRRC77P	167919368	167919430	0	63	0	5364	0	5301	0.0	0.0
chr3	LRRC77P	167917298	167917496	0	199	0	5364	0	5165	0.0	0.0
chr3	LRRC77P	167915756	167915910	0	155	0	5364	0	5209	0.0	0.0
chr3	EGFEM1P	168314070	168314176	0	107	25	4669	25	4562	0.0	0.0054800526085050415
chr3	MYNN	169784621	169784708	0	88	132	5175	132	5087	0.0	0.02594849616669943
chr3	MYNN	169774030	169774097	0	68	132	5175	132	5107	0.0	0.025846876835715685
chr3	MYNN	169783729	169783858	0	130	132	5175	132	5045	0.0	0.02616451932606541
chr3	SAMD7	169926212	169926325	0	114	4	2522	4	2408	0.0	0.0016611295681063123
chr3	SEC62	169969286	169969383	0	98	39097	7317	39097	7219	0.0	5.415847070231334
chr3	GPR160	170077122	170077923	26665	802	33204	4391	6539	3589	33.248129675810475	1.8219559765951518
chr3	GPR160	170083364	170083522	0	159	33204	4391	33204	4232	0.0	7.84593572778828
chr3	SKIL	170384532	170384765	14	234	511	7601	497	7367	0.05982905982905983	0.06746301072349667
chr3	SKIL	170384532	170384627	14	96	511	7601	497	7505	0.14583333333333334	0.06622251832111925
chr3	ECT2	172752149	172752472	0	324	0	5475	0	5151	0.0	0.0
chr3	ECT2	172755482	172755575	0	94	0	5475	0	5381	0.0	0.0
chr3	ECT2	172752149	172752436	0	288	0	5475	0	5187	0.0	0.0
chr3	ECT2	172752149	172752272	0	124	0	5475	0	5351	0.0	0.0
chr3	ECT2	172818547	172818814	0	268	0	5475	0	5207	0.0	0.0
chr3	NAALADL2	175324174	175324325	0	152	66	13578	66	13426	0.0	0.004915834947117533
chr3	NAALADL2	175447228	175447372	0	145	66	13578	66	13433	0.0	0.0049132732822154395
chr3	NAALADL2	175460044	175460175	0	132	66	13578	66	13446	0.0	0.0049085229808121375
chr3	LINC00578	177539394	177539493	51	100	51	6327	0	6227	0.51	0.0
chr3	LINC00578	177629416	177629555	0	140	51	6327	51	6187	0.0	0.008243090350735413
chr3	LINC00578	177751910	177752065	0	156	51	6327	51	6171	0.0	0.008264462809917356
chr3	LINC00578	177669081	177669184	0	104	51	6327	51	6223	0.0	0.008195404145910332
chr3	LINC02015	177820716	177820889	0	174	0	2528	0	2354	0.0	0.0
chr3	LINC02015	177896563	177896895	0	333	0	2528	0	2195	0.0	0.0
chr3	LINC01014	178456613	178456774	0	162	0	555	0	393	0.0	0.0
chr3	KCNMB2	178795141	178795218	0	78	0	3552	0	3474	0.0	0.0
chr3	KCNMB2	178824557	178824682	0	126	0	3552	0	3426	0.0	0.0
chr3	PIK3CA	179219195	179219277	0	83	901	13620	901	13537	0.0	0.0665583216369949
chr3	PIK3CA	179233288	179233371	49	84	901	13620	852	13536	0.5833333333333334	0.06294326241134751
chr3	ZNF639	179325041	179325322	309	282	325760	6830	325451	6548	1.0957446808510638	49.702351863164324
chr3	ZNF639	179324949	179324993	12	45	325760	6830	325748	6785	0.26666666666666666	48.010022107590274
chr3	MFN1	179377041	179377168	0	128	3382	5649	3382	5521	0.0	0.6125701865604057
chr3	ACTL6A	179575402	179575504	0	103	0	3491	0	3388	0.0	0.0
chr3	NDUFB5	179614970	179615059	0	90	51	5543	51	5453	0.0	0.009352649917476618
chr3	NDUFB5	179618414	179618521	0	108	51	5543	51	5435	0.0	0.0093836246550138
chr3	NDUFB5	179616982	179617044	0	63	51	5543	51	5480	0.0	0.009306569343065693
chr3	NDUFB5	179615984	179616049	0	66	51	5543	51	5477	0.0	0.00931166697096951
chr3	NDUFB5	179615982	179616049	0	68	51	5543	51	5475	0.0	0.009315068493150684
chr3	NDUFB5	179614951	179615059	0	109	51	5543	51	5434	0.0	0.009385351490614648
chr3	NDUFB5	179615555	179615615	0	61	51	5543	51	5482	0.0	0.009303174024078804
chr3	NDUFB5	179607757	179607812	0	56	51	5543	51	5487	0.0	0.009294696555494806
chr3	USP13	179690240	179690301	0	62	0	8177	0	8115	0.0	0.0
chr3	USP13	179757051	179757078	0	28	0	8177	0	8149	0.0	0.0
chr3	FXR1	180935137	180935231	0	95	103	11810	103	11715	0.0	0.008792146820315835
chr3	FXR1	180914651	180914995	0	345	103	11810	103	11465	0.0	0.008983863933711296
chr3	FXR1	180975312	180975404	0	93	103	11810	103	11717	0.0	0.008790646069813092
chr3	FXR1	180933333	180933386	0	54	103	11810	103	11756	0.0	0.008761483497788363
chr3	FXR1	180971074	180971155	0	82	103	11810	103	11728	0.0	0.008782401091405184
chr3	SOX2-OT	181030569	181030689	0	121	302	31226	302	31105	0.0	0.009709049991962707
chr3	SOX2-OT	181056696	181056786	0	91	302	31226	302	31135	0.0	0.009699694877147905
chr3	SOX2-OT	181610860	181610929	0	70	302	31226	302	31156	0.0	0.009693157016305045
chr3	SOX2-OT	181715184	181715292	0	109	302	31226	302	31117	0.0	0.009705305781405663
chr3	SOX2-OT	181003774	181003933	0	160	302	31226	302	31066	0.0	0.009721238653189983
chr3	SOX2-OT	181630854	181631004	0	151	302	31226	302	31075	0.0	0.009718423169750603
chr3	SOX2-OT	181604291	181604340	0	50	302	31226	302	31176	0.0	0.00968693867077239
chr3	SOX2-OT	181699597	181699883	0	287	302	31226	302	30939	0.0	0.009761142894081903
chr3	SOX2-OT	181601310	181601389	0	80	302	31226	302	31146	0.0	0.009696269183843833
chr3	SOX2-OT	181690833	181691002	0	170	302	31226	302	31056	0.0	0.009724368882019578
chr3	SOX2-OT	181610608	181610745	0	138	302	31226	302	31088	0.0	0.009714359238291302
chr3	SOX2-OT	181610856	181610929	0	74	302	31226	302	31152	0.0	0.009694401643554186
chr3	SOX2-OT	181737270	181737361	0	92	302	31226	302	31134	0.0	0.009700006423845314
chr3	SOX2-OT	181736374	181736542	0	169	302	31226	302	31057	0.0	0.009724055768425797
chr3	SOX2-OT	181732463	181732612	0	150	302	31226	302	31076	0.0	0.009718110438923929
chr3	SOX2-OT	181722201	181722298	0	98	302	31226	302	31128	0.0	0.009701876124389617
chr3	SOX2-OT	181774260	181774415	0	156	302	31226	302	31070	0.0	0.009719987125844867
chr3	SOX2-OT	181774247	181774415	0	169	302	31226	302	31057	0.0	0.009724055768425797
chr3	SOX2-OT	181778534	181778669	0	136	302	31226	302	31090	0.0	0.00971373431971695
chr3	SOX2-OT	181778534	181778662	0	129	302	31226	302	31097	0.0	0.009711547737723897
chr3	SOX2-OT	181814212	181814516	0	305	302	31226	302	30921	0.0	0.009766825135021506
chr3	SOX2-OT	181825603	181825744	0	142	302	31226	302	31084	0.0	0.00971560931669026
chr3	SOX2-OT	181825627	181825744	0	118	302	31226	302	31108	0.0	0.009708113668509709
chr3	SOX2-OT	181701399	181701449	0	51	302	31226	302	31175	0.0	0.009687249398556535
chr3	SOX2-OT	181722204	181722298	0	95	302	31226	302	31131	0.0	0.009700941184028781
chr3	LINC01206	182000188	182000506	0	319	51	11383	51	11064	0.0	0.004609544468546637
chr3	LINC01206	181971563	181971734	0	172	51	11383	51	11211	0.0	0.004549103559004549
chr3	LINC01206	181984369	181984491	0	123	51	11383	51	11260	0.0	0.004529307282415631
chr3	LINC01206	181971563	181971719	0	157	51	11383	51	11226	0.0	0.004543025120256547
chr3	LINC01206	181984369	181984431	0	63	51	11383	51	11320	0.0	0.00450530035335689
chr3	LINC01206	182000188	182000508	0	321	51	11383	51	11062	0.0	0.004610377870186223
chr3	LINC01206	182000188	182000445	0	258	51	11383	51	11125	0.0	0.004584269662921348
chr3	LINC01206	182000188	182000469	0	282	51	11383	51	11101	0.0	0.004594180704441042
chr3	LINC01206	182000107	182000506	0	400	51	11383	51	10983	0.0	0.004643540016388965
chr3	LINC01206	182000107	182000445	0	339	51	11383	51	11044	0.0	0.0046178920680912715
chr3	LINC01206	182002773	182002845	0	73	51	11383	51	11310	0.0	0.004509283819628647
chr3	LINC01206	181984723	181984827	0	105	51	11383	51	11278	0.0	0.004522078382691966
chr3	LINC01206	181973542	181973661	0	120	51	11383	51	11263	0.0	0.0045281008612270265
chr3	LINC01206	182001533	182001760	0	228	51	11383	51	11155	0.0	0.004571940833706858
chr3	LINC01206	181984727	181984827	0	101	51	11383	51	11282	0.0	0.004520475093068605
chr3	LINC01206	181957100	181957294	0	195	51	11383	51	11188	0.0	0.004558455488022882
chr3	ATP11B	182885950	182886010	0	61	1320	9220	1320	9159	0.0	0.14412053717654766
chr3	ATP11B	182902480	182902566	0	87	1320	9220	1320	9133	0.0	0.1445308222927844
chr3	ATP11B	182908458	182908505	0	48	1320	9220	1320	9172	0.0	0.14391626689925863
chr3	KLHL24	183644085	183644167	0	83	85262	8653	85262	8570	0.0	9.948891481913652
chr3	KLHL24	183643479	183643542	5836	64	85262	8653	79426	8589	91.1875	9.247409477238328
chr3	KLHL24	183636220	183636311	0	92	85262	8653	85262	8561	0.0	9.959350543160845
chr3	HTR3D	184036368	184036540	0	173	411438	1963	411438	1790	0.0	229.8536312849162
chr3	HTR3E	184101484	184101529	0	46	30	2479	30	2433	0.0	0.012330456226880395
chr3	EIF2B5	184140417	184140730	0	314	51	6302	51	5988	0.0	0.008517034068136272
chr3	EIF2B5	184140417	184140740	0	324	51	6302	51	5978	0.0	0.00853128136500502
chr3	EIF2B5	184138846	184138939	0	94	51	6302	51	6208	0.0	0.00821520618556701
chr3	EIF2B5	184140417	184140615	0	199	51	6302	51	6103	0.0	0.008356545961002786
chr3	EIF2B5	184135663	184135916	0	254	51	6302	51	6048	0.0	0.008432539682539682
chr3	EIF2B5	184140079	184140157	0	79	51	6302	51	6223	0.0	0.008195404145910332
chr3	DVL3	184166445	184166522	0	78	153	6169	153	6091	0.0	0.025119028074207846
chr3	DVL3	184156359	184156447	0	89	153	6169	153	6080	0.0	0.025164473684210525
chr3	DVL3	184162604	184162801	0	198	153	6169	153	5971	0.0	0.025623848601574274
chr3	AP2M1	184177542	184177611	0	70	204	4554	204	4484	0.0	0.045495093666369314
chr3	AP2M1	184178217	184178223	0	7	204	4554	204	4547	0.0	0.04486474598636463
chr3	AP2M1	184180644	184180650	0	7	204	4554	204	4547	0.0	0.04486474598636463
chr3	AP2M1	184180644	184180741	0	98	204	4554	204	4456	0.0	0.04578096947935368
chr3	AP2M1	184180841	184180844	0	4	204	4554	204	4550	0.0	0.04483516483516484
chr3	ECE2	184278491	184278557	0	67	103	4745	103	4678	0.0	0.02201795639162035
chr3	ECE2	184276480	184276567	0	88	103	4745	103	4657	0.0	0.022117242860210436
chr3	ECE2	184276480	184276705	0	226	103	4745	103	4519	0.0	0.02279265324186767
chr3	PSMD2	184301846	184302071	0	226	102	4392	102	4166	0.0	0.024483917426788286
chr3	PSMD2	184306750	184306834	0	85	102	4392	102	4307	0.0	0.02368237752495937
chr3	PSMD2	184301793	184302071	0	279	102	4392	102	4113	0.0	0.024799416484318017
chr3	PSMD2	184301857	184302071	0	215	102	4392	102	4177	0.0	0.02441943978932248
chr3	EIF4G1	184316712	184316733	0	22	255	7868	255	7846	0.0	0.0325006372673974
chr3	EIF4G1	184315488	184315545	0	58	255	7868	255	7810	0.0	0.03265044814340589
chr3	EIF4G1	184317320	184317497	0	178	255	7868	255	7690	0.0	0.03315994798439532
chr3	EIF4G1	184317320	184317431	0	112	255	7868	255	7756	0.0	0.032877772047447136
chr3	EIF4G1	184317716	184317816	0	101	255	7868	255	7767	0.0	0.032831208960988796
chr3	FAM131A	184338386	184338529	0	144	30	7862	30	7718	0.0	0.0038870173620108835
chr3	FAM131A	184337310	184337371	0	62	30	7862	30	7800	0.0	0.0038461538461538464
chr3	FAM131A	184341723	184341817	0	95	30	7862	30	7767	0.0	0.003862495171881035
chr3	POLR2H	184362872	184363565	0	694	51	3089	51	2395	0.0	0.02129436325678497
chr3	POLR2H	184366716	184366800	0	85	51	3089	51	3004	0.0	0.016977363515312916
chr3	CHRD	184381079	184381130	0	52	357	6337	357	6285	0.0	0.056801909307875896
chr3	CHRD	184383522	184383642	0	121	357	6337	357	6216	0.0	0.057432432432432436
chr3	CHRD	184387373	184387477	0	105	357	6337	357	6232	0.0	0.05728498074454429
chr3	CHRD	184381075	184381130	0	56	357	6337	357	6281	0.0	0.05683808310778538
chr3	LINC02054	184422952	184423132	5516	181	20998	4067	15482	3886	30.475138121546962	3.984045290787442
chr3	LINC02054	184425696	184425838	457	143	20998	4067	20541	3924	3.195804195804196	5.234709480122324
chr3	AC107294.2	184734034	184734100	0	67	102	3702	102	3635	0.0	0.028060522696011003
chr3	AC107294.2	184726102	184726205	0	104	102	3702	102	3598	0.0	0.028349082823790995
chr3	AC107294.2	184728833	184728905	0	73	102	3702	102	3629	0.0	0.028106916505924496
chr3	AC107294.2	184727399	184727580	0	182	102	3702	102	3520	0.0	0.028977272727272727
chr3	AC107294.2	184734034	184734240	0	207	102	3702	102	3495	0.0	0.029184549356223177
chr3	VPS8	184839697	184839758	0	62	5510	9433	5510	9371	0.0	0.5879842065948138
chr3	VPS8	184843239	184843245	0	7	5510	9433	5510	9426	0.0	0.5845533630384044
chr3	VPS8	184839697	184839752	0	56	5510	9433	5510	9377	0.0	0.5876079769649142
chr3	VPS8	184824146	184824232	0	87	5510	9433	5510	9346	0.0	0.5895570297453456
chr3	VPS8	184824930	184825048	0	119	5510	9433	5510	9314	0.0	0.5915825638823277
chr3	VPS8	184836246	184836330	0	85	5510	9433	5510	9348	0.0	0.5894308943089431
chr3	VPS8	184893233	184893412	0	180	5510	9433	5510	9253	0.0	0.5954825462012321
chr3	VPS8	184882348	184882433	0	86	5510	9433	5510	9347	0.0	0.5894939552797689
chr3	VPS8	184922428	184922483	1273	56	5510	9433	4237	9377	22.732142857142858	0.45185027194198574
chr3	MAP3K13	185437446	185437630	128	185	86887	12248	86759	12063	0.6918918918918919	7.192157838017077
chr3	MAP3K13	185443444	185443636	0	193	86887	12248	86887	12055	0.0	7.207548734964745
chr3	SENP2	185598411	185598545	0	135	4459	6876	4459	6741	0.0	0.6614745586708204
chr3	SENP2	185598957	185599024	0	68	4459	6876	4459	6808	0.0	0.6549647473560517
chr3	SENP2	185598991	185599024	0	34	4459	6876	4459	6842	0.0	0.651710026308097
chr3	SENP2	185617479	185617611	73	133	4459	6876	4386	6743	0.5488721804511278	0.6504523209254042
chr3	SENP2	185598393	185598545	0	153	4459	6876	4459	6723	0.0	0.6632455748921612
chr3	IGF2BP2-AS1	185728686	185728870	0	185	294	3425	294	3240	0.0	0.09074074074074075
chr3	NMRAL2P	185968478	185968649	0	172	0	2634	0	2462	0.0	0.0
chr3	NMRAL2P	185968478	185968708	0	231	0	2634	0	2403	0.0	0.0
chr3	NMRAL2P	185968478	185968717	0	240	0	2634	0	2394	0.0	0.0
chr3	LINC02020	186441844	186442081	0	238	51	3478	51	3240	0.0	0.01574074074074074
chr3	LINC02020	186440981	186441121	0	141	51	3478	51	3337	0.0	0.015283188492658075
chr3	LINC02020	186440981	186441179	0	199	51	3478	51	3279	0.0	0.01555352241537054
chr3	LINC02020	186444905	186445953	0	1049	51	3478	51	2429	0.0	0.02099629477151091
chr3	LINC02020	186441017	186441121	0	105	51	3478	51	3373	0.0	0.015120071153276016
chr3	LINC02020	186440981	186442081	51	1101	51	3478	0	2377	0.04632152588555858	0.0
chr3	LINC02020	186444905	186445833	0	929	51	3478	51	2549	0.0	0.02000784621420165
chr3	FETUB	186641029	186641140	0	112	400	2000	400	1888	0.0	0.211864406779661
chr3	FETUB	186642470	186642558	0	89	400	2000	400	1911	0.0	0.20931449502878074
chr3	KNG1	186727236	186727344	0	109	87	2509	87	2400	0.0	0.03625
chr3	EIF4A2	186787494	186787584	0	91	4018	5023	4018	4932	0.0	0.8146796431467964
chr3	EIF4A2	186787478	186787584	0	107	4018	5023	4018	4916	0.0	0.8173311635475997
chr3	EIF4A2	186784961	186785101	0	141	4018	5023	4018	4882	0.0	0.8230233510856206
chr3	EIF4A2	186788309	186788416	0	108	4018	5023	4018	4915	0.0	0.8174974567650051
chr3	ADIPOQ	186845556	186845607	0	52	129789	4603	129789	4551	0.0	28.51878707976269
chr3	ST6GAL1	186942347	186942427	51	81	51	9537	0	9456	0.6296296296296297	0.0
chr3	ST6GAL1	187042653	187043310	0	658	51	9537	51	8879	0.0	0.005743890077711454
chr3	ST6GAL1	187038741	187038873	0	133	51	9537	51	9404	0.0	0.0054232241599319435
chr3	ST6GAL1	186963784	186963926	0	143	51	9537	51	9394	0.0	0.005428997232275921
chr3	ST6GAL1	186948854	186948938	0	85	51	9537	51	9452	0.0	0.00539568345323741
chr3	ST6GAL1	187041916	187041966	0	51	51	9537	51	9486	0.0	0.005376344086021506
chr3	ST6GAL1	187038391	187038491	0	101	51	9537	51	9436	0.0	0.005404832556167868
chr3	ST6GAL1	187038394	187038491	0	98	51	9537	51	9439	0.0	0.005403114736730586
chr3	ST6GAL1	187064519	187064616	0	98	51	9537	51	9439	0.0	0.005403114736730586
chr3	AC108681.1	187804216	187804386	0	171	0	781	0	610	0.0	0.0
chr3	LPP	188406111	188406313	0	203	91	25561	91	25358	0.0	0.0035886110892026186
chr3	LPP	188312834	188312918	0	85	91	25561	91	25476	0.0	0.00357198932328466
chr3	LPP	188225404	188225527	0	124	91	25561	91	25437	0.0	0.0035774658961355505
chr3	LPP	188341662	188341719	0	58	91	25561	91	25503	0.0	0.0035682076618437047
chr3	TPRG1	189147583	189147647	0	65	714	9563	714	9498	0.0	0.07517372078332281
chr3	TP63	189890788	189890882	0	95	649	7496	649	7401	0.0	0.08769085258748818
chr3	TP63	189889339	189889484	0	146	649	7496	649	7350	0.0	0.08829931972789115
chr3	TP63	189808271	189808526	59	256	649	7496	590	7240	0.23046875	0.08149171270718232
chr3	TP63	189844196	189844412	0	217	649	7496	649	7279	0.0	0.08916059898337683
chr3	IL1RAP	190629349	190629498	0	150	0	11579	0	11429	0.0	0.0
chr3	IL1RAP	190550341	190550505	0	165	0	11579	0	11414	0.0	0.0
chr3	IL1RAP	190556129	190556216	0	88	0	11579	0	11491	0.0	0.0
chr3	IL1RAP	190554632	190554693	0	62	0	11579	0	11517	0.0	0.0
chr3	CCDC50	191375061	191375589	0	529	102	9195	102	8666	0.0	0.011770136164320332
chr3	AC073365.1	191557261	191557384	0	124	0	8311	0	8187	0.0	0.0
chr3	AC073365.1	191559677	191559754	0	78	0	8311	0	8233	0.0	0.0
chr3	AC073365.1	191546050	191546115	0	66	0	8311	0	8245	0.0	0.0
chr3	AC073365.1	191568205	191568341	0	137	0	8311	0	8174	0.0	0.0
chr3	AC073365.1	191531649	191531707	0	59	0	8311	0	8252	0.0	0.0
chr3	AC073365.1	191585327	191585362	0	36	0	8311	0	8275	0.0	0.0
chr3	AC073365.1	191539293	191539529	0	237	0	8311	0	8074	0.0	0.0
chr3	AC073365.1	191530815	191530850	0	36	0	8311	0	8275	0.0	0.0
chr3	AC073365.1	191559677	191559969	0	293	0	8311	0	8018	0.0	0.0
chr3	AC073365.1	191557261	191557288	0	28	0	8311	0	8283	0.0	0.0
chr3	AC073365.1	191559677	191559750	0	74	0	8311	0	8237	0.0	0.0
chr3	AC073365.1	191546050	191546111	0	62	0	8311	0	8249	0.0	0.0
chr3	AC073365.1	191473550	191473688	0	139	0	8311	0	8172	0.0	0.0
chr3	OPA1	193626091	193626202	0	112	357	9079	357	8967	0.0	0.03981264637002342
chr3	OPA1	193642974	193643049	0	76	357	9079	357	9003	0.0	0.0396534488503832
chr3	OPA1	193645552	193645625	0	74	357	9079	357	9005	0.0	0.03964464186563021
chr3	OPA1	193648069	193648134	0	66	357	9079	357	9013	0.0	0.03960945301231555
chr3	OPA1	193617783	193617837	0	55	357	9079	357	9024	0.0	0.03956117021276596
chr3	OPA1	193617177	193617285	0	109	357	9079	357	8970	0.0	0.03979933110367893
chr3	OPA1	193689068	193689170	0	103	357	9079	357	8976	0.0	0.03977272727272727
chr3	OPA1	193668314	193668484	0	171	357	9079	357	8908	0.0	0.04007633587786259
chr3	OPA1	193596799	193596946	0	148	357	9079	357	8931	0.0	0.03997312730937185
chr3	OPA1	193603499	193603557	0	59	357	9079	357	9020	0.0	0.039578713968957874
chr3	OPA1	193646484	193646579	0	96	357	9079	357	8983	0.0	0.03974173438717578
chr3	OPA1	193628508	193628616	0	109	357	9079	357	8970	0.0	0.03979933110367893
chr3	OPA1	193631754	193631769	0	16	357	9079	357	9063	0.0	0.039390930155577625
chr3	OPA1	193642764	193642845	0	82	357	9079	357	8997	0.0	0.039679893297765924
chr3	OPA1	193667370	193667455	0	86	357	9079	357	8993	0.0	0.03969754253308128
chr3	LINC00884	194490509	194490594	0	86	0	9432	0	9346	0.0	0.0
chr3	TMEM44-AS1	194589473	194589626	0	154	0	1583	0	1429	0.0	0.0
chr3	LINC01968	194718855	194718978	0	124	1184	9041	1184	8917	0.0	0.13278008298755187
chr3	LINC01968	194714978	194715182	0	205	1184	9041	1184	8836	0.0	0.1339972838388411
chr3	LINC01968	194726726	194726848	0	123	1184	9041	1184	8918	0.0	0.13276519398968378
chr3	LINC01968	194709273	194709397	0	125	1184	9041	1184	8916	0.0	0.13279497532525797
chr3	LINC01968	194743689	194743761	0	73	1184	9041	1184	8968	0.0	0.1320249776984835
chr3	LINC01968	194747417	194747539	0	123	1184	9041	1184	8918	0.0	0.13276519398968378
chr3	LINC01968	194747947	194748040	0	94	1184	9041	1184	8947	0.0	0.13233486084721136
chr3	LINC01968	194768452	194768608	0	157	1184	9041	1184	8884	0.0	0.13327330031517334
chr3	LINC01968	194715403	194715652	0	250	1184	9041	1184	8791	0.0	0.13468319872596973
chr3	LINC01968	194747950	194748040	0	91	1184	9041	1184	8950	0.0	0.1322905027932961
chr3	LINC01968	194820560	194820731	0	172	1184	9041	1184	8869	0.0	0.1334987033487428
chr3	LINC01968	194770770	194770876	0	107	1184	9041	1184	8934	0.0	0.1325274233266174
chr3	LINC01968	194769739	194769811	0	73	1184	9041	1184	8968	0.0	0.1320249776984835
chr3	MUC20-OT1	195663623	195663767	4575	145	188855	13794	184280	13649	31.551724137931036	13.501355410652796
chr3	MUC20-OT1	195663623	195663832	6375	210	188855	13794	182480	13584	30.357142857142858	13.433451118963486
chr3	MUC20-OT1	195689338	195689438	3996	101	188855	13794	184859	13693	39.56435643564357	13.500255605053677
chr3	MUC20-OT1	195701379	195701669	10919	291	188855	13794	177936	13503	37.52233676975945	13.177516107531659
chr3	MUC20-OT1	195685817	195685939	7206	123	188855	13794	181649	13671	58.58536585365854	13.287177236485991
chr3	MUC20-OT1	195688201	195688319	1529	119	188855	13794	187326	13675	12.84873949579832	13.698427787934186
chr3	MUC20-OT1	195686603	195686718	6410	116	188855	13794	182445	13678	55.258620689655174	13.338572890773506
chr3	MUC20-OT1	195707005	195707126	51	122	188855	13794	188804	13672	0.4180327868852459	13.809537741369223
chr3	MUC20-OT1	195688532	195688797	5822	266	188855	13794	183033	13528	21.887218045112782	13.529937906564163
chr3	MUC20-OT1	195696360	195696589	12409	230	188855	13794	176446	13564	53.95217391304348	13.008404600412858
chr3	MUC20-OT1	195708133	195708268	1014	136	188855	13794	187841	13658	7.455882352941177	13.753184946551471
chr3	MUC20-OT1	195689545	195689608	3422	64	188855	13794	185433	13730	53.46875	13.505680990531683
chr3	MUC20-OT1	195686297	195686389	1348	93	188855	13794	187507	13701	14.494623655913978	13.685643383694622
chr3	MUC20-OT1	195688197	195688319	1543	123	188855	13794	187312	13671	12.544715447154472	13.701411747494697
chr3	MUC20-OT1	195701379	195701432	10295	54	188855	13794	178560	13740	190.64814814814815	12.995633187772926
chr3	MUC20-OT1	195699029	195699207	0	179	188855	13794	188855	13615	0.0	13.871098053617335
chr3	MUC20-OT1	195708133	195708435	1625	303	188855	13794	187230	13491	5.363036303630363	13.878140982877474
chr3	MUC20-OT1	195701379	195701495	10747	117	188855	13794	178108	13677	91.85470085470085	13.022446442933392
chr3	MUC20-OT1	195701587	195701669	0	83	188855	13794	188855	13711	0.0	13.773977098679891
chr3	MUC20-OT1	195708428	195708513	582	86	188855	13794	188273	13708	6.767441860465116	13.73453457834841
chr3	MUC20-OT1	195702182	195702442	132	261	188855	13794	188723	13533	0.5057471264367817	13.945392743663637
chr3	MUC20-OT1	195708133	195708387	1565	255	188855	13794	187290	13539	6.137254901960785	13.833370263682694
chr3	MUC20-OT1	195707028	195707126	51	99	188855	13794	188804	13695	0.5151515151515151	13.786345381526104
chr3	MUC20-OT1	195718026	195718196	0	171	188855	13794	188855	13623	0.0	13.862952359979447
chr3	MUC20-OT1	195708428	195708435	8	8	188855	13794	188847	13786	1.0	13.698462208037139
chr3	MUC20-OT1	195708428	195708555	634	128	188855	13794	188221	13666	4.953125	13.77294014342163
chr3	MUC20-OT1	195722500	195722818	611	319	188855	13794	188244	13475	1.915360501567398	13.969870129870129
chr3	MUC20-OT1	195717913	195718196	161	284	188855	13794	188694	13510	0.5669014084507042	13.96698741672835
chr3	MUC20-OT1	195729647	195729739	0	93	188855	13794	188855	13701	0.0	13.784030362747245
chr3	MUC20-OT1	195729342	195729551	0	210	188855	13794	188855	13584	0.0	13.902753239104829
chr3	MUC20-OT1	195718023	195718196	0	174	188855	13794	188855	13620	0.0	13.866005873715125
chr3	MUC20-OT1	195718043	195718196	0	154	188855	13794	188855	13640	0.0	13.845674486803519
chr3	MUC20-OT1	195715020	195715082	24	63	188855	13794	188831	13731	0.38095238095238093	13.752166630252713
chr3	SLC51A	196228808	196228920	95	113	20129	5092	20034	4979	0.8407079646017699	4.0236995380598515
chr3	PIGX	196728701	196728755	1110	55	45933	4459	44823	4404	20.181818181818183	10.177792915531334
chr3	PIGX	196726654	196726771	0	118	45933	4459	45933	4341	0.0	10.581202487906012
chr3	PIGX	196721176	196721356	0	181	45933	4459	45933	4278	0.0	10.737026647966339
chr3	PAK2	196827195	196827333	0	139	13897	6285	13897	6146	0.0	2.2611454604620893
chr3	SENP5	196885150	196886694	51	1545	51	6245	0	4700	0.03300970873786408	0.0
chr3	SENP5	196923413	196923551	0	139	51	6245	51	6106	0.0	0.008352440222731738
chr3	SENP5	196927795	196927879	0	85	51	6245	51	6160	0.0	0.008279220779220779
chr3	MELTF-AS1	197004096	197004359	0	264	102	1110	102	846	0.0	0.12056737588652482
chr3	FYTTD1	197770131	197770244	2375	114	12994	7912	10619	7798	20.833333333333332	1.3617594254937164
chr3	FYTTD1	197763465	197763638	0	174	12994	7912	12994	7738	0.0	1.679245283018868
chr3	FYTTD1	197755669	197755834	0	166	12994	7912	12994	7746	0.0	1.6775109734056286
chr3	LRCH3	197820324	197820430	0	107	0	12658	0	12551	0.0	0.0
chr3	LRCH3	197858833	197858905	0	73	0	12658	0	12585	0.0	0.0
chr3	LRCH3	197866111	197866219	0	109	0	12658	0	12549	0.0	0.0
chr3	LRCH3	197880511	197880757	0	247	0	12658	0	12411	0.0	0.0
chr3	LRCH3	197865422	197865471	0	50	0	12658	0	12608	0.0	0.0
chr3	RPL35A	197953487	197953660	153	174	5798	2565	5645	2391	0.8793103448275862	2.3609368465077374
chr3	LMLN	198003014	198003125	0	112	0	8699	0	8587	0.0	0.0
chr3	FRG2FP	198110643	198110732	0	90	0	1159	0	1069	0.0	0.0
chr3	FRG2FP	198110961	198111039	0	79	0	1159	0	1080	0.0	0.0
chr3	CHL1-AS2	196606	196702	0	97	0	3876	0	3779	0.0	0.0
chr3	CNTN4-AS1	3059214	3059380	0	167	0	2084	0	1917	0.0	0.0
chr3	IL5RA	3074781	3074866	0	86	51	6583	51	6497	0.0	0.007849776820070802
chr3	IL5RA	3105467	3105536	0	70	51	6583	51	6513	0.0	0.00783049286043298
chr3	CRBN	3152455	3152587	0	133	4911	7022	4911	6889	0.0	0.7128755987806649
chr3	CRBN	3175162	3175269	0	108	4911	7022	4911	6914	0.0	0.7102979461961239
chr3	CRBN	3175162	3175266	0	105	4911	7022	4911	6917	0.0	0.7099898800057829
chr3	SUMF1	4449265	4449340	0	76	48171	6965	48171	6889	0.0	6.992451734649441
chr3	SUMF1	4376329	4376389	0	61	48171	6965	48171	6904	0.0	6.9772595596755504
chr3	AC018816.1	4825745	4825862	0	118	1124	1261	1124	1143	0.0	0.9833770778652668
chr3	AC018816.1	4817432	4817551	0	120	1124	1261	1124	1141	0.0	0.9851007887817704
chr3	BHLHE40-AS1	4949558	4949698	0	141	2856	4557	2856	4416	0.0	0.6467391304347826
chr3	BHLHE40-AS1	4959197	4959385	0	189	2856	4557	2856	4368	0.0	0.6538461538461539
chr3	GRM7-AS3	6635086	6635197	0	112	725	3700	725	3588	0.0	0.2020624303232999
chr3	GRM7-AS3	6640933	6641066	0	134	725	3700	725	3566	0.0	0.20330902972518228
chr3	LMCD1-AS1	8194915	8195073	0	159	3629	11271	3629	11112	0.0	0.3265838732901368
chr3	LMCD1-AS1	8611493	8611639	0	147	3629	11271	3629	11124	0.0	0.32623157137720243
chr3	SSUH2	8634397	8634645	0	249	515	6307	515	6058	0.0	0.08501155496863651
chr3	SSUH2	8639947	8640069	0	123	515	6307	515	6184	0.0	0.08327943078913325
chr3	SSUH2	8659489	8659801	0	313	515	6307	515	5994	0.0	0.08591925258591926
chr3	SSUH2	8671893	8672035	0	143	515	6307	515	6164	0.0	0.08354964308890331
chr3	RAD18	8913643	8913720	0	78	5501	6999	5501	6921	0.0	0.7948273370900159
chr3	RAD18	8948508	8948570	0	63	5501	6999	5501	6936	0.0	0.7931084198385236
chr3	RAD18	8958919	8959001	0	83	5501	6999	5501	6916	0.0	0.795401966454598
chr3	SRGAP3	9032649	9032752	0	104	87176	18958	87176	18854	0.0	4.623740320356423
chr3	SRGAP3	9028099	9028130	0	32	87176	18958	87176	18926	0.0	4.60615026947057
chr3	SRGAP3	9014741	9014841	0	101	87176	18958	87176	18857	0.0	4.623004719732725
chr3	SRGAP3	9049260	9049469	0	210	87176	18958	87176	18748	0.0	4.649882654149776
chr3	SRGAP3	9330527	9330596	0	70	87176	18958	87176	18888	0.0	4.615417196103346
chr3	AC026191.1	9355800	9355859	0	60	51	1656	51	1596	0.0	0.03195488721804511
chr3	THUMPD3-AS1	9391426	9391826	6359	401	14563	6225	8204	5824	15.85785536159601	1.4086538461538463
chr3	THUMPD3-AS1	9391678	9391826	2170	149	14563	6225	12393	6076	14.563758389261745	2.0396642527978934
chr3	THUMPD3-AS1	9395505	9395579	51	75	14563	6225	14512	6150	0.68	2.3596747967479677
chr3	CAMK1	9759487	9759575	0	89	3944	2727	3944	2638	0.0	1.4950720242608035
chr3	CAMK1	9765758	9765890	0	133	3944	2727	3944	2594	0.0	1.520431765612953
chr3	CAMK1	9766124	9766213	0	90	3944	2727	3944	2637	0.0	1.4956389836935913
chr3	RPUSD3	9838984	9839171	50	188	720622	5249	720572	5061	0.26595744680851063	142.37739577158663
chr3	RPUSD3	9839031	9839171	3	141	720622	5249	720619	5108	0.02127659574468085	141.0765465935787
chr3	RPUSD3	9842198	9842243	0	46	720622	5249	720622	5203	0.0	138.50124927926197
chr3	RPUSD3	9843464	9843601	5788	138	720622	5249	714834	5111	41.94202898550725	139.86186656231658
chr3	CIDEC	9877065	9877219	18375	155	66180	1418	47805	1263	118.54838709677419	37.850356294536816
chr3	CIDEC	9870444	9870474	1772	31	66180	1418	64408	1387	57.16129032258065	46.43691420331651
chr3	CIDEC	9878941	9879054	0	114	66180	1418	66180	1304	0.0	50.75153374233129
chr3	EMC3	9981633	9981747	460	115	120480	4281	120020	4166	4.0	28.809409505520883
chr3	AC022007.1	10010170	10010402	3221	233	396562	4728	393341	4495	13.82403433476395	87.506340378198
chr3	GHRL	10286703	10286812	0	110	112255	2081	112255	1971	0.0	56.953323186199896
chr3	GHRL	10290072	10290209	338	138	112255	2081	111917	1943	2.449275362318841	57.60010293360782
chr3	GHRL	10290715	10291451	108220	737	112255	2081	4035	1344	146.83853459972863	3.002232142857143
chr3	GHRL	10290715	10290990	19949	276	112255	2081	92306	1805	72.27898550724638	51.139058171745155
chr3	GHRL	10289761	10289878	545	118	112255	2081	111710	1963	4.61864406779661	56.907794192562406
chr3	GHRL	10289761	10289875	542	115	112255	2081	111713	1966	4.71304347826087	56.822482197355036
chr3	GHRL	10290715	10290912	10287	198	112255	2081	101968	1883	51.95454545454545	54.15188528943176
chr3	SEC13	10319138	10319172	146	35	271117	4364	270971	4329	4.171428571428572	62.59436359436359
chr3	SEC13	10319138	10319316	1372	179	271117	4364	269745	4185	7.664804469273743	64.45519713261649
chr3	SEC13	10319256	10319316	114	61	271117	4364	271003	4303	1.8688524590163935	62.98001394376017
chr3	ATP2B2	10386479	10386512	0	34	555339	10290	555339	10256	0.0	54.14771840873635
chr3	ATP2B2	10331910	10332037	302	128	555339	10290	555037	10162	2.359375	54.61887423735485
chr3	ATP2B2	10331982	10332037	0	56	555339	10290	555339	10234	0.0	54.2641196013289
chr3	ATP2B2	10385267	10385327	74	61	555339	10290	555265	10229	1.2131147540983607	54.283409912992475
chr3	ATP2B2	10338725	10338915	804	191	555339	10290	554535	10099	4.209424083769633	54.909892068521636
chr3	ATP2B2	10379242	10379284	30	43	555339	10290	555309	10247	0.6976744186046512	54.19234898018932
chr3	ATP2B2	10336128	10336300	5050	173	555339	10290	550289	10117	29.190751445086704	54.39250766037363
chr3	VGLL4	11671261	11671394	2290	134	29745	7253	27455	7119	17.08955223880597	3.856580980474786
chr3	VGLL4	11693044	11693163	0	120	29745	7253	29745	7133	0.0	4.170054675452124
chr3	TAMM41	11807832	11807895	0	64	27364	5499	27364	5435	0.0	5.034774609015639
chr3	TAMM41	11833002	11833151	11005	150	27364	5499	16359	5349	73.36666666666666	3.058328659562535
chr3	TAMM41	11830721	11830874	0	154	27364	5499	27364	5345	0.0	5.11955098222638
chr3	TAMM41	11844890	11845096	946	207	27364	5499	26418	5292	4.570048309178744	4.992063492063492
chr3	MKRN2OS	12543179	12543229	111	51	49295	3058	49184	3007	2.176470588235294	16.356501496508148
chr3	RAF1	12606200	12606299	287	100	18014	7443	17727	7343	2.87	2.4141359117526897
chr3	RAF1	12611949	12612062	0	114	18014	7443	18014	7329	0.0	2.457906945012962
chr3	RAF1	12603477	12603537	0	61	18014	7443	18014	7382	0.0	2.440260092115958
chr3	TMEM40	12743899	12743989	0	91	153	3311	153	3220	0.0	0.04751552795031056
chr3	TMEM40	12748654	12748792	0	139	153	3311	153	3172	0.0	0.04823455233291299
chr3	IQSEC1	12902772	12902822	0	51	81891	10028	81891	9977	0.0	8.207978350205472
chr3	CHCHD4	14121916	14122086	0	171	12	1777	12	1606	0.0	0.007471980074719801
chr3	XPC	14168256	14168380	6347	125	53769	4652	47422	4527	50.776	10.475370002208969
chr3	MRPS25	15053379	15053467	1470	89	2775	4677	1305	4588	16.51685393258427	0.28443766346992155
chr3	MRPS25	15053290	15053467	1470	178	2775	4677	1305	4499	8.258426966292134	0.29006445876861525
chr3	RBSN	15082366	15082608	3048	243	217482	7927	214434	7684	12.54320987654321	27.906559083810514
chr3	RBSN	15098118	15098274	5618	157	217482	7927	211864	7770	35.78343949044586	27.266924066924066
chr3	RBSN	15091338	15091493	34742	156	217482	7927	182740	7771	222.7051282051282	23.51563505340368
chr3	COL6A4P1	15173455	15174061	0	607	51	4580	51	3973	0.0	0.012836647369745784
chr3	SH3BP5	15271600	15271671	0	72	10810	4631	10810	4559	0.0	2.3711340206185567
chr3	SH3BP5	15273115	15273405	51	291	10810	4631	10759	4340	0.17525773195876287	2.479032258064516
chr3	METTL6	15411244	15411437	0	194	32127	6989	32127	6795	0.0	4.7280353200883
chr3	METTL6	15424954	15425089	3426	136	32127	6989	28701	6853	25.191176470588236	4.188092806070334
chr3	METTL6	15415497	15415583	0	87	32127	6989	32127	6902	0.0	4.6547377571718345
chr3	METTL6	15414729	15414914	0	186	32127	6989	32127	6803	0.0	4.722475378509481
chr3	COLQ	15488205	15488307	21	103	45173	3998	45152	3895	0.20388349514563106	11.59229781771502
chr3	HACL1	15571667	15571769	0	103	2837	2788	2837	2685	0.0	1.056610800744879
chr3	HACL1	15574976	15575082	0	107	2837	2788	2837	2681	0.0	1.0581872435658337
chr3	HACL1	15586524	15586602	1053	79	2837	2788	1784	2709	13.329113924050633	0.658545588778147
chr3	HACL1	15589539	15589612	0	74	2837	2788	2837	2714	0.0	1.0453205600589537
chr3	HACL1	15591599	15591680	0	82	2837	2788	2837	2706	0.0	1.048410938654841
chr3	HACL1	15585247	15585342	0	96	2837	2788	2837	2692	0.0	1.0538632986627043
chr3	ANKRD28	15714577	15714656	663	80	169885	11300	169222	11220	8.2875	15.08217468805704
chr3	ANKRD28	15751749	15751820	29	72	169885	11300	169856	11228	0.4027777777777778	15.127894549340933
chr3	ANKRD28	15814239	15814309	143	71	169885	11300	169742	11229	2.0140845070422535	15.116395048535043
chr3	DPH3	16264154	16264229	0	76	0	4480	0	4404	0.0	0.0
chr3	RFTN1	16416111	16416211	0	101	13001	4790	13001	4689	0.0	2.7726594156536577
chr3	TBC1D5	17291894	17292001	0	108	1526	11311	1526	11203	0.0	0.1362135142372579
chr3	TBC1D5	17428449	17428519	0	71	1526	11311	1526	11240	0.0	0.13576512455516015
chr3	TBC1D5	17562018	17562142	0	125	1526	11311	1526	11186	0.0	0.13642052565707133
chr3	TBC1D5	17233684	17233750	0	67	1526	11311	1526	11244	0.0	0.13571682675204552
chr3	TBC1D5	17518901	17518995	0	95	1526	11311	1526	11216	0.0	0.13605563480741797
chr3	TBC1D5	17623848	17623913	0	66	1526	11311	1526	11245	0.0	0.1357047576700756
chr3	TBC1D5	17622647	17622765	0	119	1526	11311	1526	11192	0.0	0.13634739099356682
chr3	TBC1D5	17576413	17576549	255	137	1526	11311	1271	11174	1.8613138686131387	0.11374619652765348
chr3	TBC1D5	17547015	17547076	0	62	1526	11311	1526	11249	0.0	0.1356565028002489
chr3	SATB1	18351312	18351408	0	97	51	11420	51	11323	0.0	0.004504106685507375
chr3	SATB1	18436788	18436871	0	84	51	11420	51	11336	0.0	0.00449894142554693
chr3	EFHB	19888443	19888651	0	209	99	4179	99	3970	0.0	0.024937027707808566
chr3	EFHB	19920504	19920567	0	64	99	4179	99	4115	0.0	0.024058323207776428
chr3	SGO1	20174248	20175055	0	808	11442	3751	11442	2943	0.0	3.887869520897044
chr3	SGO1	20175004	20175055	0	52	11442	3751	11442	3699	0.0	3.0932684509326847
chr3	ZNF385D	21441685	21441742	0	58	1938	13099	1938	13041	0.0	0.1486082355647573
chr3	ZNF385D	21459331	21459449	0	119	1938	13099	1938	12980	0.0	0.14930662557781202
chr3	ZNF385D	21511621	21511757	0	137	1938	13099	1938	12962	0.0	0.14951396389446073
chr3	NKIRAS1	23911328	23911450	0	123	7155	2968	7155	2845	0.0	2.51493848857645
chr3	NKIRAS1	23911328	23911446	0	119	7155	2968	7155	2849	0.0	2.5114075114075116
chr3	THRB	24228937	24229001	0	65	1326	10954	1326	10889	0.0	0.1217742676095142
chr3	THRB	24297225	24297371	0	147	1326	10954	1326	10807	0.0	0.12269825113352456
chr3	THRB	24483922	24484095	0	174	1326	10954	1326	10780	0.0	0.12300556586270872
chr3	THRB	24237990	24238081	0	92	1326	10954	1326	10862	0.0	0.12207696556803535
chr3	THRB	24297225	24297323	0	99	1326	10954	1326	10855	0.0	0.12215568862275449
chr3	THRB	24318357	24318494	0	138	1326	10954	1326	10816	0.0	0.12259615384615384
chr3	THRB	24430100	24430172	0	73	1326	10954	1326	10881	0.0	0.12186379928315412
chr3	THRB	24348557	24348614	0	58	1326	10954	1326	10896	0.0	0.12169603524229075
chr3	TOP2B	25618417	25618509	0	93	6051	6082	6051	5989	0.0	1.0103523125730507
chr3	NGLY1	25720013	25720191	0	179	9869	6316	9869	6137	0.0	1.6081147140296561
chr3	NGLY1	25732318	25732483	0	166	9869	6316	9869	6150	0.0	1.6047154471544716
chr3	NGLY1	25739576	25739799	0	224	9869	6316	9869	6092	0.0	1.6199934340118187
chr3	NGLY1	25740402	25740450	0	49	9869	6316	9869	6267	0.0	1.5747566618796873
chr3	NGLY1	25737333	25737455	0	123	9869	6316	9869	6193	0.0	1.593573389310512
chr3	NGLY1	25736003	25736149	0	147	9869	6316	9869	6169	0.0	1.5997730588426
chr3	NGLY1	25720129	25720191	0	63	9869	6316	9869	6253	0.0	1.5782824244362705
chr3	NGLY1	25761677	25761708	2045	32	9869	6316	7824	6284	63.90625	1.24506683640993
chr3	NEK10	27143444	27143474	0	31	12251	7836	12251	7805	0.0	1.5696348494554773
chr3	NEK10	27162460	27162601	0	142	12251	7836	12251	7694	0.0	1.5922796984663374
chr3	NEK10	27290616	27290754	204	139	12251	7836	12047	7697	1.4676258992805755	1.5651552552942705
chr3	NEK10	27363686	27363844	0	159	12251	7836	12251	7677	0.0	1.5958056532499674
chr3	NEK10	27367522	27367562	0	41	12251	7836	12251	7795	0.0	1.5716484926234766
chr3	SLC4A7	27409355	27409530	2373	176	91932	9251	89559	9075	13.482954545454545	9.868760330578512
chr3	SLC4A7	27421621	27421779	51	159	91932	9251	91881	9092	0.32075471698113206	10.105697316322042
chr3	SLC4A7	27379248	27379356	0	109	91932	9251	91932	9142	0.0	10.056005250492234
chr3	SLC4A7	27431297	27431669	36914	373	91932	9251	55018	8878	98.9651474530831	6.197116467672899
chr3	SLC4A7	27422780	27422840	503	61	91932	9251	91429	9190	8.245901639344263	9.948748639825897
chr3	LINC01967	28010469	28010564	0	96	0	2810	0	2714	0.0	0.0
chr3	AZI2	28341511	28341647	0	137	3337	6285	3337	6148	0.0	0.5427781392322707
chr3	AZI2	28341511	28341596	0	86	3337	6285	3337	6199	0.0	0.5383126310695273
chr3	RBMS3-AS3	29274281	29274424	0	144	0	5926	0	5782	0.0	0.0
chr3	OSBPL10	31830039	31830231	0	193	380467	12095	380467	11902	0.0	31.966644261468662
chr3	OSBPL10	31879654	31879830	0	177	380467	12095	380467	11918	0.0	31.923728813559322
chr3	OSBPL10	31797754	31797841	0	88	380467	12095	380467	12007	0.0	31.687099192137918
chr3	DYNC1LI1	32566612	32566735	0	124	7729	5790	7729	5666	0.0	1.364101659018708
chr3	GLB1	33058088	33058269	72081	182	74738	4250	2657	4068	396.04945054945057	0.6531465093411996
chr3	GLB1	33072543	33072713	0	171	74738	4250	74738	4079	0.0	18.322628095121352
chr3	GLB1	33065462	33065557	47	96	74738	4250	74691	4154	0.4895833333333333	17.980500722195476
chr3	GLB1	33077093	33077237	1053	145	74738	4250	73685	4105	7.2620689655172415	17.95006090133983
chr3	SUSD5	33174885	33175074	0	190	434	4607	434	4417	0.0	0.098256735340729
chr3	UBP1	33408689	33408797	0	109	25954	7661	25954	7552	0.0	3.436705508474576
chr3	UBP1	33396744	33396878	0	135	25954	7661	25954	7526	0.0	3.44857826202498
chr3	CLASP2	33510557	33510764	0	208	27199	15265	27199	15057	0.0	1.806402337783091
chr3	CLASP2	33574472	33574496	0	25	27199	15265	27199	15240	0.0	1.784711286089239
chr3	CLASP2	33577201	33577264	0	64	27199	15265	27199	15201	0.0	1.7892901782777448
chr3	CLASP2	33563963	33563966	0	4	27199	15265	27199	15261	0.0	1.7822554223183278
chr3	CLASP2	33566731	33566734	0	4	27199	15265	27199	15261	0.0	1.7822554223183278
chr3	CLASP2	33514579	33514679	0	101	27199	15265	27199	15164	0.0	1.7936560274333948
chr3	CLASP2	33559124	33559175	0	52	27199	15265	27199	15213	0.0	1.7878787878787878
chr3	CLASP2	33658973	33659009	0	37	27199	15265	27199	15228	0.0	1.7861176779616497
chr3	TRANK1	36838371	36838504	0	134	5569	12161	5569	12027	0.0	0.46304148998087635
chr3	TRANK1	36908322	36908454	0	133	5569	12161	5569	12028	0.0	0.46300299301629533
chr3	TRANK1	36850153	36851417	0	1265	5569	12161	5569	10896	0.0	0.5111049926578561
chr3	TRANK1	36929314	36929415	0	102	5569	12161	5569	12059	0.0	0.4618127539596982
chr3	TRANK1	36834386	36834475	0	90	5569	12161	5569	12071	0.0	0.4613536575263027
chr3	LRRFIP2	37066223	37066325	0	103	409188	10009	409188	9906	0.0	41.30708661417323
chr3	LRRFIP2	37072789	37072882	0	94	409188	10009	409188	9915	0.0	41.2695915279879
chr3	LRRFIP2	37091466	37091538	1173	73	409188	10009	408015	9936	16.068493150684933	41.0643115942029
chr3	LRRFIP2	37115053	37115095	386	43	409188	10009	408802	9966	8.976744186046512	41.01966686734899
chr3	LRRFIP2	37127629	37127680	0	52	409188	10009	409188	9957	0.0	41.09551069599277
chr3	LRRFIP2	37121634	37121691	0	58	409188	10009	409188	9951	0.0	41.12028941814893
chr3	LRRFIP2	37154613	37154656	0	44	409188	10009	409188	9965	0.0	41.0625188158555
chr3	ITGA9-AS1	37808703	37808880	0	178	6374	14074	6374	13896	0.0	0.4586931491076569
chr3	ITGA9-AS1	37821013	37821100	0	88	6374	14074	6374	13986	0.0	0.45574145574145575
chr3	ITGA9-AS1	37728429	37728530	0	102	6374	14074	6374	13972	0.0	0.45619811050672776
chr3	ITGA9-AS1	37834678	37834767	0	90	6374	14074	6374	13984	0.0	0.4558066361556064
chr3	ITGA9-AS1	37749535	37749664	0	130	6374	14074	6374	13944	0.0	0.45711417096959267
chr3	ITGA9-AS1	37806078	37806185	0	108	6374	14074	6374	13966	0.0	0.4563940999570385
chr3	ITGA9-AS1	37790842	37790911	0	70	6374	14074	6374	14004	0.0	0.4551556698086261
chr3	ITGA9-AS1	37818809	37818930	0	122	6374	14074	6374	13952	0.0	0.4568520642201835
chr3	ITGA9-AS1	37806078	37806228	0	151	6374	14074	6374	13923	0.0	0.4578036342742225
chr3	ITGA9-AS1	37851423	37851492	37	70	6374	14074	6337	14004	0.5285714285714286	0.45251356755212796
chr3	ITGA9-AS1	37818679	37818930	0	252	6374	14074	6374	13822	0.0	0.4611488930690204
chr3	ACAA1	38133951	38134009	0	59	582	6653	582	6594	0.0	0.08826205641492266
chr3	ACAA1	38131925	38132005	0	81	582	6653	582	6572	0.0	0.08855751673767498
chr3	ACAA1	38126161	38126341	0	181	582	6653	582	6472	0.0	0.08992583436341162
chr3	ACAA1	38129289	38129388	0	100	582	6653	582	6553	0.0	0.08881428353425912
chr3	ACAA1	38131595	38131638	0	44	582	6653	582	6609	0.0	0.08806173399909215
chr3	ACAA1	38134508	38134552	0	45	582	6653	582	6608	0.0	0.08807506053268765
chr3	SCN5A	38579333	38579495	2331	163	29446	10059	27115	9896	14.300613496932515	2.7399959579628135
chr3	SCN5A	38557230	38557284	0	55	29446	10059	29446	10004	0.0	2.943422630947621
chr3	SCN5A	38579333	38579492	2262	160	29446	10059	27184	9899	14.1375	2.7461359733306394
chr3	SCN11A	38886124	38886238	0	115	84	11921	84	11806	0.0	0.007115026257834999
chr3	SCN11A	38896844	38897225	0	382	84	11921	84	11539	0.0	0.007279660282520149
chr3	SCN11A	38921075	38921255	0	181	84	11921	84	11740	0.0	0.007155025553662692
chr3	SCN11A	38960784	38960847	0	64	84	11921	84	11857	0.0	0.007084422703887999
chr3	SCN11A	38848072	38848151	0	80	84	11921	84	11841	0.0	0.00709399543957436
chr3	SCN11A	38892085	38892139	0	55	84	11921	84	11866	0.0	0.007079049384796899
chr3	SCN11A	38947042	38947086	0	45	84	11921	84	11876	0.0	0.007073088582014146
chr3	GORASP1	39100746	39100877	1428	132	45177	5965	43749	5833	10.818181818181818	7.50025715755186
chr3	GORASP1	39100304	39100454	0	151	45177	5965	45177	5814	0.0	7.770381836945305
chr3	GORASP1	39101509	39101570	0	62	45177	5965	45177	5903	0.0	7.6532271726240895
chr3	XIRP1	39186088	39189525	11051	3438	92342	6469	81291	3031	3.214368819080861	26.81986143187067
chr3	EIF1B-AS1	40248183	40248471	0	289	19636	19255	19636	18966	0.0	1.0353263735104925
chr3	ENTPD3-AS1	40451704	40451782	0	79	102	5559	102	5480	0.0	0.018613138686131386
chr3	ULK4	41954621	41954807	66	187	299444	6325	299378	6138	0.35294117647058826	48.774519387422615
chr3	ULK4	41937228	41937340	0	113	299444	6325	299444	6212	0.0	48.204121056020604
chr3	ULK4	41937294	41937340	0	47	299444	6325	299444	6278	0.0	47.69735584581077
chr3	VIPR1-AS1	42511714	42511909	0	196	29	4487	29	4291	0.0	0.006758331391284083
chr3	VIPR1-AS1	42516781	42516836	0	56	29	4487	29	4431	0.0	0.0065447980139923265
chr3	VIPR1-AS1	42530859	42530958	0	100	29	4487	29	4387	0.0	0.006610439936175063
chr3	VIPR1-AS1	42508811	42508935	0	125	29	4487	29	4362	0.0	0.006648326455754241
chr3	VIPR1-AS1	42512057	42512292	0	236	29	4487	29	4251	0.0	0.006821924253116914
chr3	VIPR1-AS1	42521476	42521577	0	102	29	4487	29	4385	0.0	0.0066134549600912204
chr3	VIPR1-AS1	42528548	42528658	0	111	29	4487	29	4376	0.0	0.0066270566727605115
chr3	VIPR1-AS1	42512057	42512311	0	255	29	4487	29	4232	0.0	0.006852551984877127
chr3	VIPR1-AS1	42507892	42508006	29	115	29	4487	0	4372	0.25217391304347825	0.0
chr3	VIPR1-AS1	42509184	42509371	0	188	29	4487	29	4299	0.0	0.006745754826703885
chr3	VIPR1-AS1	42530576	42530602	0	27	29	4487	29	4460	0.0	0.006502242152466368
chr3	VIPR1-AS1	42530859	42531052	0	194	29	4487	29	4293	0.0	0.006755182855811786
chr3	VIPR1-AS1	42529339	42529461	0	123	29	4487	29	4364	0.0	0.006645279560036663
chr3	SEC22C	42555929	42555995	0	67	1438	8177	1438	8110	0.0	0.1773119605425401
chr3	SEC22C	42563764	42563880	0	117	1438	8177	1438	8060	0.0	0.1784119106699752
chr3	SEC22C	42563764	42563980	0	217	1438	8177	1438	7960	0.0	0.1806532663316583
chr3	SEC22C	42566743	42566836	0	94	1438	8177	1438	8083	0.0	0.1779042434739577
chr3	SEC22C	42565775	42565883	0	109	1438	8177	1438	8068	0.0	0.1782350024789291
chr3	SEC22C	42580442	42580505	0	64	1438	8177	1438	8113	0.0	0.1772463946752126
chr3	AC006059.1	42632628	42632695	0	68	27883	3108	27883	3040	0.0	9.17203947368421
chr3	HHATL	42698707	42698902	0	196	53252	2901	53252	2705	0.0	19.686506469500923
chr3	HHATL	42701131	42701190	4761	60	53252	2901	48491	2841	79.35	17.068285814853926
chr3	CCDC13	42730466	42730589	0	124	197927	7092	197927	6968	0.0	28.405137772675086
chr3	HIGD1A	42786027	42786162	51	136	323	3029	272	2893	0.375	0.09402004839267197
chr3	HIGD1A	42794156	42794275	272	120	323	3029	51	2909	2.2666666666666666	0.017531797868683398
chr3	HIGD1A	42794156	42794299	272	144	323	3029	51	2885	1.8888888888888888	0.017677642980935875
chr3	POMGNT2	43090487	43090609	0	123	5956	2674	5956	2551	0.0	2.3347706781654254
chr3	ANO10	43576691	43577261	0	571	30451	5236	30451	4665	0.0	6.527545551982851
chr3	ANO10	43600383	43600581	0	199	30451	5236	30451	5037	0.0	6.0454635695850705
chr3	ANO10	43598531	43598666	0	136	30451	5236	30451	5100	0.0	5.97078431372549
chr3	ANO10	43551471	43551588	0	118	30451	5236	30451	5118	0.0	5.9497850722938646
chr3	ANO10	43618019	43618086	0	68	30451	5236	30451	5168	0.0	5.892221362229102
chr3	ANO10	43652946	43653040	0	95	30451	5236	30451	5141	0.0	5.923166699085781
chr3	ZNF445	44458243	44458364	0	122	101412	18652	101412	18530	0.0	5.472854830005397
chr3	ZNF852	44502964	44503056	0	93	6016	2285	6016	2192	0.0	2.7445255474452557
chr3	ZDHHC3	44959130	44959460	1172	331	12115	12129	10943	11798	3.540785498489426	0.9275300898457366
chr3	ZDHHC3	44932906	44932990	0	85	12115	12129	12115	12044	0.0	1.0058950514779144
chr3	ZDHHC3	44958587	44958685	1863	99	12115	12129	10252	12030	18.818181818181817	0.8522028262676642
chr3	SLC6A20	45772504	45772615	989	112	18744	4633	17755	4521	8.830357142857142	3.927228489272285
chr3	SLC6A20	45782082	45782223	630	142	18744	4633	18114	4491	4.436619718309859	4.0334001336005345
chr3	LZTFL1	45827355	45827459	0	105	219	7195	219	7090	0.0	0.0308885754583921
chr3	LZTFL1	45831072	45831138	0	67	219	7195	219	7128	0.0	0.030723905723905723
chr3	LZTFL1	45837926	45838051	0	126	219	7195	219	7069	0.0	0.03098033668128448
chr3	LZTFL1	45854985	45855074	0	90	219	7195	219	7105	0.0	0.030823363828289936
chr3	LZTFL1	45837926	45838047	0	122	219	7195	219	7073	0.0	0.03096281634384278
chr3	FYCO1	45938195	45938255	0	61	25745	8909	25745	8848	0.0	2.9096971066907775
chr3	XCR1	46022155	46022277	153	123	12922	5168	12769	5045	1.2439024390243902	2.5310208126858273
chr3	LTF	46460564	46460597	0	34	408	3990	408	3956	0.0	0.10313447927199192
chr3	LRRC2	46551466	46551610	0	145	370	5644	370	5499	0.0	0.06728496090198217
chr3	PRSS46P	46732819	46732852	0	34	0	1020	0	986	0.0	0.0
chr3	PRSS43P	46755409	46755672	0	264	0	1677	0	1413	0.0	0.0
chr3	PRSS43P	46756404	46756629	0	226	0	1677	0	1451	0.0	0.0
chr3	PRSS44P	46810155	46810310	4	156	4	1079	0	923	0.02564102564102564	0.0
chr3	CCDC12	46976937	46977040	102	104	838	3358	736	3254	0.9807692307692307	0.22618315918869084
chr3	SETD2	47080915	47081083	0	169	78047	10270	78047	10101	0.0	7.726660726660727
chr3	SETD2	47119451	47119780	2156	330	78047	10270	75891	9940	6.533333333333333	7.634909456740442
chr3	SETD2	47105996	47106120	0	125	78047	10270	78047	10145	0.0	7.69314933464761
chr3	SETD2	47064554	47064630	33	77	78047	10270	78014	10193	0.42857142857142855	7.653683900716178
chr3	KIF9	47243050	47243245	2769	196	19379	5311	16610	5115	14.127551020408163	3.247311827956989
chr3	KIF9	47271236	47271461	0	226	19379	5311	19379	5085	0.0	3.8110127826941986
chr3	KIF9	47273551	47273658	448	108	19379	5311	18931	5203	4.148148148148148	3.638477801268499
chr3	KIF9	47282139	47282385	562	247	19379	5311	18817	5064	2.2753036437246963	3.7158372827804107
chr3	KIF9	47263832	47263899	0	68	19379	5311	19379	5243	0.0	3.6961663169940873
chr3	KIF9	47280951	47281195	872	245	19379	5311	18507	5066	3.559183673469388	3.6531780497433872
chr3	SCAP	47423932	47424045	0	114	19569	6315	19569	6201	0.0	3.1557813255926463
chr3	ELP6	47510183	47510254	149	72	6259	3043	6110	2971	2.0694444444444446	2.056546617300572
chr3	ELP6	47511147	47511226	0	80	6259	3043	6259	2963	0.0	2.1123860951738105
chr3	ELP6	47510148	47510254	273	107	6259	3043	5986	2936	2.5514018691588785	2.0388283378746594
chr3	ELP6	47503124	47503449	0	326	6259	3043	6259	2717	0.0	2.3036437246963564
chr3	CSPG5	47569151	47569227	0	77	0	3353	0	3276	0.0	0.0
chr3	CSPG5	47569070	47569227	0	158	0	3353	0	3195	0.0	0.0
chr3	SMARCC1	47738028	47738110	0	83	104354	7655	104354	7572	0.0	13.781563655573164
chr3	MAP4	47853162	47853352	0	191	814302	14847	814302	14656	0.0	55.560998908296945
chr3	MAP4	47871226	47871286	804	61	814302	14847	813498	14786	13.180327868852459	55.01812525361829
chr3	MAP4	47875684	47875900	969	217	814302	14847	813333	14630	4.465437788018433	55.593506493506496
chr3	MAP4	47869213	47869327	51	115	814302	14847	814251	14732	0.4434782608695652	55.270906869399944
chr3	MAP4	47921764	47921878	0	115	814302	14847	814302	14732	0.0	55.274368721151234
chr3	MAP4	47909037	47912421	304295	3385	814302	14847	510007	11462	89.89512555391433	44.49546326993544
chr3	MAP4	47987382	47987433	0	52	814302	14847	814302	14795	0.0	55.03899966204799
chr3	MAP4	47867245	47867338	84	94	814302	14847	814218	14753	0.8936170212765957	55.189995255202334
chr3	MAP4	48013474	48013517	66	44	814302	14847	814236	14803	1.5	55.00479632506924
chr3	CDC25A	48180720	48180840	0	121	13	4148	13	4027	0.0	0.00322820958529923
chr3	NME6	48295074	48295235	0	162	29559	6219	29559	6057	0.0	4.8801386825160975
chr3	NME6	48298426	48298523	744	98	29559	6219	28815	6121	7.591836734693878	4.707564123509231
chr3	NME6	48296118	48296158	0	41	29559	6219	29559	6178	0.0	4.784558109420525
chr3	NME6	48300430	48300634	0	205	29559	6219	29559	6014	0.0	4.915031592949783
chr3	NME6	48300526	48300634	0	109	29559	6219	29559	6110	0.0	4.837806873977087
chr3	NME6	48296118	48296236	0	119	29559	6219	29559	6100	0.0	4.845737704918033
chr3	NME6	48300276	48300723	0	448	29559	6219	29559	5771	0.0	5.121989256627967
chr3	PLXNB1	48418916	48419039	0	124	3101	9551	3101	9427	0.0	0.3289487641879707
chr3	PLXNB1	48420223	48420257	0	35	3101	9551	3101	9516	0.0	0.3258722152164775
chr3	SHISA5	48476819	48477091	990	273	46564	4383	45574	4110	3.6263736263736264	11.088564476885646
chr3	SHISA5	48503094	48503193	591	100	46564	4383	45973	4283	5.91	10.73383142657016
chr3	SHISA5	48502320	48502452	6890	133	46564	4383	39674	4250	51.80451127819549	9.335058823529412
chr3	SHISA5	48502320	48502543	7954	224	46564	4383	38610	4159	35.50892857142857	9.283481606155325
chr3	PFKFB4	48525564	48525669	231	106	63246	6039	63015	5933	2.1792452830188678	10.62110230911849
chr3	PFKFB4	48556085	48556233	3889	149	63246	6039	59357	5890	26.100671140939596	10.077589134125637
chr3	PFKFB4	48556085	48556222	3533	138	63246	6039	59713	5901	25.60144927536232	10.119132350449076
chr3	UQCRC1	48605769	48605856	0	88	13227	3165	13227	3077	0.0	4.298667533311667
chr3	SLC26A6	48628621	48628714	0	94	32383	4986	32383	4892	0.0	6.619582992641047
chr3	SLC26A6	48632244	48632396	0	153	32383	4986	32383	4833	0.0	6.7003931305607285
chr3	SLC26A6	48631879	48632092	537	214	32383	4986	31846	4772	2.5093457943925235	6.673512154233026
chr3	SLC26A6	48632244	48632337	0	94	32383	4986	32383	4892	0.0	6.619582992641047
chr3	NCKIPSD	48679376	48679457	3749	82	207177	3266	203428	3184	45.71951219512195	63.89070351758794
chr3	IP6K2	48693269	48693338	1663	70	162572	5121	160909	5051	23.757142857142856	31.856860027717282
chr3	IP6K2	48711366	48711459	22998	94	162572	5121	139574	5027	244.6595744680851	27.764869703600557
chr3	IP6K2	48708119	48708237	0	119	162572	5121	162572	5002	0.0	32.50139944022391
chr3	IP6K2	48715314	48715527	2295	214	162572	5121	160277	4907	10.72429906542056	32.662930507438354
chr3	IP6K2	48694458	48694525	2020	68	162572	5121	160552	5053	29.705882352941178	31.773599841678212
chr3	IP6K2	48694693	48694824	6242	132	162572	5121	156330	4989	47.28787878787879	31.33493686109441
chr3	IP6K2	48715388	48715527	1988	140	162572	5121	160584	4981	14.2	32.239309375627386
chr3	IP6K2	48694701	48694824	6110	124	162572	5121	156462	4997	49.274193548387096	31.311186712027215
chr3	IP6K2	48716431	48716477	1619	47	162572	5121	160953	5074	34.4468085106383	31.721127315727237
chr3	PRKAR2A	48752175	48752317	0	143	4695	2432	4695	2289	0.0	2.051114023591088
chr3	PRKAR2A	48756378	48756444	0	67	4695	2432	4695	2365	0.0	1.985200845665962
chr3	PRKAR2A	48807648	48807684	0	37	4695	2432	4695	2395	0.0	1.9603340292275575
chr3	SLC25A20	48895754	48895815	0	62	3727	1908	3727	1846	0.0	2.0189599133261105
chr3	DALRD3	49016611	49016673	959	63	342932	2755	341973	2692	15.222222222222221	127.03306092124814
chr3	DALRD3	49018399	49018553	187	155	342932	2755	342745	2600	1.206451612903226	131.825
chr3	IMPDH2	49028247	49028322	4312	76	74898	4064	70586	3988	56.73684210526316	17.699598796389168
chr3	IMPDH2	49025994	49026066	338	73	74898	4064	74560	3991	4.63013698630137	18.68203457780005
chr3	IMPDH2	49028198	49028322	4461	125	74898	4064	70437	3939	35.688	17.881949733434883
chr3	QRICH1	49092396	49092456	52	61	83090	3888	83038	3827	0.8524590163934426	21.697935719885027
chr3	QARS1	49097991	49098117	0	127	803	3938	803	3811	0.0	0.2107058514825505
chr3	QARS1	49098191	49098258	0	68	803	3938	803	3870	0.0	0.20749354005167958
chr3	QARS1	49101354	49101441	0	88	803	3938	803	3850	0.0	0.20857142857142857
chr3	QARS1	49101619	49101705	0	87	803	3938	803	3851	0.0	0.20851726824201505
chr3	QARS1	49104323	49104471	0	149	803	3938	803	3789	0.0	0.21192926893639483
chr3	QARS1	49097109	49097287	0	179	803	3938	803	3759	0.0	0.21362064378824155
chr3	QARS1	49097133	49097287	0	155	803	3938	803	3783	0.0	0.21226539783240814
chr3	QARS1	49104372	49104471	0	100	803	3938	803	3838	0.0	0.2092235539343408
chr3	QARS1	49097991	49098092	0	102	803	3938	803	3836	0.0	0.20933263816475495
chr3	QARS1	49104356	49104471	0	116	803	3938	803	3822	0.0	0.21009942438513868
chr3	QARS1	49098191	49098251	0	61	803	3938	803	3877	0.0	0.20711890637090533
chr3	QARS1	49104616	49104698	297	83	803	3938	506	3855	3.5783132530120483	0.13125810635538263
chr3	QARS1	49104323	49104465	0	143	803	3938	803	3795	0.0	0.21159420289855072
chr3	USP19	49117436	49117570	0	135	47512	5602	47512	5467	0.0	8.690689592098042
chr3	USP19	49117058	49117361	0	304	47512	5602	47512	5298	0.0	8.96791241978105
chr3	USP4	49278813	49278902	0	90	41665	7226	41665	7136	0.0	5.838705156950673
chr3	USP4	49300466	49300691	102	226	41665	7226	41563	7000	0.45132743362831856	5.937571428571428
chr3	USP4	49311513	49311654	4999	142	41665	7226	36666	7084	35.20422535211268	5.175889328063241
chr3	USP4	49335468	49335596	142	129	41665	7226	41523	7097	1.1007751937984496	5.850782020572073
chr3	RHOA	49368427	49368548	0	122	381001	4270	381001	4148	0.0	91.85173577627772
chr3	RHOA	49362495	49362626	0	132	381001	4270	381001	4138	0.0	92.07370710488159
chr3	RHOA	49360927	49361066	15092	140	381001	4270	365909	4130	107.8	88.59782082324455
chr3	RHOA	49406711	49406806	32	96	381001	4270	380969	4174	0.3333333333333333	91.27192141830379
chr3	AMT	49417817	49417973	46	157	2924	4678	2878	4521	0.2929936305732484	0.6365848263658482
chr3	AMT	49419259	49419405	0	147	2924	4678	2924	4531	0.0	0.6453321562568969
chr3	AMT	49420210	49420342	0	133	2924	4678	2924	4545	0.0	0.6433443344334433
chr3	AMT	49421491	49421572	47	82	2924	4678	2877	4596	0.573170731707317	0.6259791122715405
chr3	NICN1	49425882	49425996	0	115	10191	2933	10191	2818	0.0	3.6163946061036194
chr3	AMT	49422103	49422271	0	169	2924	4678	2924	4509	0.0	0.6484808161454868
chr3	AMT	49422103	49422257	0	155	2924	4678	2924	4523	0.0	0.6464735794826443
chr3	AMT	49418970	49419151	136	182	2924	4678	2788	4496	0.7472527472527473	0.6201067615658363
chr3	AMT	49420214	49420342	0	129	2924	4678	2924	4549	0.0	0.6427786326665201
chr3	AMT	49421981	49422049	0	69	2924	4678	2924	4609	0.0	0.6344109351269256
chr3	AMT	49419259	49419335	0	77	2924	4678	2924	4601	0.0	0.6355140186915887
chr3	AMT	49419259	49419393	0	135	2924	4678	2924	4543	0.0	0.6436275588817961
chr3	AMT	49419709	49419788	0	80	2924	4678	2924	4598	0.0	0.6359286646367986
chr3	AMT	49417932	49417973	42	42	2924	4678	2882	4636	1.0	0.6216566005176877
chr3	AMT	49421959	49422049	10	91	2924	4678	2914	4587	0.10989010989010989	0.6352735993023763
chr3	MST1	49687363	49687478	0	116	3710	4051	3710	3935	0.0	0.9428208386277002
chr3	MST1	49687749	49687897	0	149	3710	4051	3710	3902	0.0	0.9507944643772425
chr3	GMPPB	49722595	49722754	5670	160	903145	6681	897475	6521	35.4375	137.6284312222052
chr3	GMPPB	49722230	49722358	9121	129	903145	6681	894024	6552	70.70542635658914	136.45054945054946
chr3	IP6K1	49747817	49748168	3774	352	17474	2590	13700	2238	10.721590909090908	6.1215370866845396
chr3	CDHR4	49791440	49791471	0	32	7212	3124	7212	3092	0.0	2.332470892626132
chr3	CDHR4	49792467	49792610	373	144	7212	3124	6839	2980	2.5902777777777777	2.29496644295302
chr3	CDHR4	49791440	49791468	0	29	7212	3124	7212	3095	0.0	2.330210016155089
chr3	UBA7	49812647	49812738	42	92	5829	4028	5787	3936	0.45652173913043476	1.4702743902439024
chr3	TRAIP	49844540	49844580	0	41	5766	3275	5766	3234	0.0	1.782931354359926
chr3	CAMKV	49859769	49859881	51	113	412	3414	361	3301	0.45132743362831856	0.1093607997576492
chr3	MST1R	49895166	49895373	0	208	1274	5135	1274	4927	0.0	0.25857519788918204
chr3	MST1R	49895960	49896107	70	148	1274	5135	1204	4987	0.47297297297297297	0.24142771205133345
chr3	MON1A	49911525	49912011	0	487	7714	6358	7714	5871	0.0	1.313915857605178
chr3	MON1A	49924533	49924673	4353	141	7714	6358	3361	6217	30.872340425531913	0.540614444265723
chr3	IFRD2	50289446	50289628	10544	183	514423	3353	503879	3170	57.61748633879781	158.95236593059937
chr3	IFRD2	50290387	50290472	50084	86	514423	3353	464339	3267	582.3720930232558	142.13008876645242
chr3	HYAL3	50293631	50293721	226488	91	429603	1973	203115	1882	2488.879120879121	107.92507970244421
chr3	NAA80	50297806	50298083	391	278	358444	2186	358053	1908	1.4064748201438848	187.65880503144655
chr3	HYAL1	50300987	50301077	98	91	23168	3091	23070	3000	1.0769230769230769	7.69
chr3	HYAL2	50321365	50321773	220	409	697	3005	477	2596	0.5378973105134475	0.1837442218798151
chr3	HYAL2	50321567	50321773	220	207	697	3005	477	2798	1.0628019323671498	0.17047891350964975
chr3	TUSC2	50327037	50327219	58003	183	522386	2409	464383	2226	316.95628415300547	208.61769991015274
chr3	TUSC2	50327027	50327219	65860	193	522386	2409	456526	2216	341.2435233160622	206.01353790613717
chr3	TUSC2	50327027	50327224	65860	198	522386	2409	456526	2211	332.62626262626264	206.479421076436
chr3	RASSF1	50332049	50332154	864	106	128698	2894	127834	2788	8.150943396226415	45.85150645624103
chr3	RASSF1	50337904	50338023	14479	120	128698	2894	114219	2774	120.65833333333333	41.174837779379956
chr3	RASSF1	50337904	50338011	13338	108	128698	2894	115360	2786	123.5	41.4070351758794
chr3	ZMYND10	50342014	50342140	3880	127	23495	2382	19615	2255	30.551181102362204	8.698447893569845
chr3	ZMYND10	50343306	50343444	859	139	23495	2382	22636	2243	6.179856115107913	10.09184128399465
chr3	NPRL2	50349664	50349833	3299	170	40418	2878	37119	2708	19.405882352941177	13.707163958641063
chr3	NPRL2	50349664	50349828	3015	165	40418	2878	37403	2713	18.272727272727273	13.786583118319204
chr3	CACNA2D2	50373064	50373085	99	22	349069	6548	348970	6526	4.5	53.47379711921545
chr3	C3ORF18	50565465	50565861	0	397	76	3252	76	2855	0.0	0.026619964973730297
chr3	C3ORF18	50566005	50566094	0	90	76	3252	76	3162	0.0	0.02403542061986085
chr3	C3ORF18	50565525	50565700	0	176	76	3252	76	3076	0.0	0.0247074122236671
chr3	C3ORF18	50562372	50562588	0	217	76	3252	76	3035	0.0	0.025041186161449753
chr3	CISH	50610372	50610529	345	158	42865	3280	42520	3122	2.1835443037974684	13.61947469570788
chr3	IQCF1	51902789	51902839	0	51	0	768	0	717	0.0	0.0
chr3	PCBP4	51959894	51960023	0	130	5643	3664	5643	3534	0.0	1.596774193548387
chr3	PCBP4	51961940	51962088	0	149	5643	3664	5643	3515	0.0	1.6054054054054054
chr3	PCBP4	51962809	51962892	0	84	5643	3664	5643	3580	0.0	1.5762569832402236
chr3	PCBP4	51961748	51962088	700	341	5643	3664	4943	3323	2.0527859237536656	1.4875112849834486
chr3	PCBP4	51961748	51961894	700	147	5643	3664	4943	3517	4.761904761904762	1.4054591981802673
chr3	ABHD14B	51971459	51971698	20712	240	238344	2831	217632	2591	86.3	83.99536858355847
chr3	ABHD14B	51971459	51971892	32714	434	238344	2831	205630	2397	75.3778801843318	85.78639966624948
chr3	ABHD14B	51971811	51971892	14	82	238344	2831	238330	2749	0.17073170731707318	86.69698072026192
chr3	RPL29	51994772	51994857	1210	86	153287	1436	152077	1350	14.069767441860465	112.64962962962963
chr3	POC1A	52096568	52096712	0	145	4421	2285	4421	2140	0.0	2.0658878504672895
chr3	TWF2	52229660	52229782	0	123	23446	3540	23446	3417	0.0	6.861574480538484
chr3	TWF2	52231943	52232122	401	180	23446	3540	23045	3360	2.227777777777778	6.8586309523809526
chr3	TWF2	52231943	52232117	243	175	23446	3540	23203	3365	1.3885714285714286	6.895393759286776
chr3	TWF2	52231943	52232096	0	154	23446	3540	23446	3386	0.0	6.924394565859421
chr3	TWF2	52229340	52229542	0	203	23446	3540	23446	3337	0.0	7.026071321546299
chr3	BAP1	52407173	52407316	0	144	32490	4068	32490	3924	0.0	8.279816513761467
chr3	BAP1	52408473	52408606	6875	134	32490	4068	25615	3934	51.30597014925373	6.511184544992374
chr3	SEMA3G	52443015	52443069	126	55	734620	5064	734494	5009	2.290909090909091	146.63485725693752
chr3	NT5DC2	52528445	52528539	0	95	329452	4574	329452	4479	0.0	73.55481134181737
chr3	NT5DC2	52528860	52528935	0	76	329452	4574	329452	4498	0.0	73.2441084926634
chr3	NT5DC2	52528511	52528539	0	29	329452	4574	329452	4545	0.0	72.48668866886689
chr3	PBRM1	52554723	52554879	0	157	160620	9463	160620	9306	0.0	17.259832366215345
chr3	PBRM1	52643247	52643343	206	97	160620	9463	160414	9366	2.1237113402061856	17.127268844757634
chr3	PBRM1	52558248	52558413	572	166	160620	9463	160048	9297	3.4457831325301207	17.215015596428955
chr3	PBRM1	52624896	52624941	0	46	160620	9463	160620	9417	0.0	17.05638738451736
chr3	PBRM1	52603520	52603732	0	213	160620	9463	160620	9250	0.0	17.364324324324325
chr3	PBRM1	52682091	52682233	0	143	160620	9463	160620	9320	0.0	17.233905579399142
chr3	PBRM1	52681703	52681820	0	118	160620	9463	160620	9345	0.0	17.187800963081862
chr3	PBRM1	52684855	52684914	0	60	160620	9463	160620	9403	0.0	17.08178240986919
chr3	GLT8D1	52696233	52696318	2243	86	6733	3420	4490	3334	26.08139534883721	1.346730653869226
chr3	GLT8D1	52703798	52703928	621	131	6733	3420	6112	3289	4.740458015267175	1.8583155974460321
chr3	GLT8D1	52704723	52704952	0	230	6733	3420	6733	3190	0.0	2.1106583072100316
chr3	GLT8D1	52703086	52703255	714	170	6733	3420	6019	3250	4.2	1.852
chr3	NEK4	52749691	52749829	101	139	60149	6410	60048	6271	0.7266187050359713	9.575506298835911
chr3	NEK4	52768337	52768604	51	268	60149	6410	60098	6142	0.19029850746268656	9.784760664278737
chr3	NEK4	52747329	52747451	112	123	60149	6410	60037	6287	0.9105691056910569	9.54938762525847
chr3	NEK4	52768337	52768566	51	230	60149	6410	60098	6180	0.2217391304347826	9.724595469255663
chr3	ITIH4	52818051	52818168	0	118	0	4681	0	4563	0.0	0.0
chr3	ITIH4	52829118	52829279	0	162	0	4681	0	4519	0.0	0.0
chr3	AC006254.1	52831407	52831478	0	72	153	6358	153	6286	0.0	0.02433980273623926
chr3	STIMATE-MUSTN1	52834939	52835003	0	65	1915	6283	1915	6218	0.0	0.30797684142811194
chr3	STIMATE	52895877	52895955	0	79	3151	1951	3151	1872	0.0	1.6832264957264957
chr3	SFMBT1	53043135	53043254	0	120	3751	5707	3751	5587	0.0	0.671379989260784
chr3	SFMBT1	53018085	53018228	0	144	3751	5707	3751	5563	0.0	0.6742764695308286
chr3	RFT1	53119883	53120021	2891	139	81923	5492	79032	5353	20.798561151079138	14.764057537829254
chr3	RFT1	53123723	53123840	2458	118	81923	5492	79465	5374	20.83050847457627	14.786937104577596
chr3	TKT	53228055	53228149	0	95	2460	8000	2460	7905	0.0	0.3111954459203036
chr3	TKT	53237796	53237820	0	25	2460	8000	2460	7975	0.0	0.3084639498432602
chr3	TKT	53237796	53237921	0	126	2460	8000	2460	7874	0.0	0.31242062484124966
chr3	TKT	53243582	53243622	0	41	2460	8000	2460	7959	0.0	0.30908405578590276
chr3	DCP1A	53304176	53304290	0	115	13790	6113	13790	5998	0.0	2.299099699899967
chr3	DCP1A	53338090	53338145	777	56	13790	6113	13013	6057	13.875	2.148423311870563
chr3	ERC2	55683793	55683859	0	67	53919	8060	53919	7993	0.0	6.745777555360941
chr3	ERC2	55985976	55985988	0	13	53919	8060	53919	8047	0.0	6.700509506648441
chr3	ERC2	55606779	55606966	0	188	53919	8060	53919	7872	0.0	6.849466463414634
chr3	ERC2	56003098	56003134	0	37	53919	8060	53919	8023	0.0	6.720553408949271
chr3	TASOR	56624827	56625006	255	180	55146	9849	54891	9669	1.4166666666666667	5.677008997828111
chr3	TASOR	56638705	56638765	919	61	55146	9849	54227	9788	15.065573770491802	5.540151205557826
chr3	TASOR	56662384	56662490	666	107	55146	9849	54480	9742	6.224299065420561	5.592280845822213
chr3	ARHGEF3	56751055	56751132	0	78	1550	6495	1550	6417	0.0	0.24154589371980675
chr3	ARHGEF3	57035087	57035176	0	90	1550	6495	1550	6405	0.0	0.2419984387197502
chr3	ARHGEF3	57007181	57007336	0	156	1550	6495	1550	6339	0.0	0.2445180627859284
chr3	ARHGEF3	57076745	57076892	0	148	1550	6495	1550	6347	0.0	0.24420986292736727
chr3	ARHGEF3	56898549	56898638	0	90	1550	6495	1550	6405	0.0	0.2419984387197502
chr3	ARHGEF3	56975761	56975820	0	60	1550	6495	1550	6435	0.0	0.24087024087024086
chr3	IL17RD	57169231	57169394	0	164	715	9578	715	9414	0.0	0.07595071170596983
chr3	HESX1	57198390	57198492	48	103	48	1500	0	1397	0.46601941747572817	0.0
chr3	HESX1	57211334	57211502	0	169	48	1500	48	1331	0.0	0.03606311044327573
chr3	DNAH12	57301734	57301939	4441	206	52217	13352	47776	13146	21.558252427184467	3.6342613722805415
chr3	DNAH12	57314493	57314631	0	139	52217	13352	52217	13213	0.0	3.951941269961402
chr3	ARF4	57583897	57584007	741	111	16132	2603	15391	2492	6.675675675675675	6.176163723916533
chr3	ARF4	57584383	57584464	0	82	16132	2603	16132	2521	0.0	6.399047996826656
chr3	ARF4	57583897	57584032	969	136	16132	2603	15163	2467	7.125	6.146331576813944
chr3	DENND6A	57659117	57659180	46	64	24035	4973	23989	4909	0.71875	4.88673864330821
chr3	DNASE1L3	58193342	58193439	0	98	58	3002	58	2904	0.0	0.01997245179063361
chr3	DNASE1L3	58205470	58205560	0	91	58	3002	58	2911	0.0	0.01992442459635864
chr3	PDHB	58433630	58433684	0	55	2805	4248	2805	4193	0.0	0.6689720963510613
chr3	ACOX2	58530465	58530638	0	174	835	3288	835	3114	0.0	0.26814386640976234
chr3	ACOX2	58510978	58511054	0	77	835	3288	835	3211	0.0	0.2600436001245718
chr3	FAM107A	58570325	58570423	0	99	255	5329	255	5230	0.0	0.04875717017208413
chr3	FAM3D	58653673	58653781	0	109	0	1637	0	1528	0.0	0.0
chr3	CFAP20DC	58806394	58806456	0	63	13384	9238	13384	9175	0.0	1.4587465940054496
chr3	CFAP20DC	58734471	58734558	0	88	13384	9238	13384	9150	0.0	1.4627322404371585
chr3	CFAP20DC	58737155	58737224	0	70	13384	9238	13384	9168	0.0	1.4598603839441535
chr3	CFAP20DC	58913707	58913864	0	158	13384	9238	13384	9080	0.0	1.4740088105726872
chr3	CFAP20DC	58849031	58849409	4954	379	13384	9238	8430	8859	13.071240105540896	0.9515746698272943
chr3	CFAP20DC	58913697	58913864	0	168	13384	9238	13384	9070	0.0	1.4756339581036384
chr3	CFAP20DC	58794179	58794330	0	152	13384	9238	13384	9086	0.0	1.473035439137134
chr3	CFAP20DC	58992507	58992615	0	109	13384	9238	13384	9129	0.0	1.4660970533464783
chr3	FHIT	60765523	60765563	0	41	51	5456	51	5415	0.0	0.009418282548476454
chr3	PTPRG-AS1	62317105	62317192	0	88	37526	7308	37526	7220	0.0	5.197506925207756
chr3	PTPRG-AS1	62294699	62294778	0	80	37526	7308	37526	7228	0.0	5.191754288876591
chr3	PTPRG-AS1	62317807	62317903	82	97	37526	7308	37444	7211	0.845360824742268	5.1926223824712245
chr3	PTPRG-AS1	62317807	62317900	76	94	37526	7308	37450	7214	0.8085106382978723	5.191294704740782
chr3	PTPRG-AS1	62292613	62292717	0	105	37526	7308	37526	7203	0.0	5.2097737054005275
chr3	PTPRG-AS1	62313893	62313970	0	78	37526	7308	37526	7230	0.0	5.1903181189488246
chr3	CADPS	62445764	62445797	0	34	0	14019	0	13985	0.0	0.0
chr3	CADPS	62530653	62530812	0	160	0	14019	0	13859	0.0	0.0
chr3	CADPS	62467297	62467312	0	16	0	14019	0	14003	0.0	0.0
chr3	CADPS	62481722	62481869	0	148	0	14019	0	13871	0.0	0.0
chr3	CADPS	62493644	62493665	0	22	0	14019	0	13997	0.0	0.0
chr3	CADPS	62512750	62512768	0	19	0	14019	0	14000	0.0	0.0
chr3	CADPS	62513637	62513706	0	70	0	14019	0	13949	0.0	0.0
chr3	CADPS	62498145	62498154	0	10	0	14019	0	14009	0.0	0.0
chr3	CADPS	62544847	62544859	0	13	0	14019	0	14006	0.0	0.0
chr3	AC104162.1	63758245	63758478	0	234	1113	3626	1113	3392	0.0	0.328125
chr3	AC104162.1	63784730	63784854	0	125	1113	3626	1113	3501	0.0	0.31790916880891174
chr3	AC104162.1	63787107	63787213	0	107	1113	3626	1113	3519	0.0	0.31628303495311166
chr3	THOC7	63839655	63839773	0	119	448	1759	448	1640	0.0	0.2731707317073171
chr3	THOC7	63846103	63846217	174	115	448	1759	274	1644	1.5130434782608695	0.16666666666666666
chr3	PSMD6	64013438	64013607	0	170	102	8946	102	8776	0.0	0.01162260711030082
chr3	PSMD6	64022642	64022801	0	160	102	8946	102	8786	0.0	0.0116093785567949
chr3	PSMD6	64022738	64022801	0	64	102	8946	102	8882	0.0	0.011483900022517451
chr3	ADAMTS9	64655791	64655875	0	85	0	10621	0	10536	0.0	0.0
chr3	ADAMTS9	64521493	64521668	0	176	0	10621	0	10445	0.0	0.0
chr3	MAGI1	65359063	65359152	0	90	4247	11686	4247	11596	0.0	0.3662469817178337
chr3	MAGI1	65375744	65375945	0	202	4247	11686	4247	11484	0.0	0.3698188784395681
chr3	MAGI1	65387142	65387226	0	85	4247	11686	4247	11601	0.0	0.3660891302473925
chr3	MAGI1	65448021	65448057	0	37	4247	11686	4247	11649	0.0	0.36458065069963086
chr3	MAGI1	65375744	65375948	0	205	4247	11686	4247	11481	0.0	0.3699155125860117
chr3	LRIG1	66401608	66401680	0	73	6010	7069	6010	6996	0.0	0.8590623213264723
chr3	UBA3	69075429	69075510	54	82	41520	4125	41466	4043	0.6585365853658537	10.256245362354687
chr3	UBA3	69080111	69080153	172	43	41520	4125	41348	4082	4.0	10.129348358647722
chr3	FRMD4B	69249225	69249248	0	24	0	11238	0	11214	0.0	0.0
chr3	FOXP1	70972554	70972676	0	123	30419	26565	30419	26442	0.0	1.1504046592542168
chr3	FOXP1	71000971	71001059	0	89	30419	26565	30419	26476	0.0	1.148927330412449
chr3	FOXP1	71198201	71198392	0	192	30419	26565	30419	26373	0.0	1.1534144769271604
chr3	FOXP1	71359149	71359244	0	96	30419	26565	30419	26469	0.0	1.1492311760927878
chr3	FOXP1	71493425	71493555	0	131	30419	26565	30419	26434	0.0	1.1507528183400166
chr3	FOXP1	71581548	71581697	539	150	30419	26565	29880	26415	3.5933333333333333	1.131175468483816
chr3	FOXP1	70972010	70972180	0	171	30419	26565	30419	26394	0.0	1.1524967795711147
chr3	FOXP1	71296432	71296445	0	14	30419	26565	30419	26551	0.0	1.145681895220519
chr3	FOXP1	70970735	70970805	0	71	30419	26565	30419	26494	0.0	1.1481467502075942
chr3	FOXP1	71335159	71335281	0	123	30419	26565	30419	26442	0.0	1.1504046592542168
chr3	EIF4E3	71699613	71699708	0	96	0	10820	0	10724	0.0	0.0
chr3	FOXP1	71335159	71335277	0	119	30419	26565	30419	26446	0.0	1.1502306587007487
chr3	FOXP1	71130497	71130584	0	88	30419	26565	30419	26477	0.0	1.1488839370019261
chr3	FOXP1	71467250	71467315	0	66	30419	26565	30419	26499	0.0	1.1479301105702102
chr3	EIF4E3	71696459	71696520	0	62	0	10820	0	10758	0.0	0.0
chr3	EIF4E3	71693874	71693941	0	68	0	10820	0	10752	0.0	0.0
chr3	PROK2	71774444	71774507	0	64	0	1617	0	1553	0.0	0.0
chr3	LINC00877	72060509	72060611	0	103	0	8637	0	8534	0.0	0.0
chr3	LINC00877	72234147	72234244	0	98	0	8637	0	8539	0.0	0.0
chr3	SHQ1	72844358	72844423	0	66	5929	5849	5929	5783	0.0	1.0252464118969393
chr3	SHQ1	72844358	72844453	0	96	5929	5849	5929	5753	0.0	1.0305927342256214
chr3	OR7E22P	75361951	75362039	0	89	0	1280	0	1191	0.0	0.0
chr3	FAM86DP	75429135	75429237	0	103	0	3442	0	3339	0.0	0.0
chr3	ZNF717	75783305	75783364	0	60	28790	7528	28790	7468	0.0	3.8551151580074987
chr3	ZNF717	75784914	75785002	0	89	28790	7528	28790	7439	0.0	3.870143836537169
chr3	ROBO1	78647628	78647655	1033	28	16876	11098	15843	11070	36.892857142857146	1.4311653116531164
chr3	ROBO1	78693347	78693356	0	10	16876	11098	16876	11088	0.0	1.522005772005772
chr3	LINC00971	84863705	84864005	0	301	0	8753	0	8452	0.0	0.0
chr3	LINC00971	84868902	84869024	0	123	0	8753	0	8630	0.0	0.0
chr3	LINC00971	84868781	84868843	0	63	0	8753	0	8690	0.0	0.0
chr3	POU1F1	87264287	87264512	0	226	10124	1572	10124	1346	0.0	7.521545319465082
chr3	CGGBP1	88057190	88057292	0	103	805	5365	805	5262	0.0	0.15298365640440897
chr3	CGGBP1	88058018	88058223	0	206	805	5365	805	5159	0.0	0.1560379918588874
chr3	PROS1	93876965	93877191	0	227	0	5212	0	4985	0.0	0.0
chr3	PROS1	93928701	93928797	0	97	0	5212	0	5115	0.0	0.0
chr3	PROS1	93881130	93881318	0	189	0	5212	0	5023	0.0	0.0
chr3	PROS1	93923774	93923894	0	121	0	5212	0	5091	0.0	0.0
chr3	RIOX2	97952151	97952252	0	102	0	6599	0	6497	0.0	0.0
chr3	CLDND1	98521652	98521718	1650	67	1935605	4629	1933955	4562	24.62686567164179	423.9270056992547
chr3	CLDND1	98521652	98521703	1605	52	1935605	4629	1934000	4577	30.865384615384617	422.5475202097444
chr3	CLDND1	98521132	98521442	2339	311	1935605	4629	1933266	4318	7.520900321543408	447.72255673923115
chr3	CLDND1	98521652	98521696	1455	45	1935605	4629	1934150	4584	32.333333333333336	421.9349912739965
chr3	CLDND1	98516799	98516879	154687	81	1935605	4629	1780918	4548	1909.716049382716	391.5826737027265
chr3	CLDND1	98521329	98521442	911	114	1935605	4629	1934694	4515	7.991228070175438	428.5036544850498
chr3	CLDND1	98521132	98521437	2254	306	1935605	4629	1933351	4323	7.366013071895424	447.22438121674764
chr3	ST3GAL6-AS1	98715649	98715777	0	129	918	9394	918	9265	0.0	0.09908256880733946
chr3	ST3GAL6-AS1	98718418	98718521	0	104	918	9394	918	9290	0.0	0.09881593110871906
chr3	ST3GAL6-AS1	98714407	98714498	0	92	918	9394	918	9302	0.0	0.09868845409589336
chr3	ST3GAL6-AS1	98718423	98718521	0	99	918	9394	918	9295	0.0	0.09876277568585261
chr3	ST3GAL6-AS1	98715375	98715521	0	147	918	9394	918	9247	0.0	0.0992754406834649
chr3	DCBLD2	98890391	98890456	0	66	0	11299	0	11233	0.0	0.0
chr3	FILIP1L	99874287	99874486	0	200	5909	5543	5909	5343	0.0	1.1059329964439453
chr3	ABI3BP	100787727	100787802	0	76	2754	9536	2754	9460	0.0	0.2911205073995772
chr3	ABI3BP	100792690	100792768	0	79	2754	9536	2754	9457	0.0	0.2912128582002749
chr3	ABI3BP	100795803	100795851	0	49	2754	9536	2754	9487	0.0	0.2902919784968905
chr3	ABI3BP	100828392	100828452	0	61	2754	9536	2754	9475	0.0	0.2906596306068602
chr3	ABI3BP	100829580	100829664	0	85	2754	9536	2754	9451	0.0	0.291397735689345
chr3	ABI3BP	100830577	100830634	0	58	2754	9536	2754	9478	0.0	0.2905676303017514
chr3	ABI3BP	100838209	100838284	0	76	2754	9536	2754	9460	0.0	0.2911205073995772
chr3	ABI3BP	100840071	100840164	0	94	2754	9536	2754	9442	0.0	0.2916754924804067
chr3	ABI3BP	100851874	100851940	0	67	2754	9536	2754	9469	0.0	0.29084380610412924
chr3	ABI3BP	100862837	100862909	0	73	2754	9536	2754	9463	0.0	0.29102821515375676
chr3	ABI3BP	100864001	100864076	0	76	2754	9536	2754	9460	0.0	0.2911205073995772
chr3	ABI3BP	100926301	100926481	0	181	2754	9536	2754	9355	0.0	0.29438802779262424
chr3	ABI3BP	100796408	100796468	0	61	2754	9536	2754	9475	0.0	0.2906596306068602
chr3	ABI3BP	100837123	100837171	0	49	2754	9536	2754	9487	0.0	0.2902919784968905
chr3	ABI3BP	100821053	100821113	0	61	2754	9536	2754	9475	0.0	0.2906596306068602
chr3	ABI3BP	100838401	100838464	0	64	2754	9536	2754	9472	0.0	0.2907516891891892
chr3	ABI3BP	100835600	100835660	0	61	2754	9536	2754	9475	0.0	0.2906596306068602
chr3	ABI3BP	100945579	100945676	0	98	2754	9536	2754	9438	0.0	0.2917991099809282
chr3	SENP7	101398860	101399055	3207	196	7920	6421	4713	6225	16.362244897959183	0.7571084337349397
chr3	SENP7	101417592	101417790	4221	199	7920	6421	3699	6222	21.21105527638191	0.59450337512054
chr3	SENP7	101501069	101501119	417	51	7920	6421	7503	6370	8.176470588235293	1.1778649921507065
chr3	RPL24	101682428	101682492	0	65	1173	1683	1173	1618	0.0	0.7249690976514215
chr3	CBLB	105681478	105681610	0	133	1816	10339	1816	10206	0.0	0.17793454830491867
chr3	CBLB	105724025	105724189	0	165	1816	10339	1816	10174	0.0	0.17849420090426577
chr3	CBLB	105749621	105749765	0	145	1816	10339	1816	10194	0.0	0.17814400627820287
chr3	CBLB	105671020	105671046	0	27	1816	10339	1816	10312	0.0	0.1761055081458495
chr3	CBLB	105671023	105671046	0	24	1816	10339	1816	10315	0.0	0.17605428986912264
chr3	CBLB	105839422	105839470	0	49	1816	10339	1816	10290	0.0	0.17648202137998056
chr3	CBLB	105681292	105681610	20	319	1816	10339	1796	10020	0.06269592476489028	0.17924151696606785
chr3	CBLB	105672336	105672462	0	127	1816	10339	1816	10212	0.0	0.17783000391696044
chr3	LINC00882	107040074	107040116	0	43	6851	18708	6851	18665	0.0	0.3670506295204929
chr3	LINC00882	107129887	107129992	0	106	6851	18708	6851	18602	0.0	0.3682937318567896
chr3	LINC00882	107049796	107049902	0	107	6851	18708	6851	18601	0.0	0.3683135315305629
chr3	LINC00882	107057669	107057932	0	264	6851	18708	6851	18444	0.0	0.3714487096074604
chr3	LINC00882	106843178	106843256	0	79	6851	18708	6851	18629	0.0	0.3677599441730635
chr3	LINC00882	106913041	106913166	0	126	6851	18708	6851	18582	0.0	0.36869013023355934
chr3	LINC00882	106909800	106909864	0	65	6851	18708	6851	18643	0.0	0.36748377407069677
chr3	LINC00882	106913024	106913166	0	143	6851	18708	6851	18565	0.0	0.36902774037166713
chr3	LINC00882	106913041	106913169	0	129	6851	18708	6851	18579	0.0	0.3687496635986867
chr3	LINC00882	106878989	106879072	0	84	6851	18708	6851	18624	0.0	0.36785867697594504
chr3	LINC00882	106925927	106926375	0	449	6851	18708	6851	18259	0.0	0.37521222410865873
chr3	LINC00882	107007065	107007164	0	100	6851	18708	6851	18608	0.0	0.3681749785038693
chr3	LINC00882	107112059	107112146	0	88	6851	18708	6851	18620	0.0	0.367937701396348
chr3	LINC00882	107129192	107129317	0	126	6851	18708	6851	18582	0.0	0.36869013023355934
chr3	LINC00882	107110591	107110653	0	63	6851	18708	6851	18645	0.0	0.3674443550549745
chr3	LINC00882	107114752	107114843	0	92	6851	18708	6851	18616	0.0	0.3680167597765363
chr3	LINC00882	107139443	107139637	0	195	6851	18708	6851	18513	0.0	0.37006427915518825
chr3	LINC00882	107220726	107220895	0	170	6851	18708	6851	18538	0.0	0.3695652173913043
chr3	LINC00882	107129887	107129989	0	103	6851	18708	6851	18605	0.0	0.36823434560601986
chr3	LINC00882	107135625	107135712	0	88	6851	18708	6851	18620	0.0	0.367937701396348
chr3	LINC00882	107171266	107171331	0	66	6851	18708	6851	18642	0.0	0.36750348675034866
chr3	LINC00882	107202913	107202981	0	69	6851	18708	6851	18639	0.0	0.3675626374805515
chr3	AC063944.1	107299901	107300152	0	252	180	3050	180	2798	0.0	0.06433166547533953
chr3	AC063944.1	107320329	107320422	0	94	180	3050	180	2956	0.0	0.06089309878213803
chr3	AC063944.1	107324307	107324502	0	196	180	3050	180	2854	0.0	0.06306937631394534
chr3	LINC00635	107841895	107842019	0	125	260	7071	260	6946	0.0	0.03743161531816873
chr3	LINC00635	107849822	107849971	0	150	260	7071	260	6921	0.0	0.03756682560323653
chr3	LINC00635	107876129	107876186	0	58	260	7071	260	7013	0.0	0.037074005418508485
chr3	LINC00635	107848905	107849118	0	214	260	7071	260	6857	0.0	0.03791745661367945
chr3	LINC00635	107867310	107867425	0	116	260	7071	260	6955	0.0	0.037383177570093455
chr3	LINC00635	107872967	107873026	0	60	260	7071	260	7011	0.0	0.03708458137212951
chr3	LINC00635	107853872	107854054	0	183	260	7071	260	6888	0.0	0.03774680603948897
chr3	LINC00635	107850296	107850351	0	56	260	7071	260	7015	0.0	0.03706343549536707
chr3	LINC00635	107855129	107855229	0	101	260	7071	260	6970	0.0	0.03730272596843615
chr3	LINC00635	107854653	107854694	0	42	260	7071	260	7029	0.0	0.036989614454403186
chr3	LINC00635	107855312	107855384	0	73	260	7071	260	6998	0.0	0.03715347242069163
chr3	LINC00635	107853872	107853959	0	88	260	7071	260	6983	0.0	0.037233280824860375
chr3	LINC00635	107876434	107876531	0	98	260	7071	260	6973	0.0	0.03728667718342177
chr3	LINC00635	107877312	107877497	0	186	260	7071	260	6885	0.0	0.03776325344952796
chr3	LINC00635	107866231	107866505	0	275	260	7071	260	6796	0.0	0.03825779870512066
chr3	LINC00635	107876454	107876531	0	78	260	7071	260	6993	0.0	0.03718003718003718
chr3	LINC00635	107867310	107867577	0	268	260	7071	260	6803	0.0	0.03821843304424519
chr3	LINC00635	107849033	107849118	0	86	260	7071	260	6985	0.0	0.03722261989978525
chr3	LINC00635	107855312	107855425	0	114	260	7071	260	6957	0.0	0.037372430645393126
chr3	LINC00635	107853872	107855229	0	1358	260	7071	260	5713	0.0	0.04551023980395589
chr3	LINC00635	107877901	107878077	0	177	260	7071	260	6894	0.0	0.037713954163040325
chr3	LINC00635	107872325	107872480	0	156	260	7071	260	6915	0.0	0.03759942154736081
chr3	LINC00635	107875458	107875574	0	117	260	7071	260	6954	0.0	0.03738855335058959
chr3	LINC00635	107859130	107859261	0	132	260	7071	260	6939	0.0	0.03746937599077677
chr3	LINC00635	107856007	107856324	0	318	260	7071	260	6753	0.0	0.038501406782170886
chr3	LINC00635	107866651	107866753	0	103	260	7071	260	6968	0.0	0.03731343283582089
chr3	CD47	108049618	108049651	0	34	0	8247	0	8213	0.0	0.0
chr3	CD47	108055519	108055566	0	48	0	8247	0	8199	0.0	0.0
chr3	CD47	108050577	108050602	0	26	0	8247	0	8221	0.0	0.0
chr3	IFT57	108219409	108219572	0	164	162	3544	162	3380	0.0	0.04792899408284024
chr3	CIP2A	108585665	108585749	0	85	25	4607	25	4522	0.0	0.005528527200353826
chr3	MORC1	109007028	109007091	0	64	297	3775	297	3711	0.0	0.08003233629749394
chr3	NECTIN3-AS1	111052503	111052659	0	157	0	3269	0	3112	0.0	0.0
chr3	GCSAM	112125225	112125254	0	30	0	3757	0	3727	0.0	0.0
chr3	GCSAM	112128016	112128061	0	46	0	3757	0	3711	0.0	0.0
chr3	GCSAM	112128016	112128228	0	213	0	3757	0	3544	0.0	0.0
chr3	GCSAM	112132636	112132910	0	275	0	3757	0	3482	0.0	0.0
chr3	SLC9C1	112264199	112264343	51	145	49700	4237	49649	4092	0.35172413793103446	12.13318670576735
chr3	SLC9C1	112269915	112270077	2040	163	49700	4237	47660	4074	12.515337423312884	11.698576337751595
chr3	SLC9C1	112286703	112286878	0	176	49700	4237	49700	4061	0.0	12.238364934745137
chr3	BTLA	112471211	112471355	0	145	51	3616	51	3471	0.0	0.014693171996542784
chr3	CCDC80	112607175	112607256	0	82	255	12973	255	12891	0.0	0.019781242727484293
chr3	CD200R1L	112837941	112838010	0	70	748	1720	748	1650	0.0	0.4533333333333333
chr3	CD200R1L	112841246	112841344	0	99	748	1720	748	1621	0.0	0.46144355336212217
chr3	CD200R1	112947855	112947924	0	70	255	3897	255	3827	0.0	0.06663182649594983
chr3	CD200R1	112931105	112931171	0	67	255	3897	255	3830	0.0	0.06657963446475196
chr3	NEPRO	113010642	113010704	0	63	10550	6041	10550	5978	0.0	1.7648042823686851
chr3	NEPRO	113017447	113017602	714	156	10550	6041	9836	5885	4.576923076923077	1.6713678844519966
chr3	NEPRO	113013948	113014032	0	85	10550	6041	10550	5956	0.0	1.7713230355943586
chr3	CFAP44	113344515	113344712	0	198	4375	12198	4375	12000	0.0	0.3645833333333333
chr3	CFAP44	113373410	113373556	1836	147	4375	12198	2539	12051	12.489795918367347	0.21068790971703594
chr3	CFAP44	113401583	113401739	0	157	4375	12198	4375	12041	0.0	0.36334191512332864
chr3	CFAP44	113409105	113409322	0	218	4375	12198	4375	11980	0.0	0.36519198664440733
chr3	CFAP44	113427186	113427339	612	154	4375	12198	3763	12044	3.9740259740259742	0.31243772832945865
chr3	CFAP44	113293951	113294038	0	88	4375	12198	4375	12110	0.0	0.36127167630057805
chr3	CFAP44	113366038	113366309	0	272	4375	12198	4375	11926	0.0	0.36684554754318294
chr3	NAA50	113723421	113723541	411	121	4491	1410	4080	1289	3.396694214876033	3.165244375484872
chr3	CCDC191	114053596	114053635	0	40	832	5304	832	5264	0.0	0.1580547112462006
chr3	CCDC191	114036985	114037094	0	110	832	5304	832	5194	0.0	0.1601848286484405
chr3	CCDC191	114046590	114046732	0	143	832	5304	832	5161	0.0	0.16120906801007556
chr3	CCDC191	114039384	114039488	684	105	832	5304	148	5199	6.514285714285714	0.028467012887093673
chr3	DRD3	114175925	114176193	0	269	0	3182	0	2913	0.0	0.0
chr3	ZBTB20	114350273	114351878	1887	1606	2749	32044	862	30438	1.1749688667496887	0.02831986332873382
chr3	ZBTB20	114380776	114380940	612	165	2749	32044	2137	31879	3.709090909090909	0.06703472505411086
chr3	ZBTB20	114693527	114693575	0	49	2749	32044	2749	31995	0.0	0.08591967494921081
chr3	ZBTB20	115071218	115071414	0	197	2749	32044	2749	31847	0.0	0.08631896253964266
chr3	ZBTB20	114710267	114710313	0	47	2749	32044	2749	31997	0.0	0.08591430446604369
chr3	ZBTB20	114713975	114714015	0	41	2749	32044	2749	32003	0.0	0.08589819704402712
chr3	LINC02024	117680938	117680972	0	35	0	1048	0	1013	0.0	0.0
chr3	LINC02024	117688346	117688901	0	556	0	1048	0	492	0.0	0.0
chr3	LINC02024	117688718	117688901	0	184	0	1048	0	864	0.0	0.0
chr3	AC068633.1	118648066	118648172	0	107	0	2255	0	2148	0.0	0.0
chr3	IGSF11	119112649	119112778	0	130	2451	4915	2451	4785	0.0	0.5122257053291536
chr3	IGSF11	118949228	118949318	0	91	2451	4915	2451	4824	0.0	0.5080845771144279
chr3	IGSF11	119112673	119112778	0	106	2451	4915	2451	4809	0.0	0.5096693699313787
chr3	B4GALT4	119229846	119230244	4385	399	185032	6991	180647	6592	10.989974937343359	27.403974514563107
chr3	B4GALT4	119235144	119235227	170	84	185032	6991	184862	6907	2.0238095238095237	26.764441870566092
chr3	B4GALT4	119236852	119237070	0	219	185032	6991	185032	6772	0.0	27.32309509746013
chr3	B4GALT4	119240360	119240530	0	171	185032	6991	185032	6820	0.0	27.130791788856303
chr3	B4GALT4	119236152	119236251	8551	100	185032	6991	176481	6891	85.51	25.610361340879408
chr3	TMEM39A	119435754	119435935	0	182	7850	5677	7850	5495	0.0	1.4285714285714286
chr3	TMEM39A	119451208	119451317	2201	110	7850	5677	5649	5567	20.009090909090908	1.014729656906772
chr3	TMEM39A	119458017	119458240	192	224	7850	5677	7658	5453	0.8571428571428571	1.404364569961489
chr3	CD80	119529841	119529937	0	97	33086	3220	33086	3123	0.0	10.594300352225424
chr3	POPDC2	119654504	119654613	0	110	765	1450	765	1340	0.0	0.5708955223880597
chr3	POPDC2	119643366	119643449	0	84	765	1450	765	1366	0.0	0.5600292825768668
chr3	COX17	119674672	119674788	0	117	102	1920	102	1803	0.0	0.056572379367720464
chr3	COX17	119676861	119676966	0	106	102	1920	102	1814	0.0	0.05622932745314223
chr3	GSK3B	119843254	119843353	0	100	11430	16821	11430	16721	0.0	0.6835715567250763
chr3	GSK3B	119863418	119863605	0	188	11430	16821	11430	16633	0.0	0.6871881200024048
chr3	GSK3B	119876412	119876508	0	97	11430	16821	11430	16724	0.0	0.683448935661325
chr3	GSK3B	119905754	119905852	0	99	11430	16821	11430	16722	0.0	0.6835306781485468
chr3	GSK3B	119912703	119912810	0	108	11430	16821	11430	16713	0.0	0.683898761443188
chr3	GSK3B	119923372	119923483	0	112	11430	16821	11430	16709	0.0	0.6840624812975044
chr3	GSK3B	119947267	119947351	0	85	11430	16821	11430	16736	0.0	0.6829588910133844
chr3	GSK3B	120002045	120002239	0	195	11430	16821	11430	16626	0.0	0.6874774449657164
chr3	GSK3B	119866589	119866628	0	40	11430	16821	11430	16781	0.0	0.6811274655860795
chr3	GSK3B	119831101	119831251	0	151	11430	16821	11430	16670	0.0	0.6856628674265147
chr3	GSK3B	119840796	119840862	0	67	11430	16821	11430	16754	0.0	0.6822251402650114
chr3	GSK3B	119840796	119840935	0	140	11430	16821	11430	16681	0.0	0.6852107187818476
chr3	GSK3B	119847354	119847452	0	99	11430	16821	11430	16722	0.0	0.6835306781485468
chr3	GSK3B	119875079	119875185	0	107	11430	16821	11430	16714	0.0	0.6838578437238243
chr3	GSK3B	119900557	119900613	184	57	11430	16821	11246	16764	3.2280701754385963	0.6708422810785015
chr3	GSK3B	119880244	119880498	0	255	11430	16821	11430	16566	0.0	0.6899674031148135
chr3	GSK3B	119881160	119881270	0	111	11430	16821	11430	16710	0.0	0.6840215439856373
chr3	GSK3B	119880244	119880510	0	267	11430	16821	11430	16554	0.0	0.6904675607104023
chr3	GSK3B	119882636	119882834	867	199	11430	16821	10563	16622	4.35678391959799	0.6354830946937793
chr3	GSK3B	119912703	119912800	0	98	11430	16821	11430	16723	0.0	0.6834898044609221
chr3	GSK3B	119906791	119906916	0	126	11430	16821	11430	16695	0.0	0.6846361185983828
chr3	GSK3B	119976484	119976545	0	62	11430	16821	11430	16759	0.0	0.6820216003341488
chr3	GSK3B	119981956	119982125	0	170	11430	16821	11430	16651	0.0	0.6864452585430304
chr3	GSK3B	120000551	120000723	0	173	11430	16821	11430	16648	0.0	0.6865689572321
chr3	GSK3B	120021578	120021626	0	49	11430	16821	11430	16772	0.0	0.6814929644645839
chr3	FSTL1	120415922	120416027	0	106	2628	4552	2628	4446	0.0	0.5910931174089069
chr3	HGD	120638454	120638581	0	128	73	2676	73	2548	0.0	0.028649921507064365
chr3	HGD	120674900	120674989	0	90	73	2676	73	2586	0.0	0.02822892498066512
chr3	RABL3	120694152	120694224	51	73	102	6437	51	6364	0.6986301369863014	0.008013827781269642
chr3	RABL3	120698422	120698573	0	152	102	6437	102	6285	0.0	0.016229116945107397
chr3	RABL3	120709779	120709909	51	131	102	6437	51	6306	0.3893129770992366	0.008087535680304472
chr3	RABL3	120698422	120698520	0	99	102	6437	102	6338	0.0	0.016093404859577155
chr3	AC072026.2	120888073	120888245	0	173	51	4443	51	4270	0.0	0.011943793911007026
chr3	POLQ	121460049	121460234	408	186	142817	9414	142409	9228	2.193548387096774	15.432271348071088
chr3	HCLS1	121637145	121637256	528	112	5642	5108	5114	4996	4.714285714285714	1.023618895116093
chr3	HCLS1	121642926	121642981	0	56	5642	5108	5642	5052	0.0	1.1167854315122723
chr3	GOLGB1	121719645	121719753	0	109	0	11889	0	11780	0.0	0.0
chr3	GOLGB1	121719645	121719768	0	124	0	11889	0	11765	0.0	0.0
chr3	GOLGB1	121722261	121722378	0	118	0	11889	0	11771	0.0	0.0
chr3	GOLGB1	121668313	121668508	0	196	0	11889	0	11693	0.0	0.0
chr3	IQCB1	121795456	121795566	0	111	109	3066	109	2955	0.0	0.03688663282571912
chr3	IQCB1	121808915	121809009	0	95	109	3066	109	2971	0.0	0.03668798384382363
chr3	IQCB1	121828469	121828632	0	164	109	3066	109	2902	0.0	0.037560303239145415
chr3	ILDR1	121994181	121994313	0	133	0	3003	0	2870	0.0	0.0
chr3	KPNA1	122453869	122454001	204	133	119957	8433	119753	8300	1.5338345864661653	14.428072289156626
chr3	KPNA1	122457725	122457848	0	124	119957	8433	119957	8309	0.0	14.436996028402936
chr3	SEMA5B	122961139	122961301	2259	163	13443	8546	11184	8383	13.858895705521473	1.3341285935822498
chr3	SEMA5B	123027097	123027233	0	137	13443	8546	13443	8409	0.0	1.5986443096682126
chr3	ADCY5	123296979	123297054	0	76	17369	8233	17369	8157	0.0	2.12933676596788
chr3	ADCY5	123367904	123368046	3401	143	17369	8233	13968	8090	23.783216783216783	1.726576019777503
chr3	MYLK	123647223	123647427	411	205	4457	18744	4046	18539	2.004878048780488	0.218242623658234
chr3	MYLK	123732895	123733102	0	208	4457	18744	4457	18536	0.0	0.24045101424255502
chr3	MYLK	123752330	123752538	0	209	4457	18744	4457	18535	0.0	0.24046398705152414
chr3	MYLK	123835867	123835935	0	69	4457	18744	4457	18675	0.0	0.23866131191432396
chr3	MYLK	123629473	123629626	0	154	4457	18744	4457	18590	0.0	0.23975255513717053
chr3	CCDC14	123955842	123955965	0	124	0	7677	0	7553	0.0	0.0
chr3	CCDC14	123956739	123956795	0	57	0	7677	0	7620	0.0	0.0
chr3	CCDC14	123955842	123956795	0	954	0	7677	0	6723	0.0	0.0
chr3	ROPN1	123981378	123981424	0	47	0	4526	0	4479	0.0	0.0
chr3	ROPN1	123991180	123991293	0	114	0	4526	0	4412	0.0	0.0
chr3	ITGB5	124809021	124809156	0	136	75	6538	75	6402	0.0	0.011715089034676664
chr3	ITGB5	124817620	124817710	0	91	75	6538	75	6447	0.0	0.011633317822242903
chr3	ITGB5	124857231	124857313	0	83	75	6538	75	6455	0.0	0.011618900077459334
chr3	HEG1	125014712	125015012	0	301	1594	9984	1594	9683	0.0	0.16461840338737996
chr3	HEG1	124971042	124971148	0	107	1594	9984	1594	9877	0.0	0.16138503594208767
chr3	SLC12A8	125177742	125177974	918	233	7453	5608	6535	5375	3.939914163090129	1.215813953488372
chr3	SLC12A8	125119865	125119891	0	27	7453	5608	7453	5581	0.0	1.335423759182942
chr3	SLC12A8	125177742	125177964	915	223	7453	5608	6538	5385	4.103139013452915	1.214113277623027
chr3	ZNF148	125331157	125331238	68	82	6756	3608	6688	3526	0.8292682926829268	1.8967668746454907
chr3	ZNF148	125314936	125315053	0	118	6756	3608	6756	3490	0.0	1.9358166189111747
chr3	ZNF148	125338821	125338911	0	91	6756	3608	6756	3517	0.0	1.9209553596815467
chr3	SNX4	125489407	125489463	41	57	653	2723	612	2666	0.7192982456140351	0.22955738934733683
chr3	SNX4	125504622	125504744	0	123	653	2723	653	2600	0.0	0.25115384615384617
chr3	SNX4	125480246	125480319	0	74	653	2723	653	2649	0.0	0.24650811627029068
chr3	LINC02614	125870710	125870817	0	108	102	6139	102	6031	0.0	0.016912618139612003
chr3	LINC02614	125872072	125872253	0	182	102	6139	102	5957	0.0	0.017122712774886688
chr3	LINC02614	125875073	125875166	0	94	102	6139	102	6045	0.0	0.01687344913151365
chr3	LINC02614	125848229	125848447	0	219	102	6139	102	5920	0.0	0.01722972972972973
chr3	LINC02614	125861703	125861821	0	119	102	6139	102	6020	0.0	0.016943521594684385
chr3	LINC02614	125887161	125887226	0	66	102	6139	102	6073	0.0	0.016795652889840276
chr3	LINC02614	125887719	125887914	0	196	102	6139	102	5943	0.0	0.017163048965169108
chr3	LINC02614	125908781	125908874	0	94	102	6139	102	6045	0.0	0.01687344913151365
chr3	LINC02614	125915219	125915475	0	257	102	6139	102	5882	0.0	0.017341040462427744
chr3	SLC41A3	126050942	126051050	0	109	1590	5485	1590	5376	0.0	0.29575892857142855
chr3	SLC41A3	126033606	126033678	0	73	1590	5485	1590	5412	0.0	0.29379157427937913
chr3	SLC41A3	126050897	126051050	0	154	1590	5485	1590	5331	0.0	0.29825548677546426
chr3	SLC41A3	126056357	126056513	0	157	1590	5485	1590	5328	0.0	0.29842342342342343
chr3	SLC41A3	126073152	126073269	0	118	1590	5485	1590	5367	0.0	0.29625489100055896
chr3	SLC41A3	126067946	126068246	408	301	1590	5485	1182	5184	1.3554817275747508	0.22800925925925927
chr3	SLC41A3	126067485	126067586	102	102	1590	5485	1488	5383	1.0	0.27642578487832065
chr3	ALDH1L1	126114556	126114656	0	101	222298	13574	222298	13473	0.0	16.49951755362577
chr3	ALDH1L1	126158404	126158639	10052	236	222298	13574	212246	13338	42.59322033898305	15.91288049182786
chr3	ALDH1L1	126131383	126131534	0	152	222298	13574	222298	13422	0.0	16.56221129488899
chr3	ALDH1L1	126159382	126159566	406	185	222298	13574	221892	13389	2.1945945945945944	16.57270894017477
chr3	CCDC37-DT	126393482	126393534	0	53	0	912	0	859	0.0	0.0
chr3	CCDC37-DT	126393482	126393653	0	172	0	912	0	740	0.0	0.0
chr3	TXNRD3	126615354	126615462	0	109	843	3790	843	3681	0.0	0.22901385493072535
chr3	LINC01471	127499684	127499730	0	47	357	6875	357	6828	0.0	0.05228471001757469
chr3	LINC01471	127532798	127532913	0	116	357	6875	357	6759	0.0	0.052818464269862406
chr3	LINC01471	127535185	127535463	0	279	357	6875	357	6596	0.0	0.05412371134020619
chr3	LINC01471	127535185	127535404	0	220	357	6875	357	6655	0.0	0.05364387678437265
chr3	LINC01471	127499684	127499742	0	59	357	6875	357	6816	0.0	0.05237676056338028
chr3	LINC01471	127535185	127535347	0	163	357	6875	357	6712	0.0	0.053188319427890346
chr3	LINC01471	127535185	127535561	0	377	357	6875	357	6498	0.0	0.05493998153277932
chr3	LINC01471	127532384	127532443	0	60	357	6875	357	6815	0.0	0.052384446074834924
chr3	LINC01471	127535185	127535785	0	601	357	6875	357	6274	0.0	0.056901498246732546
chr3	LINC01471	127532384	127532446	0	63	357	6875	357	6812	0.0	0.05240751614797416
chr3	TPRA1	127575402	127575505	0	104	204	5638	204	5534	0.0	0.03686302855077701
chr3	TPRA1	127575748	127575809	0	62	204	5638	204	5576	0.0	0.036585365853658534
chr3	TPRA1	127590409	127590592	0	184	204	5638	204	5454	0.0	0.0374037403740374
chr3	TPRA1	127588069	127588160	0	92	204	5638	204	5546	0.0	0.03678326721961774
chr3	TPRA1	127591889	127591950	0	62	204	5638	204	5576	0.0	0.036585365853658534
chr3	MGLL	127694974	127695190	0	217	119167	11869	119167	11652	0.0	10.227171301064194
chr3	MGLL	127710575	127710665	0	91	119167	11869	119167	11778	0.0	10.117761929020206
chr3	MGLL	127715852	127715930	0	79	119167	11869	119167	11790	0.0	10.10746395250212
chr3	MGLL	127692965	127693201	0	237	119167	11869	119167	11632	0.0	10.244755845942228
chr3	RUVBL1	128087705	128087808	0	104	2399	4913	2399	4809	0.0	0.4988563110833853
chr3	GATA2	128492003	128492222	255	220	11241	4485	10986	4265	1.1590909090909092	2.575849941383353
chr3	RPN1	128644534	128644646	2874	113	76877	3959	74003	3846	25.43362831858407	19.24154966198648
chr3	ISY1	129134073	129134195	0	123	14146	3885	14146	3762	0.0	3.760233918128655
chr3	RAB43	129092499	129092593	48	95	2272	4999	2224	4904	0.5052631578947369	0.4535073409461664
chr3	ISY1	129137130	129137196	0	67	14146	3885	14146	3818	0.0	3.7050811943425876
chr3	ISY1	129134831	129134954	0	124	14146	3885	14146	3761	0.0	3.7612337144376498
chr3	ISY1	129144067	129144189	0	123	14146	3885	14146	3762	0.0	3.760233918128655
chr3	RPL32P3	129396216	129396420	0	205	14	4487	14	4282	0.0	0.003269500233535731
chr3	RPL32P3	129397039	129397140	0	102	14	4487	14	4385	0.0	0.0031927023945267957
chr3	EFCAB12	129421366	129421803	0	438	5068	7796	5068	7358	0.0	0.6887741234030986
chr3	MBD4	129436460	129437308	0	849	0	3360	0	2511	0.0	0.0
chr3	MBD4	129436442	129437308	0	867	0	3360	0	2493	0.0	0.0
chr3	PLXND1	129584384	129584562	224	179	29247	9501	29023	9322	1.2513966480446927	3.1133876850461273
chr3	TMCC1	129860939	129861012	0	74	17801	8156	17801	8082	0.0	2.202548874041079
chr3	TMCC1	129880308	129880559	0	252	17801	8156	17801	7904	0.0	2.252150809716599
chr3	TMCC1	129867009	129867098	0	90	17801	8156	17801	8066	0.0	2.206917927101413
chr3	FAM86HP	130103740	130104006	0	267	0	1310	0	1043	0.0	0.0
chr3	FAM86HP	130105529	130105631	0	103	0	1310	0	1207	0.0	0.0
chr3	ASTE1	131015181	131015256	0	76	0	3157	0	3081	0.0	0.0
chr3	ASTE1	131016989	131017049	0	61	0	3157	0	3096	0.0	0.0
chr3	ASTE1	131025473	131025594	0	122	0	3157	0	3035	0.0	0.0
chr3	AC010210.1	131354308	131354388	0	81	0	6702	0	6621	0.0	0.0
chr3	MRPL3	131498178	131498277	0	100	0	2662	0	2562	0.0	0.0
chr3	MRPL3	131501843	131501924	0	82	0	2662	0	2580	0.0	0.0
chr3	CPNE4	132034566	132035442	459	877	821	5868	362	4991	0.5233751425313569	0.0725305549989982
chr3	CPNE4	132034566	132034759	0	194	821	5868	821	5674	0.0	0.14469510045823053
chr3	CPNE4	132039524	132039605	51	82	821	5868	770	5786	0.6219512195121951	0.13307984790874525
chr3	ACAD11	132575771	132575926	0	156	0	4422	0	4266	0.0	0.0
chr3	NPHP3	132682702	132682818	0	117	150	9222	150	9105	0.0	0.016474464579901153
chr3	NPHP3	132696730	132696813	0	84	150	9222	150	9138	0.0	0.016414970453053186
chr3	NPHP3	132699352	132699450	0	99	150	9222	150	9123	0.0	0.01644195988161789
chr3	NPHP3	132717954	132718117	0	164	150	9222	150	9058	0.0	0.016559947008169575
chr3	TOPBP1	133652462	133652629	2643	168	6519	7110	3876	6942	15.732142857142858	0.5583405358686258
chr3	TOPBP1	133652462	133652614	2469	153	6519	7110	4050	6957	16.137254901960784	0.5821474773609314
chr3	TOPBP1	133652462	133652547	1422	86	6519	7110	5097	7024	16.53488372093023	0.7256548974943052
chr3	RAB6B	133864583	133864642	0	60	63142	5656	63142	5596	0.0	11.283416726233023
chr3	RAB6B	133885534	133885665	0	132	63142	5656	63142	5524	0.0	11.430485155684286
chr3	RAB6B	133885570	133885665	0	96	63142	5656	63142	5560	0.0	11.356474820143886
chr3	SLCO2A1	133947255	133947445	0	191	102	5144	102	4953	0.0	0.02059357964869776
chr3	SLCO2A1	133954965	133955193	0	229	102	5144	102	4915	0.0	0.020752797558494403
chr3	RYK	134177940	134178073	0	134	300929	8180	300929	8046	0.0	37.40106885408899
chr3	AMOTL2	134373515	134373602	0	88	0	6413	0	6325	0.0	0.0
chr3	KY	134608648	134608839	0	192	0	9018	0	8826	0.0	0.0
chr3	KY	134643315	134643378	0	64	0	9018	0	8954	0.0	0.0
chr3	AC092969.1	135357271	135357382	0	112	816	9666	816	9554	0.0	0.08540925266903915
chr3	STAG1	136363365	136363467	0	103	5818	7880	5818	7777	0.0	0.7481033817667481
chr3	STAG1	136464880	136464988	0	109	5818	7880	5818	7771	0.0	0.7486809934371381
chr3	STAG1	136341440	136341551	0	112	5818	7880	5818	7768	0.0	0.7489701338825953
chr3	STAG1	136518247	136518415	0	169	5818	7880	5818	7711	0.0	0.7545065490857217
chr3	STAG1	136591444	136591549	0	106	5818	7880	5818	7774	0.0	0.7483920761512735
chr3	STAG1	136586801	136586926	0	126	5818	7880	5818	7754	0.0	0.7503224142378128
chr3	NCK1-DT	136858517	136858603	0	87	29	5008	29	4921	0.0	0.005893111156269051
chr3	DZIP1L	138071642	138071835	0	194	7323	5033	7323	4839	0.0	1.5133292002479852
chr3	DZIP1L	138084112	138084253	0	142	7323	5033	7323	4891	0.0	1.4972398282559805
chr3	DZIP1L	138112363	138112500	0	138	7323	5033	7323	4895	0.0	1.4960163432073545
chr3	NME9	138304872	138305027	0	156	6677	3719	6677	3563	0.0	1.873982598933483
chr3	NME9	138318147	138318219	0	73	6677	3719	6677	3646	0.0	1.831321996708722
chr3	NME9	138327030	138327128	0	99	6677	3719	6677	3620	0.0	1.844475138121547
chr3	NME9	138315526	138315643	0	118	6677	3719	6677	3601	0.0	1.8542071646764788
chr3	NME9	138324174	138324594	0	421	6677	3719	6677	3298	0.0	2.0245603395997573
chr3	CEP70	138572858	138572932	0	75	71	4206	71	4131	0.0	0.01718712176228516
chr3	CEP70	138572858	138572984	0	127	71	4206	71	4079	0.0	0.017406227016425593
chr3	CEP70	138572858	138572914	0	57	71	4206	71	4149	0.0	0.017112557242709086
chr3	PIK3CB	138684624	138684803	0	180	11932	7866	11932	7686	0.0	1.552432995055946
chr3	PIK3CB	138704442	138704493	0	52	11932	7866	11932	7814	0.0	1.5270028154594317
chr3	PIK3CB	138707158	138707289	0	132	11932	7866	11932	7734	0.0	1.5427980346521852
chr3	PIK3CB	138734633	138734804	50	172	11932	7866	11882	7694	0.29069767441860467	1.5443202495451
chr3	PIK3CB	138796462	138796567	0	106	11932	7866	11932	7760	0.0	1.5376288659793815
chr3	PIK3CB	138770050	138770117	0	68	11932	7866	11932	7798	0.0	1.530135932290331
chr3	COPB2	139373665	139373808	0	144	3162	16215	3162	16071	0.0	0.1967519133843569
chr3	COPB2	139379771	139379907	0	137	3162	16215	3162	16078	0.0	0.1966662520213957
chr3	COPB2	139373665	139373833	0	169	3162	16215	3162	16046	0.0	0.1970584569363081
chr3	COPB2	139385003	139385200	0	198	3162	16215	3162	16017	0.0	0.1974152463008054
chr3	COPB2	139385003	139385429	0	427	3162	16215	3162	15788	0.0	0.2002786926779833
chr3	RBP2	139480497	139480592	0	96	0	851	0	755	0.0	0.0
chr3	NMNAT3	139575582	139575994	0	413	87	12995	87	12582	0.0	0.006914639961850262
chr3	NMNAT3	139627615	139627764	0	150	87	12995	87	12845	0.0	0.0067730634488127675
chr3	NMNAT3	139637962	139638062	0	101	87	12995	87	12894	0.0	0.006747324336900884
chr3	NMNAT3	139573597	139573680	0	84	87	12995	87	12911	0.0	0.006738440089845868
chr3	NMNAT3	139582926	139583208	0	283	87	12995	87	12712	0.0	0.00684392699811202
chr3	NMNAT3	139634610	139634647	0	38	87	12995	87	12957	0.0	0.006714517249363279
chr3	NMNAT3	139572106	139572233	0	128	87	12995	87	12867	0.0	0.006761482863138261
chr3	NMNAT3	139578871	139579055	0	185	87	12995	87	12810	0.0	0.006791569086651054
chr3	AC010181.1	140454361	140454418	0	58	51	1066	51	1008	0.0	0.050595238095238096
chr3	TFDP2	141995019	141995141	0	123	6886	11917	6886	11794	0.0	0.5838561980668137
chr3	TFDP2	142005440	142005544	0	105	6886	11917	6886	11812	0.0	0.5829664747714189
chr3	TFDP2	142093060	142093127	238	68	6886	11917	6648	11849	3.5	0.5610600050637184
chr3	TFDP2	141993537	141993585	0	49	6886	11917	6886	11868	0.0	0.5802157061004382
chr3	TFDP2	142054114	142054149	0	36	6886	11917	6886	11881	0.0	0.5795808433633532
chr3	TFDP2	142000251	142000354	0	104	6886	11917	6886	11813	0.0	0.5829171252010497
chr3	TFDP2	142101734	142101841	0	108	6886	11917	6886	11809	0.0	0.583114573630282
chr3	GK5	142184710	142185793	13029	1084	36309	6036	23280	4952	12.019372693726938	4.701130856219709
chr3	GK5	142173075	142173197	0	123	36309	6036	36309	5913	0.0	6.140537798072045
chr3	XRN1	142313135	142313174	0	40	4053	12028	4053	11988	0.0	0.3380880880880881
chr3	XRN1	142329433	142329615	0	183	4053	12028	4053	11845	0.0	0.3421696918531026
chr3	ATR	142450465	142450602	0	138	123312	22010	123312	21872	0.0	5.637893196781273
chr3	ATR	142560262	142560454	0	193	123312	22010	123312	21817	0.0	5.652106155750103
chr3	ATR	142562231	142563109	8405	879	123312	22010	114907	21131	9.562002275312855	5.437840140078557
chr3	ATR	142562231	142562348	357	118	123312	22010	122955	21892	3.0254237288135593	5.616435227480358
chr3	PCOLCE2	142843244	142843309	0	66	0	3533	0	3467	0.0	0.0
chr3	SLC9A9	143796825	143796903	0	79	0	4059	0	3980	0.0	0.0
chr3	SLC9A9	143832018	143832221	0	204	0	4059	0	3855	0.0	0.0
chr3	PLOD2	146077861	146077924	0	64	51	6735	51	6671	0.0	0.007645030730025483
chr3	PLOD2	146123264	146123325	0	62	51	6735	51	6673	0.0	0.007642739397572307
chr3	PLSCR4	146199812	146200039	0	228	1865	4242	1865	4014	0.0	0.46462381664175384
chr3	PLSCR4	146222064	146222092	0	29	1865	4242	1865	4213	0.0	0.44267742701163065
chr3	PLSCR4	146223732	146223777	0	46	1865	4242	1865	4196	0.0	0.4444709246901811
chr3	PLSCR4	146250556	146250637	0	82	1865	4242	1865	4160	0.0	0.4483173076923077
chr3	PLSCR4	146201034	146201077	0	44	1865	4242	1865	4198	0.0	0.4442591710338256
chr3	PLSCR2	146460171	146460284	0	114	0	2724	0	2610	0.0	0.0
chr3	PLSCR1	146521832	146522053	0	222	0	3554	0	3332	0.0	0.0
chr3	PLSCR1	146528613	146528831	0	219	0	3554	0	3335	0.0	0.0
chr3	PLSCR1	146536539	146536565	0	27	0	3554	0	3527	0.0	0.0
chr3	PLSCR1	146537995	146538044	0	50	0	3554	0	3504	0.0	0.0
chr3	PLSCR1	146541133	146541180	0	48	0	3554	0	3506	0.0	0.0
chr3	PLSCR1	146521543	146521705	0	163	0	3554	0	3391	0.0	0.0
chr3	PLSCR1	146521543	146522053	0	511	0	3554	0	3043	0.0	0.0
chr3	PLSCR1	146521543	146521701	0	159	0	3554	0	3395	0.0	0.0
chr3	PLSCR1	146521832	146521981	0	150	0	3554	0	3404	0.0	0.0
chr3	ZIC4	147395851	147396469	0	619	0	7806	0	7187	0.0	0.0
chr3	ZIC4	147405674	147405849	0	176	0	7806	0	7630	0.0	0.0
chr3	CP	149176249	149176412	0	164	512	6555	512	6391	0.0	0.08011265842591143
chr3	CP	149186519	149186732	0	214	512	6555	512	6341	0.0	0.08074436208799873
chr3	CP	149217865	149217985	0	121	512	6555	512	6434	0.0	0.07957724588125582
chr3	CPHL1P	149230738	149230901	0	164	45979	3958	45979	3794	0.0	12.118871903004745
chr3	TM4SF1	149375442	149375588	2039	147	14168	3498	12129	3351	13.870748299319727	3.6195165622202325
chr3	COMMD2	149750256	149750382	0	127	102	4899	102	4772	0.0	0.02137468566638726
chr3	SERP1	150545702	150545778	0	77	153	5463	153	5386	0.0	0.028406981062012625
chr3	AC020636.2	150893323	150893415	0	93	14	1341	14	1248	0.0	0.011217948717948718
chr3	CLRN1	150940480	150940519	0	40	0	3358	0	3318	0.0	0.0
chr3	CLRN1	150943819	150943991	0	173	0	3358	0	3185	0.0	0.0
chr3	CLRN1	150945528	150945679	0	152	0	3358	0	3206	0.0	0.0
chr3	GPR171	151200908	151200997	0	90	0	1218	0	1128	0.0	0.0
chr3	P2RY14	151261386	151261438	0	53	0	2895	0	2842	0.0	0.0
chr3	AADACL2-AS1	151917614	151917741	0	128	0	640	0	512	0.0	0.0
chr3	ARHGEF26-AS1	154108668	154108785	0	118	17447	7258	17447	7140	0.0	2.443557422969188
chr3	ARHGEF26-AS1	154119685	154119808	0	124	17447	7258	17447	7134	0.0	2.445612559573872
chr3	ARHGEF26-AS1	154060013	154060062	0	50	17447	7258	17447	7208	0.0	2.4205049944506105
chr3	ARHGEF26-AS1	154119685	154119783	0	99	17447	7258	17447	7159	0.0	2.4370722167900545
chr3	ARHGEF26-AS1	154028405	154028562	0	158	17447	7258	17447	7100	0.0	2.457323943661972
chr3	DHX36	154280762	154280862	0	101	0	10578	0	10477	0.0	0.0
chr3	DHX36	154284582	154284669	0	88	0	10578	0	10490	0.0	0.0
chr3	DHX36	154288865	154288964	0	100	0	10578	0	10478	0.0	0.0
chr3	PLCH1	155486146	155486206	0	61	45176	7204	45176	7143	0.0	6.3245135097298055
chr3	PLCH1	155483348	155483376	0	29	45176	7204	45176	7175	0.0	6.29630662020906
chr3	C3ORF33	155775700	155775848	0	149	12448	2068	12448	1919	0.0	6.486711829077644
chr3	C3ORF33	155805596	155805723	0	128	12448	2068	12448	1940	0.0	6.416494845360825
chr3	SLC33A1	155833467	155833585	0	119	0	4422	0	4303	0.0	0.0
chr3	SLC33A1	155833856	155834041	0	186	0	4422	0	4236	0.0	0.0
chr3	C3ORF33	155804050	155804173	0	124	12448	2068	12448	1944	0.0	6.403292181069959
chr3	SLC33A1	155842431	155842619	0	189	0	4422	0	4233	0.0	0.0
chr3	SLC33A1	155833467	155834041	0	575	0	4422	0	3847	0.0	0.0
chr3	SLC33A1	155845012	155845076	0	65	0	4422	0	4357	0.0	0.0
chr3	CCNL1	157151728	157151930	0	203	7688	6386	7688	6183	0.0	1.2434093482128417
chr3	CCNL1	157157010	157157083	0	74	7688	6386	7688	6312	0.0	1.2179974651457541
chr3	CCNL1	157151916	157151930	0	15	7688	6386	7688	6371	0.0	1.2067179406686548
chr3	CCNL1	157156935	157157083	0	149	7688	6386	7688	6237	0.0	1.232643899310566
chr3	CCNL1	157151485	157151591	0	107	7688	6386	7688	6279	0.0	1.224398789616181
chr3	CCNL1	157157006	157157083	0	78	7688	6386	7688	6308	0.0	1.2187698161065315
chr3	VEPH1	157313620	157313755	0	136	2931	6465	2931	6329	0.0	0.46310633591404643
chr3	VEPH1	157499394	157499656	0	263	2931	6465	2931	6202	0.0	0.4725894872621735
chr3	VEPH1	157495211	157495506	0	296	2931	6465	2931	6169	0.0	0.47511752309936783
chr3	VEPH1	157493186	157493293	0	108	2931	6465	2931	6357	0.0	0.46106654082114207
chr3	VEPH1	157489054	157489160	0	107	2931	6465	2931	6358	0.0	0.4609940232777603
chr3	VEPH1	157499394	157499675	0	282	2931	6465	2931	6183	0.0	0.47404172731683647
chr3	VEPH1	157505277	157505409	0	133	2931	6465	2931	6332	0.0	0.4628869235628553
chr3	SHOX2	158105057	158105129	0	73	1071	3842	1071	3769	0.0	0.284160254709472
chr3	SHOX2	158105057	158105125	0	69	1071	3842	1071	3773	0.0	0.28385899814471244
chr3	AC106707.1	158561396	158561505	0	110	1122	1135	1122	1025	0.0	1.0946341463414635
chr3	RARRES1	158710737	158710933	0	197	0	2037	0	1840	0.0	0.0
chr3	IL12A-AS1	159994236	159994305	30	70	10252	11401	10222	11331	0.42857142857142855	0.9021269084811578
chr3	IL12A-AS1	159997843	159998317	0	475	10252	11401	10252	10926	0.0	0.9383122826285923
chr3	IL12A-AS1	160025469	160025534	8305	66	10252	11401	1947	11335	125.83333333333333	0.1717688575209528
chr3	IL12A-AS1	159997843	159998105	0	263	10252	11401	10252	11138	0.0	0.9204525049380499
chr3	IL12A-AS1	160007781	160007875	0	95	10252	11401	10252	11306	0.0	0.906775163629931
chr3	IL12A-AS1	160009111	160009257	0	147	10252	11401	10252	11254	0.0	0.9109649902256975
chr3	IL12A-AS1	160011465	160011551	0	87	10252	11401	10252	11314	0.0	0.9061339932826586
chr3	IFT80	160366042	160366152	0	111	4292	7073	4292	6962	0.0	0.6164895145073255
chr3	IFT80	160391545	160391643	0	99	4292	7073	4292	6974	0.0	0.6154287353025524
chr3	IFT80	160343650	160343815	0	166	4292	7073	4292	6907	0.0	0.6213985811495584
chr3	IFT80	160366092	160366152	0	61	4292	7073	4292	7012	0.0	0.612093553907587
chr3	IFT80	160377832	160377890	0	59	4292	7073	4292	7014	0.0	0.6119190191046479
chr3	IFT80	160394152	160394310	0	159	4292	7073	4292	6914	0.0	0.6207694532831936
chr3	TRIM59	160448725	160448795	0	71	51	7827	51	7756	0.0	0.0065755544094894276
chr3	TRIM59	160447731	160447842	0	112	51	7827	51	7715	0.0	0.00661049902786779
chr3	KPNA4	160509799	160509871	0	73	357	13663	357	13590	0.0	0.026269315673289183
chr3	KPNA4	160521778	160521910	10	133	357	13663	347	13530	0.07518796992481203	0.02564671101256467
chr3	KPNA4	160525020	160525132	0	113	357	13663	357	13550	0.0	0.026346863468634685
chr3	KPNA4	160564504	160564640	0	137	357	13663	357	13526	0.0	0.026393612302232736
chr3	KPNA4	160564520	160564640	0	121	357	13663	357	13542	0.0	0.026362428001772263
chr3	KPNA4	160504000	160504067	0	68	357	13663	357	13595	0.0	0.02625965428466348
chr3	B3GALNT1	161101138	161101233	0	96	51	6044	51	5948	0.0	0.008574310692669805
chr3	B3GALNT1	161089943	161090062	0	120	51	6044	51	5924	0.0	0.008609047940580688
chr3	B3GALNT1	161103112	161103205	0	94	51	6044	51	5950	0.0	0.008571428571428572
chr3	B3GALNT1	161104784	161104895	0	112	51	6044	51	5932	0.0	0.008597437626432907
chr3	B3GALNT1	161103957	161104105	0	149	51	6044	51	5895	0.0	0.008651399491094147
chr3	B3GALNT1	161089959	161090062	0	104	51	6044	51	5940	0.0	0.008585858585858586
chr3	B3GALNT1	161101444	161101631	0	188	51	6044	51	5856	0.0	0.008709016393442622
chr3	B3GALNT1	161089943	161090066	0	124	51	6044	51	5920	0.0	0.008614864864864865
chr3	SPTSSB	161347964	161348103	0	140	51	2437	51	2297	0.0	0.02220287331301698
chr3	LINC01192	163199873	163199951	765	79	837	7521	72	7442	9.683544303797468	0.009674818597151304
chr3	LINC01192	163203417	163203515	21	99	837	7521	816	7422	0.21212121212121213	0.1099434114793856
chr3	LINC01192	163275195	163275319	0	125	837	7521	837	7396	0.0	0.11316928069226609
chr3	LINC01192	163220100	163220187	0	88	837	7521	837	7433	0.0	0.11260594645499798
chr3	LINC01192	163124386	163124486	0	101	837	7521	837	7420	0.0	0.11280323450134772
chr3	LINC01192	163249264	163249381	0	118	837	7521	837	7403	0.0	0.11306227205187086
chr3	LINC01192	163187067	163187264	0	198	837	7521	837	7323	0.0	0.11429741909053666
chr3	LINC01192	163249264	163249374	0	111	837	7521	837	7410	0.0	0.11295546558704453
chr3	LINC01192	163184064	163184133	0	70	837	7521	837	7451	0.0	0.11233391491075023
chr3	LINC01192	163112460	163112617	0	158	837	7521	837	7363	0.0	0.11367649056091267
chr3	LINC01192	163184064	163184129	0	66	837	7521	837	7455	0.0	0.11227364185110664
chr3	LINC01192	163202081	163202249	0	169	837	7521	837	7352	0.0	0.11384657236126224
chr3	LINC01192	163303983	163304098	0	116	837	7521	837	7405	0.0	0.11303173531397705
chr3	LINC01192	163207642	163207757	0	116	837	7521	837	7405	0.0	0.11303173531397705
chr3	LINC01324	164717571	164717791	0	221	0	848	0	627	0.0	0.0
chr3	BCHE	165829516	165831041	0	1526	150	3079	150	1553	0.0	0.09658725048293625
chr3	BCHE	165827985	165828069	0	85	150	3079	150	2994	0.0	0.050100200400801605
chr3	BCHE	165777716	165777795	0	80	150	3079	150	2999	0.0	0.050016672224074694
chr3	ZBBX	167288866	167288983	0	118	1212	4593	1212	4475	0.0	0.27083798882681565
chr3	ZBBX	167315749	167315829	0	81	1212	4593	1212	4512	0.0	0.26861702127659576
chr3	ZBBX	167373705	167373787	0	83	1212	4593	1212	4510	0.0	0.2687361419068736
chr3	ZBBX	167379637	167379792	0	156	1212	4593	1212	4437	0.0	0.27315753887762
chr3	ZBBX	167368687	167368804	0	118	1212	4593	1212	4475	0.0	0.27083798882681565
chr3	ZBBX	167252125	167252211	0	87	1212	4593	1212	4506	0.0	0.26897470039946736
chr3	ZBBX	167248607	167248649	0	43	1212	4593	1212	4550	0.0	0.2663736263736264
chr3	SERPINI2	167473736	167473827	0	92	51	2847	51	2755	0.0	0.018511796733212342
chr3	WDR49	167527819	167528017	0	199	0	3913	0	3714	0.0	0.0
chr3	WDR49	167626851	167627292	0	442	0	3913	0	3471	0.0	0.0
chr3	PDCD10	167687614	167687693	0	80	51	3179	51	3099	0.0	0.016456921587608905
chr3	PDCD10	167720061	167720273	0	213	51	3179	51	2966	0.0	0.017194875252865813
chr3	PDCD10	167725400	167725473	0	74	51	3179	51	3105	0.0	0.01642512077294686
chr3	PDCD10	167734213	167734345	0	133	51	3179	51	3046	0.0	0.01674326986211425
chr3	PDCD10	167734213	167734246	0	34	51	3179	51	3145	0.0	0.016216216216216217
chr3	PDCD10	167734213	167734350	0	138	51	3179	51	3041	0.0	0.016770799079250248
chr3	PDCD10	167697850	167697978	0	129	51	3179	51	3050	0.0	0.016721311475409836
chr3	GOLIM4	168040785	168040869	0	85	0	4600	0	4515	0.0	0.0
chr3	MECOM	169107925	169107952	0	28	0	9118	0	9090	0.0	0.0
chr3	MECOM	169144996	169145058	0	63	0	9118	0	9055	0.0	0.0
chr3	MECOM	169086512	169086565	0	54	0	9118	0	9064	0.0	0.0
chr3	MECOM	169133349	169133474	0	126	0	9118	0	8992	0.0	0.0
chr3	MECOM	169565968	169566040	0	73	0	9118	0	9045	0.0	0.0
chr3	LRRC34	169795484	169795611	663	128	31149	2712	30486	2584	5.1796875	11.797987616099071
chr3	LRRC34	169800658	169800754	0	97	31149	2712	31149	2615	0.0	11.911663479923519
chr3	LRRC34	169808627	169808745	7373	119	31149	2712	23776	2593	61.95798319327731	9.169301966833784
chr3	LRRC31	169860560	169860728	0	169	5823	3135	5823	2966	0.0	1.9632501685772084
chr3	AC008040.1	169954519	169955207	0	689	51	7981	51	7292	0.0	0.0069939659901261655
chr3	PHC3	170149085	170149244	0	160	31803	16850	31803	16690	0.0	1.9055122828040743
chr3	PHC3	170145422	170145521	0	100	31803	16850	31803	16750	0.0	1.898686567164179
chr3	PHC3	170128339	170128387	0	49	31803	16850	31803	16801	0.0	1.8929230402952206
chr3	PHC3	170176864	170176925	0	62	31803	16850	31803	16788	0.0	1.8943888491779843
chr3	AC026316.5	170733846	170733942	0	97	0	1786	0	1689	0.0	0.0
chr3	EIF5A2	170894291	170894423	0	133	663	5546	663	5413	0.0	0.1224829115093294
chr3	EIF5A2	170894291	170894383	0	93	663	5546	663	5453	0.0	0.12158444892719604
chr3	SLC2A2	171005942	171006105	0	164	0	3422	0	3258	0.0	0.0
chr3	SLC2A2	171009957	171010082	0	126	0	3422	0	3296	0.0	0.0
chr3	SLC2A2	171014468	171014731	0	264	0	3422	0	3158	0.0	0.0
chr3	TNIK	171107182	171107206	0	25	408	6345	408	6320	0.0	0.06455696202531645
chr3	TNIK	171128713	171128878	0	166	408	6345	408	6179	0.0	0.06603010195824567
chr3	TNIK	171139469	171139556	0	88	408	6345	408	6257	0.0	0.0652069681956209
chr3	PLD1	171686684	171686798	51	115	2269	11660	2218	11545	0.4434782608695652	0.1921177999133824
chr3	PLD1	171737531	171737659	0	129	2269	11660	2269	11531	0.0	0.1967739137975891
chr3	TNFSF10	172511616	172511659	0	44	2291	3448	2291	3404	0.0	0.6730317273795534
chr3	LINC02068	172574272	172574340	0	69	0	3672	0	3603	0.0	0.0
chr3	NCEH1	172647885	172648114	0	230	0	4813	0	4583	0.0	0.0
chr3	NCEH1	172647861	172648114	0	254	0	4813	0	4559	0.0	0.0
chr3	SPATA16	172922229	172922284	0	56	0	2141	0	2085	0.0	0.0
chr3	NLGN1-AS1	173912545	173912617	0	73	0	819	0	746	0.0	0.0
chr3	LINC01208	176636308	176636533	0	226	1826	5627	1826	5401	0.0	0.3380855397148676
chr3	TBL1XR1	177053772	177053918	0	147	87	10475	87	10328	0.0	0.008423702556158017
chr3	TBL1XR1	177064919	177065022	0	104	87	10475	87	10371	0.0	0.008388776395718832
chr3	TBL1XR1	177098465	177098541	0	77	87	10475	87	10398	0.0	0.008366993652625505
chr3	TBL1XR1	177037636	177037842	0	207	87	10475	87	10268	0.0	0.008472925594078692
chr3	TBL1XR1	177110808	177110887	0	80	87	10475	87	10395	0.0	0.00836940836940837
chr3	TBL1XR1	177079826	177079945	0	120	87	10475	87	10355	0.0	0.00840173829068083
chr3	TBL1XR1	177131362	177131449	0	88	87	10475	87	10387	0.0	0.0083758544334264
chr3	TBL1XR1	177086964	177087041	43	78	87	10475	44	10397	0.5512820512820513	0.004231989997114553
chr3	TBL1XR1	177160870	177160988	0	119	87	10475	87	10356	0.0	0.008400926998841252
chr3	TBL1XR1	177091150	177091180	0	31	87	10475	87	10444	0.0	0.008330141708157794
chr3	TBL1XR1	177078631	177078778	0	148	87	10475	87	10327	0.0	0.008424518253122881
chr3	AC117453.1	178191507	178191597	0	91	0	10965	0	10874	0.0	0.0
chr3	AC117453.1	178371750	178371819	0	70	0	10965	0	10895	0.0	0.0
chr3	KCNMB2-AS1	178757079	178757136	0	58	2894	4760	2894	4702	0.0	0.6154827732879625
chr3	KCNMB2-AS1	178859488	178859623	0	136	2894	4760	2894	4624	0.0	0.6258650519031141
chr3	ZMAT3	179071326	179071447	0	122	22853	4793	22853	4671	0.0	4.892528366516806
chr3	KCNMB3	179242808	179243284	0	477	0	5833	0	5356	0.0	0.0
chr3	GNB4	179405189	179405406	681	218	30439	7989	29758	7771	3.123853211009174	3.829365590014155
chr3	GNB4	179420888	179420927	0	40	30439	7989	30439	7949	0.0	3.8292867027299033
chr3	GNB4	179424111	179424284	0	174	30439	7989	30439	7815	0.0	3.8949456174024313
chr3	GNB4	179437740	179437899	9521	160	30439	7989	20918	7829	59.50625	2.671861029505684
chr3	MRPL47	179602651	179602797	0	147	0	1372	0	1225	0.0	0.0
chr3	MRPL47	179602651	179602737	0	87	0	1372	0	1285	0.0	0.0
chr3	PEX5L	179879928	179880123	0	196	51	10258	51	10062	0.0	0.005068574836016696
chr3	PEX5L	179898141	179898246	0	106	51	10258	51	10152	0.0	0.005023640661938535
chr3	PEX5L	179971593	179971665	0	73	51	10258	51	10185	0.0	0.005007363770250369
chr3	PEX5L	179900669	179900735	0	67	51	10258	51	10191	0.0	0.005004415660877244
chr3	PEX5L	179973158	179973318	0	161	51	10258	51	10097	0.0	0.005051005249083886
chr3	PEX5L	179971593	179971660	0	68	51	10258	51	10190	0.0	0.005004906771344455
chr3	CCDC39	180614995	180615077	0	83	25792	11338	25792	11255	0.0	2.2916037316748112
chr3	CCDC39	180619810	180619970	0	161	25792	11338	25792	11177	0.0	2.3075959559810326
chr3	CCDC39	180654761	180654953	0	193	25792	11338	25792	11145	0.0	2.3142216240466578
chr3	CCDC39	180679290	180679382	21142	93	25792	11338	4650	11245	227.33333333333334	0.41351711871943087
chr3	AC108734.4	180847506	180847624	0	119	2652	3116	2652	2997	0.0	0.8848848848848849
chr3	AC108734.4	180810409	180810470	0	62	2652	3116	2652	3054	0.0	0.8683693516699411
chr3	DNAJC19	180986942	180987022	0	81	0	3243	0	3162	0.0	0.0
chr3	DNAJC19	180988177	180988229	0	53	0	3243	0	3190	0.0	0.0
chr3	DNAJC19	180986997	180987022	0	26	0	3243	0	3217	0.0	0.0
chr3	DNAJC19	180986947	180987022	0	76	0	3243	0	3167	0.0	0.0
chr3	AC068308.1	181439976	181440034	0	59	0	6618	0	6559	0.0	0.0
chr3	AC068308.1	181436157	181436191	0	35	0	6618	0	6583	0.0	0.0
chr3	DCUN1D1	182985503	182985622	0	120	261	8289	261	8169	0.0	0.03195005508630187
chr3	DCUN1D1	182980834	182980935	210	102	261	8289	51	8187	2.0588235294117645	0.00622938805423232
chr3	MCCC1	183025754	183025804	0	51	10957	4334	10957	4283	0.0	2.5582535605883727
chr3	MCCC1	183037217	183037434	0	218	10957	4334	10957	4116	0.0	2.6620505344995142
chr3	MCCC1	183072365	183072487	0	123	10957	4334	10957	4211	0.0	2.6019947755877464
chr3	MCCC1	183092408	183092545	0	138	10957	4334	10957	4196	0.0	2.6112964728312678
chr3	MCCC1	183086692	183086788	0	97	10957	4334	10957	4237	0.0	2.5860278498937928
chr3	MCCC1	183029092	183029189	0	98	10957	4334	10957	4236	0.0	2.586638338054769
chr3	MCCC1	183094558	183094605	0	48	10957	4334	10957	4286	0.0	2.5564629024731684
chr3	MCCC1	183086692	183086784	0	93	10957	4334	10957	4241	0.0	2.5835887762320207
chr3	MCCC1	183090935	183091031	0	97	10957	4334	10957	4237	0.0	2.5860278498937928
chr3	LAMP3	183160856	183160957	0	102	0	3795	0	3693	0.0	0.0
chr3	KLHL6	183499589	183499827	0	239	104543	10287	104543	10048	0.0	10.40435907643312
chr3	PARL	183833723	183833825	0	103	926803	2279	926803	2176	0.0	425.9204963235294
chr3	PARL	183842297	183842447	51	151	926803	2279	926752	2128	0.33774834437086093	435.50375939849624
chr3	PARL	183866624	183866765	0	142	926803	2279	926803	2137	0.0	433.69349555451566
chr3	PARL	183856431	183856551	273	121	926803	2279	926530	2158	2.256198347107438	429.3466172381835
chr3	PARL	183833491	183833589	0	99	926803	2279	926803	2180	0.0	425.1389908256881
chr3	PARL	183842297	183842384	3	88	926803	2279	926800	2191	0.03409090909090909	423.00319488817894
chr3	ABCC5	183949752	183949881	0	130	175332	10992	175332	10862	0.0	16.14177867795986
chr3	ABCC5	183942432	183942515	0	84	175332	10992	175332	10908	0.0	16.073707370737075
chr3	ABCC5	183985303	183985378	0	76	175332	10992	175332	10916	0.0	16.061927445950896
chr3	ABCC5	183985303	183985455	0	153	175332	10992	175332	10839	0.0	16.176030999169665
chr3	ABCC5	184009888	184009977	0	90	175332	10992	175332	10902	0.0	16.082553659878922
chr3	ALG3	184245197	184245358	0	162	0	3286	0	3124	0.0	0.0
chr3	ALG3	184245712	184245812	0	101	0	3286	0	3185	0.0	0.0
chr3	ALG3	184245467	184245615	0	149	0	3286	0	3137	0.0	0.0
chr3	CLCN2	184346934	184347021	0	88	0	7330	0	7242	0.0	0.0
chr3	CLCN2	184352012	184352117	0	106	0	7330	0	7224	0.0	0.0
chr3	CLCN2	184353661	184353795	0	135	0	7330	0	7195	0.0	0.0
chr3	CLCN2	184354903	184354973	0	71	0	7330	0	7259	0.0	0.0
chr3	CLCN2	184357778	184357856	0	79	0	7330	0	7251	0.0	0.0
chr3	CLCN2	184358681	184358813	0	133	0	7330	0	7197	0.0	0.0
chr3	CLCN2	184356513	184356611	0	99	0	7330	0	7231	0.0	0.0
chr3	CLCN2	184357619	184357698	0	80	0	7330	0	7250	0.0	0.0
chr3	CLCN2	184353541	184353795	0	255	0	7330	0	7075	0.0	0.0
chr3	CLCN2	184358681	184358783	0	103	0	7330	0	7227	0.0	0.0
chr3	LIPH	185527483	185527585	588	103	10374	4108	9786	4005	5.70873786407767	2.4434456928838952
chr3	LIPH	185524070	185524160	0	91	10374	4108	10374	4017	0.0	2.5825242718446604
chr3	LIPH	185546876	185546972	4728	97	10374	4108	5646	4011	48.74226804123711	1.4076290201944652
chr3	IGF2BP2	185672540	185672669	0	130	494637	5350	494637	5220	0.0	94.75804597701149
chr3	TRA2B	185919436	185919496	0	61	51	11300	51	11239	0.0	0.004537770264258386
chr3	TRA2B	185926600	185926734	0	135	51	11300	51	11165	0.0	0.004567845947156292
chr3	TRA2B	185931576	185931852	0	277	51	11300	51	11023	0.0	0.0046266896489159035
chr3	ETV5	186084168	186084280	0	113	51	5754	51	5641	0.0	0.00904095018613721
chr3	DGKG	186260438	186260513	1551	76	41171	11004	39620	10928	20.407894736842106	3.625549048316252
chr3	DGKG	186268800	186268917	0	118	41171	11004	41171	10886	0.0	3.782013595443689
chr3	DGKG	186279850	186279973	0	124	41171	11004	41171	10880	0.0	3.7840992647058824
chr3	LINC02052	186456916	186457061	0	146	280	3834	280	3688	0.0	0.07592190889370933
chr3	LINC02052	186456163	186456257	0	95	280	3834	280	3739	0.0	0.07488633324418294
chr3	LINC02052	186479704	186479805	0	102	280	3834	280	3732	0.0	0.07502679528403002
chr3	TBCCD1	186563993	186564372	0	380	102	3408	102	3028	0.0	0.03368560105680317
chr3	AC068631.1	186647041	186647162	0	122	14778	10018	14778	9896	0.0	1.4933306386418754
chr3	AC068631.1	186642220	186642294	0	75	14778	10018	14778	9943	0.0	1.486271748969124
chr3	AC068631.1	186651809	186651871	306	63	14778	10018	14472	9955	4.857142857142857	1.453741838272225
chr3	AC068631.1	186666967	186667261	0	295	14778	10018	14778	9723	0.0	1.519901265041654
chr3	AC068631.1	186668911	186669043	0	133	14778	10018	14778	9885	0.0	1.4949924127465857
chr3	AC068631.1	186721219	186721344	0	126	14778	10018	14778	9892	0.0	1.4939344925192075
chr3	AC068631.1	186736538	186736650	0	113	14778	10018	14778	9905	0.0	1.4919737506309945
chr3	AC068631.1	186714739	186714858	0	120	14778	10018	14778	9898	0.0	1.4930288947262074
chr3	AC068631.1	186714447	186714539	0	93	14778	10018	14778	9925	0.0	1.4889672544080605
chr3	AC068631.1	186721219	186721416	0	198	14778	10018	14778	9820	0.0	1.504887983706721
chr3	AC068631.1	186734712	186734834	0	123	14778	10018	14778	9895	0.0	1.4934815563415866
chr3	AC068631.1	186721742	186722089	0	348	14778	10018	14778	9670	0.0	1.5282316442605999
chr3	AC068631.1	186736746	186736883	396	138	14778	10018	14382	9880	2.869565217391304	1.455668016194332
chr3	AC068631.1	186742072	186742249	0	178	14778	10018	14778	9840	0.0	1.5018292682926828
chr3	AC068631.1	186745109	186745202	0	94	14778	10018	14778	9924	0.0	1.4891172914147521
chr3	AC068631.1	186746698	186746795	189	98	14778	10018	14589	9920	1.9285714285714286	1.4706653225806452
chr3	AC068631.1	186746698	186746820	208	123	14778	10018	14570	9895	1.6910569105691058	1.4724608388074785
chr3	RFC4	186790325	186790406	0	82	9373	2909	9373	2827	0.0	3.3155288291475062
chr3	RFC4	186805559	186805598	0	40	9373	2909	9373	2869	0.0	3.266991983269432
chr3	RPL39L	187127998	187128062	0	65	0	1038	0	973	0.0	0.0
chr3	MASP1	187285824	187286056	0	233	51	9431	51	9198	0.0	0.005544683626875407
chr3	MASP1	187291244	187291350	0	107	51	9431	51	9324	0.0	0.0054697554697554695
chr3	MASP1	187285824	187286077	0	254	51	9431	51	9177	0.0	0.005557371690094802
chr3	MASP1	187291244	187291488	0	245	51	9431	51	9186	0.0	0.005551926845199217
chr3	BCL6	187726730	187726898	0	169	0	5524	0	5355	0.0	0.0
chr3	GMNC	190859744	190859819	0	76	0	3969	0	3893	0.0	0.0
chr3	UTS2B	191276806	191276844	0	39	135	3865	135	3826	0.0	0.0352848928384736
chr3	UTS2B	191304491	191304548	0	58	135	3865	135	3807	0.0	0.03546099290780142
chr3	UTS2B	191273385	191273564	0	180	135	3865	135	3685	0.0	0.036635006784260515
chr3	UTS2B	191294559	191294726	0	168	135	3865	135	3697	0.0	0.03651609413037598
chr3	FGF12	192360427	192360538	0	112	0	7205	0	7093	0.0	0.0
chr3	FGF12	192727180	192727323	0	144	0	7205	0	7061	0.0	0.0
chr3	ATP13A5	193372219	193372285	0	67	22118	5709	22118	5642	0.0	3.9202410492733075
chr3	ATP13A4	193438474	193438584	36	111	14814	9023	14778	8912	0.32432432432432434	1.658213644524237
chr3	OPA1-AS1	193619600	193619686	0	87	0	500	0	413	0.0	0.0
chr3	LINC02028	194010289	194010429	0	141	2219	10141	2219	10000	0.0	0.2219
chr3	LINC02028	194023106	194023207	0	102	2219	10141	2219	10039	0.0	0.22103795198724974
chr3	LINC02028	194015550	194015635	0	86	2219	10141	2219	10055	0.0	0.2206862257583292
chr3	LINC02028	194052359	194052442	0	84	2219	10141	2219	10057	0.0	0.22064233866958338
chr3	LINC02028	194058059	194058147	0	89	2219	10141	2219	10052	0.0	0.22075208913649025
chr3	LINC02028	194029645	194029753	0	109	2219	10141	2219	10032	0.0	0.22119218500797447
chr3	LINC02028	194046469	194046679	0	211	2219	10141	2219	9930	0.0	0.22346424974823767
chr3	LINC02028	194043743	194043855	0	113	2219	10141	2219	10028	0.0	0.22128041483845234
chr3	LINC02028	194057636	194057815	0	180	2219	10141	2219	9961	0.0	0.22276879831342233
chr3	LINC02028	194057632	194057815	0	184	2219	10141	2219	9957	0.0	0.22285829064979412
chr3	LINC02036	194210613	194210710	0	98	7790	3513	7790	3415	0.0	2.281112737920937
chr3	LINC02036	194211207	194211350	0	144	7790	3513	7790	3369	0.0	2.3122588305135054
chr3	LRRC15	194363355	194363412	0	58	7108	5941	7108	5883	0.0	1.208227095019548
chr3	ATP13A3	194457093	194457174	0	82	366	13292	366	13210	0.0	0.027706283118849356
chr3	ATP13A3	194412198	194412288	0	91	366	13292	366	13201	0.0	0.027725172335429135
chr3	ATP13A3	194424401	194424432	0	32	366	13292	366	13260	0.0	0.02760180995475113
chr3	TMEM44	194617635	194617776	0	142	0	4577	0	4435	0.0	0.0
chr3	TMEM44	194625896	194625990	0	95	0	4577	0	4482	0.0	0.0
chr3	TMEM44	194593040	194593073	0	34	0	4577	0	4543	0.0	0.0
chr3	TMEM44	194593040	194593070	0	31	0	4577	0	4546	0.0	0.0
chr3	TMEM44	194625896	194625926	0	31	0	4577	0	4546	0.0	0.0
chr3	LSG1	194660741	194660886	0	146	0	4817	0	4671	0.0	0.0
chr3	XXYLT1	195207424	195207498	0	75	2039	5414	2039	5339	0.0	0.38190672410563775
chr3	XXYLT1	195270088	195270205	626	118	2039	5414	1413	5296	5.305084745762712	0.2668051359516616
chr3	ACAP2	195392089	195392147	0	59	41081	10066	41081	10007	0.0	4.105226341560908
chr3	ACAP2	195295195	195295300	0	106	41081	10066	41081	9960	0.0	4.124598393574297
chr3	ACAP2	195312946	195312967	0	22	41081	10066	41081	10044	0.0	4.09010354440462
chr3	ACAP2	195325443	195325455	0	13	41081	10066	41081	10053	0.0	4.086441858151796
chr3	PPP1R2	195523691	195523786	0	96	306	4053	306	3957	0.0	0.07733131159969674
chr3	PPP1R2	195524818	195524896	0	79	306	4053	306	3974	0.0	0.0770005032712632
chr3	PPP1R2	195527757	195527902	0	146	306	4053	306	3907	0.0	0.07832096237522396
chr3	APOD	195577061	195577183	0	123	42	2030	42	1907	0.0	0.02202412165705296
chr3	APOD	195582616	195582739	0	124	42	2030	42	1906	0.0	0.022035676810073453
chr3	APOD	195583066	195583202	0	137	42	2030	42	1893	0.0	0.022187004754358162
chr3	MUC4	195754212	195754372	0	161	227788	19948	227788	19787	0.0	11.512002830141002
chr3	MUC4	195770215	195770371	0	157	227788	19948	227788	19791	0.0	11.509676115405993
chr3	MUC4	195766662	195766751	0	90	227788	19948	227788	19858	0.0	11.470842985194883
chr3	MUC4	195770677	195770886	1683	210	227788	19948	226105	19738	8.014285714285714	11.455314621542202
chr3	MUC4	195778302	195778455	14990	154	227788	19948	212798	19794	97.33766233766234	10.750631504496312
chr3	MUC4	195778789	195791497	205951	12709	227788	19948	21837	7239	16.205130222676843	3.016576875259014
chr3	TNK2	195867168	195867264	0	97	204	8460	204	8363	0.0	0.024393160349157002
chr3	TNK2	195882050	195882328	102	279	204	8460	102	8181	0.3655913978494624	0.012467913458012467
chr3	TNK2	195884811	195885033	0	223	204	8460	204	8237	0.0	0.02476629840961515
chr3	TNK2	195869496	195869541	0	46	204	8460	204	8414	0.0	0.02424530544330877
chr3	TNK2	195867168	195867258	0	91	204	8460	204	8369	0.0	0.024375672123312223
chr3	TNK2	195876443	195876508	29	66	204	8460	175	8394	0.4393939393939394	0.020848224922563736
chr3	TNK2	195882444	195882527	0	84	204	8460	204	8376	0.0	0.024355300859598854
chr3	TNK2	195882285	195882328	8	44	204	8460	196	8416	0.18181818181818182	0.02328897338403042
chr3	TNK2	195885412	195885543	0	132	204	8460	204	8328	0.0	0.024495677233429394
chr3	SDHAP1	195960299	195960423	196	125	127316	3371	127120	3246	1.568	39.16204559457794
chr3	SDHAP1	195968218	195968385	359	168	127316	3371	126957	3203	2.136904761904762	39.63690290352794
chr3	SDHAP1	195984491	195984737	17831	247	127316	3371	109485	3124	72.19028340080972	35.04641485275288
chr3	SDHAP1	195984593	195984737	16250	145	127316	3371	111066	3226	112.06896551724138	34.42839429634222
chr3	TFRC	196073929	196074125	0	197	58199	7608	58199	7411	0.0	7.85305626771016
chr3	TFRC	196075158	196075360	27948	203	58199	7608	30251	7405	137.67487684729065	4.085212694125591
chr3	ZDHHC19	196199345	196199522	8774	178	44655	2438	35881	2260	49.29213483146067	15.876548672566372
chr3	PCYT1A	196283474	196283538	0	65	40966	7356	40966	7291	0.0	5.618707996159649
chr3	PCYT1A	196267279	196267365	0	87	40966	7356	40966	7269	0.0	5.635713303067822
chr3	TCTEX1D2	196305655	196305773	77	119	10438	1253	10361	1134	0.6470588235294118	9.13668430335097
chr3	TM4SF19	196326954	196327032	0	79	102	1901	102	1822	0.0	0.05598243688254665
chr3	UBXN7	196393553	196393619	0	67	2283	11261	2283	11194	0.0	0.20394854386278363
chr3	UBXN7	196407245	196407393	0	149	2283	11261	2283	11112	0.0	0.2054535637149028
chr3	RNF168	196488606	196488683	0	78	11811	5353	11811	5275	0.0	2.239052132701422
chr3	WDR53	196567190	196567307	0	118	13330	1801	13330	1683	0.0	7.92038027332145
chr3	CEP19	196708527	196708727	1032	201	3989	2161	2957	1960	5.134328358208955	1.508673469387755
chr3	NCBP2	196941486	196941602	0	117	0	4358	0	4241	0.0	0.0
chr3	DLG1	197069218	197069260	0	43	54021	16100	54021	16057	0.0	3.3643270847605407
chr3	DLG1	197081050	197081117	0	68	54021	16100	54021	16032	0.0	3.369573353293413
chr3	DLG1	197119409	197119530	0	122	54021	16100	54021	15978	0.0	3.380961321817499
chr3	DLG1	197142717	197142768	0	52	54021	16100	54021	16048	0.0	3.3662138584247256
chr3	DLG1	197161639	197161738	0	100	54021	16100	54021	16000	0.0	3.3763125
chr3	DLG1	197149742	197149796	0	55	54021	16100	54021	16045	0.0	3.3668432533499533
chr3	DLG1	197068501	197068537	0	37	54021	16100	54021	16063	0.0	3.3630704102596027
chr3	DLG1	197068501	197068522	0	22	54021	16100	54021	16078	0.0	3.359932827466103
chr3	DLG1	197155668	197155763	0	96	54021	16100	54021	16004	0.0	3.3754686328417898
chr3	DLG1	197075836	197075870	0	35	54021	16100	54021	16065	0.0	3.3626517273576098
chr3	DLG1	197076585	197076682	0	98	54021	16100	54021	16002	0.0	3.375890513685789
chr3	DLG1	197270699	197270784	4390	86	54021	16100	49631	16014	51.04651162790697	3.0992256775321594
chr3	DLG1	197297352	197297426	0	75	54021	16100	54021	16025	0.0	3.3710452418096724
chr3	DLG1	197076585	197076685	0	101	54021	16100	54021	15999	0.0	3.376523532720795
chr3	DLG1	197141229	197141353	0	125	54021	16100	54021	15975	0.0	3.3815962441314555
chr3	BDH1	197546360	197546486	53	127	284194	10256	284141	10129	0.41732283464566927	28.052226280975418
chr3	BDH1	197554561	197554713	51	153	284194	10256	284143	10103	0.3333333333333333	28.12461645055924
chr3	BDH1	197538305	197538952	102	648	284194	10256	284092	9608	0.1574074074074074	29.56827643630308
chr3	BDH1	197555341	197555507	306	167	284194	10256	283888	10089	1.8323353293413174	28.138368520170484
chr3	AC132008.2	197622186	197622330	0	145	41546	2727	41546	2582	0.0	16.090627420604182
chr3	AC132008.2	197624471	197624720	0	250	41546	2727	41546	2477	0.0	16.772708922083165
chr3	AC132008.2	197621703	197621868	264	166	41546	2727	41282	2561	1.5903614457831325	16.119484576337367
chr3	RUBCN	197696953	197697049	0	97	56427	11010	56427	10913	0.0	5.170622193713919
chr3	RUBCN	197717976	197718130	0	155	56427	11010	56427	10855	0.0	5.198249654537079
chr3	RUBCN	197699186	197699231	0	46	56427	11010	56427	10964	0.0	5.146570594673477
chr3	RUBCN	197691073	197691148	0	76	56427	11010	56427	10934	0.0	5.160691421254802
chr3	IQCG	197891445	197891547	0	103	15762	4487	15762	4384	0.0	3.5953467153284673
chr3	IQCG	197945619	197945686	1215	68	15762	4487	14547	4419	17.86764705882353	3.291921249151392
chr3	IQCG	197949372	197949449	585	78	15762	4487	15177	4409	7.5	3.4422771603538216
chr4	ABCA11P	437445	437511	921	67	8980	2794	8059	2727	13.746268656716419	2.955262192885955
chr4	ZNF721	472574	472701	0	128	17470	6398	17470	6270	0.0	2.7862838915470496
chr4	PDE6B-AS1	654064	654213	777	150	38268	2333	37491	2183	5.18	17.17407237746221
chr4	ATP5ME	673911	673966	0	56	24758	936	24758	880	0.0	28.134090909090908
chr4	GAK	859605	859722	0	118	156683	14541	156683	14423	0.0	10.863412604867227
chr4	GAK	896459	896549	31	91	156683	14541	156652	14450	0.34065934065934067	10.840968858131488
chr4	GAK	904636	904779	102	144	156683	14541	156581	14397	0.7083333333333334	10.87594637771758
chr4	GAK	859361	859493	93	133	156683	14541	156590	14408	0.6992481203007519	10.868267629094948
chr4	GAK	912734	912794	0	61	156683	14541	156683	14480	0.0	10.820649171270718
chr4	GAK	913606	913668	0	63	156683	14541	156683	14478	0.0	10.822143942533499
chr4	DGKQ	961687	961834	597	148	24861	5008	24264	4860	4.033783783783784	4.992592592592593
chr4	DGKQ	965490	965529	0	40	24861	5008	24861	4968	0.0	5.004227053140097
chr4	SLC26A1	992720	992935	595	216	26265	4299	25670	4083	2.7546296296296298	6.287043840313495
chr4	RNF212	1056837	1057004	0	168	274	5018	274	4850	0.0	0.05649484536082474
chr4	RNF212	1081418	1081467	0	50	274	5018	274	4968	0.0	0.055152979066022546
chr4	RNF212	1108342	1108404	0	63	274	5018	274	4955	0.0	0.05529767911200807
chr4	RNF212	1099715	1099927	0	213	274	5018	274	4805	0.0	0.057023933402705514
chr4	TMED11P	1117147	1117273	0	127	1479	758	1479	631	0.0	2.3438985736925515
chr4	SPON2	1179447	1179541	0	95	113227	5995	113227	5900	0.0	19.19101694915254
chr4	SPON2	1201268	1201462	0	195	113227	5995	113227	5800	0.0	19.521896551724137
chr4	CTBP1	1225359	1225566	7508	208	226480	5959	218972	5751	36.09615384615385	38.075465136498
chr4	CTBP1	1241324	1241519	5572	196	226480	5959	220908	5763	28.428571428571427	38.332118688183236
chr4	CTBP1	1238182	1238337	2122	156	226480	5959	224358	5803	13.602564102564102	38.662415991728416
chr4	FAM53A	1644188	1644342	0	155	5680	3942	5680	3787	0.0	1.4998679693688937
chr4	SLBP	1703595	1703700	0	106	18123	1892	18123	1786	0.0	10.147256438969764
chr4	SLBP	1711873	1711990	144	118	18123	1892	17979	1774	1.2203389830508475	10.134723788049605
chr4	TMEM129	1717515	1717675	255	161	66474	3448	66219	3287	1.5838509316770186	20.145725585640402
chr4	TMEM129	1717515	1717703	529	189	66474	3448	65945	3259	2.798941798941799	20.234734581159866
chr4	NELFA	1991543	1991715	27630	173	426389	5076	398759	4903	159.71098265895955	81.32959412604528
chr4	NELFA	1991543	1991730	27645	188	426389	5076	398744	4888	147.04787234042553	81.57610474631751
chr4	NELFA	2006997	2007199	1390	203	426389	5076	424999	4873	6.847290640394089	87.21506258978042
chr4	NELFA	2007971	2008046	29	76	426389	5076	426360	5000	0.3815789473684211	85.272
chr4	NELFA	2007962	2008046	29	85	426389	5076	426360	4991	0.3411764705882353	85.42576637948306
chr4	POLN	2176265	2176334	0	70	27453	5714	27453	5644	0.0	4.864103472714387
chr4	POLN	2131232	2131290	0	59	27453	5714	27453	5655	0.0	4.854641909814323
chr4	POLN	2179307	2179465	0	159	27453	5714	27453	5555	0.0	4.942034203420342
chr4	HAUS3	2231834	2232160	2752	327	193335	9687	190583	9360	8.415902140672783	20.361431623931622
chr4	HAUS3	2241519	2241790	4418	272	193335	9687	188917	9415	16.24264705882353	20.065533722782792
chr4	HAUS3	2241519	2241781	2782	263	193335	9687	190553	9424	10.577946768060837	20.219970288624786
chr4	HAUS3	2241519	2241837	16872	319	193335	9687	176463	9368	52.89028213166144	18.836784799316824
chr4	MXD4	2255154	2255351	5737	198	266764	6880	261027	6682	28.974747474747474	39.06420233463035
chr4	MXD4	2258884	2259057	2476	174	266764	6880	264288	6706	14.229885057471265	39.410677005666564
chr4	ZFYVE28	2335704	2335794	641	91	10280	9633	9639	9542	7.043956043956044	1.010165583735066
chr4	ZFYVE28	2353932	2354073	0	142	10280	9633	10280	9491	0.0	1.0831313876303867
chr4	TNIP2	2744696	2744945	4761	250	24921	2658	20160	2408	19.044	8.372093023255815
chr4	MFSD10	2931554	2931663	72903	110	1198630	2703	1125727	2593	662.7545454545455	434.1407635942923
chr4	HTT-AS	3069977	3070173	97	197	199	2254	102	2057	0.49238578680203043	0.049586776859504134
chr4	LRPAP1	3516386	3516718	147736	333	309405	11827	161669	11494	443.65165165165166	14.065512441273707
chr4	FAM86EP	3947143	3948220	920	1078	2101	2974	1181	1896	0.8534322820037106	0.6228902953586498
chr4	FAM86EP	3954959	3955033	0	75	2101	2974	2101	2899	0.0	0.7247326664367023
chr4	FAM86EP	3948089	3948220	510	132	2101	2974	1591	2842	3.8636363636363638	0.55981703026038
chr4	FAM86EP	3949447	3949549	451	103	2101	2974	1650	2871	4.378640776699029	0.5747126436781609
chr4	FAM86EP	3951138	3951219	0	82	2101	2974	2101	2892	0.0	0.7264868603042877
chr4	FAM86EP	3949447	3949592	608	146	2101	2974	1493	2828	4.164383561643835	0.5279349363507779
chr4	STX18	4425163	4425222	0	60	17828	5361	17828	5301	0.0	3.363139030371628
chr4	CYTL1	5016835	5016964	4080	130	4080	993	0	863	31.384615384615383	0.0
chr4	CYTL1	5017134	5017179	0	46	4080	993	4080	947	0.0	4.308342133051743
chr4	EVC2	5708046	5708140	0	95	2586	5527	2586	5432	0.0	0.47606774668630336
chr4	CRMP1	5861025	5861210	0	186	84251	5869	84251	5683	0.0	14.825092380784797
chr4	JAKMIP1	6078938	6078998	0	61	0	3837	0	3776	0.0	0.0
chr4	JAKMIP1	6105472	6105967	0	496	0	3837	0	3341	0.0	0.0
chr4	JAKMIP1	6054747	6054803	0	57	0	3837	0	3780	0.0	0.0
chr4	PPP2R2C	6378406	6378572	0	167	17113	8702	17113	8535	0.0	2.005038078500293
chr4	LINC02482	6671429	6671502	0	74	5090	3288	5090	3214	0.0	1.583696328562539
chr4	LINC02447	7097322	7097379	0	58	0	2543	0	2485	0.0	0.0
chr4	AFAP1	7781375	7781627	0	253	1164511	10058	1164511	9805	0.0	118.7670576236614
chr4	ABLIM2	8020201	8020303	0	103	33	5158	33	5055	0.0	0.006528189910979229
chr4	ABLIM2	8032647	8032680	0	34	33	5158	33	5124	0.0	0.006440281030444965
chr4	ABLIM2	8027758	8027857	33	100	33	5158	0	5058	0.33	0.0
chr4	ABLIM2	8019617	8019671	0	55	33	5158	33	5103	0.0	0.006466784244562022
chr4	ACOX3	8373560	8373628	0	69	11983	3867	11983	3798	0.0	3.1550816219062665
chr4	ACOX3	8416377	8416535	0	159	11983	3867	11983	3708	0.0	3.2316612729234087
chr4	AC108519.1	9151094	9151266	0	173	283	10108	283	9935	0.0	0.02848515349773528
chr4	SLC2A9	9996780	9996941	0	162	0	6650	0	6488	0.0	0.0
chr4	SLC2A9	10040129	10040264	0	136	0	6650	0	6514	0.0	0.0
chr4	ZNF518B	10454804	10454988	1836	185	83595	10919	81759	10734	9.924324324324324	7.616825041922862
chr4	RAB28	13460698	13460828	0	131	9171	2232	9171	2101	0.0	4.365064255116611
chr4	RAB28	13369870	13369965	7849	96	9171	2232	1322	2136	81.76041666666667	0.6189138576779026
chr4	RAB28	13371794	13371867	0	74	9171	2232	9171	2158	0.0	4.249768303985172
chr4	LINC01097	13528921	13529102	0	182	0	2231	0	2049	0.0	0.0
chr4	BOD1L1	13572701	13572842	0	142	44110	15890	44110	15748	0.0	2.800990601981204
chr4	BOD1L1	13623389	13626312	1377	2924	44110	15890	42733	12966	0.47093023255813954	3.2957735616227057
chr4	LINC00504	14614279	14614416	0	138	102	5105	102	4967	0.0	0.020535534527884036
chr4	LINC00504	14716094	14716169	0	76	102	5105	102	5029	0.0	0.020282362298667728
chr4	CPEB2-DT	14990453	14990554	0	102	0	3100	0	2998	0.0	0.0
chr4	FBXL5	15640787	15640883	0	97	19735	4396	19735	4299	0.0	4.590602465689695
chr4	FBXL5	15644492	15644708	0	217	19735	4396	19735	4179	0.0	4.722421631969371
chr4	FBXL5	15641523	15641627	0	105	19735	4396	19735	4291	0.0	4.59916103472384
chr4	FBXL5	15644492	15644657	0	166	19735	4396	19735	4230	0.0	4.66548463356974
chr4	FBXL5	15656228	15656342	0	115	19735	4396	19735	4281	0.0	4.609904227984116
chr4	PROM1	15979880	15979904	0	25	115	7501	115	7476	0.0	0.015382557517388979
chr4	PROM1	15979394	15979463	0	70	115	7501	115	7431	0.0	0.015475709864082896
chr4	PROM1	16035734	16035761	0	28	115	7501	115	7473	0.0	0.01538873277131005
chr4	PROM1	16038945	16039001	0	57	115	7501	115	7444	0.0	0.015448683503492745
chr4	PROM1	15980276	15980301	0	26	115	7501	115	7475	0.0	0.015384615384615385
chr4	PROM1	16055236	16055449	0	214	115	7501	115	7287	0.0	0.015781528749828463
chr4	TAPT1	16170652	16170729	114	78	27037	6756	26923	6678	1.4615384615384615	4.031596286313268
chr4	TAPT1	16213767	16213898	0	132	27037	6756	27037	6624	0.0	4.08167270531401
chr4	TAPT1	16202461	16202580	0	120	27037	6756	27037	6636	0.0	4.074291742013261
chr4	TAPT1	16196657	16196723	0	67	27037	6756	27037	6689	0.0	4.042009268949021
chr4	LDB2	16505839	16505982	0	144	0	5476	0	5332	0.0	0.0
chr4	LDB2	16674199	16674319	0	121	0	5476	0	5355	0.0	0.0
chr4	LDB2	16752406	16752458	0	53	0	5476	0	5423	0.0	0.0
chr4	LINC02493	17181851	17181896	0	46	0	2097	0	2051	0.0	0.0
chr4	QDPR	17490661	17490745	740	85	34342	3043	33602	2958	8.705882352941176	11.35970250169033
chr4	QDPR	17509270	17509363	0	94	34342	3043	34342	2949	0.0	11.645303492709393
chr4	QDPR	17492231	17492340	13962	110	34342	3043	20380	2933	126.92727272727272	6.948516876917831
chr4	QDPR	17509933	17509975	0	43	34342	3043	34342	3000	0.0	11.447333333333333
chr4	AC006160.1	17588317	17588481	0	165	53814	2132	53814	1967	0.0	27.358413828164718
chr4	LCORL	17886067	17886161	1166	95	164395	16931	163229	16836	12.273684210526316	9.695236398194345
chr4	LCORL	17909093	17909345	0	253	164395	16931	164395	16678	0.0	9.856997241875524
chr4	LCORL	17962969	17963049	0	81	164395	16931	164395	16850	0.0	9.756379821958458
chr4	LCORL	17873387	17878213	10098	4827	164395	16931	154297	12104	2.0919825978868865	12.747604097818902
chr4	LCORL	17866998	17867025	0	28	164395	16931	164395	16903	0.0	9.725788321599715
chr4	LCORL	17884274	17884752	102	479	164395	16931	164293	16452	0.21294363256784968	9.986202285436422
chr4	LCORL	17960264	17960311	0	48	164395	16931	164395	16883	0.0	9.737309719836523
chr4	KCNIP4	20882607	20882709	0	103	106273	4251	106273	4148	0.0	25.62029893924783
chr4	KCNIP4	21762920	21763032	0	113	106273	4251	106273	4138	0.0	25.682213629772836
chr4	ADGRA3	22454865	22454937	0	73	48549	9289	48549	9216	0.0	5.267903645833333
chr4	PPARGC1A	23820434	23820638	0	205	0	10896	0	10691	0.0	0.0
chr4	DHX15	24529600	24529770	19471	171	166079	8183	146608	8012	113.86549707602339	18.298552171742386
chr4	CCDC149	24821054	24821087	34	34	17495	9685	17461	9651	1.0	1.80924256553725
chr4	CCDC149	24894991	24895118	0	128	17495	9685	17495	9557	0.0	1.8305953751177149
chr4	SEPSECS	25127263	25127357	1785	95	69022	6251	67237	6156	18.789473684210527	10.922189733593243
chr4	SEPSECS	25158952	25159107	2427	156	69022	6251	66595	6095	15.557692307692308	10.92616899097621
chr4	SEPSECS	25159627	25159764	1989	138	69022	6251	67033	6113	14.41304347826087	10.965646981841976
chr4	SEPSECS	25159509	25159764	3408	256	69022	6251	65614	5995	13.3125	10.944787322768974
chr4	SEL1L3	25757687	25757790	0	104	0	7498	0	7394	0.0	0.0
chr4	SEL1L3	25847293	25847864	0	572	0	7498	0	6926	0.0	0.0
chr4	AC016687.3	33811624	33811692	0	69	51	3625	51	3556	0.0	0.014341957255343082
chr4	LINC02484	34121260	34121455	0	196	51	3792	51	3596	0.0	0.01418242491657397
chr4	LINC02505	36584664	36584796	0	133	0	2189	0	2056	0.0	0.0
chr4	LINC01258	38493992	38494098	0	107	0	2576	0	2469	0.0	0.0
chr4	KLF3-AS1	38625601	38625762	0	162	10211	6467	10211	6305	0.0	1.6195083267248216
chr4	KLF3-AS1	38635955	38636058	0	104	10211	6467	10211	6363	0.0	1.6047461889046049
chr4	KLF3-AS1	38620071	38620162	0	92	10211	6467	10211	6375	0.0	1.6017254901960785
chr4	KLF3-AS1	38625462	38625503	0	42	10211	6467	10211	6425	0.0	1.589260700389105
chr4	TLR10	38775774	38775963	0	190	0	1194	0	1004	0.0	0.0
chr4	TLR10	38776109	38776426	0	318	0	1194	0	876	0.0	0.0
chr4	TLR1	38800856	38800948	0	93	0	4545	0	4452	0.0	0.0
chr4	TLR1	38804305	38804382	0	78	0	4545	0	4467	0.0	0.0
chr4	TLR1	38804753	38804787	0	35	0	4545	0	4510	0.0	0.0
chr4	TLR6	38843638	38843791	0	154	612	1723	612	1569	0.0	0.390057361376673
chr4	RFC1	39326562	39326640	0	79	28712	6752	28712	6673	0.0	4.302712423197962
chr4	RFC1	39341486	39341665	0	180	28712	6752	28712	6572	0.0	4.3688374923919655
chr4	RPL9	39458393	39458598	5803	206	694582	4943	688779	4737	28.16990291262136	145.40405319822673
chr4	RPL9	39458393	39458440	811	48	694582	4943	693771	4895	16.895833333333332	141.73054136874362
chr4	RPL9	39458393	39458441	838	49	694582	4943	693744	4894	17.102040816326532	141.75398447078055
chr4	UGDH	39510660	39510861	0	202	7903	3990	7903	3788	0.0	2.086325237592397
chr4	UGDH	39521350	39521519	0	170	7903	3990	7903	3820	0.0	2.068848167539267
chr4	UGDH	39527052	39527119	0	68	7903	3990	7903	3922	0.0	2.0150433452320247
chr4	UGDH	39521350	39521544	0	195	7903	3990	7903	3795	0.0	2.0824769433465087
chr4	SMIM14	39556427	39556570	0	144	70717	3667	70717	3523	0.0	20.07294919103037
chr4	SMIM14	39572414	39572463	0	50	70717	3667	70717	3617	0.0	19.551285595797623
chr4	SMIM14	39611965	39612110	0	146	70717	3667	70717	3521	0.0	20.08435103663732
chr4	PDS5A	39910243	39910338	0	96	128788	12238	128788	12142	0.0	10.60681930489211
chr4	RBM47	40436440	40436647	0	208	636	8557	636	8349	0.0	0.07617678763923823
chr4	RBM47	40437770	40438924	357	1155	636	8557	279	7402	0.3090909090909091	0.03769251553634153
chr4	RBM47	40436440	40436885	0	446	636	8557	636	8111	0.0	0.07841203304154852
chr4	RBM47	40455474	40455595	0	122	636	8557	636	8435	0.0	0.07540011855364552
chr4	RBM47	40544421	40544506	0	86	636	8557	636	8471	0.0	0.07507968362649038
chr4	APBB2	40935076	40935139	0	64	15471	11681	15471	11617	0.0	1.3317551863648103
chr4	APBB2	41033235	41033304	0	70	15471	11681	15471	11611	0.0	1.3324433726638532
chr4	APBB2	41065575	41065673	0	99	15471	11681	15471	11582	0.0	1.3357796580901398
chr4	APBB2	40842369	40842375	0	7	15471	11681	15471	11674	0.0	1.3252526983039232
chr4	APBB2	41138041	41138156	0	116	15471	11681	15471	11565	0.0	1.3377431906614785
chr4	ATP8A1	42485495	42485668	0	174	51	10764	51	10590	0.0	0.004815864022662889
chr4	ATP8A1	42569160	42569205	0	46	51	10764	51	10718	0.0	0.004758350438514648
chr4	ATP8A1	42590810	42590884	0	75	51	10764	51	10689	0.0	0.0047712601740106655
chr4	ATP8A1	42594288	42594362	0	75	51	10764	51	10689	0.0	0.0047712601740106655
chr4	AC114757.1	43981597	43981647	0	51	0	9122	0	9071	0.0	0.0
chr4	AC114757.1	43993012	43993112	0	101	0	9122	0	9021	0.0	0.0
chr4	AC114757.1	43992592	43993112	0	521	0	9122	0	8601	0.0	0.0
chr4	AC114757.1	43992592	43992831	0	240	0	9122	0	8882	0.0	0.0
chr4	YIPF7	44635921	44636085	0	165	0	1821	0	1656	0.0	0.0
chr4	GNPDA2	44718308	44718410	0	103	59557	2710	59557	2607	0.0	22.845032604526274
chr4	GNPDA2	44722083	44722242	0	160	59557	2710	59557	2550	0.0	23.355686274509804
chr4	GABRA2	46332614	46332682	0	69	0	16399	0	16330	0.0	0.0
chr4	GABRA2	46256194	46256374	0	181	0	16399	0	16218	0.0	0.0
chr4	COX7B2	46876638	46876737	0	100	2	822	2	722	0.0	0.002770083102493075
chr4	COX7B2	46903875	46904014	0	140	2	822	2	682	0.0	0.002932551319648094
chr4	GABRA4	46971082	46971235	0	154	0	11246	0	11092	0.0	0.0
chr4	GABRA4	46992827	46992946	0	120	0	11246	0	11126	0.0	0.0
chr4	CORIN	47653552	47653660	0	109	10851	9500	10851	9391	0.0	1.1554680012778191
chr4	CORIN	47680140	47680251	0	112	10851	9500	10851	9388	0.0	1.1558372390285472
chr4	CORIN	47786724	47786925	0	202	10851	9500	10851	9298	0.0	1.1670251667025167
chr4	NFXL1	47877011	47877191	436	181	3543	4518	3107	4337	2.408839779005525	0.7163938206133272
chr4	CNGA1	47970895	47971100	0	206	0	3603	0	3397	0.0	0.0
chr4	CNGA1	47981392	47981500	0	109	0	3603	0	3494	0.0	0.0
chr4	TXK	48073934	48074053	0	120	0	3481	0	3361	0.0	0.0
chr4	TXK	48076401	48076466	0	66	0	3481	0	3415	0.0	0.0
chr4	TEC	48145078	48145295	51	218	4113	4023	4062	3805	0.23394495412844038	1.0675427069645205
chr4	TEC	48163701	48163767	0	67	4113	4023	4113	3956	0.0	1.039686552072801
chr4	FRYL	48502827	48502845	0	19	14656	18237	14656	18218	0.0	0.8044790866176309
chr4	FRYL	48539970	48540068	0	99	14656	18237	14656	18138	0.0	0.8080273459036278
chr4	FRYL	48561467	48561636	0	170	14656	18237	14656	18067	0.0	0.8112027453368019
chr4	FRYL	48684672	48684795	0	124	14656	18237	14656	18113	0.0	0.8091426047590129
chr4	FRYL	48710518	48710698	0	181	14656	18237	14656	18056	0.0	0.8116969428444838
chr4	FRYL	48523487	48523496	0	10	14656	18237	14656	18227	0.0	0.8040818565863829
chr4	OCIAD2	48892771	48892889	0	119	6135	2490	6135	2371	0.0	2.5875158161113454
chr4	OCIAD2	48899828	48899925	6037	98	6135	2490	98	2392	61.60204081632653	0.04096989966555184
chr4	OCIAD2	48897803	48897857	18	55	6135	2490	6117	2435	0.32727272727272727	2.5121149897330595
chr4	SGCB	52031864	52031961	0	98	0	4365	0	4267	0.0	0.0
chr4	SGCB	52031851	52031961	0	111	0	4365	0	4254	0.0	0.0
chr4	USP46	52631063	52631144	0	82	0	8909	0	8827	0.0	0.0
chr4	USP46	52656295	52656572	0	278	0	8909	0	8631	0.0	0.0
chr4	USP46	52658173	52658281	0	109	0	8909	0	8800	0.0	0.0
chr4	USP46	52629633	52629685	0	53	0	8909	0	8856	0.0	0.0
chr4	ERVMER34-1	52750709	52750829	0	121	26408	4027	26408	3906	0.0	6.760880696364567
chr4	SCFD2	52907456	52907591	0	136	51	3186	51	3050	0.0	0.016721311475409836
chr4	LNX1	53591387	53591515	0	129	27241	5644	27241	5515	0.0	4.939437896645512
chr4	CHIC2	54014062	54014119	0	58	0	1239	0	1181	0.0	0.0
chr4	SRD5A3-AS1	55377606	55377770	0	165	0	4773	0	4608	0.0	0.0
chr4	SRD5A3-AS1	55369605	55369727	0	123	0	4773	0	4650	0.0	0.0
chr4	SRD5A3-AS1	55377606	55377836	0	231	0	4773	0	4542	0.0	0.0
chr4	SRD5A3-AS1	55382506	55382562	0	57	0	4773	0	4716	0.0	0.0
chr4	SRD5A3-AS1	55380795	55380879	0	85	0	4773	0	4688	0.0	0.0
chr4	SRD5A3-AS1	55383764	55383882	0	119	0	4773	0	4654	0.0	0.0
chr4	SRD5A3-AS1	55377606	55377786	0	181	0	4773	0	4592	0.0	0.0
chr4	SRD5A3-AS1	55383291	55383433	0	143	0	4773	0	4630	0.0	0.0
chr4	SRD5A3-AS1	55383291	55383359	0	69	0	4773	0	4704	0.0	0.0
chr4	SRD5A3-AS1	55387271	55387541	0	271	0	4773	0	4502	0.0	0.0
chr4	SRD5A3-AS1	55386702	55386890	0	189	0	4773	0	4584	0.0	0.0
chr4	SRD5A3-AS1	55393416	55393715	0	300	0	4773	0	4473	0.0	0.0
chr4	CLOCK	55509911	55510065	0	155	51	11559	51	11404	0.0	0.004472115047351806
chr4	CLOCK	55486392	55486549	0	158	51	11559	51	11401	0.0	0.004473291816507324
chr4	NMU	55605274	55605349	34	76	34	986	0	910	0.4473684210526316	0.0
chr4	NMU	55607297	55607348	0	52	34	986	34	934	0.0	0.03640256959314775
chr4	NMU	55616337	55616385	0	49	34	986	34	937	0.0	0.03628601921024546
chr4	NMU	55607436	55607466	0	31	34	986	34	955	0.0	0.0356020942408377
chr4	AASDH	56371450	56371643	0	194	792	4669	792	4475	0.0	0.17698324022346368
chr4	AASDH	56378147	56378464	0	318	792	4669	792	4351	0.0	0.18202712020225237
chr4	AASDH	56382476	56382597	0	122	792	4669	792	4547	0.0	0.174180778535298
chr4	AASDH	56384069	56384341	0	273	792	4669	792	4396	0.0	0.18016378525932666
chr4	AASDH	56345126	56345290	134	165	792	4669	658	4504	0.8121212121212121	0.1460923623445826
chr4	PPAT	56403979	56404118	0	140	2869	4069	2869	3929	0.0	0.7302112496818529
chr4	HOPX	56650682	56650812	0	131	0	3242	0	3111	0.0	0.0
chr4	HOPX	56657774	56657899	0	126	0	3242	0	3116	0.0	0.0
chr4	HOPX	56676498	56676566	0	69	0	3242	0	3173	0.0	0.0
chr4	ADGRL3-AS1	62155941	62156041	0	101	0	958	0	857	0.0	0.0
chr4	ADGRL3-AS1	62127046	62127087	0	42	0	958	0	916	0.0	0.0
chr4	ADGRL3-AS1	62161746	62161863	0	118	0	958	0	840	0.0	0.0
chr4	TECRL	64281040	64281086	0	47	95	6035	95	5988	0.0	0.01586506346025384
chr4	LINC02232	64939955	64940036	0	82	0	6375	0	6293	0.0	0.0
chr4	LINC02232	64977488	64977629	0	142	0	6375	0	6233	0.0	0.0
chr4	LINC02232	65008781	65008912	0	132	0	6375	0	6243	0.0	0.0
chr4	LINC02232	65004402	65004501	0	100	0	6375	0	6275	0.0	0.0
chr4	LINC02232	64939272	64939365	0	94	0	6375	0	6281	0.0	0.0
chr4	EPHA5	65376997	65377063	0	67	51	9851	51	9784	0.0	0.005212591986917416
chr4	AC104806.2	67419893	67420049	0	157	0	2410	0	2253	0.0	0.0
chr4	AC104806.2	67455458	67455565	0	108	0	2410	0	2302	0.0	0.0
chr4	CENPC	67510672	67511025	0	354	0	8516	0	8162	0.0	0.0
chr4	UBA6	67624125	67624253	0	129	110	10788	110	10659	0.0	0.010319917440660475
chr4	UBA6	67633344	67633473	0	130	110	10788	110	10658	0.0	0.010320885719647213
chr4	TMPRSS11D	67835082	67835121	0	40	204	3040	204	3000	0.0	0.068
chr4	TMPRSS11D	67842557	67842625	0	69	204	3040	204	2971	0.0	0.06866374957926624
chr4	TMPRSS11D	67859556	67859678	0	123	204	3040	204	2917	0.0	0.06993486458690436
chr4	TMPRSS11A	67924127	67924166	0	40	83	3961	83	3921	0.0	0.02116806937005866
chr4	TMPRSS11GP	67994521	67994586	0	66	0	1279	0	1213	0.0	0.0
chr4	TMPRSS11BNL	68185366	68185509	0	144	0	4327	0	4183	0.0	0.0
chr4	TMPRSS11BNL	68212361	68212477	0	117	0	4327	0	4210	0.0	0.0
chr4	YTHDC1	68332793	68332847	0	55	72861	7051	72861	6996	0.0	10.414665523156089
chr4	YTHDC1	68344048	68344080	0	33	72861	7051	72861	7018	0.0	10.382017668851525
chr4	UGT2A3	68943281	68943378	0	98	1385	3082	1385	2984	0.0	0.464142091152815
chr4	UGT2B4	69485207	69485427	0	221	0	2514	0	2293	0.0	0.0
chr4	UGT2B4	69495140	69495410	0	271	0	2514	0	2243	0.0	0.0
chr4	UGT2A1	69596249	69596381	0	133	0	3689	0	3556	0.0	0.0
chr4	UGT2A1	69638898	69639528	0	631	0	3689	0	3058	0.0	0.0
chr4	UGT2A1	69635690	69635822	0	133	0	3689	0	3556	0.0	0.0
chr4	SULT1B1	69760207	69760250	0	44	0	7270	0	7226	0.0	0.0
chr4	JCHAIN	70665859	70665886	0	28	0	1554	0	1526	0.0	0.0
chr4	JCHAIN	70664101	70664149	0	49	0	1554	0	1505	0.0	0.0
chr4	GRSF1	70831538	70831674	0	137	17	7579	17	7442	0.0	0.0022843321687718355
chr4	GC	71746150	71746205	0	56	817	2110	817	2054	0.0	0.3977604673807206
chr4	GC	71752517	71752650	0	134	817	2110	817	1976	0.0	0.41346153846153844
chr4	GC	71754977	71755107	0	131	817	2110	817	1979	0.0	0.4128347650328449
chr4	COX18	73068028	73068129	0	102	0	6983	0	6881	0.0	0.0
chr4	COX18	73068028	73068133	0	106	0	6983	0	6877	0.0	0.0
chr4	ANKRD17	73139530	73140283	0	754	3392	12081	3392	11327	0.0	0.29946146375915955
chr4	ANKRD17	73147240	73147432	1076	193	3392	12081	2316	11888	5.575129533678757	0.19481830417227455
chr4	RASSF6	73582188	73582290	0	103	0	6644	0	6541	0.0	0.0
chr4	BTC	74750572	74750719	0	148	0	2659	0	2511	0.0	0.0
chr4	RCHY1	75491610	75491637	0	28	0	5692	0	5664	0.0	0.0
chr4	RCHY1	75509176	75509296	0	121	0	5692	0	5571	0.0	0.0
chr4	RCHY1	75491582	75491637	0	56	0	5692	0	5636	0.0	0.0
chr4	G3BP2	75646337	75646456	42	120	2760	11241	2718	11121	0.35	0.24440248179120583
chr4	G3BP2	75647028	75647157	70	130	2760	11241	2690	11111	0.5384615384615384	0.24210242102421023
chr4	G3BP2	75653982	75654081	0	100	2760	11241	2760	11141	0.0	0.24773359662507854
chr4	G3BP2	75656923	75657014	0	92	2760	11241	2760	11149	0.0	0.24755583460400035
chr4	G3BP2	75657556	75657730	0	175	2760	11241	2760	11066	0.0	0.2494126152177842
chr4	G3BP2	75658842	75658924	0	83	2760	11241	2760	11158	0.0	0.24735615701738664
chr4	G3BP2	75661930	75662049	0	120	2760	11241	2760	11121	0.0	0.2481791205826814
chr4	G3BP2	75662212	75662520	0	309	2760	11241	2760	10932	0.0	0.2524698133918771
chr4	G3BP2	75661930	75662073	0	144	2760	11241	2760	11097	0.0	0.24871586915382535
chr4	G3BP2	75654592	75654745	0	154	2760	11241	2760	11087	0.0	0.24894020023450888
chr4	G3BP2	75694797	75694929	0	133	2760	11241	2760	11108	0.0	0.24846957148001442
chr4	G3BP2	75694797	75695073	0	277	2760	11241	2760	10964	0.0	0.2517329441809559
chr4	G3BP2	75694792	75694929	0	138	2760	11241	2760	11103	0.0	0.2485814644690624
chr4	G3BP2	75724055	75724176	0	122	2760	11241	2760	11119	0.0	0.248223761129598
chr4	G3BP2	75720876	75720969	0	94	2760	11241	2760	11147	0.0	0.24760025118866064
chr4	G3BP2	75662689	75662841	0	153	2760	11241	2760	11088	0.0	0.24891774891774893
chr4	G3BP2	75662765	75662841	0	77	2760	11241	2760	11164	0.0	0.2472232174847725
chr4	G3BP2	75646662	75646911	153	250	2760	11241	2607	10991	0.612	0.23719406787371486
chr4	G3BP2	75656923	75656962	0	40	2760	11241	2760	11201	0.0	0.2464065708418891
chr4	G3BP2	75662212	75662525	0	314	2760	11241	2760	10927	0.0	0.2525853390683628
chr4	G3BP2	75657800	75657893	0	94	2760	11241	2760	11147	0.0	0.24760025118866064
chr4	G3BP2	75657556	75657695	0	140	2760	11241	2760	11101	0.0	0.24862624988739754
chr4	G3BP2	75662381	75662525	0	145	2760	11241	2760	11096	0.0	0.2487382840663302
chr4	G3BP2	75713125	75713336	0	212	2760	11241	2760	11029	0.0	0.2502493426421253
chr4	G3BP2	75722196	75722244	0	49	2760	11241	2760	11192	0.0	0.24660471765546818
chr4	G3BP2	75722196	75722247	0	52	2760	11241	2760	11189	0.0	0.24667083742961837
chr4	PPEF2	75881330	75881985	0	656	0	4998	0	4342	0.0	0.0
chr4	NAAA	75918760	75918789	0	30	0	2984	0	2954	0.0	0.0
chr4	NAAA	75914867	75914985	0	119	0	2984	0	2865	0.0	0.0
chr4	SDAD1	75967276	75967334	0	59	220	3458	220	3399	0.0	0.06472491909385113
chr4	SDAD1	75974075	75974133	0	59	220	3458	220	3399	0.0	0.06472491909385113
chr4	SDAD1	75977645	75977756	0	112	220	3458	220	3346	0.0	0.0657501494321578
chr4	NUP54	76124648	76124756	37	109	141	4007	104	3898	0.3394495412844037	0.02668034889687019
chr4	NUP54	76134174	76134362	0	189	141	4007	141	3818	0.0	0.03693033001571503
chr4	NUP54	76136185	76136412	0	228	141	4007	141	3779	0.0	0.03731145805768722
chr4	NUP54	76144148	76144292	2	145	141	4007	139	3862	0.013793103448275862	0.03599171413775246
chr4	NUP54	76145554	76145577	0	24	141	4007	141	3983	0.0	0.035400451920662816
chr4	NUP54	76147478	76147640	0	163	141	4007	141	3844	0.0	0.03668054110301769
chr4	NUP54	76145982	76146129	0	148	141	4007	141	3859	0.0	0.036537963202902306
chr4	SCARB2	76175790	76175910	0	121	102	15139	102	15018	0.0	0.0067918497802636835
chr4	SCARB2	76176436	76176528	0	93	102	15139	102	15046	0.0	0.006779210421374452
chr4	SCARB2	76180210	76180354	0	145	102	15139	102	14994	0.0	0.006802721088435374
chr4	SCARB2	76184656	76184780	0	125	102	15139	102	15014	0.0	0.0067936592513653925
chr4	CCDC158	76396268	76396486	0	219	4041	5887	4041	5668	0.0	0.7129498941425547
chr4	CCDC158	76414260	76414364	0	105	4041	5887	4041	5782	0.0	0.6988931165686614
chr4	SHROOM3-AS1	76742807	76742900	0	94	695	4352	695	4258	0.0	0.16322217003287928
chr4	CCNI	77055149	77055380	7333	232	21918	4058	14585	3826	31.607758620689655	3.8120752744380555
chr4	CCNI	77066248	77066405	68	158	21918	4058	21850	3900	0.43037974683544306	5.602564102564102
chr4	CNOT6L	77744717	77744875	0	159	0	9382	0	9223	0.0	0.0
chr4	PAQR3	78888060	78888148	0	89	51	7282	51	7193	0.0	0.007090226609203392
chr4	PAQR3	78922828	78922983	0	156	51	7282	51	7126	0.0	0.007156890261015998
chr4	PAQR3	78935120	78935283	0	164	51	7282	51	7118	0.0	0.007164933970216353
chr4	PAQR3	78922140	78922421	0	282	51	7282	51	7000	0.0	0.007285714285714286
chr4	PAQR3	78935120	78935176	0	57	51	7282	51	7225	0.0	0.007058823529411765
chr4	PAQR3	78933075	78933231	0	157	51	7282	51	7125	0.0	0.007157894736842105
chr4	NAA11	79294004	79294114	0	111	51	2722	51	2611	0.0	0.019532746074301034
chr4	ANTXR2	80024636	80024755	0	120	102	5611	102	5491	0.0	0.018575851393188854
chr4	PRKG2	81153429	81153555	0	127	4318	5137	4318	5010	0.0	0.86187624750499
chr4	RASGEF1B	81457498	81457621	0	124	930	10205	930	10081	0.0	0.09225275270310485
chr4	HNRNPD	82356536	82356683	10	148	259	3903	249	3755	0.06756756756756757	0.06631158455392809
chr4	HNRNPD	82371527	82371584	0	58	259	3903	259	3845	0.0	0.06736020806241873
chr4	HNRNPD	82354894	82355001	0	108	259	3903	259	3795	0.0	0.06824769433465086
chr4	HNRNPD	82359470	82359639	153	170	259	3903	106	3733	0.9	0.028395392445754085
chr4	HNRNPDL	82426462	82426633	0	172	0	4690	0	4518	0.0	0.0
chr4	HNRNPDL	82425562	82425667	0	106	0	4690	0	4584	0.0	0.0
chr4	TMEM150C	82509669	82509787	0	119	0	3507	0	3388	0.0	0.0
chr4	SEC31A	82821036	82821108	0	73	102	8631	102	8558	0.0	0.01191867258705305
chr4	SEC31A	82842139	82842481	0	343	102	8631	102	8288	0.0	0.012306949806949807
chr4	SEC31A	82861630	82861708	0	79	102	8631	102	8552	0.0	0.011927034611786716
chr4	SEC31A	82862533	82862572	0	40	102	8631	102	8591	0.0	0.011872890233965778
chr4	SEC31A	82880798	82880922	0	125	102	8631	102	8506	0.0	0.011991535386785799
chr4	SEC31A	82881857	82881940	0	84	102	8631	102	8547	0.0	0.011934011934011933
chr4	SEC31A	82830936	82830975	0	40	102	8631	102	8591	0.0	0.011872890233965778
chr4	SEC31A	82842184	82842481	0	298	102	8631	102	8333	0.0	0.012240489619584783
chr4	SEC31A	82881857	82881937	0	81	102	8631	102	8550	0.0	0.011929824561403509
chr4	SEC31A	82845200	82845293	0	94	102	8631	102	8537	0.0	0.01194799109757526
chr4	THAP9-AS1	82897988	82898062	0	75	0	4254	0	4179	0.0	0.0
chr4	THAP9-AS1	82899712	82899737	0	26	0	4254	0	4228	0.0	0.0
chr4	LIN54	82946257	82946474	0	218	51	3486	51	3268	0.0	0.015605875152998777
chr4	LIN54	82978882	82979006	0	125	51	3486	51	3361	0.0	0.01517405534067242
chr4	PLAC8	83107803	83107950	0	148	51	3797	51	3649	0.0	0.013976431899150453
chr4	PLAC8	83104895	83105020	0	126	51	3797	51	3671	0.0	0.01389267229637701
chr4	COQ2	83267089	83267208	35	120	19345	2785	19310	2665	0.2916666666666667	7.24577861163227
chr4	COQ2	83269859	83269993	460	135	19345	2785	18885	2650	3.4074074074074074	7.126415094339623
chr4	HPSE	83306202	83306317	0	116	92745	4700	92745	4584	0.0	20.232329842931936
chr4	HPSE	83310721	83310890	0	170	92745	4700	92745	4530	0.0	20.473509933774835
chr4	HPSE	83313113	83313287	0	175	92745	4700	92745	4525	0.0	20.496132596685083
chr4	HPSE	83308844	83308951	0	108	92745	4700	92745	4592	0.0	20.1970818815331
chr4	HELQ	83446834	83447035	0	202	459	3602	459	3400	0.0	0.135
chr4	HELQ	83443516	83443614	0	99	459	3602	459	3503	0.0	0.1310305452469312
chr4	ABRAXAS1	83472221	83472288	0	68	621	7552	621	7484	0.0	0.08297701763762694
chr4	ABRAXAS1	83483991	83484166	0	176	621	7552	621	7376	0.0	0.08419197396963124
chr4	AC079160.1	84149218	84149256	0	39	286675	4984	286675	4945	0.0	57.9726996966633
chr4	AC079160.1	84148046	84148130	0	85	286675	4984	286675	4899	0.0	58.51704429475403
chr4	WDFY3	84726860	84726911	0	52	306	15989	306	15937	0.0	0.019200602371839116
chr4	WDFY3	84808333	84808417	0	85	306	15989	306	15904	0.0	0.019240442655935615
chr4	WDFY3	84932269	84932363	0	95	306	15989	306	15894	0.0	0.01925254813137033
chr4	WDFY3	84844455	84844509	0	55	306	15989	306	15934	0.0	0.019204217396761643
chr4	MAPK10	86098523	86098595	0	73	87	36649	87	36576	0.0	0.0023786089238845144
chr4	MAPK10	86103185	86103244	0	60	87	36649	87	36589	0.0	0.002377763808794993
chr4	MAPK10	86159297	86159467	0	171	87	36649	87	36478	0.0	0.0023849991775864903
chr4	MAPK10	86194335	86194407	0	73	87	36649	87	36576	0.0	0.0023786089238845144
chr4	MAPK10	86354529	86354644	0	116	87	36649	87	36533	0.0	0.0023814085894944296
chr4	MAPK10	86194308	86194407	0	100	87	36649	87	36549	0.0	0.002380366083887384
chr4	MAPK10	86029196	86029274	0	79	87	36649	87	36570	0.0	0.002378999179655455
chr4	MAPK10	86194318	86194407	0	90	87	36649	87	36559	0.0	0.002379714981263164
chr4	MAPK10	86089205	86089277	0	73	87	36649	87	36576	0.0	0.0023786089238845144
chr4	MAPK10	86101051	86101217	0	167	87	36649	87	36482	0.0	0.0023847376788553257
chr4	MAPK10	86453029	86453181	0	153	87	36649	87	36496	0.0	0.002383822884699693
chr4	MAPK10	86321843	86322029	0	187	87	36649	87	36462	0.0	0.0023860457462563764
chr4	MAPK10	86399746	86399806	0	61	87	36649	87	36588	0.0	0.0023778287963266646
chr4	MAPK10	86277049	86277223	0	175	87	36649	87	36474	0.0	0.0023852607336733015
chr4	MAPK10	86194308	86194335	0	28	87	36649	87	36621	0.0	0.002375686081756369
chr4	MAPK10	86429677	86429805	0	129	87	36649	87	36520	0.0	0.0023822562979189483
chr4	MAPK10	86029196	86029287	0	92	87	36649	87	36557	0.0	0.002379845173291025
chr4	MAPK10	86370713	86370867	0	155	87	36649	87	36494	0.0	0.0023839535266071137
chr4	MAPK10	86335075	86335156	0	82	87	36649	87	36567	0.0	0.0023791943555664945
chr4	MAPK10	86040872	86040984	0	113	87	36649	87	36536	0.0	0.0023812130501423253
chr4	MAPK10	86340338	86340423	0	86	87	36649	87	36563	0.0	0.002379454639936548
chr4	MAPK10	86356461	86356519	0	59	87	36649	87	36590	0.0	0.0023776988248155233
chr4	MAPK10	86151990	86152196	0	207	87	36649	87	36442	0.0	0.0023873552494374623
chr4	MAPK10	86151990	86152144	0	155	87	36649	87	36494	0.0	0.0023839535266071137
chr4	MAPK10	86152462	86152629	0	168	87	36649	87	36481	0.0	0.002384803048162057
chr4	MAPK10	86352164	86352224	0	61	87	36649	87	36588	0.0	0.0023778287963266646
chr4	MAPK10	86356665	86357052	0	388	87	36649	87	36261	0.0	0.0023992719450649457
chr4	MAPK10	86090304	86090437	0	134	87	36649	87	36515	0.0	0.002382582500342325
chr4	MAPK10	86098523	86099285	0	763	87	36649	87	35886	0.0	0.002424343755224879
chr4	MAPK10	86332542	86332727	0	186	87	36649	87	36463	0.0	0.002385980308806187
chr4	MAPK10	86358207	86358312	0	106	87	36649	87	36543	0.0	0.0023807569165093176
chr4	MAPK10	86308661	86308754	0	94	87	36649	87	36555	0.0	0.002379975379565039
chr4	MAPK10	86384099	86384236	0	138	87	36649	87	36511	0.0	0.0023828435266084196
chr4	MAPK10	86392313	86392432	0	120	87	36649	87	36529	0.0	0.0023816693585918037
chr4	SLC10A6	86827992	86828168	0	177	0	1629	0	1452	0.0	0.0
chr4	AC093827.5	86932221	86932319	0	99	0	2486	0	2387	0.0	0.0
chr4	C4ORF36	86890047	86890138	0	92	0	1920	0	1828	0.0	0.0
chr4	C4ORF36	86890047	86890158	0	112	0	1920	0	1808	0.0	0.0
chr4	KLHL8	87185250	87185799	0	550	0	6706	0	6156	0.0	0.0
chr4	KLHL8	87185250	87185571	0	322	0	6706	0	6384	0.0	0.0
chr4	KLHL8	87183202	87183389	0	188	0	6706	0	6518	0.0	0.0
chr4	KLHL8	87195323	87195690	0	368	0	6706	0	6338	0.0	0.0
chr4	HSD17B13	87318328	87318436	0	109	0	2384	0	2275	0.0	0.0
chr4	HSD17B11	87374698	87374830	0	133	0	2343	0	2210	0.0	0.0
chr4	SPARCL1	87504821	87504923	0	103	0	3494	0	3391	0.0	0.0
chr4	SPARCL1	87497130	87497239	0	110	0	3494	0	3384	0.0	0.0
chr4	SPARCL1	87530544	87530631	0	88	0	3494	0	3406	0.0	0.0
chr4	SPARCL1	87528125	87528233	0	109	0	3494	0	3385	0.0	0.0
chr4	SPARCL1	87528554	87528614	0	61	0	3494	0	3433	0.0	0.0
chr4	ABCG2	88211665	88211803	0	139	1553	5621	1553	5482	0.0	0.2832907697920467
chr4	PPM1K	88265000	88265135	0	136	143848	10583	143848	10447	0.0	13.769311764142817
chr4	PPM1K	88278143	88278642	12633	500	143848	10583	131215	10083	25.266	13.013488049191709
chr4	PPM1K	88278535	88278642	2607	108	143848	10583	141241	10475	24.13888888888889	13.483627684964201
chr4	FAM13A	88767982	88768059	0	78	5077	13191	5077	13113	0.0	0.3871730343933501
chr4	FAM13A	88805010	88805052	0	43	5077	13191	5077	13148	0.0	0.38614237906905996
chr4	FAM13A	88737471	88737555	0	85	5077	13191	5077	13106	0.0	0.3873798260338776
chr4	FAM13A	88990972	88991150	360	179	5077	13191	4717	13012	2.011173184357542	0.3625115278204734
chr4	FAM13A	88790585	88790627	0	43	5077	13191	5077	13148	0.0	0.38614237906905996
chr4	SNCA	89828142	89828184	0	43	745	6216	745	6173	0.0	0.12068686214158432
chr4	SNCA	89729193	89729277	0	85	745	6216	745	6131	0.0	0.12151361931169467
chr4	SNCA	89836460	89836529	0	70	745	6216	745	6146	0.0	0.12121705174096974
chr4	SNCA	89836742	89836789	0	48	745	6216	745	6168	0.0	0.12078469520103761
chr4	UNC5C	95222209	95222266	0	58	7393	10703	7393	10645	0.0	0.694504462188821
chr4	TSPAN5	98484384	98484441	0	58	176	5216	176	5158	0.0	0.03412175261729353
chr4	TSPAN5	98484398	98484598	0	201	176	5216	176	5015	0.0	0.03509471585244267
chr4	EIF4E	98884921	98885061	0	141	0	13445	0	13304	0.0	0.0
chr4	EIF4E	98909677	98909959	0	283	0	13445	0	13162	0.0	0.0
chr4	EIF4E	98886453	98886546	0	94	0	13445	0	13351	0.0	0.0
chr4	ADH5	99081974	99082116	0	143	68	4877	68	4734	0.0	0.01436417405999155
chr4	ADH5	99082001	99082116	0	116	68	4877	68	4761	0.0	0.014282713715605966
chr4	ADH5	99079819	99079991	0	173	68	4877	68	4704	0.0	0.01445578231292517
chr4	ADH4	99127208	99127344	0	137	0	2447	0	2310	0.0	0.0
chr4	ADH4	99143165	99143305	0	141	0	2447	0	2306	0.0	0.0
chr4	ADH4	99143043	99143071	0	29	0	2447	0	2418	0.0	0.0
chr4	ADH4	99143165	99143379	0	215	0	2447	0	2232	0.0	0.0
chr4	ADH6	99210081	99210298	0	218	0	4148	0	3930	0.0	0.0
chr4	ADH6	99213605	99213747	0	143	0	4148	0	4005	0.0	0.0
chr4	ADH6	99207445	99207581	0	137	0	4148	0	4011	0.0	0.0
chr4	ADH1B	99320792	99320914	0	123	11786	7188	11786	7065	0.0	1.6682236376503892
chr4	ADH1C	99347744	99347846	0	103	180	1584	180	1481	0.0	0.12153950033760973
chr4	ADH1C	99351012	99351132	0	121	180	1584	180	1463	0.0	0.12303485987696514
chr4	ADH7	99432618	99432731	0	114	1797	3120	1797	3006	0.0	0.5978043912175649
chr4	LAMTOR3	99893954	99894000	0	47	51	4171	51	4124	0.0	0.012366634335596509
chr4	DNAJB14	99930449	99930621	0	173	3686	9371	3686	9198	0.0	0.40073929115025003
chr4	DNAJB14	99924759	99924815	468	57	3686	9371	3218	9314	8.210526315789474	0.3455013957483358
chr4	DNAJB14	99928541	99928617	0	77	3686	9371	3686	9294	0.0	0.39659995696148054
chr4	DNAJB14	99906037	99906153	0	117	3686	9371	3686	9254	0.0	0.3983142424897342
chr4	DNAJB14	99910348	99910375	0	28	3686	9371	3686	9343	0.0	0.39451996146847906
chr4	DNAJB14	99927716	99927838	0	123	3686	9371	3686	9248	0.0	0.3985726643598616
chr4	EMCN	100447532	100447571	0	40	425	5193	425	5153	0.0	0.08247622744032602
chr4	PPP3CA	101029165	101029195	0	31	51	5231	51	5200	0.0	0.009807692307692307
chr4	PPP3CA	101063231	101063357	0	127	51	5231	51	5104	0.0	0.009992163009404389
chr4	PPP3CA	101195915	101196116	0	202	51	5231	51	5029	0.0	0.010141181149333864
chr4	PPP3CA	101108073	101108161	0	89	51	5231	51	5142	0.0	0.009918319719953326
chr4	PPP3CA	101171083	101171226	0	144	51	5231	51	5087	0.0	0.010025555337133871
chr4	SLC39A8	102307435	102307605	0	171	12992	6496	12992	6325	0.0	2.054071146245059
chr4	SLC39A8	102344443	102344915	0	473	12992	6496	12992	6023	0.0	2.157064585754607
chr4	AC098487.1	102419696	102419794	0	99	212	998	212	899	0.0	0.23581757508342602
chr4	AC098487.1	102419263	102419359	0	97	212	998	212	901	0.0	0.23529411764705882
chr4	AC098487.1	102430396	102430498	59	103	212	998	153	895	0.5728155339805825	0.17094972067039105
chr4	MANBA	102722870	102723041	0	172	153	8306	153	8134	0.0	0.018809933611999015
chr4	MANBA	102633250	102633473	0	224	153	8306	153	8082	0.0	0.01893095768374165
chr4	MANBA	102670915	102671011	0	97	153	8306	153	8209	0.0	0.018638080155926422
chr4	MANBA	102658858	102659028	0	171	153	8306	153	8135	0.0	0.018807621389059618
chr4	MANBA	102667819	102668031	0	213	153	8306	153	8093	0.0	0.018905226739157295
chr4	MANBA	102679610	102679709	0	100	153	8306	153	8206	0.0	0.018644893980014624
chr4	MANBA	102672008	102672146	0	139	153	8306	153	8167	0.0	0.018733929227378474
chr4	MANBA	102671892	102672054	0	163	153	8306	153	8143	0.0	0.018789144050104383
chr4	MANBA	102672008	102672054	0	47	153	8306	153	8259	0.0	0.01852524518706865
chr4	MANBA	102753822	102753995	0	174	153	8306	153	8132	0.0	0.01881455976389572
chr4	UBE2D3	102798927	102798977	0	51	51	9483	51	9432	0.0	0.005407124681933842
chr4	UBE2D3	102826484	102826636	0	153	51	9483	51	9330	0.0	0.005466237942122186
chr4	UBE2D3	102825238	102825317	0	80	51	9483	51	9403	0.0	0.005423800914601723
chr4	UBE2D3	102809067	102809159	0	93	51	9483	51	9390	0.0	0.005431309904153354
chr4	UBE2D3	102826484	102826619	0	136	51	9483	51	9347	0.0	0.0054562961377982245
chr4	UBE2D3	102809067	102809184	0	118	51	9483	51	9365	0.0	0.005445808862786973
chr4	UBE2D3	102827591	102827741	0	151	51	9483	51	9332	0.0	0.00546506643806258
chr4	SLC9B1	102945192	102945320	0	129	0	2968	0	2839	0.0	0.0
chr4	SLC9B1	102949256	102949427	0	172	0	2968	0	2796	0.0	0.0
chr4	SLC9B1	102912007	102912129	0	123	0	2968	0	2845	0.0	0.0
chr4	SLC9B1	102989799	102989941	0	143	0	2968	0	2825	0.0	0.0
chr4	SLC9B1	102905513	102905650	0	138	0	2968	0	2830	0.0	0.0
chr4	SLC9B2	103028746	103028883	0	138	0	8631	0	8493	0.0	0.0
chr4	SLC9B2	103057800	103057971	0	172	0	8631	0	8459	0.0	0.0
chr4	BDH2	103091619	103091737	0	119	50	5225	50	5106	0.0	0.009792401096748922
chr4	BDH2	103097635	103097754	0	120	50	5225	50	5105	0.0	0.009794319294809012
chr4	BDH2	103098643	103098802	0	160	50	5225	50	5065	0.0	0.009871668311944718
chr4	CENPE	103195113	103195233	0	121	23174	9977	23174	9856	0.0	2.351258116883117
chr4	CENPE	103163478	103163553	0	76	23174	9977	23174	9901	0.0	2.3405716594283406
chr4	AC105460.1	103556946	103557234	47795	289	172282	2274	124487	1985	165.38062283737025	62.71385390428212
chr4	AC105460.1	103556965	103557234	47641	270	172282	2274	124641	2004	176.44814814814814	62.196107784431135
chr4	AC105460.1	103552025	103552152	0	128	172282	2274	172282	2146	0.0	80.28052190121156
chr4	PPA2	105437949	105438036	0	88	204	4491	204	4403	0.0	0.04633204633204633
chr4	PPA2	105449349	105449403	0	55	204	4491	204	4436	0.0	0.045987376014427414
chr4	PPA2	105456680	105456745	0	66	204	4491	204	4425	0.0	0.04610169491525424
chr4	PPA2	105424195	105424322	0	128	204	4491	204	4363	0.0	0.04675681870272748
chr4	PPA2	105456247	105456291	0	45	204	4491	204	4446	0.0	0.04588394062078273
chr4	PPA2	105453597	105453642	0	46	204	4491	204	4445	0.0	0.045894263217097865
chr4	PPA2	105456695	105456745	0	51	204	4491	204	4440	0.0	0.04594594594594595
chr4	PPA2	105447994	105448093	0	100	204	4491	204	4391	0.0	0.04645866545206103
chr4	INTS12	105705689	105705949	0	261	0	3907	0	3646	0.0	0.0
chr4	INTS12	105703647	105703809	0	163	0	3907	0	3744	0.0	0.0
chr4	INTS12	105702885	105703023	0	139	0	3907	0	3768	0.0	0.0
chr4	INTS12	105707918	105708162	0	245	0	3907	0	3662	0.0	0.0
chr4	GSTCD-AS1	105821058	105821194	0	137	0	835	0	698	0.0	0.0
chr4	GSTCD-AS1	105826111	105826122	0	12	0	835	0	823	0.0	0.0
chr4	TBCK	106194717	106194754	0	38	2931	10864	2931	10826	0.0	0.2707371143543322
chr4	TBCK	106254946	106255047	0	102	2931	10864	2931	10762	0.0	0.27234714737037724
chr4	TBCK	106237490	106237538	0	49	2931	10864	2931	10815	0.0	0.2710124826629681
chr4	TBCK	106251078	106251194	0	117	2931	10864	2931	10747	0.0	0.2727272727272727
chr4	TBCK	106309926	106309967	0	42	2931	10864	2931	10822	0.0	0.2708371835150619
chr4	DKK2	107127941	107128009	0	69	102	4341	102	4272	0.0	0.023876404494382022
chr4	CYP2U1-AS1	107887081	107887230	102	150	102	6869	0	6719	0.68	0.0
chr4	CYP2U1-AS1	107866907	107867645	0	739	102	6869	102	6130	0.0	0.0166394779771615
chr4	CYP2U1-AS1	107874844	107874892	0	49	102	6869	102	6820	0.0	0.014956011730205278
chr4	LEF1	108089124	108089257	0	134	102	5235	102	5101	0.0	0.019996079200156832
chr4	LEF1	108063622	108063663	0	42	102	5235	102	5193	0.0	0.019641825534373193
chr4	LEF1	108081585	108081669	0	85	102	5235	102	5150	0.0	0.019805825242718445
chr4	LEF1	108063622	108063657	0	36	102	5235	102	5199	0.0	0.019619157530294286
chr4	RPL34-DT	108608522	108608650	34	129	2992	4579	2958	4450	0.26356589147286824	0.6647191011235956
chr4	ETNPPL	108759748	108759890	0	143	303	2934	303	2791	0.0	0.10856323898244356
chr4	ETNPPL	108759748	108759908	0	161	303	2934	303	2773	0.0	0.10926794085827624
chr4	ETNPPL	108760187	108760306	0	120	303	2934	303	2814	0.0	0.10767590618336886
chr4	COL25A1	108819251	108819329	0	79	6537	6485	6537	6406	0.0	1.0204495785201373
chr4	COL25A1	108825195	108825222	0	28	6537	6485	6537	6457	0.0	1.012389654638377
chr4	COL25A1	108852901	108852925	75	25	6537	6485	6462	6460	3.0	1.00030959752322
chr4	COL25A1	108862500	108862545	264	46	6537	6485	6273	6439	5.739130434782608	0.9742195993166641
chr4	COL25A1	108819811	108819898	0	88	6537	6485	6537	6397	0.0	1.0218852587150227
chr4	COL25A1	108838097	108838178	0	82	6537	6485	6537	6403	0.0	1.0209276901452444
chr4	COL25A1	108834354	108834390	516	37	6537	6485	6021	6448	13.945945945945946	0.9337779156327544
chr4	SEC24B-AS1	109382248	109382419	0	172	68	5559	68	5387	0.0	0.0126229812511602
chr4	SEC24B-AS1	109430579	109430760	0	182	68	5559	68	5377	0.0	0.012646457132229868
chr4	SEC24B-AS1	109405649	109405773	0	125	68	5559	68	5434	0.0	0.012513801987486198
chr4	SEC24B-AS1	109430579	109430780	0	202	68	5559	68	5357	0.0	0.012693671831248834
chr4	CASP6	109696409	109696486	0	78	153	1950	153	1872	0.0	0.08173076923076923
chr4	PLA2G12A	109718682	109718759	0	78	4331	5225	4331	5147	0.0	0.8414610452690888
chr4	CFI	109757762	109757783	0	22	0	4871	0	4849	0.0	0.0
chr4	PLA2G12A	109718688	109718759	0	72	4331	5225	4331	5153	0.0	0.8404812730448282
chr4	CFI	109757935	109757959	0	25	0	4871	0	4846	0.0	0.0
chr4	ELOVL6	110093105	110093134	0	30	23	7282	23	7252	0.0	0.0031715388858246
chr4	PITX2	110632342	110632480	3786	139	32758	5796	28972	5657	27.237410071942445	5.121442460668199
chr4	PITX2	110634157	110634391	10100	235	32758	5796	22658	5561	42.97872340425532	4.074447041898939
chr4	PITX2	110636780	110638154	204	1375	32758	5796	32554	4421	0.14836363636363636	7.363492422528839
chr4	ZGRF1	112548252	112548380	0	129	0	9135	0	9006	0.0	0.0
chr4	ZGRF1	112628620	112628851	0	232	0	9135	0	8903	0.0	0.0
chr4	ZGRF1	112629758	112630015	0	258	0	9135	0	8877	0.0	0.0
chr4	MIR302CHG	112647414	112647467	0	54	0	748	0	694	0.0	0.0
chr4	CAMK2D	113455725	113455821	0	97	295	7387	295	7290	0.0	0.04046639231824417
chr4	CAMK2D	113504975	113505035	0	61	295	7387	295	7326	0.0	0.040267540267540265
chr4	CAMK2D	113508235	113508268	0	34	295	7387	295	7353	0.0	0.040119679042567656
chr4	CAMK2D	113502935	113502977	40	43	295	7387	255	7344	0.9302325581395349	0.034722222222222224
chr4	ARSJ	113906664	113906745	0	82	0	4875	0	4793	0.0	0.0
chr4	NDST4	115076058	115077282	0	1225	423	3735	423	2510	0.0	0.16852589641434262
chr4	NDST4	114842675	114842773	0	99	423	3735	423	3636	0.0	0.11633663366336634
chr4	NDST4	114977186	114977274	0	89	423	3735	423	3646	0.0	0.11601755348326934
chr4	LINC02262	117351192	117351238	0	47	0	2351	0	2304	0.0	0.0
chr4	LINC02262	117321311	117321363	0	53	0	2351	0	2298	0.0	0.0
chr4	PRSS12	118294938	118295061	0	124	0	5485	0	5361	0.0	0.0
chr4	METTL14-DT	118678043	118678138	0	96	102	7533	102	7437	0.0	0.01371520774505849
chr4	SEC24D	118817263	118817412	0	150	0	9953	0	9803	0.0	0.0
chr4	SEC24D	118825440	118825618	0	179	0	9953	0	9774	0.0	0.0
chr4	SEC24D	118766528	118766823	0	296	0	9953	0	9657	0.0	0.0
chr4	SEC24D	118816743	118816850	0	108	0	9953	0	9845	0.0	0.0
chr4	GTF2IP12	119410516	119410658	0	143	6916	10047	6916	9904	0.0	0.6983037156704361
chr4	GTF2IP12	119429419	119429609	0	191	6916	10047	6916	9856	0.0	0.7017045454545454
chr4	GTF2IP12	119444873	119445027	0	155	6916	10047	6916	9892	0.0	0.6991508289526891
chr4	GTF2IP12	119410516	119410712	0	197	6916	10047	6916	9850	0.0	0.7021319796954315
chr4	LINC01365	119801351	119801394	0	44	0	747	0	703	0.0	0.0
chr4	LINC01365	119800128	119800280	0	153	0	747	0	594	0.0	0.0
chr4	MAD2L1	120061974	120062095	0	122	51	5522	51	5400	0.0	0.009444444444444445
chr4	MAD2L1	120065671	120065818	51	148	51	5522	0	5374	0.34459459459459457	0.0
chr4	PRDM5	120754552	120754638	0	87	27	9538	27	9451	0.0	0.002856840545973971
chr4	PRDM5	120816831	120816924	0	94	27	9538	27	9444	0.0	0.0028589580686149934
chr4	PRDM5	120812550	120812814	0	265	27	9538	27	9273	0.0	0.0029116790682626984
chr4	TNIP3	121138623	121138684	0	62	0	3766	0	3704	0.0	0.0
chr4	QRFPR	121334488	121334619	0	132	2754	2837	2754	2705	0.0	1.0181146025878003
chr4	ANXA5	121684676	121684771	0	96	1743	2700	1743	2604	0.0	0.6693548387096774
chr4	ANXA5	121696580	121696624	0	45	1743	2700	1743	2655	0.0	0.656497175141243
chr4	ANXA5	121686287	121686372	0	86	1743	2700	1743	2614	0.0	0.6667941851568477
chr4	TRPC3	121914779	121914944	0	166	0	9224	0	9058	0.0	0.0
chr4	TRPC3	121930770	121930828	0	59	0	9224	0	9165	0.0	0.0
chr4	CETN4P	122730819	122731683	41675	865	69025	3670	27350	2805	48.179190751445084	9.750445632798574
chr4	CETN4P	122732051	122732193	204	143	69025	3670	68821	3527	1.4265734265734267	19.512616954919196
chr4	NUDT6	122897623	122897678	0	56	0	1904	0	1848	0.0	0.0
chr4	LINC02516	124541129	124541214	0	86	0	2620	0	2534	0.0	0.0
chr4	ANKRD50	124709999	124711274	51	1276	357	8803	306	7527	0.039968652037617555	0.04065364687126345
chr4	AC093772.1	127411306	127411434	0	129	98	2660	98	2531	0.0	0.03871987356775978
chr4	AC097462.3	127557077	127557183	0	107	0	3935	0	3828	0.0	0.0
chr4	MFSD8	127921859	127921963	0	105	204	7255	204	7150	0.0	0.028531468531468533
chr4	MFSD8	127930682	127930817	0	136	204	7255	204	7119	0.0	0.028655710071639275
chr4	MFSD8	127938782	127938838	0	57	204	7255	204	7198	0.0	0.028341205890525144
chr4	MFSD8	127939852	127939997	0	146	204	7255	204	7109	0.0	0.028696019130679422
chr4	MFSD8	127942044	127942158	0	115	204	7255	204	7140	0.0	0.02857142857142857
chr4	MFSD8	127943751	127943992	51	242	204	7255	153	7013	0.21074380165289255	0.021816626265506917
chr4	MFSD8	127949803	127949847	0	45	204	7255	204	7210	0.0	0.028294036061026352
chr4	MFSD8	127965071	127965208	0	138	204	7255	204	7117	0.0	0.028663762821413516
chr4	MFSD8	127921859	127921982	0	124	204	7255	204	7131	0.0	0.02860748843079512
chr4	MFSD8	127939480	127939601	0	122	204	7255	204	7133	0.0	0.02859946726482546
chr4	MFSD8	127921117	127921198	0	82	204	7255	204	7173	0.0	0.028439983270598077
chr4	MFSD8	127938782	127938836	0	55	204	7255	204	7200	0.0	0.028333333333333332
chr4	MFSD8	127965071	127965222	0	152	204	7255	204	7103	0.0	0.028720259045473744
chr4	SCLT1	128965226	128965318	0	93	19969	9011	19969	8918	0.0	2.23917918815878
chr4	SCLT1	128942995	128943188	0	194	19969	9011	19969	8817	0.0	2.2648293070205283
chr4	LINC02466	129696291	129696350	0	60	2800	3930	2800	3870	0.0	0.7235142118863049
chr4	LINC02466	129746234	129746277	0	44	2800	3930	2800	3886	0.0	0.7205352547606794
chr4	LINC02466	129744307	129744379	0	73	2800	3930	2800	3857	0.0	0.7259528130671506
chr4	LINC02466	129725600	129725789	0	190	2800	3930	2800	3740	0.0	0.7486631016042781
chr4	LINC02466	129744307	129744523	0	217	2800	3930	2800	3713	0.0	0.7541071909507137
chr4	AC105383.1	133140585	133140659	0	75	51	11465	51	11390	0.0	0.004477611940298508
chr4	AC105383.1	133145603	133145745	0	143	51	11465	51	11322	0.0	0.0045045045045045045
chr4	AC105383.1	133140585	133140656	0	72	51	11465	51	11393	0.0	0.004476432897393136
chr4	AC105383.1	133140469	133140511	0	43	51	11465	51	11422	0.0	0.004465067413762913
chr4	AC105383.1	133110785	133110910	0	126	51	11465	51	11339	0.0	0.004497751124437781
chr4	AC105383.1	133097639	133097724	0	86	51	11465	51	11379	0.0	0.004481940416556815
chr4	AC015631.1	134166485	134166648	0	164	51	8668	51	8504	0.0	0.005997177798682972
chr4	AC015631.1	134156377	134156552	0	176	51	8668	51	8492	0.0	0.006005652378709373
chr4	AC015631.1	134156426	134156552	0	127	51	8668	51	8541	0.0	0.00597119775201967
chr4	AC015631.1	134326545	134326640	0	96	51	8668	51	8572	0.0	0.005949603359776015
chr4	LINC02511	136813649	136813731	0	83	0	3399	0	3316	0.0	0.0
chr4	LINC02511	136916174	136916226	0	53	0	3399	0	3346	0.0	0.0
chr4	LINC02511	137097717	137097807	0	91	0	3399	0	3308	0.0	0.0
chr4	LINC02511	137089986	137090041	0	56	0	3399	0	3343	0.0	0.0
chr4	PCDH18	137529601	137531742	0	2142	0	6690	0	4548	0.0	0.0
chr4	LINC00616	138098158	138098272	0	115	0	6060	0	5945	0.0	0.0
chr4	LINC00616	138095283	138095420	0	138	0	6060	0	5922	0.0	0.0
chr4	LINC00616	138048379	138048606	0	228	0	6060	0	5832	0.0	0.0
chr4	LINC00616	138032172	138032516	0	345	0	6060	0	5715	0.0	0.0
chr4	LINC00616	138028592	138028702	0	111	0	6060	0	5949	0.0	0.0
chr4	LINC00616	138098452	138098513	0	62	0	6060	0	5998	0.0	0.0
chr4	LINC00616	138097968	138098272	0	305	0	6060	0	5755	0.0	0.0
chr4	LINC00616	138095283	138095418	0	136	0	6060	0	5924	0.0	0.0
chr4	LINC00616	138047940	138047977	0	38	0	6060	0	6022	0.0	0.0
chr4	LINC00616	138083368	138083433	0	66	0	6060	0	5994	0.0	0.0
chr4	SLC7A11	138182296	138182393	0	98	0	9657	0	9559	0.0	0.0
chr4	SLC7A11	138185120	138185244	0	125	0	9657	0	9532	0.0	0.0
chr4	ELF2	139067683	139067770	0	88	859	8575	859	8487	0.0	0.10121362083186049
chr4	NDUFC1	139292529	139292609	0	81	0	2585	0	2504	0.0	0.0
chr4	NDUFC1	139297384	139297443	0	60	0	2585	0	2525	0.0	0.0
chr4	NDUFC1	139296331	139296367	0	37	0	2585	0	2548	0.0	0.0
chr4	AC097376.3	139419869	139419923	0	55	1326	4044	1326	3989	0.0	0.3324141388819253
chr4	SETD7	139548018	139548119	0	102	306	13932	306	13830	0.0	0.02212581344902386
chr4	SETD7	139606359	139606456	0	98	306	13932	306	13834	0.0	0.022119415931762323
chr4	MAML3	139889356	139890967	0	1612	51	6988	51	5376	0.0	0.009486607142857142
chr4	SCOC-AS1	140289592	140290119	34	528	14933	4236	14899	3708	0.06439393939393939	4.0180690399137005
chr4	SCOC-AS1	140362709	140362818	0	110	14933	4236	14933	4126	0.0	3.6192438196800776
chr4	CLGN	140426703	140426787	0	85	29402	2838	29402	2753	0.0	10.679985470395932
chr4	MGAT4D	140471774	140471821	0	48	1367	2816	1367	2768	0.0	0.4938583815028902
chr4	MGAT4D	140474812	140474946	0	135	1367	2816	1367	2681	0.0	0.5098843715031705
chr4	MGAT4D	140482326	140482485	0	160	1367	2816	1367	2656	0.0	0.514683734939759
chr4	RNF150	140996957	140997034	0	78	306	11023	306	10945	0.0	0.027957971676564643
chr4	INPP4B	142467956	142468055	0	100	2114	14202	2114	14102	0.0	0.14990781449439797
chr4	INPP4B	142096084	142096193	0	110	2114	14202	2114	14092	0.0	0.1500141924496168
chr4	INPP4B	142347373	142347556	0	184	2114	14202	2114	14018	0.0	0.15080610643458411
chr4	INPP4B	142383961	142384116	0	156	2114	14202	2114	14046	0.0	0.1505054819877545
chr4	INPP4B	142423695	142423817	0	123	2114	14202	2114	14079	0.0	0.1501527097094964
chr4	INPP4B	142660776	142660896	0	121	2114	14202	2114	14081	0.0	0.15013138271429585
chr4	GYPB	143997539	143997558	0	20	0	1716	0	1696	0.0	0.0
chr4	GYPB	144001184	144001283	0	100	0	1716	0	1616	0.0	0.0
chr4	GYPB	143997539	143997634	0	96	0	1716	0	1620	0.0	0.0
chr4	GYPB	144016801	144016884	0	84	0	1716	0	1632	0.0	0.0
chr4	GYPB	144002570	144002694	0	125	0	1716	0	1591	0.0	0.0
chr4	GYPB	143999410	143999449	0	40	0	1716	0	1676	0.0	0.0
chr4	GYPB	144000382	144000475	0	94	0	1716	0	1622	0.0	0.0
chr4	GYPB	144008391	144008449	0	59	0	1716	0	1657	0.0	0.0
chr4	GYPA	144114688	144114767	0	80	7369	4262	7369	4182	0.0	1.7620755619320898
chr4	GYPA	144118713	144118752	0	40	7369	4262	7369	4222	0.0	1.745381335859782
chr4	GYPA	144119685	144119781	0	97	7369	4262	7369	4165	0.0	1.769267707082833
chr4	GYPA	144120489	144120588	0	100	7369	4262	7369	4162	0.0	1.7705430081691496
chr4	AC098588.3	144213068	144213117	0	50	2070	1918	2070	1868	0.0	1.10813704496788
chr4	GYPA	144127877	144128035	0	159	7369	4262	7369	4103	0.0	1.7960029246892517
chr4	GYPA	144138160	144138340	0	181	7369	4262	7369	4081	0.0	1.8056848811565793
chr4	GYPA	144138160	144138243	0	84	7369	4262	7369	4178	0.0	1.763762565820967
chr4	GYPA	144116853	144116939	2070	87	7369	4262	5299	4175	23.79310344827586	1.2692215568862275
chr4	GYPA	144122871	144122989	0	119	7369	4262	7369	4143	0.0	1.7786628047308712
chr4	HHIP-AS1	144645287	144645467	0	181	0	2159	0	1978	0.0	0.0
chr4	HHIP-AS1	144652701	144652776	0	76	0	2159	0	2083	0.0	0.0
chr4	ANAPC10	145095984	145096111	0	128	10069	4412	10069	4284	0.0	2.350373482726424
chr4	ANAPC10	145064571	145064692	0	122	10069	4412	10069	4290	0.0	2.347086247086247
chr4	ANAPC10	145097687	145097760	0	74	10069	4412	10069	4338	0.0	2.3211157215306595
chr4	ANAPC10	145097494	145097562	0	69	10069	4412	10069	4343	0.0	2.318443472254202
chr4	OTUD4	145178513	145178570	0	58	323	9541	323	9483	0.0	0.03406095117578825
chr4	LINC02266	145336204	145336288	0	85	0	1730	0	1645	0.0	0.0
chr4	ZNF827	145763401	145763468	0	68	1041	16799	1041	16731	0.0	0.06221983145060068
chr4	ZNF827	145763089	145763122	0	34	1041	16799	1041	16765	0.0	0.06209364747986877
chr4	ZNF827	145902165	145903215	714	1051	1041	16799	327	15748	0.6793529971455756	0.02076454152908306
chr4	ZNF827	145763089	145763117	0	29	1041	16799	1041	16770	0.0	0.06207513416815742
chr4	LINC01095	146117384	146117527	0	144	1784	3553	1784	3409	0.0	0.5233206218832502
chr4	LINC01095	146113641	146113756	0	116	1784	3553	1784	3437	0.0	0.5190573174279896
chr4	SLC10A7	146509912	146510049	0	138	51	6702	51	6564	0.0	0.007769652650822669
chr4	SLC10A7	146442782	146442821	0	40	51	6702	51	6662	0.0	0.007655358751125788
chr4	SLC10A7	146256825	146256936	0	112	51	6702	51	6590	0.0	0.007738998482549317
chr4	SLC10A7	146503848	146503924	0	77	51	6702	51	6625	0.0	0.00769811320754717
chr4	TTC29	146942583	146942684	0	102	477	3350	477	3248	0.0	0.14685960591133004
chr4	TTC29	146831640	146831794	204	155	477	3350	273	3195	1.3161290322580645	0.08544600938967137
chr4	TTC29	146944096	146944333	0	238	477	3350	477	3112	0.0	0.1532776349614396
chr4	TTC29	146944096	146944350	0	255	477	3350	477	3095	0.0	0.15411954765751212
chr4	PRMT9	147680322	147680471	0	150	0	3964	0	3814	0.0	0.0
chr4	NR3C2	148154550	148154901	0	352	0	6620	0	6268	0.0	0.0
chr4	NR3C2	148152468	148152613	0	146	0	6620	0	6474	0.0	0.0
chr4	IQCM	149514524	149514742	0	219	0	2908	0	2689	0.0	0.0
chr4	IQCM	149691737	149691791	0	55	0	2908	0	2853	0.0	0.0
chr4	IQCM	149748692	149748755	0	64	0	2908	0	2844	0.0	0.0
chr4	LRBA	150277852	150278004	51	153	1453	16823	1402	16670	0.3333333333333333	0.08410317936412717
chr4	LRBA	150597082	150597115	0	34	1453	16823	1453	16789	0.0	0.08654476145095003
chr4	LRBA	150353730	150353924	0	195	1453	16823	1453	16628	0.0	0.0873827279287948
chr4	LRBA	150266398	150266441	0	44	1453	16823	1453	16779	0.0	0.08659634066392514
chr4	SH3D19	151165588	151165696	626	109	60745	7208	60119	7099	5.743119266055046	8.468657557402452
chr4	SH3D19	151144219	151144288	0	70	60745	7208	60745	7138	0.0	8.510086859064163
chr4	SH3D19	151181688	151181729	0	42	60745	7208	60745	7166	0.0	8.476835054423667
chr4	SH3D19	151226167	151226240	0	74	60745	7208	60745	7134	0.0	8.514858424446313
chr4	GATB	151679812	151679891	0	80	0	9197	0	9117	0.0	0.0
chr4	GATB	151716008	151716131	0	124	0	9197	0	9073	0.0	0.0
chr4	GATB	151716875	151717074	0	200	0	9197	0	8997	0.0	0.0
chr4	FBXW7	152412479	152412529	0	51	21804	9870	21804	9819	0.0	2.2205927283837457
chr4	FBXW7	152534940	152535033	0	94	21804	9870	21804	9776	0.0	2.2303600654664484
chr4	FBXW7	152451659	152451776	51	118	21804	9870	21753	9752	0.4322033898305085	2.230619360131255
chr4	RNF175	153728206	153728361	0	156	255	3914	255	3758	0.0	0.06785524215007983
chr4	RNF175	153748644	153748786	0	143	255	3914	255	3771	0.0	0.06762132060461416
chr4	RNF175	153751437	153751475	0	39	255	3914	255	3875	0.0	0.06580645161290323
chr4	RNF175	153748644	153748827	0	184	255	3914	255	3730	0.0	0.06836461126005362
chr4	PLRG1	154537285	154537479	0	195	3004	4940	3004	4745	0.0	0.6330874604847208
chr4	PLRG1	154546122	154546213	0	92	3004	4940	3004	4848	0.0	0.6196369636963697
chr4	PLRG1	154549663	154549772	0	110	3004	4940	3004	4830	0.0	0.6219461697722567
chr4	MAP9	155355715	155355884	0	170	150	8872	150	8702	0.0	0.01723741668581935
chr4	MAP9	155375775	155375914	0	140	150	8872	150	8732	0.0	0.01717819514429684
chr4	MAP9	155375775	155375870	0	96	150	8872	150	8776	0.0	0.017092069279854148
chr4	LINC02272	156636567	156636606	0	40	0	610	0	570	0.0	0.0
chr4	PDGFC	156861428	156861489	0	62	1479	6013	1479	5951	0.0	0.24852965888086037
chr4	PDGFC	156767772	156767876	0	105	1479	6013	1479	5908	0.0	0.2503385240352065
chr4	GASK1B	158170465	158171599	0	1135	0	5026	0	3891	0.0	0.0
chr4	C4ORF45	158960285	158960344	0	60	0	1493	0	1433	0.0	0.0
chr4	FSTL5	161510397	161510424	0	28	0	5343	0	5315	0.0	0.0
chr4	NPY1R	163326217	163326298	0	82	0	3904	0	3822	0.0	0.0
chr4	MARCHF1	163612270	163613038	0	769	28	10135	28	9366	0.0	0.0029895366218236174
chr4	MARCHF1	163854020	163854169	0	150	28	10135	28	9985	0.0	0.002804206309464196
chr4	MARCHF1	163988500	163988709	0	210	28	10135	28	9925	0.0	0.0028211586901763226
chr4	MARCHF1	163555848	163555973	0	126	28	10135	28	10009	0.0	0.0027974822659606355
chr4	TMEM192	165111648	165111679	0	32	51	10191	51	10159	0.0	0.005020179151491289
chr4	SPOCK3	166792169	166792289	0	121	0	4501	0	4380	0.0	0.0
chr4	SPOCK3	167062491	167062537	0	47	0	4501	0	4454	0.0	0.0
chr4	SPOCK3	166912619	166912743	0	125	0	4501	0	4376	0.0	0.0
chr4	SPOCK3	167000348	167000463	0	116	0	4501	0	4385	0.0	0.0
chr4	SPOCK3	167083237	167083246	0	10	0	4501	0	4491	0.0	0.0
chr4	SPOCK3	167119793	167119874	0	82	0	4501	0	4419	0.0	0.0
chr4	SPOCK3	167062641	167062650	0	10	0	4501	0	4491	0.0	0.0
chr4	SPOCK3	167011221	167011302	0	82	0	4501	0	4419	0.0	0.0
chr4	DDX60	168265464	168265614	0	151	0	6563	0	6412	0.0	0.0
chr4	DDX60L	168419301	168419397	0	97	254	12203	254	12106	0.0	0.020981331571121756
chr4	DDX60L	168419301	168419384	0	84	254	12203	254	12119	0.0	0.020958824985559864
chr4	DDX60L	168475995	168476120	0	126	254	12203	254	12077	0.0	0.021031713173801442
chr4	CBR4	168864371	168864586	0	216	0	5120	0	4904	0.0	0.0
chr4	CBR4	169007635	169007756	0	122	0	5120	0	4998	0.0	0.0
chr4	CBR4	169005884	169005914	0	31	0	5120	0	5089	0.0	0.0
chr4	CBR4	169008951	169008999	0	49	0	5120	0	5071	0.0	0.0
chr4	CBR4	169008951	169009054	0	104	0	5120	0	5016	0.0	0.0
chr4	NEK1	169508768	169508852	0	85	7899	8391	7899	8306	0.0	0.9509992776306284
chr4	NEK1	169555719	169555851	0	133	7899	8391	7899	8258	0.0	0.9565270041172197
chr4	NEK1	169561479	169561554	0	76	7899	8391	7899	8315	0.0	0.9499699338544798
chr4	NEK1	169602007	169602104	0	98	7899	8391	7899	8293	0.0	0.9524900518509586
chr4	LINC02275	169923060	169923187	457	128	33595	4372	33138	4244	3.5703125	7.808199811498587
chr4	LINC02275	169942705	169942843	0	139	33595	4372	33595	4233	0.0	7.936451689109378
chr4	MFAP3L	170005579	170006010	0	432	505	8210	505	7778	0.0	0.06492671637953201
chr4	MFAP3L	170001964	170002226	0	263	505	8210	505	7947	0.0	0.06354599219831383
chr4	MFAP3L	170006602	170006736	0	135	505	8210	505	8075	0.0	0.06253869969040247
chr4	AC105285.1	173166123	173166299	0	177	0	6261	0	6084	0.0	0.0
chr4	AC105285.1	173164977	173165132	0	156	0	6261	0	6105	0.0	0.0
chr4	AC105285.1	173165991	173166018	0	28	0	6261	0	6233	0.0	0.0
chr4	SCRG1	173389594	173389892	0	299	0	5112	0	4813	0.0	0.0
chr4	SCRG1	173398261	173398434	0	174	0	5112	0	4938	0.0	0.0
chr4	LINC02268	174097622	174097829	0	208	0	3430	0	3222	0.0	0.0
chr4	LINC02268	174114040	174114272	0	233	0	3430	0	3197	0.0	0.0
chr4	FBXO8	174256026	174256145	285	120	4050	2099	3765	1979	2.375	1.902475997978777
chr4	FBXO8	174269053	174269167	0	115	4050	2099	4050	1984	0.0	2.0413306451612905
chr4	HPGD	174493150	174493314	0	165	0	5539	0	5374	0.0	0.0
chr4	HPGD	174517970	174518077	0	108	0	5539	0	5431	0.0	0.0
chr4	HPGD	174521943	174522067	0	125	0	5539	0	5414	0.0	0.0
chr4	HPGD	174508695	174508792	0	98	0	5539	0	5441	0.0	0.0
chr4	HPGD	174495547	174495624	0	78	0	5539	0	5461	0.0	0.0
chr4	GLRA3	174656742	174656787	0	46	51	9539	51	9493	0.0	0.005372379648161804
chr4	GPM6A	175812190	175812249	0	60	0	7064	0	7004	0.0	0.0
chr4	GPM6A	175786871	175786917	0	47	0	7064	0	7017	0.0	0.0
chr4	GPM6A	175961236	175961341	0	106	0	7064	0	6958	0.0	0.0
chr4	GPM6A	175781208	175781297	0	90	0	7064	0	6974	0.0	0.0
chr4	GPM6A	175787335	175787425	0	91	0	7064	0	6973	0.0	0.0
chr4	AC097518.2	177270862	177270986	0	125	204	6326	204	6201	0.0	0.03289791969037252
chr4	AC097518.2	177115725	177115878	0	154	204	6326	204	6172	0.0	0.03305249513933895
chr4	AGA	177436275	177436351	0	77	0	2614	0	2537	0.0	0.0
chr4	AGA	177439575	177439688	0	114	0	2614	0	2500	0.0	0.0
chr4	AGA	177436297	177436351	0	55	0	2614	0	2559	0.0	0.0
chr4	TENM3-AS1	182084853	182085174	0	322	153	5430	153	5108	0.0	0.02995301487862177
chr4	DCTD	182914922	182915058	0	137	0	3477	0	3340	0.0	0.0
chr4	DCTD	182916722	182916857	0	136	0	3477	0	3341	0.0	0.0
chr4	DCTD	182916418	182916539	0	122	0	3477	0	3355	0.0	0.0
chr4	DCTD	182915880	182915888	0	9	0	3477	0	3468	0.0	0.0
chr4	DCTD	182916672	182916857	0	186	0	3477	0	3291	0.0	0.0
chr4	RWDD4	183646350	183646353	0	4	0	2762	0	2758	0.0	0.0
chr4	RWDD4	183651217	183651327	0	111	0	2762	0	2651	0.0	0.0
chr4	RWDD4	183651217	183651323	0	107	0	2762	0	2655	0.0	0.0
chr4	RWDD4	183655880	183655961	0	82	0	2762	0	2680	0.0	0.0
chr4	LINC02363	184350088	184350278	0	191	0	2723	0	2532	0.0	0.0
chr4	LINC02362	184378964	184379129	51	166	94570	5072	94519	4906	0.3072289156626506	19.26600081532817
chr4	LINC02362	184378498	184379129	51	632	94570	5072	94519	4440	0.08069620253164557	21.288063063063063
chr4	LINC02362	184368412	184368467	5956	56	94570	5072	88614	5016	106.35714285714286	17.666267942583733
chr4	IRF2	184407178	184407283	0	106	906	3036	906	2930	0.0	0.30921501706484644
chr4	IRF2	184428673	184428797	0	125	906	3036	906	2911	0.0	0.3112332531776022
chr4	CASP3	184644530	184644722	0	193	16697	2908	16697	2715	0.0	6.149907918968692
chr4	CASP3	184631036	184631157	1279	122	16697	2908	15418	2786	10.48360655737705	5.5340990667623835
chr4	CASP3	184648464	184648631	0	168	16697	2908	16697	2740	0.0	6.093795620437956
chr4	CASP3	184648502	184648631	0	130	16697	2908	16697	2778	0.0	6.010439164866811
chr4	CENPU	184700819	184700881	0	63	102	3274	102	3211	0.0	0.031765805045157275
chr4	ACSL1	184770398	184770476	0	79	102	6161	102	6082	0.0	0.016770799079250248
chr4	ACSL1	184780331	184780433	0	103	102	6161	102	6058	0.0	0.01683724001320568
chr4	ACSL1	184803319	184803546	0	228	102	6161	102	5933	0.0	0.017191977077363897
chr4	ACSL1	184788378	184788513	0	136	102	6161	102	6025	0.0	0.016929460580912863
chr4	ACSL1	184770254	184770332	0	79	102	6161	102	6082	0.0	0.016770799079250248
chr4	LINC01093	184897334	184897567	0	234	0	3158	0	2924	0.0	0.0
chr4	LINC01093	184897334	184897588	0	255	0	3158	0	2903	0.0	0.0
chr4	LINC01093	184898620	184898769	0	150	0	3158	0	3008	0.0	0.0
chr4	LINC01093	184897347	184897567	0	221	0	3158	0	2937	0.0	0.0
chr4	LINC01093	184898646	184898769	0	124	0	3158	0	3034	0.0	0.0
chr4	LINC01093	184897334	184898769	0	1436	0	3158	0	1722	0.0	0.0
chr4	LINC01093	184897347	184897588	0	242	0	3158	0	2916	0.0	0.0
chr4	LINC01093	184897669	184897746	0	78	0	3158	0	3080	0.0	0.0
chr4	LINC01093	184897347	184897570	0	224	0	3158	0	2934	0.0	0.0
chr4	LINC01093	184897334	184897749	0	416	0	3158	0	2742	0.0	0.0
chr4	LINC01093	184897669	184897749	0	81	0	3158	0	3077	0.0	0.0
chr4	LINC01093	184897347	184897746	0	400	0	3158	0	2758	0.0	0.0
chr4	LINC01093	184897334	184897746	0	413	0	3158	0	2745	0.0	0.0
chr4	CCDC110	185462993	185463049	0	57	1569	3546	1569	3489	0.0	0.44969905417024936
chr4	CCDC110	185461048	185461159	0	112	1569	3546	1569	3434	0.0	0.4569015725101922
chr4	CCDC110	185452220	185452373	0	154	1569	3546	1569	3392	0.0	0.46255896226415094
chr4	CCDC110	185457161	185457329	0	169	1569	3546	1569	3377	0.0	0.46461356233343204
chr4	CCDC110	185460893	185460953	0	61	1569	3546	1569	3485	0.0	0.45021520803443327
chr4	CCDC110	185470579	185470716	0	138	1569	3546	1569	3408	0.0	0.460387323943662
chr4	PDLIM3	185508298	185508562	0	265	408	9020	408	8755	0.0	0.04660194174757282
chr4	PDLIM3	185523361	185523446	0	86	408	9020	408	8934	0.0	0.04566823371390195
chr4	PDLIM3	185525019	185525171	0	153	408	9020	408	8867	0.0	0.04601330777038457
chr4	PDLIM3	185514702	185514890	0	189	408	9020	408	8831	0.0	0.046200883252179824
chr4	SORBS2	185606584	185607349	27139	766	207139	11677	180000	10911	35.429503916449086	16.497113005224087
chr4	SORBS2	185622913	185624494	39159	1582	207139	11677	167980	10095	24.75284450063211	16.639920752847946
chr4	SORBS2	185635354	185635411	0	58	207139	11677	207139	11619	0.0	17.827609949221102
chr4	SORBS2	185651783	185651828	195	46	207139	11677	206944	11631	4.239130434782608	17.79245120797868
chr4	SORBS2	185638876	185639035	0	160	207139	11677	207139	11517	0.0	17.985499696101414
chr4	SORBS2	185676996	185677638	130753	643	207139	11677	76386	11034	203.348367029549	6.922784121805329
chr4	SORBS2	185684753	185684846	0	94	207139	11677	207139	11583	0.0	17.883018216351548
chr4	SORBS2	185684753	185684842	0	90	207139	11677	207139	11587	0.0	17.8768447397946
chr4	SORBS2	185690561	185690611	138	51	207139	11677	207001	11626	2.7058823529411766	17.80500602098744
chr4	SORBS2	185894296	185894373	0	78	207139	11677	207139	11599	0.0	17.858349857746358
chr4	SORBS2	185638078	185638162	0	85	207139	11677	207139	11592	0.0	17.869133885438234
chr4	SORBS2	185734098	185734154	0	57	207139	11677	207139	11620	0.0	17.82607573149742
chr4	SORBS2	185733997	185734154	0	158	207139	11677	207139	11519	0.0	17.98237694244292
chr4	SORBS2	185775059	185775111	0	53	207139	11677	207139	11624	0.0	17.819941500344115
chr4	SORBS2	185775226	185775366	18	141	207139	11677	207121	11536	0.1276595744680851	17.954316920943135
chr4	F11-AS1	186424089	186424236	0	148	3476	3452	3476	3304	0.0	1.0520581113801453
chr4	F11-AS1	186428704	186428850	0	147	3476	3452	3476	3305	0.0	1.0517397881996975
chr4	FAT1	186590367	186590403	0	37	2966	16199	2966	16162	0.0	0.1835168914738275
chr4	FAT1	186590504	186590695	0	192	2966	16199	2966	16007	0.0	0.18529393390391705
chr4	FAT1	186592692	186592752	0	61	2966	16199	2966	16138	0.0	0.18378981286404758
chr4	LINC02492	187582420	187582530	0	111	5164	2773	5164	2662	0.0	1.9398948159278737
chr4	LINC02492	187592742	187592927	0	186	5164	2773	5164	2587	0.0	1.996134518747584
chr4	LINC02492	187558076	187558264	0	189	5164	2773	5164	2584	0.0	1.998452012383901
chr4	LINC02492	187555060	187555144	0	85	5164	2773	5164	2688	0.0	1.9211309523809523
chr4	LINC02492	187533351	187533609	0	259	5164	2773	5164	2514	0.0	2.054097056483691
chr4	LINC02492	187592883	187592927	0	45	5164	2773	5164	2728	0.0	1.8929618768328447
chr4	LINC02492	187555567	187555640	0	74	5164	2773	5164	2699	0.0	1.9133012226750647
chr4	TRIML2	188097323	188097346	0	24	0	2931	0	2907	0.0	0.0
chr4	TRIML2	188098204	188098279	0	76	0	2931	0	2855	0.0	0.0
chr4	TRIML2	188092786	188093022	0	237	0	2931	0	2694	0.0	0.0
chr4	FRG1-DT	189864592	189864786	0	195	51	5113	51	4918	0.0	0.010370069133794225
chr4	ZNF595	59429	59556	21	128	21997	3934	21976	3806	0.1640625	5.77404098791382
chr4	ZNF595	60057	60153	0	97	21997	3934	21997	3837	0.0	5.73286421683607
chr4	ZNF141	372663	373007	6261	345	9393	3523	3132	3178	18.14782608695652	0.9855254877281309
chr4	PIGG	501100	501170	0	71	262664	8690	262664	8619	0.0	30.474997099431487
chr4	PIGG	521055	521227	16077	173	262664	8690	246587	8517	92.9306358381503	28.952330632851943
chr4	PIGG	521055	521273	18099	219	262664	8690	244565	8471	82.64383561643835	28.870853500177073
chr4	PIGG	527038	527230	5858	193	262664	8690	256806	8497	30.352331606217618	30.223137577968696
chr4	PIGG	530435	530745	11838	311	262664	8690	250826	8379	38.064308681672024	29.935075784699844
chr4	PIGG	521055	521249	17031	195	262664	8690	245633	8495	87.33846153846154	28.91500882872278
chr4	PIGG	506760	506866	0	107	262664	8690	262664	8583	0.0	30.60281952697192
chr4	AC116565.1	582123	582230	0	108	0	3016	0	2908	0.0	0.0
chr4	PDE6B	656244	656292	116	49	56567	5076	56451	5027	2.36734693877551	11.229560373980505
chr4	PDE6B	667855	668006	18642	152	56567	5076	37925	4924	122.64473684210526	7.702071486596263
chr4	PDE6B	653436	653707	1981	272	56567	5076	54586	4804	7.283088235294118	11.362614487926727
chr4	PDE6B	667855	667941	427	87	56567	5076	56140	4989	4.908045977011494	11.252756063339346
chr4	PCGF3	732443	732498	0	56	78633	6655	78633	6599	0.0	11.915896347931504
chr4	PCGF3	732399	732498	0	100	78633	6655	78633	6555	0.0	11.99588100686499
chr4	TMEM175	947708	947892	221	185	49203	3599	48982	3414	1.1945945945945946	14.347393087287639
chr4	TMEM175	948410	948615	1071	206	49203	3599	48132	3393	5.199029126213592	14.185676392572944
chr4	TMEM175	951645	951717	3538	73	49203	3599	45665	3526	48.465753424657535	12.950935904707885
chr4	TMEM175	951681	951717	2069	37	49203	3599	47134	3562	55.91891891891892	13.232453677709152
chr4	TMEM175	948115	948154	40	40	49203	3599	49163	3559	1.0	13.813711716774375
chr4	TMEM175	948510	948615	627	106	49203	3599	48576	3493	5.915094339622642	13.906670483824792
chr4	TMEM175	945998	946126	1118	129	49203	3599	48085	3470	8.666666666666666	13.857348703170029
chr4	IDUA	987808	987949	3640	142	22583	3973	18943	3831	25.633802816901408	4.944661968154529
chr4	IDUA	987808	987911	2846	104	22583	3973	19737	3869	27.365384615384617	5.101318170069786
chr4	MAEA	1315396	1315600	1401	205	73349	6602	71948	6397	6.8341463414634145	11.24714710020322
chr4	MAEA	1323494	1323608	665	115	73349	6602	72684	6487	5.782608695652174	11.204562972098042
chr4	MAEA	1297955	1298115	918	161	73349	6602	72431	6441	5.701863354037267	11.24530352429747
chr4	MAEA	1322380	1322503	571	124	73349	6602	72778	6478	4.604838709677419	11.234640321086756
chr4	MAEA	1327626	1327703	177	78	73349	6602	73172	6524	2.269230769230769	11.215818516247701
chr4	UVSSA	1366319	1366431	97	113	155249	15270	155152	15157	0.8584070796460177	10.236326449825164
chr4	UVSSA	1364507	1364571	0	65	155249	15270	155249	15205	0.0	10.210391318645183
chr4	UVSSA	1380640	1380747	10270	108	155249	15270	144979	15162	95.0925925925926	9.56199709800818
chr4	TACC3	1727707	1728787	8263	1081	210699	7099	202436	6018	7.643848288621647	33.63841807909605
chr4	FGFR3	1806256	1806327	0	72	9698	4866	9698	4794	0.0	2.0229453483521067
chr4	FGFR3	1802913	1803064	0	152	9698	4866	9698	4714	0.0	2.057276198557488
chr4	FGFR3	1803691	1803836	706	146	9698	4866	8992	4720	4.835616438356165	1.9050847457627118
chr4	NSD2	1938450	1938532	6	83	1092167	19329	1092161	19246	0.07228915662650602	56.7474280369947
chr4	NSD2	1952107	1952231	797	125	1092167	19329	1091370	19204	6.376	56.830347844199125
chr4	NSD2	1893729	1893909	1887	181	1092167	19329	1090280	19148	10.425414364640885	56.93962815959891
chr4	NSD2	1899220	1899395	0	176	1092167	19329	1092167	19153	0.0	57.02328616926852
chr4	NSD2	1942338	1942432	2937	95	1092167	19329	1089230	19234	30.91578947368421	56.63044608505771
chr4	NSD2	1942338	1942565	6267	228	1092167	19329	1085900	19101	27.486842105263158	56.850426679231454
chr4	NSD2	1953813	1953982	24349	170	1092167	19329	1067818	19159	143.22941176470587	55.73453729317814
chr4	NSD2	1912090	1912194	0	105	1092167	19329	1092167	19224	0.0	56.81268206408656
chr4	NSD2	1939653	1939778	1275	126	1092167	19329	1090892	19203	10.119047619047619	56.808415351767955
chr4	CFAP99	2445130	2445308	0	179	372	5011	372	4832	0.0	0.07698675496688742
chr4	RNF4	2497006	2497121	0	116	262777	7130	262777	7014	0.0	37.46464214428286
chr4	RNF4	2490336	2490502	0	167	262777	7130	262777	6963	0.0	37.73904926037628
chr4	RNF4	2500658	2500738	0	81	262777	7130	262777	7049	0.0	37.278621081004395
chr4	RNF4	2512437	2512597	1930	161	262777	7130	260847	6969	11.987577639751553	37.429616874730954
chr4	RNF4	2490336	2490411	0	76	262777	7130	262777	7054	0.0	37.25219733484548
chr4	RNF4	2499336	2499419	0	84	262777	7130	262777	7046	0.0	37.29449332954868
chr4	RNF4	2470986	2471109	0	124	262777	7130	262777	7006	0.0	37.50742220953468
chr4	FAM193A	2708145	2708268	0	124	24520	6976	24520	6852	0.0	3.57851722124927
chr4	FAM193A	2655057	2655129	51	73	24520	6976	24469	6903	0.6986301369863014	3.5446907141822397
chr4	FAM193A	2719979	2720072	137	94	24520	6976	24383	6882	1.4574468085106382	3.543010752688172
chr4	FAM193A	2715321	2715493	0	173	24520	6976	24520	6803	0.0	3.604292224018815
chr4	SH3BP2	2809778	2809829	0	52	224879	12298	224879	12246	0.0	18.363465621427405
chr4	SH3BP2	2829492	2830147	0	656	224879	12298	224879	11642	0.0	19.316182786462807
chr4	SH3BP2	2831922	2831978	0	57	224879	12298	224879	12241	0.0	18.37096642431174
chr4	SH3BP2	2823394	2823569	0	176	224879	12298	224879	12122	0.0	18.551311664741792
chr4	SH3BP2	2814810	2814917	0	108	224879	12298	224879	12190	0.0	18.44782608695652
chr4	SH3BP2	2823394	2823573	0	180	224879	12298	224879	12118	0.0	18.55743522033339
chr4	ADD1	2881897	2882060	781	164	353863	11643	353082	11479	4.762195121951219	30.75895112814705
chr4	ADD1	2914883	2915040	401	158	353863	11643	353462	11485	2.537974683544304	30.775968654767087
chr4	ADD1	2926641	2926675	242	35	353863	11643	353621	11608	6.914285714285715	30.46355961405927
chr4	ADD1	2884514	2884666	224	153	353863	11643	353639	11490	1.4640522875816993	30.77798085291558
chr4	ADD1	2867971	2868129	0	159	353863	11643	353863	11484	0.0	30.813566701497734
chr4	ADD1	2926638	2926675	275	38	353863	11643	353588	11605	7.2368421052631575	30.468591124515296
chr4	ADD1	2909338	2909431	7014	94	353863	11643	346849	11549	74.61702127659575	30.03281669408607
chr4	ADD1	2926284	2926316	623	33	353863	11643	353240	11610	18.87878787878788	30.425495262704565
chr4	GRK4	2984512	2984608	1632	97	13456	4756	11824	4659	16.824742268041238	2.5378836660227515
chr4	GRK4	3035385	3035523	0	139	13456	4756	13456	4617	0.0	2.914446610353043
chr4	GRK4	3038375	3038513	140	139	13456	4756	13316	4617	1.0071942446043165	2.884123889971843
chr4	GRK4	3037373	3037511	23	139	13456	4756	13433	4617	0.16546762589928057	2.909465020576132
chr4	HTT	3233162	3233353	0	192	159747	18141	159747	17949	0.0	8.900050142069196
chr4	HTT	3202976	3203066	0	91	159747	18141	159747	18050	0.0	8.850249307479224
chr4	RGS12	3386415	3386437	0	23	99154	13133	99154	13110	0.0	7.5632341723874905
chr4	RGS12	3428557	3428711	0	155	99154	13133	99154	12978	0.0	7.640160271228233
chr4	HGFAC	3445875	3445896	0	22	7069	2771	7069	2749	0.0	2.571480538377592
chr4	DOK7	3463505	3463551	0	47	586	4047	586	4000	0.0	0.1465
chr4	AL590235.1	3546169	3546348	0	180	0	938	0	758	0.0	0.0
chr4	ZBTB49	4306137	4306184	0	48	7860	2879	7860	2831	0.0	2.776404097492052
chr4	ZBTB49	4313040	4313114	1	75	7860	2879	7859	2804	0.013333333333333334	2.8027817403708988
chr4	NSG1	4385856	4387173	0	1318	1109	4365	1109	3047	0.0	0.36396455530029537
chr4	NSG1	4391474	4391591	0	118	1109	4365	1109	4247	0.0	0.2611255003531905
chr4	NSG1	4385856	4386643	0	788	1109	4365	1109	3577	0.0	0.3100363433044451
chr4	NSG1	4387118	4387173	0	56	1109	4365	1109	4309	0.0	0.25736829890925966
chr4	STX18-AS1	4648976	4649542	0	567	21734	21284	21734	20717	0.0	1.0490901192257567
chr4	STK32B	5416844	5416934	0	91	2242	5226	2242	5135	0.0	0.43661148977604675
chr4	STK32B	5446672	5446776	0	105	2242	5226	2242	5121	0.0	0.43780511618824447
chr4	STK32B	5140196	5140306	0	111	2242	5226	2242	5115	0.0	0.43831867057673507
chr4	WFS1	6277454	6277687	0	234	98786	4521	98786	4287	0.0	23.043153720550503
chr4	WFS1	6277450	6277687	0	238	98786	4521	98786	4283	0.0	23.064674293719357
chr4	KIAA0232	6804522	6804606	0	85	53791	8511	53791	8426	0.0	6.383930690719202
chr4	TBC1D14	7007523	7007625	0	103	244839	6280	244839	6177	0.0	39.63720252549781
chr4	SH3TC1	8205166	8205366	0	201	0	8635	0	8434	0.0	0.0
chr4	SH3TC1	8209747	8209822	0	76	0	8635	0	8559	0.0	0.0
chr4	SH3TC1	8216956	8217167	0	212	0	8635	0	8423	0.0	0.0
chr4	SH3TC1	8236277	8236428	0	152	0	8635	0	8483	0.0	0.0
chr4	SH3TC1	8209664	8209822	0	159	0	8635	0	8476	0.0	0.0
chr4	SH3TC1	8204782	8205053	0	272	0	8635	0	8363	0.0	0.0
chr4	SH3TC1	8215171	8215242	0	72	0	8635	0	8563	0.0	0.0
chr4	SH3TC1	8232706	8233065	0	360	0	8635	0	8275	0.0	0.0
chr4	LINC02517	8321956	8322243	0	288	102	1963	102	1675	0.0	0.0608955223880597
chr4	LINC02517	8322125	8322243	0	119	102	1963	102	1844	0.0	0.055314533622559656
chr4	LINC02517	8321956	8322032	0	77	102	1963	102	1886	0.0	0.05408271474019088
chr4	TRMT44	8446475	8446590	0	116	51409	7662	51409	7546	0.0	6.812748476013782
chr4	CPZ	8599452	8599582	0	131	51	3293	51	3162	0.0	0.016129032258064516
chr4	CPZ	8599452	8599485	0	34	51	3293	51	3259	0.0	0.01564897207732433
chr4	AC005699.1	11763458	11763501	0	44	0	4472	0	4428	0.0	0.0
chr4	AC005699.1	11768727	11768810	0	84	0	4472	0	4388	0.0	0.0
chr4	AC005699.1	11778185	11778535	0	351	0	4472	0	4121	0.0	0.0
chr4	AC005699.1	11770611	11770688	0	78	0	4472	0	4394	0.0	0.0
chr4	AC005699.1	11773592	11773664	0	73	0	4472	0	4399	0.0	0.0
chr4	AC005699.1	11770616	11770688	0	73	0	4472	0	4399	0.0	0.0
chr4	AC005699.1	11740796	11740939	0	144	0	4472	0	4328	0.0	0.0
chr4	AC005699.1	11778182	11778535	0	354	0	4472	0	4118	0.0	0.0
chr4	AC005699.1	11776279	11776344	0	66	0	4472	0	4406	0.0	0.0
chr4	LINC02270	12246934	12246970	0	37	0	1314	0	1277	0.0	0.0
chr4	LINC01085	14127076	14127258	0	183	0	2592	0	2409	0.0	0.0
chr4	CPEB2	15008337	15008427	42	91	189752	7383	189710	7292	0.46153846153846156	26.01618211738892
chr4	CPEB2	15040463	15040487	0	25	189752	7383	189752	7358	0.0	25.788529491709703
chr4	CC2D2A	15473221	15473255	0	35	16248	12486	16248	12451	0.0	1.3049554252670468
chr4	CC2D2A	15574149	15574326	0	178	16248	12486	16248	12308	0.0	1.320116997075073
chr4	CC2D2A	15596084	15596207	969	124	16248	12486	15279	12362	7.814516129032258	1.2359650541983498
chr4	CC2D2A	15479218	15479328	0	111	16248	12486	16248	12375	0.0	1.312969696969697
chr4	CC2D2A	15479222	15479328	0	107	16248	12486	16248	12379	0.0	1.3125454398578238
chr4	CC2D2A	15561587	15561602	0	16	16248	12486	16248	12470	0.0	1.3029671210906175
chr4	CC2D2A	15576603	15576624	0	22	16248	12486	16248	12464	0.0	1.303594351732991
chr4	CC2D2A	15576603	15577094	1428	492	16248	12486	14820	11994	2.902439024390244	1.2356178089044523
chr4	CC2D2A	15596143	15596207	304	65	16248	12486	15944	12421	4.676923076923077	1.2836325577650753
chr4	BST1	15704919	15704964	17166	46	35369	2878	18203	2832	373.17391304347825	6.427612994350283
chr4	BST1	15736052	15736131	1661	80	35369	2878	33708	2798	20.7625	12.047176554681915
chr4	CD38	15824880	15825016	0	137	9741	6865	9741	6728	0.0	1.4478299643281807
chr4	CD38	15824880	15824998	0	119	9741	6865	9741	6746	0.0	1.4439667951378594
chr4	LAP3	17582287	17582393	0	107	88004	3618	88004	3511	0.0	25.06522358302478
chr4	NCAPG	17815273	17815358	0	86	34074	4868	34074	4782	0.0	7.125470514429109
chr4	SLIT2	20525148	20525172	0	25	84528	9063	84528	9038	0.0	9.352511617614516
chr4	SLIT2	20489942	20489954	0	13	84528	9063	84528	9050	0.0	9.34011049723757
chr4	SLIT2	20490802	20490814	0	13	84528	9063	84528	9050	0.0	9.34011049723757
chr4	SLIT2	20573233	20573260	0	28	84528	9063	84528	9035	0.0	9.355617044825678
chr4	SLIT2	20554307	20554340	0	34	84528	9063	84528	9029	0.0	9.361834090153948
chr4	PACRGL	20707802	20707870	84	69	124873	7747	124789	7678	1.2173913043478262	16.2528002083876
chr4	PACRGL	20709682	20709773	0	92	124873	7747	124873	7655	0.0	16.312606139777923
chr4	PACRGL	20724807	20724888	0	82	124873	7747	124873	7665	0.0	16.29132420091324
chr4	PACRGL	20701757	20701884	0	128	124873	7747	124873	7619	0.0	16.389683685523035
chr4	PACRGL	20702140	20702221	2441	82	124873	7747	122432	7665	29.76829268292683	15.972863666014351
chr4	PACRGL	20700670	20700787	0	118	124873	7747	124873	7629	0.0	16.368200288373313
chr4	PACRGL	20713431	20713539	275	109	124873	7747	124598	7638	2.522935779816514	16.312909138517938
chr4	PACRGL	20701518	20701667	53	150	124873	7747	124820	7597	0.35333333333333333	16.430169803869948
chr4	PACRGL	20702650	20702740	255	91	124873	7747	124618	7656	2.802197802197802	16.277168234064785
chr4	PACRGL	20712787	20712922	422	136	124873	7747	124451	7611	3.1029411764705883	16.351464984890292
chr4	PACRGL	20716106	20716248	0	143	124873	7747	124873	7604	0.0	16.422014729089952
chr4	PACRGL	20701725	20701884	0	160	124873	7747	124873	7587	0.0	16.45881112429155
chr4	PACRGL	20701509	20701667	53	159	124873	7747	124820	7588	0.3333333333333333	16.449657353716393
chr4	PACRGL	20718815	20718976	0	162	124873	7747	124873	7585	0.0	16.463150955833882
chr4	AC097512.1	23083696	23083788	0	93	164	7737	164	7644	0.0	0.021454735740450027
chr4	AC097512.1	22999584	22999712	0	129	164	7737	164	7608	0.0	0.021556256572029444
chr4	AC097512.1	23032831	23032868	27	38	164	7737	137	7699	0.7105263157894737	0.017794518768671257
chr4	AC097512.1	23003149	23003243	0	95	164	7737	164	7642	0.0	0.021460350693535725
chr4	AC097512.1	23004836	23004928	0	93	164	7737	164	7644	0.0	0.021454735740450027
chr4	AC097512.1	23001413	23001537	0	125	164	7737	164	7612	0.0	0.021544929059379925
chr4	AC097512.1	23038003	23038097	0	95	164	7737	164	7642	0.0	0.021460350693535725
chr4	AC097512.1	23055838	23055915	0	78	164	7737	164	7659	0.0	0.02141271706489098
chr4	AC097512.1	23127177	23127246	0	70	164	7737	164	7667	0.0	0.0213903743315508
chr4	LINC02473	24665341	24665420	0	80	1530	2277	1530	2197	0.0	0.6964041875284479
chr4	SMIM20	25928312	25928369	0	58	2346	1617	2346	1559	0.0	1.5048107761385503
chr4	RBPJ	26320699	26320815	561	117	182912	9040	182351	8923	4.794871794871795	20.436064104000895
chr4	RBPJ	26429897	26430053	1275	157	182912	9040	181637	8883	8.121019108280255	20.447709107283575
chr4	RBPJ	26430418	26430522	7887	105	182912	9040	175025	8935	75.11428571428571	19.58869613878008
chr4	RBPJ	26362445	26362628	141	184	182912	9040	182771	8856	0.7663043478260869	20.638098464317977
chr4	RBPJ	26410041	26410292	0	252	182912	9040	182912	8788	0.0	20.813837050523443
chr4	STIM2	27007982	27008006	0	25	82272	8406	82272	8381	0.0	9.816489679035914
chr4	STIM2	27019399	27021068	11486	1670	82272	8406	70786	6736	6.877844311377245	10.508610451306414
chr4	STIM2	27021000	27021068	120	69	82272	8406	82152	8337	1.7391304347826086	9.853904282115868
chr4	STIM2	27021493	27021612	84	120	82272	8406	82188	8286	0.7	9.918899348298334
chr4	LINC02364	29003482	29003638	0	157	0	1744	0	1587	0.0	0.0
chr4	LINC02364	29012714	29012792	0	79	0	1744	0	1665	0.0	0.0
chr4	LINC02364	29000783	29000865	0	83	0	1744	0	1661	0.0	0.0
chr4	LINC02364	29005889	29006131	0	243	0	1744	0	1501	0.0	0.0
chr4	LINC02364	29008673	29008747	0	75	0	1744	0	1669	0.0	0.0
chr4	LINC02364	29012893	29013024	0	132	0	1744	0	1612	0.0	0.0
chr4	LINC02472	29273183	29273269	0	87	51	1037	51	950	0.0	0.05368421052631579
chr4	LINC02472	29215287	29215486	51	200	51	1037	0	837	0.255	0.0
chr4	PCDH7	30869021	30869087	0	67	28468	9622	28468	9555	0.0	2.979382522239665
chr4	LINC02501	31522290	31522439	0	150	0	1163	0	1013	0.0	0.0
chr4	LINC02501	31509138	31509309	0	172	0	1163	0	991	0.0	0.0
chr4	LINC02506	32146052	32146267	0	216	42	2011	42	1795	0.0	0.0233983286908078
chr4	LINC02506	32104854	32104915	0	62	42	2011	42	1949	0.0	0.021549512570549
chr4	LINC02506	32157955	32158081	42	127	42	2011	0	1884	0.33070866141732286	0.0
chr4	LINC02506	32155313	32155406	0	94	42	2011	42	1917	0.0	0.02190923317683881
chr4	AC016687.2	33881581	33881754	0	174	3977	7125	3977	6951	0.0	0.5721478923895842
chr4	AC016687.2	33884309	33884379	0	71	3977	7125	3977	7054	0.0	0.5637935922880635
chr4	AC016687.2	33892135	33892245	0	111	3977	7125	3977	7014	0.0	0.5670088394639293
chr4	AC016687.2	33974210	33974539	0	330	3977	7125	3977	6795	0.0	0.5852832965415747
chr4	AC016687.2	33890305	33890367	0	63	3977	7125	3977	7062	0.0	0.5631549136222034
chr4	DTHD1	36283975	36284591	0	617	0	7392	0	6775	0.0	0.0
chr4	AL136537.1	37100714	37100904	0	191	0	3825	0	3634	0.0	0.0
chr4	AL136537.1	37099033	37099746	0	714	0	3825	0	3111	0.0	0.0
chr4	AL136537.1	37077131	37077250	0	120	0	3825	0	3705	0.0	0.0
chr4	PGM2	37844363	37844553	0	191	64085	3602	64085	3411	0.0	18.78774552917033
chr4	PGM2	37839516	37839683	48	168	64085	3602	64037	3434	0.2857142857142857	18.647932440302853
chr4	TBC1D1	38051898	38052060	459	163	72738	8862	72279	8699	2.815950920245399	8.30888607885964
chr4	TBC1D1	38053105	38053225	0	121	72738	8862	72738	8741	0.0	8.321473515616063
chr4	TBC1D1	38060619	38060658	0	40	72738	8862	72738	8822	0.0	8.245069145318523
chr4	LINC02278	38565836	38566029	0	194	0	2048	0	1854	0.0	0.0
chr4	FAM114A1	38878070	38878426	510	357	114066	4744	113556	4387	1.4285714285714286	25.88465922042398
chr4	FAM114A1	38868397	38868546	0	150	114066	4744	114066	4594	0.0	24.82934262080975
chr4	KLHL5	39062558	39063035	0	478	7127	5158	7127	4680	0.0	1.5228632478632478
chr4	KLHL5	39075964	39076147	0	184	7127	5158	7127	4974	0.0	1.4328508242862887
chr4	KLHL5	39063571	39063797	766	227	7127	5158	6361	4931	3.3744493392070485	1.2900020279862097
chr4	WDR19	39185725	39185817	0	93	37645	8810	37645	8717	0.0	4.318572903521853
chr4	WDR19	39186538	39186604	0	67	37645	8810	37645	8743	0.0	4.305730298524534
chr4	WDR19	39194543	39194659	0	117	37645	8810	37645	8693	0.0	4.330495801219372
chr4	WDR19	39199477	39199593	0	117	37645	8810	37645	8693	0.0	4.330495801219372
chr4	LIAS	39463524	39463605	0	82	222853	9122	222853	9040	0.0	24.65188053097345
chr4	LIAS	39465045	39465202	14463	158	222853	9122	208390	8964	91.5379746835443	23.247434181169123
chr4	LIAS	39467517	39468427	10201	911	222853	9122	212652	8211	11.197585071350165	25.898428936792108
chr4	LIAS	39462195	39462289	0	95	222853	9122	222853	9027	0.0	24.68738229755179
chr4	LIAS	39468118	39468427	2006	310	222853	9122	220847	8812	6.470967741935484	25.06207444394008
chr4	LIAS	39473099	39473211	0	113	222853	9122	222853	9009	0.0	24.736707736707736
chr4	LIAS	39467517	39467646	0	130	222853	9122	222853	8992	0.0	24.783474199288257
chr4	LIAS	39466016	39466117	3003	102	222853	9122	219850	9020	29.441176470588236	24.373614190687363
chr4	LIAS	39465284	39465342	1099	59	222853	9122	221754	9063	18.627118644067796	24.468056934789804
chr4	AC108471.2	39650376	39650454	0	79	13909	3742	13909	3663	0.0	3.7971607971607972
chr4	AC108471.2	39654386	39654509	1468	124	13909	3742	12441	3618	11.838709677419354	3.4386401326699834
chr4	UBE2K	39737419	39737513	51	95	567672	5157	567621	5062	0.5368421052631579	112.13374160410905
chr4	UBE2K	39777681	39777810	663	130	567672	5157	567009	5027	5.1	112.79271931569525
chr4	UBE2K	39745751	39745810	0	60	567672	5157	567672	5097	0.0	111.3737492642731
chr4	UBE2K	39755656	39755739	24	84	567672	5157	567648	5073	0.2857142857142857	111.89591957421644
chr4	N4BP2	40097226	40097569	0	344	17819	9830	17819	9486	0.0	1.8784524562513176
chr4	N4BP2	40100035	40100126	1248	92	17819	9830	16571	9738	13.565217391304348	1.701684124050113
chr4	RHOH	40235176	40235358	0	183	2040	6620	2040	6437	0.0	0.31691781885971726
chr4	RHOH	40197100	40197300	0	201	2040	6620	2040	6419	0.0	0.31780651191774417
chr4	RHOH	40197120	40197300	0	181	2040	6620	2040	6439	0.0	0.3168193818915981
chr4	RHOH	40235192	40235358	0	167	2040	6620	2040	6453	0.0	0.31613203161320313
chr4	RHOH	40200511	40200565	0	55	2040	6620	2040	6565	0.0	0.31073876618431073
chr4	RHOH	40212663	40212791	765	129	2040	6620	1275	6491	5.930232558139535	0.19642582036666154
chr4	RHOH	40218146	40218298	0	153	2040	6620	2040	6467	0.0	0.31544765733725066
chr4	NSUN7	40790601	40790745	0	145	3871	5892	3871	5747	0.0	0.6735688185140073
chr4	NSUN7	40807060	40807184	0	125	3871	5892	3871	5767	0.0	0.6712328767123288
chr4	UCHL1	41261875	41261923	84	49	11536	2218	11452	2169	1.7142857142857142	5.279852466574458
chr4	LIMCH1	41524408	41524478	0	71	0	10455	0	10384	0.0	0.0
chr4	LIMCH1	41603874	41603905	0	32	0	10455	0	10423	0.0	0.0
chr4	LIMCH1	41670717	41670792	0	76	0	10455	0	10379	0.0	0.0
chr4	LIMCH1	41494535	41494606	0	72	0	10455	0	10383	0.0	0.0
chr4	LIMCH1	41638931	41638967	0	37	0	10455	0	10418	0.0	0.0
chr4	LIMCH1	41687839	41687917	0	79	0	10455	0	10376	0.0	0.0
chr4	TMEM33	41939195	41939383	0	189	236591	7774	236591	7585	0.0	31.191957811470008
chr4	TMEM33	41939720	41939828	0	109	236591	7774	236591	7665	0.0	30.866405740378344
chr4	SLC30A9	42018388	42018505	0	118	154747	7219	154747	7101	0.0	21.792282777073652
chr4	SLC30A9	42070525	42070691	255	167	154747	7219	154492	7052	1.526946107784431	21.90754395916052
chr4	AC080132.1	43778527	43778731	0	205	0	10484	0	10279	0.0	0.0
chr4	GUF1	44680440	44680552	0	113	43025	4473	43025	4360	0.0	9.868119266055047
chr4	GUF1	44695614	44695734	54	121	43025	4473	42971	4352	0.4462809917355372	9.873851102941176
chr4	GABRB1	47032416	47032484	0	69	0	2963	0	2894	0.0	0.0
chr4	AC107068.2	47875176	47875331	0	156	51	2267	51	2111	0.0	0.024159166271909047
chr4	NIPAL1	48032992	48033083	0	92	172	3240	172	3148	0.0	0.054637865311308764
chr4	SLAIN2	48394575	48394653	147	79	301013	6316	300866	6237	1.860759493670886	48.23889690556357
chr4	SLAIN2	48387365	48387466	0	102	301013	6316	301013	6214	0.0	48.44110074026392
chr4	OCIAD1	48833400	48833481	1761	82	251287	3485	249526	3403	21.475609756097562	73.32530120481928
chr4	OCIAD1	48857212	48857365	595	154	251287	3485	250692	3331	3.8636363636363638	75.26028219753827
chr4	OCIAD1	48831226	48831496	0	271	251287	3485	251287	3214	0.0	78.18512756689483
chr4	OCIAD1	48831226	48831398	0	173	251287	3485	251287	3312	0.0	75.87167874396135
chr4	OCIAD1	48831226	48831249	0	24	251287	3485	251287	3461	0.0	72.6053163825484
chr4	OCIAD1	48832619	48832682	0	64	251287	3485	251287	3421	0.0	73.45425314235604
chr4	OCIAD1	48831226	48831433	0	208	251287	3485	251287	3277	0.0	76.68202624351541
chr4	OCIAD1	48837159	48837252	0	94	251287	3485	251287	3391	0.0	74.10409908581539
chr4	OCIAD1	48832619	48832761	0	143	251287	3485	251287	3342	0.0	75.19060442848594
chr4	DCUN1D4	51863669	51863709	0	41	0	6539	0	6498	0.0	0.0
chr4	DCUN1D4	51891759	51891851	0	93	0	6539	0	6446	0.0	0.0
chr4	DCUN1D4	51860542	51860663	0	122	0	6539	0	6417	0.0	0.0
chr4	DCUN1D4	51848204	51848367	0	164	0	6539	0	6375	0.0	0.0
chr4	DCUN1D4	51899269	51899378	0	110	0	6539	0	6429	0.0	0.0
chr4	DCUN1D4	51911069	51911174	0	106	0	6539	0	6433	0.0	0.0
chr4	DCUN1D4	51908919	51908975	0	57	0	6539	0	6482	0.0	0.0
chr4	DCUN1D4	51887122	51887244	0	123	0	6539	0	6416	0.0	0.0
chr4	DCUN1D4	51905188	51905320	0	133	0	6539	0	6406	0.0	0.0
chr4	SPATA18	52060418	52060524	0	107	0	4988	0	4881	0.0	0.0
chr4	SPATA18	52069820	52069916	0	97	0	4988	0	4891	0.0	0.0
chr4	SPATA18	52062219	52062332	0	114	0	4988	0	4874	0.0	0.0
chr4	DANCR	52712823	52712959	0	137	12541	7739	12541	7602	0.0	1.6496974480399895
chr4	DANCR	52713493	52713542	0	50	12541	7739	12541	7689	0.0	1.6310313434776955
chr4	DANCR	52714198	52714238	0	41	12541	7739	12541	7698	0.0	1.6291244479085476
chr4	DANCR	52713493	52713702	102	210	12541	7739	12439	7529	0.4857142857142857	1.6521450391818302
chr4	FIP1L1	53379072	53379117	0	46	12830	4818	12830	4772	0.0	2.6886001676445934
chr4	FIP1L1	53391429	53391498	0	70	12830	4818	12830	4748	0.0	2.702190395956192
chr4	FIP1L1	53414614	53414722	0	109	12830	4818	12830	4709	0.0	2.7245699723932892
chr4	FIP1L1	53440581	53440608	0	28	12830	4818	12830	4790	0.0	2.6784968684759916
chr4	PDGFRA	54261094	54261412	1057	319	23035	8586	21978	8267	3.3134796238244513	2.6585218337970242
chr4	PDGFRA	54240037	54240115	0	79	23035	8586	23035	8507	0.0	2.7077700717056543
chr4	PDGFRA	54278818	54278971	0	154	23035	8586	23035	8432	0.0	2.7318548387096775
chr4	SRD5A3	55367587	55367722	0	136	51	7681	51	7545	0.0	0.006759443339960238
chr4	SRD5A3	55364073	55364271	0	199	51	7681	51	7482	0.0	0.00681635926222935
chr4	SRD5A3	55361116	55361250	0	135	51	7681	51	7546	0.0	0.006758547574874105
chr4	TMEM165	55403235	55403338	0	104	134	6798	134	6694	0.0	0.02001792650134449
chr4	EXOC1	55888887	55888932	17	46	68	5360	51	5314	0.3695652173913043	0.00959729017689123
chr4	CRACD	56297839	56297996	984	158	12988	6766	12004	6608	6.227848101265823	1.8165859564164648
chr4	CRACD	56196343	56196427	0	85	12988	6766	12988	6681	0.0	1.9440203562340967
chr4	CRACD	56324103	56324266	0	164	12988	6766	12988	6602	0.0	1.9672826416237503
chr4	CRACD	56301225	56301247	168	23	12988	6766	12820	6743	7.304347826086956	1.9012309061248702
chr4	AC068620.3	56414232	56414316	0	85	3876	2281	3876	2196	0.0	1.7650273224043715
chr4	PAICS	56446356	56446377	0	22	10980	7527	10980	7505	0.0	1.4630246502331778
chr4	SRP72	56483138	56483270	0	133	6042	4758	6042	4625	0.0	1.3063783783783784
chr4	ARL9	56511184	56511347	0	164	0	2259	0	2095	0.0	0.0
chr4	REST	56919786	56919870	0	85	3672	7466	3672	7381	0.0	0.49749356455764804
chr4	REST	56927614	56927664	0	51	3672	7466	3672	7415	0.0	0.4952124072825354
chr4	POLR2B	56990747	56990898	0	152	515	5303	515	5151	0.0	0.0999805862939235
chr4	POLR2B	56985279	56985457	0	179	515	5303	515	5124	0.0	0.10050741608118657
chr4	POLR2B	56985259	56985457	0	199	515	5303	515	5104	0.0	0.1009012539184953
chr4	IGFBP7-AS1	57188169	57188319	0	151	13558	3695	13558	3544	0.0	3.8256207674943568
chr4	IGFBP7-AS1	57201785	57201820	0	36	13558	3695	13558	3659	0.0	3.705383984695272
chr4	LINC02380	57426978	57427109	0	132	0	2890	0	2758	0.0	0.0
chr4	LINC02380	57462373	57462418	0	46	0	2890	0	2844	0.0	0.0
chr4	AC013724.1	57492439	57492672	0	234	0	1716	0	1482	0.0	0.0
chr4	LINC02496	60788333	60788452	0	120	0	1318	0	1198	0.0	0.0
chr4	ADGRL3	61912718	61912757	0	40	0	14022	0	13982	0.0	0.0
chr4	ADGRL3	62028854	62028881	0	28	0	14022	0	13994	0.0	0.0
chr4	ADGRL3	62068165	62068217	0	53	0	14022	0	13969	0.0	0.0
chr4	ADGRL3	61517314	61517518	0	205	0	14022	0	13817	0.0	0.0
chr4	ADGRL3	62063504	62063633	0	130	0	14022	0	13892	0.0	0.0
chr4	UBA6-AS1	67720421	67721051	0	631	0	13708	0	13077	0.0	0.0
chr4	UBA6-AS1	68077278	68077421	0	144	0	13708	0	13564	0.0	0.0
chr4	UBA6-AS1	67754158	67754240	0	83	0	13708	0	13625	0.0	0.0
chr4	UBA6-AS1	67716922	67717021	0	100	0	13708	0	13608	0.0	0.0
chr4	UBA6-AS1	68077462	68077630	0	169	0	13708	0	13539	0.0	0.0
chr4	TMPRSS11E	68471459	68471623	0	165	6018	2134	6018	1969	0.0	3.0563737938039615
chr4	UGT2B7	69107174	69107262	0	89	0	2268	0	2179	0.0	0.0
chr4	UGT2B7	69108102	69108322	0	221	0	2268	0	2047	0.0	0.0
chr4	AC111000.4	69201171	69201284	2346	114	51627	3031	49281	2917	20.57894736842105	16.89441206719232
chr4	CSN1S1	69937120	69937144	0	25	41	1014	41	989	0.0	0.041456016177957536
chr4	CSN1S1	69940020	69940044	0	25	41	1014	41	989	0.0	0.041456016177957536
chr4	STATH	69999779	69999809	0	31	0	2054	0	2023	0.0	0.0
chr4	HTN3	70032077	70032107	0	31	0	2041	0	2010	0.0	0.0
chr4	CSN1S2AP	70071229	70071253	0	25	0	899	0	874	0.0	0.0
chr4	CSN1S2AP	70073004	70073031	0	28	0	899	0	871	0.0	0.0
chr4	PRR27	70154745	70154791	0	47	0	4239	0	4192	0.0	0.0
chr4	ODAM	70196691	70196733	0	43	0	1574	0	1531	0.0	0.0
chr4	ODAM	70201453	70201501	0	49	0	1574	0	1525	0.0	0.0
chr4	ODAM	70200101	70200149	0	49	0	1574	0	1525	0.0	0.0
chr4	OPRPN	70399270	70399336	0	67	31	1052	31	985	0.0	0.03147208121827411
chr4	MUC7	70474006	70474075	0	70	0	2802	0	2732	0.0	0.0
chr4	RUFY3	70804347	70804416	0	70	230	8987	230	8917	0.0	0.02579342828305484
chr4	RUFY3	70741626	70741680	0	55	230	8987	230	8932	0.0	0.02575011195700851
chr4	RUFY3	70802955	70802983	0	29	230	8987	230	8958	0.0	0.02567537396740344
chr4	MOB1B	70942822	70942882	0	61	0	8811	0	8750	0.0	0.0
chr4	MOB1B	70950699	70950811	0	113	0	8811	0	8698	0.0	0.0
chr4	DCK	71025815	71025931	0	117	0	2944	0	2827	0.0	0.0
chr4	DCK	71028622	71028719	0	98	0	2944	0	2846	0.0	0.0
chr4	SLC4A4	71563792	71563889	0	98	24298	8798	24298	8700	0.0	2.7928735632183908
chr4	NPFFR2	72128584	72128919	0	336	51	2366	51	2030	0.0	0.025123152709359605
chr4	NPFFR2	72068912	72069023	0	112	51	2366	51	2254	0.0	0.022626441881100266
chr4	ALB	73405115	73405173	0	59	0	3401	0	3342	0.0	0.0
chr4	ALB	73408593	73408805	0	213	0	3401	0	3188	0.0	0.0
chr4	ALB	73417530	73417669	0	140	0	3401	0	3261	0.0	0.0
chr4	ALB	73420253	73420321	0	69	0	3401	0	3332	0.0	0.0
chr4	ALB	73405120	73405173	0	54	0	3401	0	3347	0.0	0.0
chr4	ALB	73406628	73406761	0	134	0	3401	0	3267	0.0	0.0
chr4	AFP	73434469	73434610	0	142	0	3219	0	3077	0.0	0.0
chr4	AFP	73455235	73455290	0	56	0	3219	0	3163	0.0	0.0
chr4	MTHFD2L	74143392	74143467	0	76	4814	8834	4814	8758	0.0	0.5496688741721855
chr4	MTHFD2L	74160054	74160088	350	35	4814	8834	4464	8799	10.0	0.5073303784520968
chr4	EPGN	74309092	74309182	0	91	0	3305	0	3214	0.0	0.0
chr4	EPGN	74313017	74313170	0	154	0	3305	0	3151	0.0	0.0
chr4	EPGN	74314128	74314326	0	199	0	3305	0	3106	0.0	0.0
chr4	EPGN	74309092	74309155	0	64	0	3305	0	3241	0.0	0.0
chr4	EPGN	74313017	74313044	0	28	0	3305	0	3277	0.0	0.0
chr4	AREG	74452543	74452655	0	113	153	1648	153	1535	0.0	0.0996742671009772
chr4	PARM1	75012424	75013150	0	727	7810	5038	7810	4311	0.0	1.8116446300162374
chr4	AC096759.2	75407894	75408012	0	119	0	804	0	685	0.0	0.0
chr4	THAP6	75514869	75514991	0	123	0	7138	0	7015	0.0	0.0
chr4	THAP6	75515432	75515532	0	101	0	7138	0	7037	0.0	0.0
chr4	THAP6	75521735	75521861	0	127	0	7138	0	7011	0.0	0.0
chr4	THAP6	75539858	75539959	0	102	0	7138	0	7036	0.0	0.0
chr4	ODAPH	75563209	75563345	0	137	0	2019	0	1882	0.0	0.0
chr4	ODAPH	75556540	75556584	0	45	0	2019	0	1974	0.0	0.0
chr4	USO1	75760593	75760605	0	13	0	4630	0	4617	0.0	0.0
chr4	USO1	75795335	75795356	0	22	0	4630	0	4608	0.0	0.0
chr4	ART3	76058591	76058625	0	35	0	3298	0	3263	0.0	0.0
chr4	ART3	76097643	76097676	0	34	0	3298	0	3264	0.0	0.0
chr4	ART3	76081823	76082535	0	713	0	3298	0	2585	0.0	0.0
chr4	ART3	76057989	76058070	0	82	0	3298	0	3216	0.0	0.0
chr4	ART3	76104596	76104629	0	34	0	3298	0	3264	0.0	0.0
chr4	ART3	76107760	76107793	0	34	0	3298	0	3264	0.0	0.0
chr4	ART3	76105521	76105554	0	34	0	3298	0	3264	0.0	0.0
chr4	FAM47E	76217578	76217688	0	111	51	3721	51	3610	0.0	0.014127423822714681
chr4	FAM47E	76268659	76268813	0	155	51	3721	51	3566	0.0	0.01430173864273696
chr4	FAM47E-STBD1	76271567	76271768	0	202	0	3250	0	3048	0.0	0.0
chr4	FAM47E	76256177	76256523	0	347	51	3721	51	3374	0.0	0.015115589804386485
chr4	FAM47E	76268659	76268768	0	110	51	3721	51	3611	0.0	0.014123511492661313
chr4	FAM47E-STBD1	76278068	76278224	0	157	0	3250	0	3093	0.0	0.0
chr4	FAM47E-STBD1	76289901	76290060	0	160	0	3250	0	3090	0.0	0.0
chr4	SHROOM3	76738760	76741926	51	3167	36447	13852	36396	10685	0.016103568045468898	3.4062704726251756
chr4	SEPTIN11	77036769	77036837	0	69	20319	7910	20319	7841	0.0	2.591378650682311
chr4	SEPTIN11	76987808	76987870	0	63	20319	7910	20319	7847	0.0	2.58939722186823
chr4	SEPTIN11	76995780	76995938	0	159	20319	7910	20319	7751	0.0	2.621468197651916
chr4	SEPTIN11	77036772	77036837	0	66	20319	7910	20319	7844	0.0	2.5903875573686896
chr4	MRPL1	77871743	77871855	0	113	15396	1636	15396	1523	0.0	10.108995403808272
chr4	MRPL1	77949796	77949878	8878	83	15396	1636	6518	1553	106.96385542168674	4.19703799098519
chr4	FRAS1	78421862	78422000	0	139	4743	19284	4743	19145	0.0	0.24774092452337426
chr4	ANXA3	78571032	78571173	0	142	0	4911	0	4769	0.0	0.0
chr4	ANXA3	78573179	78573267	0	89	0	4911	0	4822	0.0	0.0
chr4	ANXA3	78552184	78552345	0	162	0	4911	0	4749	0.0	0.0
chr4	LINC01094	78649600	78649709	0	110	7306	5306	7306	5196	0.0	1.4060816012317168
chr4	LINC01094	78673342	78673414	0	73	7306	5306	7306	5233	0.0	1.396139881521116
chr4	LINC01094	78662917	78663011	0	95	7306	5306	7306	5211	0.0	1.4020341585108425
chr4	LINC01094	78648392	78648475	0	84	7306	5306	7306	5222	0.0	1.3990808119494447
chr4	LINC01094	78662917	78662972	0	56	7306	5306	7306	5250	0.0	1.3916190476190475
chr4	BMP2K	78860035	78860079	0	45	17141	9955	17141	9910	0.0	1.7296670030272452
chr4	LINC01088	78972999	78973052	0	54	431	10645	431	10591	0.0	0.040694929657256164
chr4	LINC01088	79195835	79195932	0	98	431	10645	431	10547	0.0	0.04086470086280459
chr4	LINC01088	79307063	79307231	0	169	431	10645	431	10476	0.0	0.041141657121038566
chr4	LINC00989	79513784	79513902	0	119	0	6191	0	6072	0.0	0.0
chr4	PRDM8	80196012	80196124	0	113	38	4602	38	4489	0.0	0.008465137001559367
chr4	FGF5	80274908	80275012	0	105	0	5786	0	5681	0.0	0.0
chr4	CFAP299	80944809	80944939	0	131	306	4474	306	4343	0.0	0.07045820861155883
chr4	CFAP299	80639717	80639835	0	119	306	4474	306	4355	0.0	0.07026406429391505
chr4	CFAP299	80420213	80420323	0	111	306	4474	306	4363	0.0	0.07013522805409123
chr4	CFAP299	80608332	80608383	0	52	306	4474	306	4422	0.0	0.06919945725915876
chr4	PRKG2-AS1	81172073	81172100	0	28	204	874	204	846	0.0	0.24113475177304963
chr4	PRKG2-AS1	81175997	81176037	0	41	204	874	204	833	0.0	0.24489795918367346
chr4	ENOPH1	82451042	82451245	0	204	0	2031	0	1827	0.0	0.0
chr4	THAP9	82905860	82905926	0	67	0	4341	0	4274	0.0	0.0
chr4	THAP9	82910696	82910811	0	116	0	4341	0	4225	0.0	0.0
chr4	COPS4	83045625	83045705	0	81	1020	3579	1020	3498	0.0	0.2915951972555746
chr4	COPS4	83068437	83068522	0	86	1020	3579	1020	3493	0.0	0.29201259662181506
chr4	COPS4	83045596	83045705	0	110	1020	3579	1020	3469	0.0	0.29403286249639665
chr4	COPS4	83065059	83065155	0	97	1020	3579	1020	3482	0.0	0.2929350947731189
chr4	COPS4	83073205	83073353	0	149	1020	3579	1020	3430	0.0	0.29737609329446063
chr4	MRPS18C	83459739	83459797	0	59	204	3399	204	3340	0.0	0.06107784431137724
chr4	MRPS18C	83458345	83458429	204	85	204	3399	0	3314	2.4	0.0
chr4	CDS1	84604242	84604370	0	129	0	4322	0	4193	0.0	0.0
chr4	WDFY3-AS2	84969724	84969876	0	153	0	8359	0	8206	0.0	0.0
chr4	WDFY3-AS2	85000690	85000765	0	76	0	8359	0	8283	0.0	0.0
chr4	WDFY3-AS2	85005473	85005568	0	96	0	8359	0	8263	0.0	0.0
chr4	WDFY3-AS2	84969775	84969876	0	102	0	8359	0	8257	0.0	0.0
chr4	WDFY3-AS2	84967609	84967640	0	32	0	8359	0	8327	0.0	0.0
chr4	WDFY3-AS2	85002537	85002737	0	201	0	8359	0	8158	0.0	0.0
chr4	ARHGAP24	85923647	85923770	0	124	375	7888	375	7764	0.0	0.04829984544049459
chr4	PTPN13	86753008	86753065	0	58	1623	9546	1623	9488	0.0	0.17105817875210794
chr4	AFF1	87046165	87046286	0	122	204	10993	204	10871	0.0	0.018765522950970472
chr4	AFF1	87089983	87090070	0	88	204	10993	204	10905	0.0	0.018707015130674003
chr4	NUDT9	87438276	87438372	0	97	0	3188	0	3091	0.0	0.0
chr4	NUDT9	87449141	87449253	0	113	0	3188	0	3075	0.0	0.0
chr4	NUDT9	87434980	87435220	0	241	0	3188	0	2947	0.0	0.0
chr4	DMP1	87659430	87659478	0	49	306	2715	306	2666	0.0	0.11477869467366841
chr4	MEPE	87839684	87839777	0	94	44311	2485	44311	2391	0.0	18.53241321622752
chr4	MEPE	87837638	87837774	0	137	44311	2485	44311	2348	0.0	18.871805792163542
chr4	MEPE	87839926	87840032	0	107	44311	2485	44311	2378	0.0	18.63372582001682
chr4	MEPE	87839926	87840054	0	129	44311	2485	44311	2356	0.0	18.807724957555177
chr4	SPP1	87980045	87980126	0	82	0	2329	0	2247	0.0	0.0
chr4	SPP1	87980392	87980434	0	43	0	2329	0	2286	0.0	0.0
chr4	PKD2	88046641	88046870	0	230	28497	5545	28497	5315	0.0	5.361618062088429
chr4	PKD2	88057982	88058103	3780	122	28497	5545	24717	5423	30.983606557377048	4.557809330628803
chr4	PPM1K-DT	88319330	88319425	0	96	830	2598	830	2502	0.0	0.3317346123101519
chr4	PPM1K-DT	88311795	88311871	0	77	830	2598	830	2521	0.0	0.32923443078143594
chr4	PPM1K-DT	88325100	88325688	0	589	830	2598	830	2009	0.0	0.4131408661025386
chr4	HERC6	88424594	88424702	0	109	22269	5803	22269	5694	0.0	3.910958904109589
chr4	HERC6	88396850	88396987	0	138	22269	5803	22269	5665	0.0	3.9309796999117386
chr4	HERC6	88404875	88404997	0	123	22269	5803	22269	5680	0.0	3.920598591549296
chr4	HERC3	88597949	88598087	0	139	0	6999	0	6860	0.0	0.0
chr4	HERC3	88667891	88668081	0	191	0	6999	0	6808	0.0	0.0
chr4	HERC3	88676217	88676241	0	25	0	6999	0	6974	0.0	0.0
chr4	HERC3	88597968	88598087	0	120	0	6999	0	6879	0.0	0.0
chr4	FAM13A-AS1	88722150	88722344	0	195	408	9133	408	8938	0.0	0.04564779592750056
chr4	CCSER1	90663844	90663935	0	92	561	10502	561	10410	0.0	0.05389048991354467
chr4	CCSER1	90325595	90325707	0	113	561	10502	561	10389	0.0	0.05399942246606988
chr4	CCSER1	90403923	90404019	0	97	561	10502	561	10405	0.0	0.05391638635271504
chr4	CCSER1	90727203	90727297	0	95	561	10502	561	10407	0.0	0.053906024791006056
chr4	CCSER1	90693388	90693498	0	111	561	10502	561	10391	0.0	0.05398902896737561
chr4	CCSER1	90918229	90918327	0	99	561	10502	561	10403	0.0	0.05392675189849082
chr4	CCSER1	90911254	90911357	0	104	561	10502	561	10398	0.0	0.05395268320830929
chr4	CCSER1	91283808	91283854	0	47	561	10502	561	10455	0.0	0.05365853658536585
chr4	GRID2	93084994	93085279	0	286	0	10642	0	10356	0.0	0.0
chr4	SMARCAD1	94248480	94248553	0	74	0	6342	0	6268	0.0	0.0
chr4	SMARCAD1	94213034	94213152	0	119	0	6342	0	6223	0.0	0.0
chr4	PDLIM5	94523723	94523875	0	153	154	10424	154	10271	0.0	0.014993671502287996
chr4	PDLIM5	94584985	94585003	0	19	154	10424	154	10405	0.0	0.014800576645843345
chr4	PDLIM5	94575615	94576034	0	420	154	10424	154	10004	0.0	0.015393842463014795
chr4	PDLIM5	94575942	94576034	0	93	154	10424	154	10331	0.0	0.01490659181105411
chr4	PDLIM5	94656817	94656911	0	95	154	10424	154	10329	0.0	0.014909478168264111
chr4	STPG2-AS1	97463544	97463592	0	49	0	4117	0	4068	0.0	0.0
chr4	RAP1GDS1	98343138	98343261	0	124	0	5439	0	5315	0.0	0.0
chr4	RAP1GDS1	98352475	98352601	0	127	0	5439	0	5312	0.0	0.0
chr4	RAP1GDS1	98379016	98379163	0	148	0	5439	0	5291	0.0	0.0
chr4	RAP1GDS1	98404476	98404602	0	127	0	5439	0	5312	0.0	0.0
chr4	RAP1GDS1	98296917	98296990	0	74	0	5439	0	5365	0.0	0.0
chr4	RAP1GDS1	98391951	98392080	0	130	0	5439	0	5309	0.0	0.0
chr4	RAP1GDS1	98343138	98343319	0	182	0	5439	0	5257	0.0	0.0
chr4	METAP1	99037934	99037941	0	8	0	3921	0	3913	0.0	0.0
chr4	METAP1	99005768	99005866	0	99	0	3921	0	3822	0.0	0.0
chr4	METAP1	99045178	99045310	0	133	0	3921	0	3788	0.0	0.0
chr4	METAP1	99048732	99048876	0	145	0	3921	0	3776	0.0	0.0
chr4	METAP1	99005768	99005870	0	103	0	3921	0	3818	0.0	0.0
chr4	METAP1	99036042	99036089	0	48	0	3921	0	3873	0.0	0.0
chr4	METAP1	99031507	99031662	0	156	0	3921	0	3765	0.0	0.0
chr4	METAP1	99037766	99037941	0	176	0	3921	0	3745	0.0	0.0
chr4	AP002026.1	99188644	99188855	0	212	4489	7378	4489	7166	0.0	0.6264303656154061
chr4	AP002026.1	99254373	99254439	0	67	4489	7378	4489	7311	0.0	0.6140062918889345
chr4	C4ORF17	99535963	99536156	0	194	0	3264	0	3070	0.0	0.0
chr4	MTTP	99574808	99574970	722	163	3558	5317	2836	5154	4.429447852760736	0.5502522312766783
chr4	MTTP	99570699	99570865	0	167	3558	5317	3558	5150	0.0	0.690873786407767
chr4	MTTP	99570703	99570865	0	163	3558	5317	3558	5154	0.0	0.6903376018626309
chr4	DAPP1	99853217	99853348	0	132	1735	4600	1735	4468	0.0	0.38831692032229187
chr4	DAPP1	99866556	99866618	0	63	1735	4600	1735	4537	0.0	0.38241128499008153
chr4	H2AZ1-DT	100007901	100008231	0	331	52261	4875	52261	4544	0.0	11.501100352112676
chr4	H2AZ1-DT	100024938	100025080	0	143	52261	4875	52261	4732	0.0	11.044167371090449
chr4	BANK1	101829807	101830206	0	400	11208	6171	11208	5771	0.0	1.942124415179345
chr4	NFKB1	102510879	102510949	0	71	0	5107	0	5036	0.0	0.0
chr4	NFKB1	102596830	102596872	0	43	0	5107	0	5064	0.0	0.0
chr4	NFKB1	102582572	102582634	0	63	0	5107	0	5044	0.0	0.0
chr4	CISD2	102882791	102882873	0	83	0	6358	0	6275	0.0	0.0
chr4	CISD2	102882770	102882873	0	104	0	6358	0	6254	0.0	0.0
chr4	LINC02428	103343091	103343235	0	145	0	3869	0	3724	0.0	0.0
chr4	LINC02428	103425054	103425185	0	132	0	3869	0	3737	0.0	0.0
chr4	LINC02428	103437717	103437842	0	126	0	3869	0	3743	0.0	0.0
chr4	LINC02428	103438706	103438763	0	58	0	3869	0	3811	0.0	0.0
chr4	AC105460.2	103569300	103569402	0	103	0	933	0	830	0.0	0.0
chr4	AC096577.1	104943523	104943645	0	123	0	1964	0	1841	0.0	0.0
chr4	AC096577.1	104923610	104923825	0	216	0	1964	0	1748	0.0	0.0
chr4	TET2	105190359	105190486	0	128	0	12501	0	12373	0.0	0.0
chr4	TET2	105241338	105241429	0	92	0	12501	0	12409	0.0	0.0
chr4	TET2	105190359	105190505	0	147	0	12501	0	12354	0.0	0.0
chr4	NPNT	105912187	105912238	0	52	51	4548	51	4496	0.0	0.011343416370106761
chr4	NPNT	105958470	105958557	0	88	51	4548	51	4460	0.0	0.011434977578475336
chr4	NPNT	105932613	105932703	0	91	51	4548	51	4457	0.0	0.01144267444469374
chr4	NPNT	105967187	105967444	0	258	51	4548	51	4290	0.0	0.011888111888111888
chr4	AIMP1	106320865	106321451	5089	587	107291	8611	102202	8024	8.669505962521296	12.73703888334995
chr4	AIMP1	106324984	106325118	421	135	107291	8611	106870	8476	3.1185185185185187	12.608541764983483
chr4	AIMP1	106320797	106320889	1516	93	107291	8611	105775	8518	16.301075268817204	12.41782108476168
chr4	AIMP1	106338779	106338965	0	187	107291	8611	107291	8424	0.0	12.736348528015196
chr4	AIMP1	106321176	106321451	4182	276	107291	8611	103109	8335	15.152173913043478	12.370605878824236
chr4	LINC02173	106449010	106449087	0	78	0	928	0	850	0.0	0.0
chr4	SGMS2	107895309	107896008	0	700	29	7647	29	6947	0.0	0.004174463797322585
chr4	HADH	108009758	108009887	0	130	153	6977	153	6847	0.0	0.022345552796845334
chr4	HADH	108019539	108019666	0	128	153	6977	153	6849	0.0	0.022339027595269383
chr4	HADH	108032326	108032377	0	52	153	6977	153	6925	0.0	0.022093862815884477
chr4	HADH	108027687	108027760	0	74	153	6977	153	6903	0.0	0.02216427640156454
chr4	HADH	108027938	108028069	0	132	153	6977	153	6845	0.0	0.02235208181154127
chr4	HADH	108028860	108028869	0	10	153	6977	153	6967	0.0	0.021960671738194344
chr4	HADH	108004663	108004917	51	255	153	6977	102	6722	0.2	0.01517405534067242
chr4	HADH	108004545	108004917	51	373	153	6977	102	6604	0.13672922252010725	0.015445184736523319
chr4	HADH	108024434	108024568	0	135	153	6977	153	6842	0.0	0.022361882490499852
chr4	RPL34	108621630	108621696	0	67	23202	2419	23202	2352	0.0	9.864795918367347
chr4	OSTC	108655563	108655657	0	95	0	1622	0	1527	0.0	0.0
chr4	OSTC	108657449	108657647	0	199	0	1622	0	1423	0.0	0.0
chr4	OSTC	108663232	108663306	0	75	0	1622	0	1547	0.0	0.0
chr4	SEC24B	109449416	109449509	0	94	374	5244	374	5150	0.0	0.07262135922330097
chr4	SEC24B	109481676	109481781	0	106	374	5244	374	5138	0.0	0.07279096924873492
chr4	LRIT3	109865118	109865275	0	158	0	3997	0	3839	0.0	0.0
chr4	EGF	109959311	109959437	0	127	45	7523	45	7396	0.0	0.006084369929691726
chr4	EGF	109993246	109993369	0	124	45	7523	45	7399	0.0	0.00608190295985944
chr4	EGF	110008151	110008230	0	80	45	7523	45	7443	0.0	0.006045949214026602
chr4	AP1AR	112262987	112263086	0	100	0	6514	0	6414	0.0	0.0
chr4	ALPK1	112430447	112432581	0	2135	347	12349	347	10214	0.0	0.0339729782651263
chr4	ALPK1	112382397	112382552	153	156	347	12349	194	12193	0.9807692307692307	0.015910768473714428
chr4	ALPK1	112343011	112343173	51	163	347	12349	296	12186	0.3128834355828221	0.024290169046446743
chr4	LARP7	112645550	112645662	0	113	0	3712	0	3599	0.0	0.0
chr4	LARP7	112644424	112644488	0	65	0	3712	0	3647	0.0	0.0
chr4	LARP7	112637643	112637787	0	145	0	3712	0	3567	0.0	0.0
chr4	LARP7	112638617	112638673	0	57	0	3712	0	3655	0.0	0.0
chr4	ANK2	113258049	113258148	0	100	41613	17468	41613	17368	0.0	2.3959580838323356
chr4	ANK2	113343016	113343142	0	127	41613	17468	41613	17341	0.0	2.3996885992733983
chr4	ANK2	113348275	113348308	0	34	41613	17468	41613	17434	0.0	2.386887690719284
chr4	ANK2	113350227	113350249	0	23	41613	17468	41613	17445	0.0	2.3853826311263973
chr4	ANK2	113374763	113374946	0	184	41613	17468	41613	17284	0.0	2.407602406850266
chr4	ANK2	113278459	113278558	0	100	41613	17468	41613	17368	0.0	2.3959580838323356
chr4	ANK2	113373284	113373449	0	166	41613	17468	41613	17302	0.0	2.405097676569183
chr4	ANK2	113237598	113237622	0	25	41613	17468	41613	17443	0.0	2.385656137132374
chr4	ANK2	113331971	113332070	0	100	41613	17468	41613	17368	0.0	2.3959580838323356
chr4	ANK2	113372532	113372625	0	94	41613	17468	41613	17374	0.0	2.3951306550017266
chr4	ANK2	113353044	113359299	15456	6256	41613	17468	26157	11212	2.4705882352941178	2.3329468426685693
chr4	ANK2	113373089	113373173	0	85	41613	17468	41613	17383	0.0	2.3938905827532646
chr4	ANK2	113323758	113323794	0	37	41613	17468	41613	17431	0.0	2.38729849119385
chr4	ANK2	113374731	113374946	0	216	41613	17468	41613	17252	0.0	2.412068166009738
chr4	ANK2	113255734	113255932	0	199	41613	17468	41613	17269	0.0	2.4096936707394754
chr4	ANK2	112949104	112949215	0	112	41613	17468	41613	17356	0.0	2.397614657755243
chr4	ANK2	113151079	113151124	54	46	41613	17468	41559	17422	1.173913043478261	2.385432212145563
chr4	ANK2	113313683	113313695	0	13	41613	17468	41613	17455	0.0	2.384016041248926
chr4	ANK2	113258312	113258411	0	100	41613	17468	41613	17368	0.0	2.3959580838323356
chr4	ANK2	113304223	113304277	0	55	41613	17468	41613	17413	0.0	2.3897662665824386
chr4	ANK2	113378089	113378181	204	93	41613	17468	41409	17375	2.193548387096774	2.383251798561151
chr4	UGT8	114619422	114619525	0	104	5161	3880	5161	3776	0.0	1.366790254237288
chr4	LINC02263	117372363	117372471	0	109	0	12565	0	12456	0.0	0.0
chr4	LINC02263	117365226	117365379	0	154	0	12565	0	12411	0.0	0.0
chr4	LINC02263	117372363	117372541	0	179	0	12565	0	12386	0.0	0.0
chr4	LINC01378	117428693	117428767	0	75	0	5792	0	5717	0.0	0.0
chr4	LINC01378	117620855	117620992	0	138	0	5792	0	5654	0.0	0.0
chr4	LINC01378	117428696	117428767	0	72	0	5792	0	5720	0.0	0.0
chr4	LINC01378	117576966	117576990	0	25	0	5792	0	5767	0.0	0.0
chr4	LINC01378	117586980	117587050	0	71	0	5792	0	5721	0.0	0.0
chr4	LINC01378	117665776	117665882	0	107	0	5792	0	5685	0.0	0.0
chr4	LINC02264	117834444	117834486	0	43	0	936	0	893	0.0	0.0
chr4	LINC02264	117861161	117861221	0	61	0	936	0	875	0.0	0.0
chr4	LINC02264	117869147	117869280	0	134	0	936	0	802	0.0	0.0
chr4	SNHG8	118279106	118279137	0	32	0	6609	0	6577	0.0	0.0
chr4	SNHG8	118278943	118279137	0	195	0	6609	0	6414	0.0	0.0
chr4	SNHG8	118278933	118279137	0	205	0	6609	0	6404	0.0	0.0
chr4	METTL14	118705610	118705821	0	212	0	6850	0	6638	0.0	0.0
chr4	METTL14	118686549	118686699	0	151	0	6850	0	6699	0.0	0.0
chr4	USP53	119214069	119214222	0	154	357	9528	357	9374	0.0	0.03808406229997866
chr4	USP53	119266299	119266333	0	35	357	9528	357	9493	0.0	0.037606657537132625
chr4	AC093752.1	119457970	119458170	357	201	28496	5140	28139	4939	1.7761194029850746	5.697307147195788
chr4	AC093752.1	119488644	119488717	0	74	28496	5140	28496	5066	0.0	5.6249506514015
chr4	AC093752.1	119457970	119458077	0	108	28496	5140	28496	5032	0.0	5.66295707472178
chr4	AC093752.1	119543752	119543845	306	94	28496	5140	28190	5046	3.25531914893617	5.586603250099088
chr4	AC073475.1	120150542	120150621	1179	80	2609	4244	1430	4164	14.7375	0.34341978866474543
chr4	EXOSC9	121804621	121804759	0	139	255	3262	255	3123	0.0	0.08165225744476465
chr4	EXOSC9	121813233	121813380	0	148	255	3262	255	3114	0.0	0.08188824662813102
chr4	EXOSC9	121816143	121816194	0	52	255	3262	255	3210	0.0	0.0794392523364486
chr4	KIAA1109	122226706	122226835	0	130	459	18530	459	18400	0.0	0.024945652173913042
chr4	KIAA1109	122316347	122316548	0	202	459	18530	459	18328	0.0	0.025043649061545176
chr4	KIAA1109	122325854	122325917	0	64	459	18530	459	18466	0.0	0.024856493014188238
chr4	ADAD1	122379371	122379445	0	75	0	2712	0	2637	0.0	0.0
chr4	BBS12	122733903	122734091	0	189	294027	3434	294027	3245	0.0	90.60924499229584
chr4	SPATA5	122952198	122952270	0	73	52	9332	52	9259	0.0	0.005616157252403067
chr4	SPRY1	123397610	123397856	0	247	0	3968	0	3721	0.0	0.0
chr4	LINC01091	123708573	123708677	969	105	23091	11515	22122	11410	9.228571428571428	1.9388255915863277
chr4	LINC01091	123854034	123854107	0	74	23091	11515	23091	11441	0.0	2.0182676339480814
chr4	LINC01091	123924096	123924200	102	105	23091	11515	22989	11410	0.9714285714285714	2.0148115687992987
chr4	LINC01091	123825993	123826173	0	181	23091	11515	23091	11334	0.0	2.037321334039174
chr4	LINC01091	123930947	123931004	0	58	23091	11515	23091	11457	0.0	2.0154490704372874
chr4	LINC01091	123910393	123910504	0	112	23091	11515	23091	11403	0.0	2.024993422783478
chr4	LINC01091	123934570	123934684	0	115	23091	11515	23091	11400	0.0	2.025526315789474
chr4	FAT4	125463562	125463667	0	106	1450	21289	1450	21183	0.0	0.06845111646131331
chr4	FAT4	125316399	125321586	51	5188	1450	21289	1399	16101	0.009830377794911334	0.0868890131047761
chr4	LINC02379	126070707	126070813	0	107	0	1913	0	1806	0.0	0.0
chr4	LINC02379	126070710	126070813	0	104	0	1913	0	1809	0.0	0.0
chr4	LINC02379	126067312	126067480	0	169	0	1913	0	1744	0.0	0.0
chr4	LINC02379	126067312	126067420	0	109	0	1913	0	1804	0.0	0.0
chr4	INTU	127704227	127704290	0	64	0	16061	0	15997	0.0	0.0
chr4	INTU	127710912	127711102	0	191	0	16061	0	15870	0.0	0.0
chr4	HSPA4L	127798586	127798709	0	124	102	11461	102	11337	0.0	0.00899708917703096
chr4	PLK4	127883265	127883357	0	93	0	4400	0	4307	0.0	0.0
chr4	PLK4	127883261	127883357	0	97	0	4400	0	4303	0.0	0.0
chr4	PLK4	127891578	127891681	0	104	0	4400	0	4296	0.0	0.0
chr4	ABHD18	127989720	127989821	63	102	63	6723	0	6621	0.6176470588235294	0.0
chr4	ABHD18	128021136	128021238	0	103	63	6723	63	6620	0.0	0.009516616314199396
chr4	ABHD18	128001715	128001760	0	46	63	6723	63	6677	0.0	0.009435375168488842
chr4	ABHD18	127965953	127966056	0	104	63	6723	63	6619	0.0	0.009518054086720048
chr4	LARP1B	128082164	128082305	0	142	204	8844	204	8702	0.0	0.02344288669271432
chr4	LARP1B	128162193	128162317	0	125	204	8844	204	8719	0.0	0.023397178575524716
chr4	LARP1B	128176871	128176907	0	37	204	8844	204	8807	0.0	0.02316339275576246
chr4	LARP1B	128206427	128206537	0	111	204	8844	204	8733	0.0	0.023359670216420474
chr4	LARP1B	128209855	128209993	0	139	204	8844	204	8705	0.0	0.02343480758184951
chr4	LINC02615	128512903	128512984	0	82	1512	5871	1512	5789	0.0	0.26118500604594924
chr4	JADE1	128846374	128846532	1377	159	29687	9067	28310	8908	8.660377358490566	3.1780422092501124
chr4	JADE1	128816366	128816463	0	98	29687	9067	29687	8969	0.0	3.309956516891515
chr4	C4ORF33	129109306	129109358	0	53	1911	7024	1911	6971	0.0	0.2741357050638359
chr4	LINC02465	129812661	129812760	0	100	9781	6408	9781	6308	0.0	1.550570703868104
chr4	LINC02465	129812377	129812760	0	384	9781	6408	9781	6024	0.0	1.62367197875166
chr4	LINC02465	129813673	129813785	0	113	9781	6408	9781	6295	0.0	1.5537728355837968
chr4	LINC02465	129825339	129825452	0	114	9781	6408	9781	6294	0.0	1.554019701302828
chr4	LINC02465	129900537	129900654	622	118	9781	6408	9159	6290	5.271186440677966	1.456120826709062
chr4	LINC02465	129908633	129908703	0	71	9781	6408	9781	6337	0.0	1.5434748303613697
chr4	LINC02465	129865077	129865109	0	33	9781	6408	9781	6375	0.0	1.5342745098039217
chr4	LINC02465	129807003	129807148	0	146	9781	6408	9781	6262	0.0	1.5619610348131587
chr4	LINC02465	129936145	129936278	19	134	9781	6408	9762	6274	0.1417910447761194	1.5559451705451068
chr4	LINC02465	129788911	129789224	7877	314	9781	6408	1904	6094	25.085987261146496	0.3124384640630128
chr4	LINC02465	129836434	129836661	0	228	9781	6408	9781	6180	0.0	1.5826860841423949
chr4	LINC02465	129896556	129896755	0	200	9781	6408	9781	6208	0.0	1.5755476804123711
chr4	LINC02465	129905818	129905925	0	108	9781	6408	9781	6300	0.0	1.5525396825396824
chr4	LINC02465	129822601	129822699	0	99	9781	6408	9781	6309	0.0	1.550324932635917
chr4	LINC02377	131469542	131469623	0	82	0	2793	0	2711	0.0	0.0
chr4	SNHG27	131777062	131777258	0	197	0	4138	0	3941	0.0	0.0
chr4	SNHG27	131774279	131774369	0	91	0	4138	0	4047	0.0	0.0
chr4	SLC7A11-AS1	138171532	138171706	0	175	0	6172	0	5997	0.0	0.0
chr4	SLC7A11-AS1	138159807	138159892	0	86	0	6172	0	6086	0.0	0.0
chr4	LINC00499	138313290	138313324	0	35	153	20150	153	20115	0.0	0.007606263982102908
chr4	LINC00499	138313290	138313401	0	112	153	20150	153	20038	0.0	0.007635492564128156
chr4	LINC00499	138349717	138349850	0	134	153	20150	153	20016	0.0	0.007643884892086331
chr4	LINC00499	138346666	138346832	0	167	153	20150	153	19983	0.0	0.007656508031827053
chr4	LINC00499	138361295	138361402	0	108	153	20150	153	20042	0.0	0.007633968665801816
chr4	LINC00499	138502011	138502121	0	111	153	20150	153	20039	0.0	0.0076351115325116025
chr4	LINC00499	138521555	138521698	0	144	153	20150	153	20006	0.0	0.007647705688293512
chr4	AC093766.1	138795058	138795214	0	157	0	2903	0	2746	0.0	0.0
chr4	AC093766.1	138800063	138800107	0	45	0	2903	0	2858	0.0	0.0
chr4	AC093766.1	138790389	138790462	0	74	0	2903	0	2829	0.0	0.0
chr4	AC093766.1	138795061	138795214	0	154	0	2903	0	2749	0.0	0.0
chr4	AC093766.1	138800063	138800155	0	93	0	2903	0	2810	0.0	0.0
chr4	AC093766.1	138790389	138790610	0	222	0	2903	0	2681	0.0	0.0
chr4	AC093766.1	138789321	138789442	0	122	0	2903	0	2781	0.0	0.0
chr4	MGST2	139678542	139678642	0	101	0	3181	0	3080	0.0	0.0
chr4	MGST2	139695196	139695267	0	72	0	3181	0	3109	0.0	0.0
chr4	SCOC	140379568	140379652	76	85	3106	6302	3030	6217	0.8941176470588236	0.4873733311886762
chr4	SCOC	140376674	140376778	0	105	3106	6302	3106	6197	0.0	0.5012102630304986
chr4	SCOC	140373936	140374316	1801	381	3106	6302	1305	5921	4.727034120734908	0.2204019591285256
chr4	ZNF330	141224606	141224677	0	72	0	2504	0	2432	0.0	0.0
chr4	IL15	141721058	141721177	0	120	51	7886	51	7766	0.0	0.006567087303631213
chr4	USP38	143204416	143204532	0	117	0	7842	0	7725	0.0	0.0
chr4	GAB1	143457679	143457769	0	91	1224	9819	1224	9728	0.0	0.12582236842105263
chr4	GAB1	143434087	143434168	0	82	1224	9819	1224	9737	0.0	0.12570606963130326
chr4	GAB1	143417432	143417550	0	119	1224	9819	1224	9700	0.0	0.12618556701030928
chr4	AC107223.1	143973109	143973251	0	143	2083	15940	2083	15797	0.0	0.1318604798379439
chr4	AC107223.1	143978919	143979068	0	150	2083	15940	2083	15790	0.0	0.13191893603546548
chr4	AC107223.1	143970424	143970538	0	115	2083	15940	2083	15825	0.0	0.13162717219589257
chr4	AC109811.1	144858798	144858905	0	108	91	2927	91	2819	0.0	0.03228095069173466
chr4	ABCE1	145110967	145111064	0	98	0	5939	0	5841	0.0	0.0
chr4	ABCE1	145121603	145121813	0	211	0	5939	0	5728	0.0	0.0
chr4	SMAD1	145483073	145483176	0	104	867	5209	867	5105	0.0	0.16983349657198824
chr4	SMAD1	145513240	145513378	0	139	867	5209	867	5070	0.0	0.17100591715976332
chr4	MMAA	145651061	145651147	0	87	23327	8168	23327	8081	0.0	2.8866476921173123
chr4	MMAA	145651127	145651147	0	21	23327	8168	23327	8147	0.0	2.8632625506321343
chr4	EDNRA	147485611	147486101	0	491	233	4247	233	3756	0.0	0.062034078807241745
chr4	EDNRA	147519850	147519978	0	129	233	4247	233	4118	0.0	0.0565808644973288
chr4	EDNRA	147532505	147532704	0	200	233	4247	233	4047	0.0	0.057573511242895975
chr4	LINC02507	147575442	147575565	0	124	0	1933	0	1809	0.0	0.0
chr4	LINC02507	147570787	147570930	0	144	0	1933	0	1789	0.0	0.0
chr4	ARHGAP10	148063147	148063300	0	154	0	6733	0	6579	0.0	0.0
chr4	DCLK2	150248304	150248385	0	82	37	4436	37	4354	0.0	0.008497932935231971
chr4	DCLK2	150253473	150253556	0	84	37	4436	37	4352	0.0	0.008501838235294117
chr4	DCLK2	150199027	150199078	0	52	37	4436	37	4384	0.0	0.00843978102189781
chr4	DCLK2	150254425	150254438	0	14	37	4436	37	4422	0.0	0.008367254635911352
chr4	RPS3A	151100974	151101162	0	189	0	2240	0	2051	0.0	0.0
chr4	RPS3A	151100484	151100588	0	105	0	2240	0	2135	0.0	0.0
chr4	RPS3A	151100974	151101085	0	112	0	2240	0	2128	0.0	0.0
chr4	RPS3A	151100974	151101012	0	39	0	2240	0	2201	0.0	0.0
chr4	FAM160A1	151454700	151454808	0	109	564	5292	564	5183	0.0	0.10881728728535597
chr4	FAM160A1	151482523	151482648	0	126	564	5292	564	5166	0.0	0.1091753774680604
chr4	FAM160A1	151534694	151534900	0	207	564	5292	564	5085	0.0	0.11091445427728613
chr4	ARFIP1	152870752	152870848	0	97	0	3791	0	3694	0.0	0.0
chr4	TRIM2	153324077	153324148	0	72	5256	14876	5256	14804	0.0	0.35503917860037826
chr4	TRIM2	153153231	153153270	0	40	5256	14876	5256	14836	0.0	0.3542733890536533
chr4	TRIM2	153270337	153270519	0	183	5256	14876	5256	14693	0.0	0.35772136391478937
chr4	TRIM2	153295312	153296036	0	725	5256	14876	5256	14151	0.0	0.3714225143099428
chr4	AC013477.1	153397218	153397333	0	116	51	5906	51	5790	0.0	0.008808290155440414
chr4	AC013477.1	153408970	153409015	0	46	51	5906	51	5860	0.0	0.00870307167235495
chr4	TRIM2	153270334	153270519	0	186	5256	14876	5256	14690	0.0	0.3577944179714091
chr4	TRIM2	153315484	153315588	0	105	5256	14876	5256	14771	0.0	0.355832374246835
chr4	TRIM2	153291731	153291816	0	86	5256	14876	5256	14790	0.0	0.35537525354969574
chr4	TRIM2	153222242	153223039	0	798	5256	14876	5256	14078	0.0	0.37334848700099443
chr4	TRIM2	153281464	153281565	0	102	5256	14876	5256	14774	0.0	0.35576011912819816
chr4	TRIM2	153290813	153290906	0	94	5256	14876	5256	14782	0.0	0.35556758219456097
chr4	TRIM2	153222242	153222759	0	518	5256	14876	5256	14358	0.0	0.36606769745089845
chr4	TRIM2	153237869	153237957	0	89	5256	14876	5256	14787	0.0	0.35544735240413877
chr4	TRIM2	153290651	153290769	0	119	5256	14876	5256	14757	0.0	0.356169953242529
chr4	TRIM2	153325781	153325911	0	131	5256	14876	5256	14745	0.0	0.35645981688708034
chr4	TMEM131L	153473844	153473888	0	45	51	6430	51	6385	0.0	0.00798747063429914
chr4	TLR2	153702226	153702510	0	285	2856	3469	2856	3184	0.0	0.8969849246231156
chr4	AC079298.3	154201747	154201831	0	85	166	3268	166	3183	0.0	0.05215205780710022
chr4	AC079298.3	154272167	154272286	0	120	166	3268	166	3148	0.0	0.05273189326556544
chr4	FGB	154569513	154569799	0	287	0	4382	0	4095	0.0	0.0
chr4	FGB	154565185	154565235	0	51	0	4382	0	4331	0.0	0.0
chr4	RBM46	154820362	154820422	0	61	51	4035	51	3974	0.0	0.012833417211877201
chr4	AC097467.3	155342259	155342424	0	166	64	5378	64	5212	0.0	0.012279355333844973
chr4	AC097467.3	155346296	155346560	0	265	64	5378	64	5113	0.0	0.01251711324075885
chr4	AC097467.3	155349380	155349457	0	78	64	5378	64	5300	0.0	0.012075471698113207
chr4	AC097467.3	155352291	155352354	0	64	64	5378	64	5314	0.0	0.012043658261196839
chr4	AC097467.3	155329733	155329953	0	221	64	5378	64	5157	0.0	0.012410316075237541
chr4	AC097467.3	155354208	155354373	0	166	64	5378	64	5212	0.0	0.012279355333844973
chr4	AC097467.3	155309003	155309076	0	74	64	5378	64	5304	0.0	0.012066365007541479
chr4	AC097467.3	155351026	155351207	0	182	64	5378	64	5196	0.0	0.012317167051578136
chr4	AC097467.3	155339968	155340034	0	67	64	5378	64	5311	0.0	0.012050461306721898
chr4	AC097467.3	155346423	155346560	0	138	64	5378	64	5240	0.0	0.012213740458015267
chr4	AC097467.3	155361200	155361322	0	123	64	5378	64	5255	0.0	0.012178877259752616
chr4	AC097467.3	155362263	155362304	0	42	64	5378	64	5336	0.0	0.01199400299850075
chr4	AC097467.3	155362464	155362529	0	66	64	5378	64	5312	0.0	0.012048192771084338
chr4	AC097467.3	155362816	155363070	0	255	64	5378	64	5123	0.0	0.012492680070271326
chr4	AC107208.1	155512336	155512441	0	106	0	3887	0	3781	0.0	0.0
chr4	GUCY1A1	155668089	155668183	0	95	102	10473	102	10378	0.0	0.00982848333012141
chr4	GUCY1A1	155696755	155696849	0	95	102	10473	102	10378	0.0	0.00982848333012141
chr4	GUCY1B1	155772601	155772697	0	97	0	3961	0	3864	0.0	0.0
chr4	GUCY1B1	155759786	155759860	0	75	0	3961	0	3886	0.0	0.0
chr4	GUCY1B1	155785263	155785329	0	67	0	3961	0	3894	0.0	0.0
chr4	GUCY1B1	155772601	155772753	0	153	0	3961	0	3808	0.0	0.0
chr4	GUCY1B1	155759355	155759541	0	187	0	3961	0	3774	0.0	0.0
chr4	TDO2	155858847	155858898	0	52	0	5282	0	5230	0.0	0.0
chr4	GLRB	157152717	157153010	0	294	0	3300	0	3006	0.0	0.0
chr4	GLRB	157091370	157091382	0	13	0	3300	0	3287	0.0	0.0
chr4	GLRB	157084663	157084724	0	62	0	3300	0	3238	0.0	0.0
chr4	GRIA2	157220907	157221130	0	224	51	8804	51	8580	0.0	0.005944055944055944
chr4	GRIA2	157360708	157360749	0	42	51	8804	51	8762	0.0	0.005820588906642319
chr4	GRIA2	157361537	157361652	0	116	51	8804	51	8688	0.0	0.005870165745856353
chr4	FAM198B-AS1	158172251	158172416	0	166	0	5647	0	5481	0.0	0.0
chr4	FAM198B-AS1	158198787	158198870	0	84	0	5647	0	5563	0.0	0.0
chr4	FAM198B-AS1	158176911	158177046	0	136	0	5647	0	5511	0.0	0.0
chr4	TMEM144	158212060	158212220	0	161	0	7537	0	7376	0.0	0.0
chr4	TMEM144	158211458	158211574	0	117	0	7537	0	7420	0.0	0.0
chr4	TMEM144	158211452	158211574	0	123	0	7537	0	7414	0.0	0.0
chr4	TMEM144	158211532	158211574	0	43	0	7537	0	7494	0.0	0.0
chr4	TMEM144	158235437	158235505	0	69	0	7537	0	7468	0.0	0.0
chr4	RXFP1	158593400	158593499	0	100	51	5710	51	5610	0.0	0.00909090909090909
chr4	RXFP1	158626819	158626891	0	73	51	5710	51	5637	0.0	0.009047365620010643
chr4	RXFP1	158607047	158607131	0	85	51	5710	51	5625	0.0	0.009066666666666667
chr4	RXFP1	158610632	158610685	0	54	51	5710	51	5656	0.0	0.009016973125884018
chr4	ETFDH	158680466	158680607	0	142	0	4508	0	4366	0.0	0.0
chr4	ETFDH	158682194	158682424	0	231	0	4508	0	4277	0.0	0.0
chr4	FNIP2	158833800	158833890	0	91	51	9317	51	9226	0.0	0.005527856058963798
chr4	RAPGEF2	159344035	159344059	0	25	233	13313	233	13288	0.0	0.017534617700180614
chr4	RAPGEF2	159351058	159351133	0	76	233	13313	233	13237	0.0	0.017602175719573922
chr4	RAPGEF2	159243773	159243791	0	19	233	13313	233	13294	0.0	0.017526703776139612
chr4	RAPGEF2	159351058	159351181	0	124	233	13313	233	13189	0.0	0.017666237015694898
chr4	TMA16	163515312	163515461	0	150	0	3154	0	3004	0.0	0.0
chr4	TRIM60	165039200	165039252	0	53	0	3021	0	2968	0.0	0.0
chr4	TRIM60	165039441	165039615	0	175	0	3021	0	2846	0.0	0.0
chr4	KLHL2	165228806	165228913	0	108	0	3948	0	3840	0.0	0.0
chr4	KLHL2	165238777	165238899	0	123	0	3948	0	3825	0.0	0.0
chr4	KLHL2	165263196	165263359	0	164	0	3948	0	3784	0.0	0.0
chr4	KLHL2	165305607	165305725	0	119	0	3948	0	3829	0.0	0.0
chr4	KLHL2	165223937	165224057	0	121	0	3948	0	3827	0.0	0.0
chr4	MSMO1	165333339	165333625	0	287	0	2856	0	2569	0.0	0.0
chr4	TLL1	166044364	166044433	0	70	8658	8130	8658	8060	0.0	1.0741935483870968
chr4	TLL1	165919833	165919939	0	107	8658	8130	8658	8023	0.0	1.0791474510781502
chr4	PALLD	168896548	168896599	0	52	102	9643	102	9591	0.0	0.010634970284641852
chr4	PALLD	168925232	168925278	0	47	102	9643	102	9596	0.0	0.0106294289287203
chr4	PALLD	168507359	168507698	0	340	102	9643	102	9303	0.0	0.010964205095130602
chr4	PALLD	168877722	168878394	0	673	102	9643	102	8970	0.0	0.01137123745819398
chr4	CLCN3	169695611	169695692	0	82	153	8113	153	8031	0.0	0.01905117669032499
chr4	CLCN3	169717791	169717867	0	77	153	8113	153	8036	0.0	0.019039323046291686
chr4	LINC01612	170278943	170279103	0	161	0	2193	0	2032	0.0	0.0
chr4	LINC01612	170273658	170273964	0	307	0	2193	0	1886	0.0	0.0
chr4	LINC01612	170278363	170278468	0	106	0	2193	0	2087	0.0	0.0
chr4	HAND2-AS1	173536847	173536970	0	124	44	14033	44	13909	0.0	0.003163419368754044
chr4	HAND2-AS1	173530966	173531078	0	113	44	14033	44	13920	0.0	0.003160919540229885
chr4	HAND2-AS1	173559096	173559201	0	106	44	14033	44	13927	0.0	0.0031593307962949667
chr4	HAND2-AS1	173530799	173531078	2	280	44	14033	42	13753	0.007142857142857143	0.003053879153639206
chr4	HAND2-AS1	173533912	173534122	0	211	44	14033	44	13822	0.0	0.0031833309217189987
chr4	HAND2-AS1	173530799	173530850	2	52	44	14033	42	13981	0.038461538461538464	0.0030040769615907303
chr4	HAND2-AS1	173588440	173588555	0	116	44	14033	44	13917	0.0	0.0031616009197384496
chr4	HAND2-AS1	173579390	173579556	0	167	44	14033	44	13866	0.0	0.0031732294821866435
chr4	LINC02269	173856283	173856466	0	184	0	3896	0	3712	0.0	0.0
chr4	LINC02269	173878215	173878280	0	66	0	3896	0	3830	0.0	0.0
chr4	LINC02269	173833922	173834011	0	90	0	3896	0	3806	0.0	0.0
chr4	LINC02269	173925877	173925957	0	81	0	3896	0	3815	0.0	0.0
chr4	LINC02269	173735369	173735543	0	175	0	3896	0	3721	0.0	0.0
chr4	LINC02269	173923111	173923281	0	171	0	3896	0	3725	0.0	0.0
chr4	LINC02269	173928494	173928644	0	151	0	3896	0	3745	0.0	0.0
chr4	LINC02269	173928489	173928644	0	156	0	3896	0	3740	0.0	0.0
chr4	LINC02269	173925639	173925766	0	128	0	3896	0	3768	0.0	0.0
chr4	LINC02269	173928494	173928617	0	124	0	3896	0	3772	0.0	0.0
chr4	LINC02269	173906696	173906768	0	73	0	3896	0	3823	0.0	0.0
chr4	LINC02269	173928489	173928617	0	129	0	3896	0	3767	0.0	0.0
chr4	CEP44	174297965	174298062	571	98	2356	6686	1785	6588	5.826530612244898	0.2709471766848816
chr4	CEP44	174285433	174285574	81	142	2356	6686	2275	6544	0.5704225352112676	0.34764669926650366
chr4	ADAM29	174920686	174920792	0	107	0	5967	0	5860	0.0	0.0
chr4	ADAM29	174936932	174937013	0	82	0	5967	0	5885	0.0	0.0
chr4	ADAM29	174918929	174918990	0	62	0	5967	0	5905	0.0	0.0
chr4	ADAM29	174930985	174931174	0	190	0	5967	0	5777	0.0	0.0
chr4	WDR17	176115795	176115979	0	185	51	7834	51	7649	0.0	0.006667538240292849
chr4	WDR17	176096462	176096585	0	124	51	7834	51	7710	0.0	0.006614785992217899
chr4	WDR17	176166123	176166144	0	22	51	7834	51	7812	0.0	0.006528417818740399
chr4	AC093801.1	176679699	176679750	0	52	0	386	0	334	0.0	0.0
chr4	NEIL3	177322458	177322580	0	123	0	2924	0	2801	0.0	0.0
chr4	WWC2	183240182	183240262	0	81	357	10028	357	9947	0.0	0.03589021815622801
chr4	STOX2	184009157	184011423	102	2267	8487	11373	8385	9106	0.044993383325981476	0.9208214364155501
chr4	STOX2	184011586	184011635	0	50	8487	11373	8487	11323	0.0	0.7495363419588448
chr4	PRIMPOL	184661773	184661903	0	131	51	2804	51	2673	0.0	0.019079685746352413
chr4	PRIMPOL	184682247	184682336	0	90	51	2804	51	2714	0.0	0.01879145173176124
chr4	PRIMPOL	184657084	184657320	0	237	51	2804	51	2567	0.0	0.019867549668874173
chr4	PRIMPOL	184657081	184657320	0	240	51	2804	51	2564	0.0	0.019890795631825272
chr4	PRIMPOL	184665916	184666064	0	149	51	2804	51	2655	0.0	0.0192090395480226
chr4	AC084871.3	184844121	184844468	0	348	0	1579	0	1231	0.0	0.0
chr4	AC084871.3	184844121	184844203	0	83	0	1579	0	1496	0.0	0.0
chr4	LINC02436	185054978	185055341	0	364	0	7067	0	6703	0.0	0.0
chr4	LINC02436	185062456	185062816	0	361	0	7067	0	6706	0.0	0.0
chr4	LINC02436	185069960	185070030	0	71	0	7067	0	6996	0.0	0.0
chr4	LINC02436	185096481	185096621	0	141	0	7067	0	6926	0.0	0.0
chr4	LINC02436	185054978	185055237	0	260	0	7067	0	6807	0.0	0.0
chr4	LINC02436	185069938	185070030	0	93	0	7067	0	6974	0.0	0.0
chr4	LINC02436	185069929	185070049	0	121	0	7067	0	6946	0.0	0.0
chr4	LINC02436	185053104	185053188	0	85	0	7067	0	6982	0.0	0.0
chr4	LINC02436	185069960	185070049	0	90	0	7067	0	6977	0.0	0.0
chr4	LINC02436	185081097	185081200	0	104	0	7067	0	6963	0.0	0.0
chr4	LINC02436	185069929	185070030	0	102	0	7067	0	6965	0.0	0.0
chr4	LINC02436	185063247	185063334	0	88	0	7067	0	6979	0.0	0.0
chr4	LINC02436	185071986	185072073	0	88	0	7067	0	6979	0.0	0.0
chr4	LINC02436	185062456	185062591	0	136	0	7067	0	6931	0.0	0.0
chr4	LINC02436	185064445	185064564	0	120	0	7067	0	6947	0.0	0.0
chr4	LINC02436	185071567	185072073	0	507	0	7067	0	6560	0.0	0.0
chr4	LINC02436	185091360	185091450	0	91	0	7067	0	6976	0.0	0.0
chr4	SNX25	185351444	185351609	0	166	462	5091	462	4925	0.0	0.09380710659898477
chr4	ANKRD37	185396831	185396950	963	120	11212	2016	10249	1896	8.025	5.405590717299578
chr4	C4ORF47	185431981	185432201	0	221	0	1374	0	1153	0.0	0.0
chr4	C4ORF47	185436283	185436359	0	77	0	1374	0	1297	0.0	0.0
chr4	FAM149A	186149565	186149704	0	140	850	5237	850	5097	0.0	0.1667647635864234
chr4	FAM149A	186149592	186149704	0	113	850	5237	850	5124	0.0	0.16588602654176424
chr4	FAM149A	186151902	186152045	0	144	850	5237	850	5093	0.0	0.1668957392499509
chr4	KLKB1	186257225	186257365	0	141	8191	2934	8191	2793	0.0	2.932688865019692
chr4	KLKB1	186228870	186228989	0	120	8191	2934	8191	2814	0.0	2.9108031272210377
chr4	F11	186286414	186286510	0	97	20076	3921	20076	3824	0.0	5.25
chr4	AC110772.2	187060033	187060077	0	45	752	1441	752	1396	0.0	0.5386819484240688
chr4	AC097521.1	187632649	187632834	0	186	408	6484	408	6298	0.0	0.06478247062559543
chr4	AC097521.1	187622641	187622740	0	100	408	6484	408	6384	0.0	0.06390977443609022
chr4	AC097521.1	187621676	187621910	0	235	408	6484	408	6249	0.0	0.06529044647143543
chr4	ZFP42	187999107	187999273	0	167	0	2656	0	2489	0.0	0.0
chr4	LINC02434	188160215	188160332	0	118	0	1294	0	1176	0.0	0.0
chr4	LINC01060	188477637	188477912	0	276	0	5920	0	5644	0.0	0.0
chr4	LINC01060	188476697	188476756	0	60	0	5920	0	5860	0.0	0.0
chr4	LINC01060	188588594	188588713	0	120	0	5920	0	5800	0.0	0.0
chr4	FRG1	189941908	189942004	0	97	0	1559	0	1462	0.0	0.0
chr4	FRG1	189941832	189942004	0	173	0	1559	0	1386	0.0	0.0
chr4	FRG1	189941908	189942000	0	93	0	1559	0	1466	0.0	0.0
chr4	FRG1	189961428	189961550	0	123	0	1559	0	1436	0.0	0.0
chr5	SDHA	235143	235339	59793	197	1126305	7050	1066512	6853	303.51776649746193	155.62702466073253
chr5	SDHA	225418	225562	22241	145	1126305	7050	1104064	6905	153.38620689655173	159.89341057204925
chr5	PDCD6	272710	272772	0	63	1215560	9301	1215560	9238	0.0	131.58259363498593
chr5	PDCD6	306601	306760	65991	160	1215560	9301	1149569	9141	412.44375	125.75965430478065
chr5	SDHA	220239	220337	0	99	1126305	7050	1126305	6951	0.0	162.03495899870524
chr5	PDCD6	306601	306754	53762	154	1215560	9301	1161798	9147	349.1038961038961	127.01410298458511
chr5	PDCD6-AHRR	427636	427690	307	55	2190369	5888	2190062	5833	5.581818181818182	375.4606548945654
chr5	PDCD6	304176	304221	1032	46	1215560	9301	1214528	9255	22.434782608695652	131.22938951917882
chr5	PDCD6	311292	311402	5268	111	1215560	9301	1210292	9190	47.45945945945946	131.69662676822634
chr5	EXOC3	444925	445064	1115	140	1071961	8157	1070846	8017	7.964285714285714	133.5719096919047
chr5	NKD2	1037519	1037698	0	180	7275	2618	7275	2438	0.0	2.984003281378179
chr5	AC124852.1	2103519	2103783	0	265	51	14286	51	14021	0.0	0.0036374010412952
chr5	C5ORF38	2753284	2753355	0	72	0	1929	0	1857	0.0	0.0
chr5	C5ORF38	2752621	2752754	0	134	0	1929	0	1795	0.0	0.0
chr5	LINC01377	3178667	3178893	0	227	0	1133	0	906	0.0	0.0
chr5	LINC01020	5051207	5051256	0	50	0	4734	0	4684	0.0	0.0
chr5	LINC01020	5059563	5059681	0	119	0	4734	0	4615	0.0	0.0
chr5	LINC01020	5057561	5057828	0	268	0	4734	0	4466	0.0	0.0
chr5	LINC01020	5051177	5051256	0	80	0	4734	0	4654	0.0	0.0
chr5	ADAMTS16	5236968	5237099	0	132	43582	5886	43582	5754	0.0	7.574209245742092
chr5	LINC01018	6583602	6583801	0	200	99762	7086	99762	6886	0.0	14.487656113854197
chr5	LINC01018	6586227	6586346	0	120	99762	7086	99762	6966	0.0	14.321274763135229
chr5	LINC01018	6583701	6583801	0	101	99762	7086	99762	6985	0.0	14.282319255547602
chr5	LINC01018	6584637	6584695	0	59	99762	7086	99762	7027	0.0	14.196954603671552
chr5	SRD5A1	6644807	6645309	1222	503	597824	7638	596602	7135	2.429423459244533	83.61625788367203
chr5	SRD5A1	6651841	6652008	19112	168	597824	7638	578712	7470	113.76190476190476	77.47148594377511
chr5	AC122710.1	6870457	6870621	0	165	0	2026	0	1861	0.0	0.0
chr5	LINC02142	7386923	7387050	0	128	0	1327	0	1199	0.0	0.0
chr5	MTRR	7856786	7856892	0	107	169758	6426	169758	6319	0.0	26.864693780661497
chr5	MTRR	7873372	7873512	1531	141	169758	6426	168227	6285	10.858156028368795	26.76642800318218
chr5	MTRR	7886614	7886703	0	90	169758	6426	169758	6336	0.0	26.792613636363637
chr5	MTRR	7873372	7873526	2369	155	169758	6426	167389	6271	15.283870967741935	26.692553021846596
chr5	MTRR	7870769	7870923	1632	155	169758	6426	168126	6271	10.529032258064516	26.81007813745814
chr5	MTRR	7872229	7872305	0	77	169758	6426	169758	6349	0.0	26.737753977004253
chr5	AC091953.1	8528476	8528678	0	203	0	1238	0	1035	0.0	0.0
chr5	AC091953.1	8528510	8528678	0	169	0	1238	0	1069	0.0	0.0
chr5	LINC02199	8868966	8869018	0	53	0	8746	0	8693	0.0	0.0
chr5	LINC02199	8873735	8873859	0	125	0	8746	0	8621	0.0	0.0
chr5	LINC02221	9859714	9859884	0	171	0	1485	0	1314	0.0	0.0
chr5	LINC02221	9889609	9889943	0	335	0	1485	0	1150	0.0	0.0
chr5	CCT5	10254673	10254838	138379	166	2324024	5425	2185645	5259	833.6084337349398	415.6008746910059
chr5	CCT5	10254765	10254838	138171	74	2324024	5425	2185853	5351	1867.1756756756756	408.49430013081667
chr5	MARCHF6	10381799	10381943	17243	145	1173766	8776	1156523	8631	118.91724137931034	133.99640829567838
chr5	MARCHF6	10386993	10387066	16	74	1173766	8776	1173750	8702	0.21621621621621623	134.88278556653643
chr5	ANKRD33B	10624724	10625181	918	458	292315	10048	291397	9590	2.004366812227074	30.38550573514077
chr5	LINC01194	12595696	12595778	0	83	11527	3128	11527	3045	0.0	3.7855500821018064
chr5	TRIO	14507121	14507260	21126	140	1678705	17006	1657579	16866	150.9	98.2793193406854
chr5	OTULINL	14601350	14601442	0	93	2151	2763	2151	2670	0.0	0.8056179775280898
chr5	OTULIN	14673641	14673718	0	78	429298	8760	429298	8682	0.0	49.44690163556784
chr5	LINC02217	17437189	17437213	0	25	0	8721	0	8696	0.0	0.0
chr5	LINC02217	17411891	17412008	0	118	0	8721	0	8603	0.0	0.0
chr5	LINC02217	17404557	17404729	0	173	0	8721	0	8548	0.0	0.0
chr5	LINC02223	17762153	17762295	0	143	0	7967	0	7824	0.0	0.0
chr5	LINC02223	17787464	17787568	0	105	0	7967	0	7862	0.0	0.0
chr5	LINC02223	17850182	17850373	0	192	0	7967	0	7775	0.0	0.0
chr5	LINC02223	17873019	17873086	0	68	0	7967	0	7899	0.0	0.0
chr5	LINC02223	17920226	17920309	0	84	0	7967	0	7883	0.0	0.0
chr5	LINC02241	20807852	20807913	0	62	0	9146	0	9084	0.0	0.0
chr5	LINC02241	20895482	20895567	0	86	0	9146	0	9060	0.0	0.0
chr5	LINC02241	20937178	20937257	0	80	0	9146	0	9066	0.0	0.0
chr5	LINC02241	20670566	20670611	0	46	0	9146	0	9100	0.0	0.0
chr5	LINC02241	20814328	20814398	0	71	0	9146	0	9075	0.0	0.0
chr5	LINC02241	20612824	20612873	0	50	0	9146	0	9096	0.0	0.0
chr5	LINC02241	20852057	20852103	0	47	0	9146	0	9099	0.0	0.0
chr5	LINC02241	20660711	20660768	0	58	0	9146	0	9088	0.0	0.0
chr5	LINC02241	20736954	20737101	0	148	0	9146	0	8998	0.0	0.0
chr5	LINC02241	20838436	20838487	0	52	0	9146	0	9094	0.0	0.0
chr5	LINC02241	20934174	20934244	0	71	0	9146	0	9075	0.0	0.0
chr5	LINC02241	20751563	20751844	0	282	0	9146	0	8864	0.0	0.0
chr5	LINC02241	20612824	20613033	0	210	0	9146	0	8936	0.0	0.0
chr5	LINC02241	20925178	20925288	0	111	0	9146	0	9035	0.0	0.0
chr5	LINC02241	20736954	20737145	0	192	0	9146	0	8954	0.0	0.0
chr5	LINC02241	20699728	20699855	0	128	0	9146	0	9018	0.0	0.0
chr5	LINC02241	20705720	20705817	0	98	0	9146	0	9048	0.0	0.0
chr5	LINC02241	20749523	20749607	0	85	0	9146	0	9061	0.0	0.0
chr5	LINC02241	20838433	20838487	0	55	0	9146	0	9091	0.0	0.0
chr5	LINC02241	20807852	20807865	0	14	0	9146	0	9132	0.0	0.0
chr5	LINC02241	20935377	20935466	0	90	0	9146	0	9056	0.0	0.0
chr5	AC091938.1	22755015	22755086	0	72	0	4537	0	4465	0.0	0.0
chr5	LINC02211	25298978	25299060	0	83	298273	5542	298273	5459	0.0	54.638761677963
chr5	PURPL	27438376	27438530	0	155	210	4915	210	4760	0.0	0.04411764705882353
chr5	PURPL	27476086	27476158	0	73	210	4915	210	4842	0.0	0.04337050805452292
chr5	PURPL	27484925	27485029	0	105	210	4915	210	4810	0.0	0.04365904365904366
chr5	PURPL	27494234	27494335	0	102	210	4915	210	4813	0.0	0.04363183045917307
chr5	PURPL	27489281	27489386	0	106	210	4915	210	4809	0.0	0.043668122270742356
chr5	PURPL	27494118	27494335	0	218	210	4915	210	4697	0.0	0.044709388971684055
chr5	PURPL	27493569	27494335	0	767	210	4915	210	4148	0.0	0.05062680810028929
chr5	PURPL	27477638	27477801	0	164	210	4915	210	4751	0.0	0.04420122079562198
chr5	PURPL	27493569	27493687	0	119	210	4915	210	4796	0.0	0.043786488740617184
chr5	PURPL	27476068	27476158	0	91	210	4915	210	4824	0.0	0.043532338308457715
chr5	LINC02109	29146270	29146461	0	192	0	5628	0	5436	0.0	0.0
chr5	LINC02109	29148602	29148912	0	311	0	5628	0	5317	0.0	0.0
chr5	LINC02109	29211311	29211413	0	103	0	5628	0	5525	0.0	0.0
chr5	C5ORF22	31540948	31541011	0	64	251685	3849	251685	3785	0.0	66.49537648612946
chr5	C5ORF22	31534958	31535051	0	94	251685	3849	251685	3755	0.0	67.02663115845539
chr5	PDZD2	32069568	32069650	0	83	14046	15956	14046	15873	0.0	0.8848988848988849
chr5	PDZD2	32101104	32101239	0	136	14046	15956	14046	15820	0.0	0.8878634639696587
chr5	SUB1	32598960	32599069	12560	110	1359166	9276	1346606	9166	114.18181818181819	146.9131573205324
chr5	SUB1	32571090	32571174	140	85	1359166	9276	1359026	9191	1.6470588235294117	147.86486780546187
chr5	SUB1	32588511	32588584	589	74	1359166	9276	1358577	9202	7.95945945945946	147.63931753966529
chr5	SUB1	32594570	32594872	10058	303	1359166	9276	1349108	8973	33.194719471947195	150.35194472305807
chr5	SUB1	32586368	32586501	4104	134	1359166	9276	1355062	9142	30.62686567164179	148.2238022314592
chr5	SUB1	32586428	32586501	979	74	1359166	9276	1358187	9202	13.22972972972973	147.5969354488155
chr5	LINC02160	33248541	33248651	0	111	0	2617	0	2506	0.0	0.0
chr5	TARS1	33448540	33448731	55538	192	597830	4126	542292	3934	289.2604166666667	137.84748347737673
chr5	TARS1	33452340	33452439	1275	100	597830	4126	596555	4026	12.75	148.175608544461
chr5	TARS1	33446643	33446764	54	122	597830	4126	597776	4004	0.4426229508196721	149.2947052947053
chr5	TARS1	33446606	33446764	114	159	597830	4126	597716	3967	0.7169811320754716	150.67204436601966
chr5	RAI14	34813573	34813660	50	88	301197	7612	301147	7524	0.5681818181818182	40.02485380116959
chr5	RAI14	34667262	34667379	0	118	301197	7612	301197	7494	0.0	40.19175340272218
chr5	RAI14	34658995	34659072	480	78	301197	7612	300717	7534	6.153846153846154	39.91465357048049
chr5	RAI14	34685031	34685081	0	51	301197	7612	301197	7561	0.0	39.83560375611692
chr5	RAI14	34688067	34688248	0	182	301197	7612	301197	7430	0.0	40.537954239569316
chr5	RAI14	34716054	34716221	0	168	301197	7612	301197	7444	0.0	40.461714132187
chr5	TTC23L	34845486	34845673	0	188	1595	2550	1595	2362	0.0	0.6752751905165114
chr5	TTC23L	34850184	34850308	0	125	1595	2550	1595	2425	0.0	0.6577319587628866
chr5	TTC23L	34868904	34869013	0	110	1595	2550	1595	2440	0.0	0.6536885245901639
chr5	TTC23L	34888454	34888537	0	84	1595	2550	1595	2466	0.0	0.6467964314679643
chr5	DNAJC21	34949542	34949677	896	136	253355	9571	252459	9435	6.588235294117647	26.757710651828297
chr5	SPEF2	35644354	35644525	4810	172	48878	16187	44068	16015	27.96511627906977	2.751670309085233
chr5	SPEF2	35702152	35702319	0	168	48878	16187	48878	16019	0.0	3.0512516386790685
chr5	SPEF2	35791507	35791575	0	69	48878	16187	48878	16118	0.0	3.0325102370021093
chr5	IL7R	35873479	35873648	1862	170	99608	5933	97746	5763	10.952941176470588	16.96095783446122
chr5	IL7R	35874448	35874542	0	95	99608	5933	99608	5838	0.0	17.062007536827682
chr5	SKP2	36163644	36163756	1177	113	447966	10355	446789	10242	10.415929203539823	43.62321812146065
chr5	SKP2	36168312	36168447	1487	136	447966	10355	446479	10219	10.933823529411764	43.69106566200215
chr5	SKP2	36178597	36178810	2753	214	447966	10355	445213	10141	12.86448598130841	43.90227788186569
chr5	SKP2	36164534	36164695	87	162	447966	10355	447879	10193	0.5370370370370371	43.93986068870794
chr5	SKP2	36159772	36159874	0	103	447966	10355	447966	10252	0.0	43.69547405384315
chr5	SKP2	36191522	36191702	255	181	447966	10355	447711	10174	1.408839779005525	44.00540593670139
chr5	SKP2	36191411	36191702	495	292	447966	10355	447471	10063	1.6952054794520548	44.466958163569515
chr5	SKP2	36152770	36153042	11183	273	447966	10355	436783	10082	40.96336996336996	43.32305098194803
chr5	SKP2	36164627	36164695	21	69	447966	10355	447945	10286	0.30434782608695654	43.5489986389267
chr5	SKP2	36192620	36192695	0	76	447966	10355	447966	10279	0.0	43.58069851152836
chr5	SLC1A3	36629449	36629587	0	139	41469	6239	41469	6100	0.0	6.798196721311475
chr5	SLC1A3	36683863	36683998	144	136	41469	6239	41325	6103	1.0588235294117647	6.771260036047845
chr5	SLC1A3	36607223	36607311	0	89	41469	6239	41469	6150	0.0	6.742926829268293
chr5	NIPBL	37057185	37057332	363	148	104702	12568	104339	12420	2.4527027027027026	8.400885668276972
chr5	NIPBL	37060843	37061018	4723	176	104702	12568	99979	12392	26.835227272727273	8.06802775984506
chr5	WDR70	37379488	37379554	3801	67	155326	5558	151525	5491	56.73134328358209	27.59515570934256
chr5	WDR70	37687909	37688007	290	99	155326	5558	155036	5459	2.9292929292929295	28.400073273493312
chr5	LINC02119	38040916	38040974	0	59	0	4422	0	4363	0.0	0.0
chr5	LINC02119	38148467	38148601	0	135	0	4422	0	4287	0.0	0.0
chr5	LINC02119	38132442	38132538	0	97	0	4422	0	4325	0.0	0.0
chr5	LINC02119	38041247	38041291	0	45	0	4422	0	4377	0.0	0.0
chr5	EGFLAM	38418065	38418255	80	191	80	6208	0	6017	0.418848167539267	0.0
chr5	EGFLAM	38445678	38445702	0	25	80	6208	80	6183	0.0	0.012938702895034774
chr5	EGFLAM	38305431	38305617	0	187	80	6208	80	6021	0.0	0.013286829430327189
chr5	LIFR-AS1	38615573	38615659	0	87	7242	7564	7242	7477	0.0	0.9685702821987429
chr5	LIFR-AS1	38646631	38646714	0	84	7242	7564	7242	7480	0.0	0.9681818181818181
chr5	LIFR-AS1	38640928	38641029	0	102	7242	7564	7242	7462	0.0	0.9705172875904583
chr5	AC114977.1	40486375	40486498	0	124	0	938	0	814	0.0	0.0
chr5	FBXO4	41927012	41927248	31300	237	384735	3022	353435	2785	132.06751054852322	126.90664272890484
chr5	FBXO4	41939440	41939616	20925	177	384735	3022	363810	2845	118.22033898305085	127.87697715289983
chr5	FBXO4	41928517	41928691	163	175	384735	3022	384572	2847	0.9314285714285714	135.0797330523358
chr5	GHR	42629037	42629103	0	67	0	6970	0	6903	0.0	0.0
chr5	GHR	42688889	42689019	0	131	0	6970	0	6839	0.0	0.0
chr5	GHR	42718051	42718121	0	71	0	6970	0	6899	0.0	0.0
chr5	GHR	42514079	42514364	0	286	0	6970	0	6684	0.0	0.0
chr5	AC008945.2	42817066	42817351	0	286	2105	1807	2105	1521	0.0	1.383957922419461
chr5	AC008945.2	42910724	42910843	0	120	2105	1807	2105	1687	0.0	1.2477771191464138
chr5	AC025171.3	43019235	43019316	64	82	14106	1782	14042	1700	0.7804878048780488	8.26
chr5	AC025171.3	43023918	43024097	102	180	14106	1782	14004	1602	0.5666666666666667	8.741573033707866
chr5	AC025171.3	43023918	43024109	102	192	14106	1782	14004	1590	0.53125	8.80754716981132
chr5	ZNF131	43139164	43139309	4433	146	265777	8233	261344	8087	30.363013698630137	32.31655743786324
chr5	ZNF131	43161248	43161931	43564	684	265777	8233	222213	7549	63.69005847953216	29.43608424956948
chr5	ZNF131	43167929	43168029	1080	101	265777	8233	264697	8132	10.693069306930694	32.55004918839154
chr5	NNT	43612907	43613137	39570	231	654496	10606	614926	10375	171.2987012987013	59.26997590361446
chr5	NNT	43619086	43619119	568	34	654496	10606	653928	10572	16.705882352941178	61.85471055618615
chr5	NNT	43700118	43700237	4109	120	654496	10606	650387	10486	34.24166666666667	62.02431813847034
chr5	NNT	43619031	43619119	986	89	654496	10606	653510	10517	11.07865168539326	62.138442521631646
chr5	NNT	43604594	43604670	30	77	654496	10606	654466	10529	0.38961038961038963	62.158419603001235
chr5	NNT	43609142	43609346	12127	205	654496	10606	642369	10401	59.15609756097561	61.7603115085088
chr5	NNT	43647923	43648440	3639	518	654496	10606	650857	10088	7.025096525096525	64.51794210943696
chr5	NNT	43612907	43613481	60447	575	654496	10606	594049	10031	105.12521739130435	59.22131392682684
chr5	NNT	43609515	43609551	0	37	654496	10606	654496	10569	0.0	61.92601002933106
chr5	NNT	43624031	43624120	51	90	654496	10606	654445	10516	0.5666666666666667	62.23326359832636
chr5	NNT	43647923	43648182	2015	260	654496	10606	652481	10346	7.75	63.066015851536825
chr5	PARP8	50668070	50668125	0	56	0	10081	0	10025	0.0	0.0
chr5	PARP8	50750150	50750188	0	39	0	10081	0	10042	0.0	0.0
chr5	PARP8	50760291	50760362	0	72	0	10081	0	10009	0.0	0.0
chr5	PARP8	50788522	50788589	0	68	0	10081	0	10013	0.0	0.0
chr5	PARP8	50821212	50821338	0	127	0	10081	0	9954	0.0	0.0
chr5	PARP8	50757118	50757215	0	98	0	10081	0	9983	0.0	0.0
chr5	PARP8	50759642	50759732	0	91	0	10081	0	9990	0.0	0.0
chr5	ITGA2	53026747	53026868	0	122	133	7926	133	7804	0.0	0.017042542286007177
chr5	ITGA2	53073117	53073259	0	143	133	7926	133	7783	0.0	0.01708852627521521
chr5	ITGA2	53078771	53078874	0	104	133	7926	133	7822	0.0	0.01700332395806699
chr5	ITGA2	53048642	53048770	0	129	133	7926	133	7797	0.0	0.017057842760035913
chr5	AC008966.1	53112239	53113034	0	796	0	7567	0	6771	0.0	0.0
chr5	NDUFS4	53573607	53573731	0	125	0	1181	0	1056	0.0	0.0
chr5	NDUFS4	53658550	53658624	0	75	0	1181	0	1106	0.0	0.0
chr5	NDUFS4	53604806	53604895	0	90	0	1181	0	1091	0.0	0.0
chr5	NDUFS4	53604723	53604895	0	173	0	1181	0	1008	0.0	0.0
chr5	LINC01033	54396996	54397134	0	139	48	3578	48	3439	0.0	0.01395754579819715
chr5	LINC01033	54395348	54395417	0	70	48	3578	48	3508	0.0	0.013683010262257697
chr5	LINC01033	54401642	54401865	0	224	48	3578	48	3354	0.0	0.014311270125223614
chr5	LINC01033	54317551	54317788	0	238	48	3578	48	3340	0.0	0.01437125748502994
chr5	LINC01033	54400436	54400532	0	97	48	3578	48	3481	0.0	0.013789141051422005
chr5	LINC01033	54340192	54340309	0	118	48	3578	48	3460	0.0	0.013872832369942197
chr5	LINC01033	54403522	54403788	0	267	48	3578	48	3311	0.0	0.014497130776200544
chr5	LINC01033	54402756	54403788	0	1033	48	3578	48	2545	0.0	0.018860510805500982
chr5	LINC01033	54400436	54400598	0	163	48	3578	48	3415	0.0	0.014055636896046853
chr5	GPX8	55161051	55161255	0	205	5413	3883	5413	3678	0.0	1.4717237629146276
chr5	GPX8	55160329	55160396	60	68	5413	3883	5353	3815	0.8823529411764706	1.4031454783748363
chr5	GPX8	55160993	55161255	0	263	5413	3883	5413	3620	0.0	1.495303867403315
chr5	MTREX	55328698	55328811	0	114	5151	6375	5151	6261	0.0	0.8227120268327743
chr5	DDX4	55760199	55760277	0	79	0	3844	0	3765	0.0	0.0
chr5	DDX4	55785296	55785344	0	49	0	3844	0	3795	0.0	0.0
chr5	DDX4	55790575	55790705	0	131	0	3844	0	3713	0.0	0.0
chr5	DDX4	55767880	55767940	0	61	0	3844	0	3783	0.0	0.0
chr5	DDX4	55779963	55780065	0	103	0	3844	0	3741	0.0	0.0
chr5	IL31RA	55868790	55868908	0	119	0	6391	0	6272	0.0	0.0
chr5	IL31RA	55853321	55853567	0	247	0	6391	0	6144	0.0	0.0
chr5	IL31RA	55852194	55852312	0	119	0	6391	0	6272	0.0	0.0
chr5	IL31RA	55866610	55866754	0	145	0	6391	0	6246	0.0	0.0
chr5	SETD9	56911168	56911536	0	369	0	2601	0	2232	0.0	0.0
chr5	SETD9	56911168	56911502	0	335	0	2601	0	2266	0.0	0.0
chr5	GPBP1	57214073	57214193	0	121	2346	5939	2346	5818	0.0	0.40323135097971813
chr5	GPBP1	57237112	57237172	0	61	2346	5939	2346	5878	0.0	0.3991153453555631
chr5	GPBP1	57221375	57221396	0	22	2346	5939	2346	5917	0.0	0.39648470508703737
chr5	LINCR-0003	57581605	57581688	0	84	0	4731	0	4647	0.0	0.0
chr5	LINCR-0003	57577833	57577924	0	92	0	4731	0	4639	0.0	0.0
chr5	LINCR-0003	57578835	57578914	0	80	0	4731	0	4651	0.0	0.0
chr5	LINCR-0003	57577698	57577924	0	227	0	4731	0	4504	0.0	0.0
chr5	PART1	60542649	60542830	0	182	487	12711	487	12529	0.0	0.03886982201293
chr5	PART1	60529403	60529543	0	141	487	12711	487	12570	0.0	0.03874303898170246
chr5	PART1	60533931	60534019	0	89	487	12711	487	12622	0.0	0.03858342576453811
chr5	PART1	60521019	60521643	0	625	487	12711	487	12086	0.0	0.04029455568426278
chr5	PART1	60521019	60522966	0	1948	487	12711	487	10763	0.0	0.04524760754436495
chr5	NDUFAF2	61073124	61073214	0	91	0	6915	0	6824	0.0	0.0
chr5	NDUFAF2	61098991	61099032	0	42	0	6915	0	6873	0.0	0.0
chr5	C5ORF64	61633847	61633970	0	124	40911	22226	40911	22102	0.0	1.8510089584652973
chr5	C5ORF64	61686882	61687070	3598	189	40911	22226	37313	22037	19.037037037037038	1.6931978036937878
chr5	C5ORF64	61751669	61751770	0	102	40911	22226	40911	22124	0.0	1.849168323992045
chr5	C5ORF64	61750336	61750544	0	209	40911	22226	40911	22017	0.0	1.8581550619975473
chr5	C5ORF64	61703865	61704108	900	244	40911	22226	40011	21982	3.6885245901639343	1.8201710490401237
chr5	C5ORF64	61713873	61713969	0	97	40911	22226	40911	22129	0.0	1.8487505083826652
chr5	C5ORF64	61643326	61643400	0	75	40911	22226	40911	22151	0.0	1.846914360525484
chr5	C5ORF64	61693495	61693560	1506	66	40911	22226	39405	22160	22.818181818181817	1.7782039711191335
chr5	AC008877.1	61881246	61881292	0	47	1424	913	1424	866	0.0	1.6443418013856812
chr5	KIF2A	62372437	62372551	0	115	357	12836	357	12721	0.0	0.028063831459790897
chr5	KIF2A	62308308	62308511	0	204	357	12836	357	12632	0.0	0.028261557948068398
chr5	KIF2A	62354314	62354369	0	56	357	12836	357	12780	0.0	0.027934272300469482
chr5	IPO11	62476682	62476753	0	72	102	7579	102	7507	0.0	0.013587318502730785
chr5	IPO11	62422504	62422568	0	65	102	7579	102	7514	0.0	0.013574660633484163
chr5	IPO11	62601763	62601848	0	86	102	7579	102	7493	0.0	0.013612705191512078
chr5	IPO11	62579400	62579483	0	84	102	7579	102	7495	0.0	0.013609072715143429
chr5	RGS7BP	64507710	64507877	0	168	13148	4635	13148	4467	0.0	2.9433624356391315
chr5	SHISAL2B	64694086	64694199	0	114	488	1241	488	1127	0.0	0.43300798580301686
chr5	SHISAL2B	64694086	64694182	0	97	488	1241	488	1144	0.0	0.42657342657342656
chr5	PPWD1	65563802	65563839	0	38	0	3309	0	3271	0.0	0.0
chr5	PPWD1	65568917	65568994	0	78	0	3309	0	3231	0.0	0.0
chr5	PPWD1	65567512	65567615	0	104	0	3309	0	3205	0.0	0.0
chr5	TRAPPC13	65637695	65637780	0	86	459	3663	459	3577	0.0	0.12831982107911657
chr5	TRAPPC13	65655635	65655653	0	19	459	3663	459	3644	0.0	0.12596048298572995
chr5	NLN	65758566	65758826	0	261	51	10957	51	10696	0.0	0.004768137621540763
chr5	NLN	65740894	65741000	0	107	51	10957	51	10850	0.0	0.004700460829493088
chr5	ERBIN	66075023	66075230	0	208	135	10160	135	9952	0.0	0.013565112540192926
chr5	ERBIN	66076874	66076949	0	76	135	10160	135	10084	0.0	0.01338754462514875
chr5	ERBIN	66072168	66072291	0	124	135	10160	135	10036	0.0	0.013451574332403349
chr5	ERBIN	66068876	66069020	0	145	135	10160	135	10015	0.0	0.01347978032950574
chr5	SREK1	66158808	66158932	0	125	524	17083	524	16958	0.0	0.03089987026772025
chr5	AC092353.1	66307093	66307313	0	221	1025	4196	1025	3975	0.0	0.2578616352201258
chr5	AC092353.1	66322832	66322940	0	109	1025	4196	1025	4087	0.0	0.25079520430633717
chr5	AC092353.1	66307671	66307775	82	105	1025	4196	943	4091	0.780952380952381	0.2305059887558054
chr5	AC092353.1	66307134	66307313	0	180	1025	4196	1025	4016	0.0	0.25522908366533864
chr5	AC092353.1	66307031	66307313	0	283	1025	4196	1025	3913	0.0	0.2619473549706108
chr5	MAST4	67149388	67149589	0	202	377	14654	377	14452	0.0	0.026086354829781343
chr5	MAST4	66916982	66917018	0	37	377	14654	377	14617	0.0	0.025791886159950744
chr5	MAST4	66902648	66902736	0	89	377	14654	377	14565	0.0	0.025883968417439066
chr5	MAST4	66963718	66963787	0	70	377	14654	377	14584	0.0	0.025850246845858474
chr5	MAST4	66870777	66870852	0	76	377	14654	377	14578	0.0	0.025860886266977638
chr5	MAST4	66964039	66964061	0	23	377	14654	377	14631	0.0	0.025767206616089125
chr5	MAST4	66963706	66963787	0	82	377	14654	377	14572	0.0	0.025871534449629426
chr5	MAST4	67094156	67094165	0	10	377	14654	377	14644	0.0	0.025744332149685877
chr5	AC112206.2	67620145	67620289	102	145	278	5824	176	5679	0.7034482758620689	0.030991371720373306
chr5	AC112206.2	67763974	67764093	0	120	278	5824	278	5704	0.0	0.04873772791023843
chr5	AC112206.2	67790448	67790538	0	91	278	5824	278	5733	0.0	0.048491191348334205
chr5	AC112206.2	67797628	67797756	0	129	278	5824	278	5695	0.0	0.04881474978050922
chr5	AC112206.2	67797349	67797756	0	408	278	5824	278	5416	0.0	0.05132939438700148
chr5	AC112206.2	67797349	67797507	0	159	278	5824	278	5665	0.0	0.04907325684024713
chr5	AC112206.2	67801625	67801698	0	74	278	5824	278	5750	0.0	0.04834782608695652
chr5	AC112206.2	67804279	67804325	0	47	278	5824	278	5777	0.0	0.048121862558421324
chr5	AC112206.2	67797349	67797492	0	144	278	5824	278	5680	0.0	0.04894366197183098
chr5	AC112206.2	67797393	67797507	0	115	278	5824	278	5709	0.0	0.04869504291469609
chr5	PIK3R1	68292258	68292361	0	104	592	10428	592	10324	0.0	0.05734211545912437
chr5	SLC30A5	69100806	69100929	0	124	459	5249	459	5125	0.0	0.0895609756097561
chr5	SLC30A5	69104630	69104716	0	87	459	5249	459	5162	0.0	0.08891902363425029
chr5	SLC30A5	69128003	69128132	0	130	459	5249	459	5119	0.0	0.08966595038093378
chr5	CCNB1	69174250	69174409	180	160	408	2442	228	2282	1.125	0.09991235758106924
chr5	CCNB1	69177238	69177349	0	112	408	2442	408	2330	0.0	0.17510729613733905
chr5	CCNB1	69177290	69177349	0	60	408	2442	408	2382	0.0	0.1712846347607053
chr5	CENPH	69195716	69195791	0	76	5382	2227	5382	2151	0.0	2.502092050209205
chr5	CENPH	69197052	69197109	0	58	5382	2227	5382	2169	0.0	2.4813278008298756
chr5	CENPH	69195716	69195750	0	35	5382	2227	5382	2192	0.0	2.4552919708029197
chr5	MRPS36	69226337	69226401	135	65	2450	1563	2315	1498	2.076923076923077	1.5453938584779707
chr5	CDK7	69252417	69252451	0	35	4518	2383	4518	2348	0.0	1.924190800681431
chr5	CDK7	69254601	69254669	36	69	4518	2383	4482	2314	0.5217391304347826	1.936905790838375
chr5	CDK7	69258042	69258153	0	112	4518	2383	4518	2271	0.0	1.989431968295905
chr5	CDK7	69259817	69259936	0	120	4518	2383	4518	2263	0.0	1.9964648696420682
chr5	CDK7	69254601	69254667	34	67	4518	2383	4484	2316	0.5074626865671642	1.936096718480138
chr5	CDK7	69255459	69255528	176	70	4518	2383	4342	2313	2.5142857142857142	1.8772157371379161
chr5	CDK7	69250744	69250831	0	88	4518	2383	4518	2295	0.0	1.968627450980392
chr5	RAD17	69371034	69371171	105	138	43435	4169	43330	4031	0.7608695652173914	10.749193748449516
chr5	RAD17	69372033	69372217	12828	185	43435	4169	30607	3984	69.34054054054054	7.682479919678715
chr5	RAD17	69373829	69374087	3124	259	43435	4169	40311	3910	12.061776061776062	10.309718670076727
chr5	RAD17	69410492	69410550	11	59	43435	4169	43424	4110	0.1864406779661017	10.565450121654502
chr5	RAD17	69371453	69371557	1745	105	43435	4169	41690	4064	16.61904761904762	10.258366141732283
chr5	RAD17	69392770	69392892	476	123	43435	4169	42959	4046	3.869918699186992	10.617647058823529
chr5	MARVELD2	69424600	69424636	148	37	6744	4722	6596	4685	4.0	1.407897545357524
chr5	OCLN	69509140	69509819	1275	680	8327	6771	7052	6091	1.875	1.157773764570678
chr5	GTF2H2C	69562672	69562770	0	99	252	6782	252	6683	0.0	0.03770761633996708
chr5	GTF2H2C	69566588	69566625	0	38	252	6782	252	6744	0.0	0.037366548042704624
chr5	GTF2H2C	69567726	69567777	0	52	252	6782	252	6730	0.0	0.037444279346210994
chr5	GTF2H2C	69568152	69568207	0	56	252	6782	252	6726	0.0	0.03746654772524532
chr5	SMN2	70069234	70069330	20	97	8592	2998	8572	2901	0.20618556701030927	2.9548431575318856
chr5	SMN2	70066933	70067134	0	202	8592	2998	8592	2796	0.0	3.072961373390558
chr5	SMN2	70071281	70071390	1	110	8592	2998	8591	2888	0.00909090909090909	2.9747229916897506
chr5	SMN2	70076520	70076574	50	55	8592	2998	8542	2943	0.9090909090909091	2.9024804621134894
chr5	SMN2	70069025	70069142	14	118	8592	2998	8578	2880	0.11864406779661017	2.9784722222222224
chr5	GTF2H2B	70421734	70421771	0	38	8433	3998	8433	3960	0.0	2.1295454545454544
chr5	GTF2H2B	70417821	70417919	300	99	8433	3998	8133	3899	3.0303030303030303	2.0859194665298793
chr5	GTF2H2B	70421736	70421771	0	36	8433	3998	8433	3962	0.0	2.128470469459869
chr5	SERF1A	70901411	70901471	0	61	0	2908	0	2847	0.0	0.0
chr5	SMN1	70942357	70942558	153	202	421606	3108	421453	2906	0.7574257425742574	145.02856159669648
chr5	SMN1	70944657	70944753	0	97	421606	3108	421606	3011	0.0	140.02191962803056
chr5	SMN1	70946706	70946815	1333	110	421606	3108	420273	2998	12.118181818181819	140.1844563042028
chr5	SMN1	70951940	70951994	0	55	421606	3108	421606	3053	0.0	138.09564362921716
chr5	SMN1	70944448	70944565	0	118	421606	3108	421606	2990	0.0	141.00535117056856
chr5	BDP1	71549419	71549606	0	188	258372	12440	258372	12252	0.0	21.08814887365328
chr5	BDP1	71539556	71539649	0	94	258372	12440	258372	12346	0.0	20.92758788271505
chr5	BDP1	71562774	71562895	0	122	258372	12440	258372	12318	0.0	20.97515830491963
chr5	MCCC2	71626639	71626753	153	115	75110	5197	74957	5082	1.3304347826086957	14.749508067689886
chr5	MAP1B	72116421	72116453	0	33	663508	12551	663508	12518	0.0	53.00431378814507
chr5	MAP1B	72193277	72193328	32	52	663508	12551	663476	12499	0.6153846153846154	53.08232658612689
chr5	PTCD2	72326611	72326741	51	131	17955	11876	17904	11745	0.3893129770992366	1.5243933588761176
chr5	PTCD2	72331257	72331375	0	119	17955	11876	17955	11757	0.0	1.527175299821383
chr5	PTCD2	72335017	72335096	0	80	17955	11876	17955	11796	0.0	1.5221261444557477
chr5	TNPO1	72855773	72855923	459	151	41979	12007	41520	11856	3.0397350993377485	3.5020242914979756
chr5	TNPO1	72875614	72875737	3180	124	41979	12007	38799	11883	25.64516129032258	3.265084574602373
chr5	FCHO2	72989426	72989501	0	76	2373	6094	2373	6018	0.0	0.39431704885343966
chr5	FCHO2	73015625	73015724	0	100	2373	6094	2373	5994	0.0	0.3958958958958959
chr5	AC116345.1	73289754	73289951	114	198	114	2303	0	2105	0.5757575757575758	0.0
chr5	BTF3	73499133	73499202	0	70	0	5245	0	5175	0.0	0.0
chr5	BTF3	73502487	73502601	0	115	0	5245	0	5130	0.0	0.0
chr5	BTF3	73504346	73504403	0	58	0	5245	0	5187	0.0	0.0
chr5	BTF3	73503936	73504028	0	93	0	5245	0	5152	0.0	0.0
chr5	UTP15	73567261	73567434	0	174	0	6337	0	6163	0.0	0.0
chr5	ARHGEF28	73897961	73898093	0	133	0	12567	0	12434	0.0	0.0
chr5	ARHGEF28	73923086	73923164	0	79	0	12567	0	12488	0.0	0.0
chr5	ARHGEF28	73627117	73627289	0	173	0	12567	0	12394	0.0	0.0
chr5	LINC01333	74325811	74325937	0	127	0	3595	0	3468	0.0	0.0
chr5	LINC01333	74338971	74339125	0	155	0	3595	0	3440	0.0	0.0
chr5	LINC01333	74324430	74324518	0	89	0	3595	0	3506	0.0	0.0
chr5	LINC01333	74324406	74324518	0	113	0	3595	0	3482	0.0	0.0
chr5	HEXB	74716586	74716673	0	88	29247	4800	29247	4712	0.0	6.206918505942275
chr5	NSA2	74773867	74774060	0	194	0	4969	0	4775	0.0	0.0
chr5	HMGCR	75355055	75355214	0	160	0	6074	0	5914	0.0	0.0
chr5	HMGCR	75359397	75359556	0	160	0	6074	0	5914	0.0	0.0
chr5	HMGCR	75359169	75359310	0	142	0	6074	0	5932	0.0	0.0
chr5	POLK	75547009	75547157	0	149	85577	8391	85577	8242	0.0	10.38303809754914
chr5	POLK	75590343	75590440	0	98	85577	8391	85577	8293	0.0	10.319184854696733
chr5	POLK	75593877	75594049	0	173	85577	8391	85577	8218	0.0	10.413360915064493
chr5	POLK	75593965	75594049	0	85	85577	8391	85577	8306	0.0	10.303033951360462
chr5	POLK	75568676	75568790	0	115	85577	8391	85577	8276	0.0	10.340381826969551
chr5	POLK	75596221	75597178	0	958	85577	8391	85577	7433	0.0	11.513117180142608
chr5	POLK	75568705	75568790	0	86	85577	8391	85577	8305	0.0	10.304274533413606
chr5	ANKDD1B	75669251	75669383	0	133	27	3255	27	3122	0.0	0.008648302370275465
chr5	ANKDD1B	75620314	75620413	0	100	27	3255	27	3155	0.0	0.00855784469096672
chr5	IQGAP2	76640932	76641103	0	172	206	7905	206	7733	0.0	0.026639079270658218
chr5	IQGAP2	76677217	76677350	0	134	206	7905	206	7771	0.0	0.02650881482434693
chr5	IQGAP2	76611019	76611183	0	165	206	7905	206	7740	0.0	0.026614987080103358
chr5	IQGAP2	76628684	76628752	0	69	206	7905	206	7836	0.0	0.02628892291985707
chr5	ZBED3-AS1	77089345	77089403	0	59	51	16340	51	16281	0.0	0.0031324857195503962
chr5	ZBED3-AS1	77100235	77100391	0	157	51	16340	51	16183	0.0	0.0031514552307977508
chr5	ZBED3-AS1	77098654	77098747	0	94	51	16340	51	16246	0.0	0.003139234273051828
chr5	ZBED3-AS1	77087486	77087619	0	134	51	16340	51	16206	0.0	0.0031469825990373935
chr5	ZBED3-AS1	77105655	77105689	0	35	51	16340	51	16305	0.0	0.0031278748850045997
chr5	PDE8B	77349418	77349559	0	142	1938	5620	1938	5478	0.0	0.3537787513691128
chr5	PDE8B	77408892	77409057	0	166	1938	5620	1938	5454	0.0	0.35533553355335534
chr5	ZBED3-AS1	77118319	77118521	0	203	51	16340	51	16137	0.0	0.003160438743260829
chr5	ZBED3-AS1	77134304	77134585	0	282	51	16340	51	16058	0.0	0.003175987046954789
chr5	ZBED3-AS1	77092491	77092533	0	43	51	16340	51	16297	0.0	0.00312941032091796
chr5	ZBED3-AS1	77098654	77098669	0	16	51	16340	51	16324	0.0	0.003124234256309728
chr5	ZBED3-AS1	77100325	77100391	0	67	51	16340	51	16273	0.0	0.003134025686720334
chr5	ZBED3-AS1	77088440	77088472	0	33	51	16340	51	16307	0.0	0.0031274912614214757
chr5	ZBED3-AS1	77139260	77139317	0	58	51	16340	51	16282	0.0	0.0031322933300577324
chr5	ZBED3-AS1	77088744	77088799	0	56	51	16340	51	16284	0.0	0.0031319086219602065
chr5	ZBED3-AS1	77139265	77139317	0	53	51	16340	51	16287	0.0	0.0031313317369681343
chr5	ZBED3-AS1	77146116	77147162	0	1047	51	16340	51	15293	0.0	0.0033348590858562743
chr5	PDE8B	77311993	77312053	1377	61	1938	5620	561	5559	22.57377049180328	0.10091743119266056
chr5	SCAMP1	78388836	78388914	0	79	1887	6758	1887	6679	0.0	0.2825273244497679
chr5	SCAMP1	78421800	78421960	0	161	1887	6758	1887	6597	0.0	0.28603910868576626
chr5	SCAMP1	78449932	78450034	0	103	1887	6758	1887	6655	0.0	0.2835462058602555
chr5	SCAMP1	78370619	78370805	0	187	1887	6758	1887	6571	0.0	0.2871709024501598
chr5	BHMT2	79071092	79071215	0	124	153	3744	153	3620	0.0	0.042265193370165745
chr5	BHMT2	79080686	79080878	0	193	153	3744	153	3551	0.0	0.04308645451985356
chr5	TENT2	79649061	79649190	0	130	255	5274	255	5144	0.0	0.049572317262830484
chr5	TENT2	79656957	79657001	0	45	255	5274	255	5229	0.0	0.04876649454962708
chr5	TENT2	79615074	79615163	0	90	255	5274	255	5184	0.0	0.04918981481481482
chr5	ZFYVE16	80448025	80448404	0	380	1122	13810	1122	13430	0.0	0.08354430379746836
chr5	ZFYVE16	80472760	80472923	0	164	1122	13810	1122	13646	0.0	0.08222189652645463
chr5	ZFYVE16	80411645	80411773	0	129	1122	13810	1122	13681	0.0	0.08201154886338718
chr5	ZFYVE16	80427491	80427545	0	55	1122	13810	1122	13755	0.0	0.08157033805888768
chr5	ZFYVE16	80435761	80435854	0	94	1122	13810	1122	13716	0.0	0.08180227471566054
chr5	ZFYVE16	80448282	80448404	0	123	1122	13810	1122	13687	0.0	0.0819755972820925
chr5	ZFYVE16	80443793	80443920	0	128	1122	13810	1122	13682	0.0	0.08200555474345855
chr5	MSH3	80848447	80848612	0	166	1165	5357	1165	5191	0.0	0.22442689269890195
chr5	MSH3	80830636	80830740	0	105	1165	5357	1165	5252	0.0	0.2218202589489718
chr5	RASGRF2	81216963	81216994	0	32	153	11063	153	11031	0.0	0.013870002719608376
chr5	CKMT2	81254992	81255214	0	223	294	2343	294	2120	0.0	0.13867924528301886
chr5	CKMT2	81256914	81257000	0	87	294	2343	294	2256	0.0	0.13031914893617022
chr5	CKMT2	81244041	81244205	0	165	294	2343	294	2178	0.0	0.1349862258953168
chr5	ZCCHC9	81304740	81305141	357	402	2870	5131	2513	4729	0.8880597014925373	0.5314019877352506
chr5	ATG10	81973154	81973301	0	148	204	5459	204	5311	0.0	0.03841084541517605
chr5	ATG10	81976192	81976327	0	136	204	5459	204	5323	0.0	0.03832425324065376
chr5	ATG10	82242796	82242882	0	87	204	5459	204	5372	0.0	0.0379746835443038
chr5	ATG10	82252561	82252659	0	99	204	5459	204	5360	0.0	0.03805970149253731
chr5	ATP6AP1L	82304933	82305481	0	549	5660	7245	5660	6696	0.0	0.8452807646356033
chr5	VCAN	83519348	83522309	0	2962	51	13298	51	10336	0.0	0.004934210526315789
chr5	VCAN	83537006	83542268	0	5263	51	13298	51	8035	0.0	0.006347230864965775
chr5	EDIL3-DT	84385887	84386055	0	169	0	8926	0	8757	0.0	0.0
chr5	NBPF22P	86284371	86284394	0	24	274	1612	274	1588	0.0	0.172544080604534
chr5	COX7C	86619738	86619878	1173	141	3162	1972	1989	1831	8.319148936170214	1.0862916439104315
chr5	RASA1	87366350	87366495	0	146	51	5265	51	5119	0.0	0.009962883375659308
chr5	RASA1	87269160	87269287	0	128	51	5265	51	5137	0.0	0.009927973525403932
chr5	RASA1	87330937	87330983	0	47	51	5265	51	5218	0.0	0.009773859716366424
chr5	TMEM161B-AS1	88426640	88426801	0	162	3060	27299	3060	27137	0.0	0.11276117477982091
chr5	TMEM161B-AS1	88410072	88410194	0	123	3060	27299	3060	27176	0.0	0.112599352369738
chr5	TMEM161B-AS1	88282714	88282866	0	153	3060	27299	3060	27146	0.0	0.11272378987696162
chr5	TMEM161B-AS1	88283009	88283086	0	78	3060	27299	3060	27221	0.0	0.11241321038903787
chr5	TMEM161B-AS1	88287435	88287622	59	188	3060	27299	3001	27111	0.31382978723404253	0.11069307661096972
chr5	TMEM161B-AS1	88285743	88285851	0	109	3060	27299	3060	27190	0.0	0.11254137550570062
chr5	TMEM161B-AS1	88285740	88285851	0	112	3060	27299	3060	27187	0.0	0.11255379409276492
chr5	TMEM161B-AS1	88281143	88281197	0	55	3060	27299	3060	27244	0.0	0.1123183086184114
chr5	TMEM161B-AS1	88269467	88269687	0	221	3060	27299	3060	27078	0.0	0.11300686904498117
chr5	TMEM161B-AS1	88291383	88291476	0	94	3060	27299	3060	27205	0.0	0.11247932365374012
chr5	TMEM161B-AS1	88287438	88287622	59	185	3060	27299	3001	27114	0.31891891891891894	0.110680829091982
chr5	TMEM161B-AS1	88269467	88269617	0	151	3060	27299	3060	27148	0.0	0.11271548548696037
chr5	TMEM161B-AS1	88282756	88282866	0	111	3060	27299	3060	27188	0.0	0.11254965425923201
chr5	TMEM161B-AS1	88424427	88424548	0	122	3060	27299	3060	27177	0.0	0.11259520918423667
chr5	TMEM161B-AS1	88319649	88319834	0	186	3060	27299	3060	27113	0.0	0.11286098919337587
chr5	MEF2C-AS1	88903937	88904160	0	224	0	7887	0	7663	0.0	0.0
chr5	MEF2C-AS1	88943015	88943122	0	108	0	7887	0	7779	0.0	0.0
chr5	MEF2C-AS1	88948135	88948215	0	81	0	7887	0	7806	0.0	0.0
chr5	MEF2C-AS1	88965840	88965915	0	76	0	7887	0	7811	0.0	0.0
chr5	MEF2C-AS1	88903937	88904203	0	267	0	7887	0	7620	0.0	0.0
chr5	MEF2C-AS1	88892166	88892277	0	112	0	7887	0	7775	0.0	0.0
chr5	AC113167.1	89963841	89963980	0	140	296	5770	296	5630	0.0	0.05257548845470693
chr5	ADGRV1	90619085	90619181	0	97	25342	33926	25342	33829	0.0	0.7491205770197168
chr5	ADGRV1	90683585	90684195	0	611	25342	33926	25342	33315	0.0	0.7606783731052079
chr5	ADGRV1	90756453	90756630	0	178	25342	33926	25342	33748	0.0	0.7509185729524712
chr5	ADGRV1	91150029	91150221	0	193	25342	33926	25342	33733	0.0	0.7512524827320428
chr5	ADGRV1	90672802	90672897	132	96	25342	33926	25210	33830	1.375	0.7451965710907479
chr5	ADGRV1	90825814	90825853	0	40	25342	33926	25342	33886	0.0	0.7478604733518267
chr5	ADGRV1	90850685	90850876	0	192	25342	33926	25342	33734	0.0	0.7512302128416435
chr5	ADGRV1	91153220	91153398	0	179	25342	33926	25342	33747	0.0	0.7509408243695735
chr5	AC114316.1	92400914	92401061	0	148	5304	7357	5304	7209	0.0	0.7357469829379941
chr5	AC106818.2	93666125	93666187	0	63	0	1992	0	1929	0.0	0.0
chr5	SLF1	94643272	94643435	0	164	102	6842	102	6678	0.0	0.015274034141958671
chr5	SLF1	94620064	94620171	0	108	102	6842	102	6734	0.0	0.015147015147015146
chr5	FAM81B	95420283	95420402	0	120	49	2488	49	2368	0.0	0.020692567567567568
chr5	FAM81B	95446561	95446697	49	137	49	2488	0	2351	0.35766423357664234	0.0
chr5	FAM81B	95424049	95424190	0	142	49	2488	49	2346	0.0	0.020886615515771527
chr5	FAM81B	95448720	95448796	0	77	49	2488	49	2411	0.0	0.020323517212774783
chr5	ARSK	95567889	95568049	0	161	0	4336	0	4175	0.0	0.0
chr5	ARSK	95580891	95580942	0	52	0	4336	0	4284	0.0	0.0
chr5	ARSK	95600624	95600683	0	60	0	4336	0	4276	0.0	0.0
chr5	RFESD	95654332	95654367	0	36	395	5072	395	5036	0.0	0.07843526608419381
chr5	RFESD	95653116	95653214	0	99	395	5072	395	4973	0.0	0.07942891614719486
chr5	RHOBTB3	95736888	95737075	0	188	0	7954	0	7766	0.0	0.0
chr5	RHOBTB3	95752238	95752350	0	113	0	7954	0	7841	0.0	0.0
chr5	LINC01554	95852791	95852926	0	136	0	2265	0	2129	0.0	0.0
chr5	AC104123.1	96308723	96308882	0	160	0	1494	0	1334	0.0	0.0
chr5	CAST	96726793	96726859	0	67	1543	12297	1543	12230	0.0	0.12616516762060506
chr5	CAST	96729152	96729209	0	58	1543	12297	1543	12239	0.0	0.12607239153525615
chr5	CAST	96730779	96730860	0	82	1543	12297	1543	12215	0.0	0.126320098239869
chr5	CAST	96746341	96746425	0	85	1543	12297	1543	12212	0.0	0.12635113003603013
chr5	CAST	96770530	96770602	0	73	1543	12297	1543	12224	0.0	0.1262270942408377
chr5	CAST	96662351	96662497	0	147	1543	12297	1543	12150	0.0	0.12699588477366255
chr5	CAST	96740744	96740783	0	40	1543	12297	1543	12257	0.0	0.12588724810312474
chr5	CAST	96736171	96736240	0	70	1543	12297	1543	12227	0.0	0.12619612333360594
chr5	CAST	96712348	96712473	0	126	1543	12297	1543	12171	0.0	0.12677676444006244
chr5	CAST	96726753	96726859	0	107	1543	12297	1543	12190	0.0	0.12657916324856439
chr5	CAST	96747344	96747392	0	49	1543	12297	1543	12248	0.0	0.12597975179621163
chr5	CAST	96757177	96757336	0	160	1543	12297	1543	12137	0.0	0.12713191068633106
chr5	AC008906.2	96805531	96805651	0	121	0	1265	0	1144	0.0	0.0
chr5	ERAP2	96886654	96886789	0	136	0	6815	0	6679	0.0	0.0
chr5	ERAP2	96896372	96896504	0	133	0	6815	0	6682	0.0	0.0
chr5	LINC01340	97521228	97521290	0	63	0	3722	0	3659	0.0	0.0
chr5	LINC01340	97528592	97528627	0	36	0	3722	0	3686	0.0	0.0
chr5	LINC02234	97899637	97899799	0	163	0	1845	0	1682	0.0	0.0
chr5	AC113385.1	100401623	100401783	0	161	0	2224	0	2063	0.0	0.0
chr5	AC113385.1	100408946	100409027	0	82	0	2224	0	2142	0.0	0.0
chr5	AC113385.1	100408798	100409027	0	230	0	2224	0	1994	0.0	0.0
chr5	FAM174A	100562053	100562188	0	136	0	1351	0	1215	0.0	0.0
chr5	PAM	102901355	102901413	0	59	6889	8786	6889	8727	0.0	0.7893892517474504
chr5	PAM	102974115	102974436	0	322	6889	8786	6889	8464	0.0	0.8139177693761814
chr5	PAM	103017333	103017433	0	101	6889	8786	6889	8685	0.0	0.7932066781807714
chr5	PAM	103025130	103025334	0	205	6889	8786	6889	8581	0.0	0.802820184127724
chr5	PAM	103028184	103028238	0	55	6889	8786	6889	8731	0.0	0.7890276027946398
chr5	PAM	103025133	103025334	0	202	6889	8786	6889	8584	0.0	0.8025396085740913
chr5	PAM	103028181	103028238	0	58	6889	8786	6889	8728	0.0	0.7892988084326306
chr5	PPIP5K2	103183233	103183407	0	175	102	17308	102	17133	0.0	0.005953423218350551
chr5	PPIP5K2	103186319	103186439	0	121	102	17308	102	17187	0.0	0.005934718100890208
chr5	PPIP5K2	103135992	103136114	0	123	102	17308	102	17185	0.0	0.005935408786732615
chr5	PPIP5K2	103187313	103187376	0	64	102	17308	102	17244	0.0	0.005915100904662491
chr5	PPIP5K2	103176865	103176910	0	46	102	17308	102	17262	0.0	0.005908932916232186
chr5	PPIP5K2	103189166	103189226	0	61	102	17308	102	17247	0.0	0.005914072012523917
chr5	FER	108768092	108768238	0	147	37322	13623	37322	13476	0.0	2.769516176907094
chr5	SLC25A46	110755995	110756121	0	127	2566	8281	2566	8154	0.0	0.31469217561932794
chr5	CAMK4	111376859	111376942	0	84	306	8858	306	8774	0.0	0.03487576931844085
chr5	CAMK4	111374849	111374912	0	64	306	8858	306	8794	0.0	0.03479645212644985
chr5	EPB41L4A-AS1	112161702	112161775	0	74	3774	3497	3774	3423	0.0	1.102541630148992
chr5	EPB41L4A-AS1	112161685	112161775	0	91	3774	3497	3774	3406	0.0	1.1080446271285966
chr5	APC	112754872	112755025	0	154	0	12460	0	12306	0.0	0.0
chr5	APC	112792445	112792529	0	85	0	12460	0	12375	0.0	0.0
chr5	APC	112810125	112810311	0	187	0	12460	0	12273	0.0	0.0
chr5	APC	112738352	112738460	0	109	0	12460	0	12351	0.0	0.0
chr5	APC	112823306	112823360	0	55	0	12460	0	12405	0.0	0.0
chr5	SRP19	112864456	112864528	0	73	26214	10412	26214	10339	0.0	2.535448302543766
chr5	SRP19	112862507	112862583	0	77	26214	10412	26214	10335	0.0	2.536429608127721
chr5	SRP19	112881956	112882049	0	94	26214	10412	26214	10318	0.0	2.540608645086257
chr5	SRP19	112864620	112864732	0	113	26214	10412	26214	10299	0.0	2.5452956597727936
chr5	DCP2	112993105	112993173	0	69	0	11385	0	11316	0.0	0.0
chr5	DCP2	113003941	113004077	0	137	0	11385	0	11248	0.0	0.0
chr5	DCP2	113007937	113008042	0	106	0	11385	0	11279	0.0	0.0
chr5	DCP2	112981041	112981171	0	131	0	11385	0	11254	0.0	0.0
chr5	KCNN2	114404437	114404856	0	420	3727	6097	3727	5677	0.0	0.6565087193940462
chr5	KCNN2	114490690	114490699	0	10	3727	6097	3727	6087	0.0	0.6122884836536882
chr5	KCNN2	114486697	114486803	0	107	3727	6097	3727	5990	0.0	0.6222036727879799
chr5	AC010226.1	115603045	115603156	0	112	0	4460	0	4348	0.0	0.0
chr5	AC010226.1	115619138	115619199	0	62	0	4460	0	4398	0.0	0.0
chr5	AP3S1	115870016	115870128	0	113	255	2941	255	2828	0.0	0.09016973125884017
chr5	AP3S1	115902884	115902992	0	109	255	2941	255	2832	0.0	0.09004237288135593
chr5	LVRN	116021711	116021752	0	42	0	6620	0	6578	0.0	0.0
chr5	LVRN	116010740	116010894	0	155	0	6620	0	6465	0.0	0.0
chr5	LVRN	116010514	116010894	0	381	0	6620	0	6239	0.0	0.0
chr5	COMMD10	116134067	116134178	0	112	30	2453	30	2341	0.0	0.012815036309269542
chr5	LINC02147	118187464	118187591	0	128	0	1755	0	1627	0.0	0.0
chr5	LINC02147	117995607	117995737	0	131	0	1755	0	1624	0.0	0.0
chr5	LINC02147	118187464	118187595	0	132	0	1755	0	1623	0.0	0.0
chr5	DMXL1	119118814	119119004	0	191	81	13391	81	13200	0.0	0.006136363636363636
chr5	DMXL1	119206833	119206896	0	64	81	13391	81	13327	0.0	0.006077886996323253
chr5	DMXL1	119233339	119233467	0	129	81	13391	81	13262	0.0	0.0061076760669582265
chr5	DMXL1	119238988	119239080	0	93	81	13391	81	13298	0.0	0.00609114152504136
chr5	TNFAIP8	119316184	119316302	0	119	153	8513	153	8394	0.0	0.018227305218012867
chr5	TNFAIP8	119356022	119356121	0	100	153	8513	153	8413	0.0	0.018186140496850113
chr5	TNFAIP8	119391364	119391483	0	120	153	8513	153	8393	0.0	0.018229476945073275
chr5	HSD17B4	119456314	119456368	0	55	153	10487	153	10432	0.0	0.014666411042944786
chr5	HSD17B4	119471635	119471700	0	66	153	10487	153	10421	0.0	0.01468189233278956
chr5	HSD17B4	119509429	119509494	0	66	153	10487	153	10421	0.0	0.01468189233278956
chr5	HSD17B4	119477797	119477894	0	98	153	10487	153	10389	0.0	0.014727115218019058
chr5	HSD17B4	119472457	119472576	0	120	153	10487	153	10367	0.0	0.014758367898138324
chr5	HSD17B4	119464613	119464693	0	81	153	10487	153	10406	0.0	0.014703055929271574
chr5	HSD17B4	119476449	119476499	0	51	153	10487	153	10436	0.0	0.014660789574549636
chr5	HSD17B4	119478093	119478141	0	49	153	10487	153	10438	0.0	0.014657980456026058
chr5	HSD17B4	119487268	119487400	0	133	153	10487	153	10354	0.0	0.014776897817268689
chr5	HSD17B4	119495715	119495813	0	99	153	10487	153	10388	0.0	0.014728532922603003
chr5	FAM170A	119632747	119632888	0	142	0	1383	0	1241	0.0	0.0
chr5	PRR16	120481168	120481293	0	126	0	2259	0	2133	0.0	0.0
chr5	AC008568.1	121324040	121324070	0	31	3403	6233	3403	6202	0.0	0.5486939696871976
chr5	AC008568.1	121326585	121326629	0	45	3403	6233	3403	6188	0.0	0.5499353587588882
chr5	ZNF474	122147874	122148007	1369	134	42501	2086	41132	1952	10.216417910447761	21.07172131147541
chr5	SNCAIP	122440461	122440516	0	56	2999	7286	2999	7230	0.0	0.41479944674965424
chr5	SNCAIP	122400985	122401126	0	142	2999	7286	2999	7144	0.0	0.4197928331466965
chr5	SNCAIP	122336787	122336904	602	118	2999	7286	2397	7168	5.101694915254237	0.3344029017857143
chr5	SNCAIP	122422867	122423739	2346	873	2999	7286	653	6413	2.6872852233676974	0.10182441914860439
chr5	SNCAIP	122431968	122432082	0	115	2999	7286	2999	7171	0.0	0.4182122437595872
chr5	SNCAIP	122452924	122452995	0	72	2999	7286	2999	7214	0.0	0.4157194344330469
chr5	SNCAIP	122388566	122389870	51	1305	2999	7286	2948	5981	0.03908045977011494	0.49289416485537535
chr5	SNCAIP	122425351	122425531	0	181	2999	7286	2999	7105	0.0	0.42209711470795214
chr5	SNX2	122799691	122799855	0	165	153	8164	153	7999	0.0	0.01912739092386548
chr5	SNX2	122827378	122827459	0	82	153	8164	153	8082	0.0	0.01893095768374165
chr5	SNX2	122799694	122799855	0	162	153	8164	153	8002	0.0	0.019120219945013745
chr5	SNX24	122891026	122891125	0	100	1464	3491	1464	3391	0.0	0.4317310527867886
chr5	SNX24	122853673	122853767	0	95	1464	3491	1464	3396	0.0	0.43109540636042404
chr5	SNX24	122965442	122965521	0	80	1464	3491	1464	3411	0.0	0.4291996481970097
chr5	SNX24	123022306	123022427	0	122	1464	3491	1464	3369	0.0	0.43455031166518254
chr5	PRDM6	123159513	123159638	0	126	897	9239	897	9113	0.0	0.09843081312410841
chr5	PRDM6	123155883	123156011	0	129	897	9239	897	9110	0.0	0.09846322722283206
chr5	CSNK1G3	123545416	123545841	0	426	5	5014	5	4588	0.0	0.001089799476896251
chr5	CSNK1G3	123605338	123605362	0	25	5	5014	5	4989	0.0	0.0010022048506714773
chr5	CSNK1G3	123595038	123595134	0	97	5	5014	5	4917	0.0	0.001016880211511084
chr5	LINC02240	124897755	124897813	0	59	357	7498	357	7439	0.0	0.0479903212797419
chr5	LINC02240	125003658	125003761	0	104	357	7498	357	7394	0.0	0.048282391127941575
chr5	GRAMD2B	126469676	126469788	0	113	1846	4832	1846	4719	0.0	0.39118457300275483
chr5	GRAMD2B	126466293	126466336	0	44	1846	4832	1846	4788	0.0	0.385547201336675
chr5	LMNB1	126815169	126815247	0	79	0	2990	0	2911	0.0	0.0
chr5	LMNB1	126777360	126777867	0	508	0	2990	0	2482	0.0	0.0
chr5	MEGF10	127433362	127433509	0	148	5722	9073	5722	8925	0.0	0.6411204481792717
chr5	MEGF10	127299995	127300046	0	52	5722	9073	5722	9021	0.0	0.6342977496951557
chr5	SLC12A2	128177104	128177152	0	49	51	10681	51	10632	0.0	0.004796839729119639
chr5	ADAMTS19	129461101	129461757	0	657	0	5416	0	4759	0.0	0.0
chr5	LYRM7	131187027	131187109	0	83	0	2776	0	2693	0.0	0.0
chr5	LYRM7	131182228	131182299	0	72	0	2776	0	2704	0.0	0.0
chr5	CDC42SE2	131315975	131316144	0	170	153	4667	153	4497	0.0	0.03402268178785857
chr5	PDLIM4	132271790	132271908	0	119	26897	2643	26897	2524	0.0	10.65649762282092
chr5	SLC22A5	132390689	132390904	0	216	8239	12829	8239	12613	0.0	0.653214936969793
chr5	SLC22A5	132378163	132378235	0	73	8239	12829	8239	12756	0.0	0.6458921291941048
chr5	SLC22A5	132390775	132390904	0	130	8239	12829	8239	12699	0.0	0.6487912434049925
chr5	IRF1-AS1	132449649	132449689	0	41	657	9736	657	9695	0.0	0.06776689014956162
chr5	RAD50	132591223	132591406	0	184	612	9711	612	9527	0.0	0.06423848010916343
chr5	RAD50	132591876	132592034	0	159	612	9711	612	9552	0.0	0.06407035175879397
chr5	AC116366.2	132556331	132556473	0	143	712	8990	712	8847	0.0	0.08047925850570815
chr5	AC116366.2	132486191	132486660	0	470	712	8990	712	8520	0.0	0.0835680751173709
chr5	RAD50	132594561	132594677	0	117	612	9711	612	9594	0.0	0.06378986866791744
chr5	RAD50	132590640	132590673	0	34	612	9711	612	9677	0.0	0.06324274051875581
chr5	RAD50	132592763	132592965	0	203	612	9711	612	9508	0.0	0.06436684896928901
chr5	AC116366.2	132642177	132642394	0	218	712	8990	712	8772	0.0	0.08116735066119471
chr5	IL13	132657065	132657244	0	180	0	2890	0	2710	0.0	0.0
chr5	IL13	132658289	132658360	0	72	0	2890	0	2818	0.0	0.0
chr5	IL4	132677780	132677881	0	102	0	825	0	723	0.0	0.0
chr5	IL4	132674458	132674506	0	49	0	825	0	776	0.0	0.0
chr5	AC004039.1	132692450	132692634	0	185	0	1795	0	1610	0.0	0.0
chr5	UQCRQ	132866868	132867035	0	168	0	2072	0	1904	0.0	0.0
chr5	TCF7	134144796	134144869	745	74	46149	7296	45404	7222	10.067567567567568	6.286901135419551
chr5	TCF7	134140795	134140888	0	94	46149	7296	46149	7202	0.0	6.4078033879477925
chr5	TCF7	134145259	134145340	0	82	46149	7296	46149	7214	0.0	6.397144441364015
chr5	UBE2B	134388976	134389052	0	77	0	2766	0	2689	0.0	0.0
chr5	JADE2	134573644	134573762	0	119	0	9892	0	9773	0.0	0.0
chr5	JADE2	134576767	134576896	0	130	0	9892	0	9762	0.0	0.0
chr5	JADE2	134576767	134577038	0	272	0	9892	0	9620	0.0	0.0
chr5	CAMLG	134741065	134741523	129	459	4855	7417	4726	6958	0.28104575163398693	0.6792181661396953
chr5	CAMLG	134741062	134741523	129	462	4855	7417	4726	6955	0.2792207792207792	0.6795111430625449
chr5	CAMLG	134743986	134744052	0	67	4855	7417	4855	7350	0.0	0.6605442176870748
chr5	DDX46	134781920	134782086	0	167	51	9230	51	9063	0.0	0.005627275736511089
chr5	DDX46	134782944	134783065	0	122	51	9230	51	9108	0.0	0.005599472990777339
chr5	DDX46	134790105	134790222	0	118	51	9230	51	9112	0.0	0.005597014925373134
chr5	DDX46	134766916	134767060	0	145	51	9230	51	9085	0.0	0.005613648871766648
chr5	C5ORF24	134846662	134846863	0	202	0	3870	0	3668	0.0	0.0
chr5	TXNDC15	134887694	134888182	0	489	0	4783	0	4294	0.0	0.0
chr5	C5ORF66	135074416	135074528	0	113	408	6660	408	6547	0.0	0.06231861921490759
chr5	AC114296.1	135824897	135825137	0	241	0	2718	0	2477	0.0	0.0
chr5	AC114296.1	135825724	135825995	0	272	0	2718	0	2446	0.0	0.0
chr5	SLC25A48	135880772	135880910	0	139	0	8390	0	8251	0.0	0.0
chr5	FBXL21P	135935622	135935724	0	103	0	3618	0	3515	0.0	0.0
chr5	FBXL21P	135940488	135940660	0	173	0	3618	0	3445	0.0	0.0
chr5	FBXL21P	135950785	135950944	0	160	0	3618	0	3458	0.0	0.0
chr5	TGFBI	136062662	136062687	0	26	0	5453	0	5427	0.0	0.0
chr5	TGFBI	136056448	136056530	0	83	0	5453	0	5370	0.0	0.0
chr5	TGFBI	136061499	136061579	0	81	0	5453	0	5372	0.0	0.0
chr5	SMAD5	136147831	136147906	0	76	175	8791	175	8715	0.0	0.020080321285140562
chr5	SMAD5	136152674	136152758	0	85	175	8791	175	8706	0.0	0.020101079715138984
chr5	AC112178.1	136504599	136504693	0	95	0	2762	0	2667	0.0	0.0
chr5	AC112178.1	136509879	136509958	0	80	0	2762	0	2682	0.0	0.0
chr5	AC112178.1	136508655	136508743	0	89	0	2762	0	2673	0.0	0.0
chr5	MYOT	137881972	137882105	0	134	6914	2836	6914	2702	0.0	2.5588452997779423
chr5	MYOT	137870876	137871007	0	132	6914	2836	6914	2704	0.0	2.5569526627218937
chr5	MYOT	137883383	137883591	0	209	6914	2836	6914	2627	0.0	2.6318995051389416
chr5	PKD2L2	137936319	137936427	0	109	105058	4377	105058	4268	0.0	24.61527647610122
chr5	KIF20A	138185511	138185710	0	200	4872	3854	4872	3654	0.0	1.3333333333333333
chr5	FAM53C	138335087	138335138	0	52	623	6668	623	6616	0.0	0.09416565900846433
chr5	FAM53C	138336788	138336807	0	20	623	6668	623	6648	0.0	0.09371239470517449
chr5	FAM53C	138341183	138341413	102	231	623	6668	521	6437	0.44155844155844154	0.08093832530681995
chr5	FAM53C	138341808	138341866	80	59	623	6668	543	6609	1.3559322033898304	0.08216068996822515
chr5	FAM53C	138341183	138341264	0	82	623	6668	623	6586	0.0	0.0945945945945946
chr5	KDM3B	138391012	138392261	663	1250	1122	7897	459	6647	0.5304	0.06905370843989769
chr5	REEP2	138441384	138441461	492	78	5475	3145	4983	3067	6.3076923076923075	1.6247147049233779
chr5	CTNNA1	138653063	138653122	0	60	28977	8697	28977	8637	0.0	3.3549843695727684
chr5	CTNNA1	138783176	138783372	0	197	28977	8697	28977	8500	0.0	3.4090588235294117
chr5	CTNNA1	138754693	138755163	867	471	28977	8697	28110	8226	1.8407643312101911	3.4172137126185267
chr5	CTNNA1	138917741	138917898	0	158	28977	8697	28977	8539	0.0	3.3934886989108795
chr5	CTNNA1	138932887	138932958	0	72	28977	8697	28977	8625	0.0	3.3596521739130436
chr5	CTNNA1	138781922	138782029	0	108	28977	8697	28977	8589	0.0	3.3737338456164863
chr5	CTNNA1	138932577	138932712	0	136	28977	8697	28977	8561	0.0	3.384768134563719
chr5	CTNNA1	138782289	138782403	0	115	28977	8697	28977	8582	0.0	3.3764856676765325
chr5	CTNNA1	138881041	138881137	0	97	28977	8697	28977	8600	0.0	3.369418604651163
chr5	CTNNA1	138881044	138881137	0	94	28977	8697	28977	8603	0.0	3.3682436359409507
chr5	CTNNA1	138880680	138880733	0	54	28977	8697	28977	8643	0.0	3.352655328011107
chr5	CTNNA1	138880213	138880288	0	76	28977	8697	28977	8621	0.0	3.3612109964041292
chr5	CTNNA1	138880194	138880288	0	95	28977	8697	28977	8602	0.0	3.3686352011160197
chr5	CTNNA1	138891182	138891211	76	30	28977	8697	28901	8667	2.533333333333333	3.3346025152878735
chr5	MATR3	139279050	139279129	0	80	765	12741	765	12661	0.0	0.060421767632888396
chr5	MATR3	139307238	139308327	0	1090	765	12741	765	11651	0.0	0.06565960003433181
chr5	MATR3	139315696	139315738	0	43	765	12741	765	12698	0.0	0.06024570798550953
chr5	MATR3	139326162	139326284	0	123	765	12741	765	12618	0.0	0.06062767475035663
chr5	MATR3	139278326	139278408	0	83	765	12741	765	12658	0.0	0.060436087849581294
chr5	MATR3	139278564	139278740	0	177	765	12741	765	12564	0.0	0.06088825214899714
chr5	MATR3	139279934	139280058	0	125	765	12741	765	12616	0.0	0.06063728598604946
chr5	MATR3	139314674	139314736	0	63	765	12741	765	12678	0.0	0.060340747752011356
chr5	MATR3	139291971	139292074	0	104	765	12741	765	12637	0.0	0.06053651974361003
chr5	MATR3	139293452	139293575	0	124	765	12741	765	12617	0.0	0.060632479987318695
chr5	MATR3	139283530	139283601	0	72	765	12741	765	12669	0.0	0.060383613544873316
chr5	MATR3	139307240	139308327	0	1088	765	12741	765	11653	0.0	0.06564833090191367
chr5	MATR3	139319333	139319501	0	169	765	12741	765	12572	0.0	0.06084950684059815
chr5	PAIP2	139343329	139343406	0	78	612	3154	612	3076	0.0	0.19895968790637192
chr5	PAIP2	139363758	139363922	0	165	612	3154	612	2989	0.0	0.20475075276012045
chr5	PAIP2	139364563	139364743	0	181	612	3154	612	2973	0.0	0.2058526740665994
chr5	UBE2D2	139562243	139562407	0	165	6388	3131	6388	2966	0.0	2.153742414025624
chr5	CXXC5	139679846	139679940	0	95	0	3537	0	3442	0.0	0.0
chr5	CXXC5	139665579	139665803	0	225	0	3537	0	3312	0.0	0.0
chr5	CYSTM1	140194445	140194652	0	208	152	1864	152	1656	0.0	0.09178743961352658
chr5	SLC4A9	140365833	140366022	0	190	3012	3662	3012	3472	0.0	0.8675115207373272
chr5	ANKHD1	140496519	140497278	105	760	10723	11160	10618	10400	0.13815789473684212	1.0209615384615385
chr5	ANKHD1	140507784	140507998	0	215	10723	11160	10723	10945	0.0	0.9797167656464139
chr5	ANKHD1	140535361	140535538	0	178	10723	11160	10723	10982	0.0	0.9764159533782554
chr5	ANKHD1	140464666	140464776	0	111	10723	11160	10723	11049	0.0	0.9704950674269165
chr5	ANKHD1	140472238	140472295	0	58	10723	11160	10723	11102	0.0	0.9658620068456134
chr5	TMCO6	140641017	140641220	0	204	186	3038	186	2834	0.0	0.06563161609033169
chr5	IK	140648882	140648980	0	99	0	2764	0	2665	0.0	0.0
chr5	HARS2	140691606	140691756	0	151	454766	3423	454766	3272	0.0	138.98716381418092
chr5	HARS2	140693490	140693665	0	176	454766	3423	454766	3247	0.0	140.05728364644287
chr5	HARS2	140696102	140696201	346	100	454766	3423	454420	3323	3.46	136.749924766777
chr5	HARS2	140691791	140692017	0	227	454766	3423	454766	3196	0.0	142.29224030037548
chr5	HARS2	140691794	140691937	0	144	454766	3423	454766	3279	0.0	138.69045440683135
chr5	HARS2	140693490	140693508	0	19	454766	3423	454766	3404	0.0	133.59753231492363
chr5	HARS2	140693590	140693665	0	76	454766	3423	454766	3347	0.0	135.87272184045415
chr5	HARS2	140696028	140696201	346	174	454766	3423	454420	3249	1.9885057471264367	139.86457371498923
chr5	PCDHA10	140867709	140867831	0	123	638691	6271	638691	6148	0.0	103.88597918022121
chr5	PCDHA10	140979673	140979926	60	254	638691	6271	638631	6017	0.23622047244094488	106.13777630048197
chr5	PCDHA10	140984065	140984249	204	185	638691	6271	638487	6086	1.1027027027027028	104.91077883667434
chr5	PCDHA10	140984065	140984149	204	85	638691	6271	638487	6186	2.4	103.21483996120271
chr5	PCDHGC3	141478393	141478546	0	154	244169	5020	244169	4866	0.0	50.17858610768599
chr5	RELL2	141638954	141639021	0	68	0	2590	0	2522	0.0	0.0
chr5	RELL2	141640411	141640445	0	35	0	2590	0	2555	0.0	0.0
chr5	RELL2	141639463	141639649	0	187	0	2590	0	2403	0.0	0.0
chr5	RNF14	141974803	141974955	2084	153	6565	4992	4481	4839	13.620915032679738	0.9260177722669973
chr5	RNF14	141970703	141970877	0	175	6565	4992	6565	4817	0.0	1.3628814614905542
chr5	RNF14	141978302	141978830	0	529	6565	4992	6565	4463	0.0	1.4709836432892673
chr5	RNF14	141980122	141980351	1934	230	6565	4992	4631	4762	8.408695652173913	0.9724905501889962
chr5	LINC01844	142757826	142757934	0	109	162	3613	162	3504	0.0	0.046232876712328765
chr5	LINC01844	142718115	142718266	36	152	162	3613	126	3461	0.23684210526315788	0.036405663103149376
chr5	LINC01844	142745207	142745718	0	512	162	3613	162	3101	0.0	0.05224121251209287
chr5	LINC01844	142757826	142757903	0	78	162	3613	162	3535	0.0	0.04582743988684583
chr5	LINC01844	142753100	142753227	0	128	162	3613	162	3485	0.0	0.04648493543758967
chr5	LINC01844	142756467	142756632	0	166	162	3613	162	3447	0.0	0.04699738903394256
chr5	LINC01844	142746477	142746585	0	109	162	3613	162	3504	0.0	0.046232876712328765
chr5	LINC01844	142750119	142750228	0	110	162	3613	162	3503	0.0	0.04624607479303454
chr5	LINC01844	142756507	142756632	0	126	162	3613	162	3487	0.0	0.04645827358761113
chr5	ARHGAP26	143207197	143207308	0	112	51	17199	51	17087	0.0	0.0029847252297067945
chr5	ARHGAP26	143207197	143207473	0	277	51	17199	51	16922	0.0	0.0030138281527006265
chr5	ARHGAP26	143207443	143207473	0	31	51	17199	51	17168	0.0	0.0029706430568499534
chr5	ARHGAP26	143207382	143207473	0	92	51	17199	51	17107	0.0	0.0029812357514467764
chr5	AC016598.2	143539840	143539996	57135	157	57943	2440	808	2283	363.9171974522293	0.3539202803328953
chr5	AC016598.2	143556786	143556927	0	142	57943	2440	57943	2298	0.0	25.214534377719755
chr5	AC008700.1	145436997	145437231	0	235	0	2327	0	2092	0.0	0.0
chr5	SH3RF2	146059865	146060224	0	360	0	7224	0	6864	0.0	0.0
chr5	TCERG1	146468340	146468403	0	64	0	8311	0	8247	0.0	0.0
chr5	TCERG1	146510066	146510160	0	95	0	8311	0	8216	0.0	0.0
chr5	STK32A	147275957	147276031	0	75	0	7512	0	7437	0.0	0.0
chr5	STK32A	147383889	147383954	0	66	0	7512	0	7446	0.0	0.0
chr5	JAKMIP2-AS1	147636276	147636405	0	130	0	2112	0	1982	0.0	0.0
chr5	SPINK5	148125523	148125613	0	91	0	4513	0	4422	0.0	0.0
chr5	SPINK14	148174233	148174370	0	138	0	298	0	160	0.0	0.0
chr5	SPINK7	148313373	148313399	0	27	0	849	0	822	0.0	0.0
chr5	FBXO38	148427212	148427947	357	736	6460	8747	6103	8011	0.485054347826087	0.761827487205093
chr5	FBXO38	148427212	148427722	357	511	6460	8747	6103	8236	0.6986301369863014	0.7410150558523555
chr5	SH3TC2-DT	149064070	149064174	0	105	102	3002	102	2897	0.0	0.035208836727649295
chr5	SH3TC2-DT	149064066	149064174	0	109	102	3002	102	2893	0.0	0.03525751814725199
chr5	ABLIM3	149242490	149242538	0	49	1692	7250	1692	7201	0.0	0.2349673656436606
chr5	ABLIM3	149240675	149240774	0	100	1692	7250	1692	7150	0.0	0.23664335664335664
chr5	ABLIM3	149199043	149199122	0	80	1692	7250	1692	7170	0.0	0.23598326359832636
chr5	AFAP1L1	149335593	149335722	0	130	25174	6588	25174	6458	0.0	3.898110870238464
chr5	GRPEL2	149349653	149349735	0	83	204	4424	204	4341	0.0	0.046993780234968904
chr5	PCYOX1L	149362966	149363016	148	51	98121	4004	97973	3953	2.9019607843137254	24.78446749304326
chr5	CARMN	149420480	149421068	0	589	617006	14357	617006	13768	0.0	44.81449738524114
chr5	CARMN	149423185	149423639	207	455	617006	14357	616799	13902	0.45494505494505494	44.367644943173644
chr5	CARMN	149420480	149420544	0	65	617006	14357	617006	14292	0.0	43.1714245731878
chr5	CARMN	149423185	149423309	0	125	617006	14357	617006	14232	0.0	43.353428892636316
chr5	CARMN	149415520	149415917	0	398	617006	14357	617006	13959	0.0	44.201303818325094
chr5	CARMN	149423433	149423639	207	207	617006	14357	616799	14150	1.0	43.590035335689045
chr5	PPARGC1B	149830766	149830883	51	118	43620	11362	43569	11244	0.4322033898305085	3.8748665955176094
chr5	SLC26A2	149961992	149962272	0	281	0	8585	0	8304	0.0	0.0
chr5	TCOF1	150374173	150374386	0	214	5079	10045	5079	9831	0.0	0.5166310649984742
chr5	TCOF1	150372005	150372236	102	232	5079	10045	4977	9813	0.4396551724137931	0.5071843472944054
chr5	TCOF1	150391543	150391657	0	115	5079	10045	5079	9930	0.0	0.5114803625377643
chr5	TCOF1	150383064	150383172	0	109	5079	10045	5079	9936	0.0	0.5111714975845411
chr5	TCOF1	150383061	150383172	0	112	5079	10045	5079	9933	0.0	0.5113258834189067
chr5	TCOF1	150364906	150365057	0	152	5079	10045	5079	9893	0.0	0.5133933083998787
chr5	TCOF1	150391543	150391795	0	253	5079	10045	5079	9792	0.0	0.5186887254901961
chr5	NDST1	150548217	150548388	0	172	7936	9532	7936	9360	0.0	0.8478632478632478
chr5	SMIM3	150782473	150782590	0	118	51	2452	51	2334	0.0	0.021850899742930592
chr5	GPX3	151027431	151027531	1	101	52	2903	51	2802	0.009900990099009901	0.018201284796573874
chr5	GPX3	151025339	151025493	0	155	52	2903	52	2748	0.0	0.018922852983988356
chr5	GPX3	151020827	151020854	0	28	52	2903	52	2875	0.0	0.01808695652173913
chr5	GPX3	151020827	151021253	0	427	52	2903	52	2476	0.0	0.0210016155088853
chr5	SLC36A1	151452342	151452491	0	150	102	6979	102	6829	0.0	0.014936301068970566
chr5	SLC36A1	151476854	151476980	0	127	102	6979	102	6852	0.0	0.0148861646234676
chr5	G3BP1	151790322	151790404	0	83	0	10115	0	10032	0.0	0.0
chr5	G3BP1	151794158	151794249	0	92	0	10115	0	10023	0.0	0.0
chr5	G3BP1	151797226	151797428	0	203	0	10115	0	9912	0.0	0.0
chr5	G3BP1	151799888	151800000	0	113	0	10115	0	10002	0.0	0.0
chr5	G3BP1	151800217	151800346	0	130	0	10115	0	9985	0.0	0.0
chr5	G3BP1	151800759	151800869	0	111	0	10115	0	10004	0.0	0.0
chr5	G3BP1	151786571	151786715	0	145	0	10115	0	9970	0.0	0.0
chr5	G3BP1	151803884	151804141	0	258	0	10115	0	9857	0.0	0.0
chr5	G3BP1	151786602	151786715	0	114	0	10115	0	10001	0.0	0.0
chr5	G3BP1	151803884	151804162	0	279	0	10115	0	9836	0.0	0.0
chr5	G3BP1	151792044	151792201	0	158	0	10115	0	9957	0.0	0.0
chr5	G3BP1	151799898	151800000	0	103	0	10115	0	10012	0.0	0.0
chr5	G3BP1	151786867	151786985	0	119	0	10115	0	9996	0.0	0.0
chr5	G3BP1	151799888	151800043	0	156	0	10115	0	9959	0.0	0.0
chr5	G3BP1	151772534	151772567	0	34	0	10115	0	10081	0.0	0.0
chr5	G3BP1	151787764	151787794	0	31	0	10115	0	10084	0.0	0.0
chr5	G3BP1	151772656	151772668	0	13	0	10115	0	10102	0.0	0.0
chr5	G3BP1	151777614	151777734	0	121	0	10115	0	9994	0.0	0.0
chr5	G3BP1	151774604	151774709	0	106	0	10115	0	10009	0.0	0.0
chr5	G3BP1	151803537	151803636	0	100	0	10115	0	10015	0.0	0.0
chr5	G3BP1	151786863	151786985	0	123	0	10115	0	9992	0.0	0.0
chr5	G3BP1	151794202	151794249	0	48	0	10115	0	10067	0.0	0.0
chr5	G3BP1	151796313	151796545	0	233	0	10115	0	9882	0.0	0.0
chr5	G3BP1	151797288	151797428	0	141	0	10115	0	9974	0.0	0.0
chr5	G3BP1	151803884	151803996	0	113	0	10115	0	10002	0.0	0.0
chr5	LINC01933	152231262	152231299	0	38	459	5425	459	5387	0.0	0.08520512344533135
chr5	GRIA1	153646927	153647167	0	241	21647	7564	21647	7323	0.0	2.9560289498839274
chr5	MFAP3	154049556	154050017	0	462	15637	7808	15637	7346	0.0	2.128641437517016
chr5	MFAP3	154121717	154121897	0	181	15637	7808	15637	7627	0.0	2.050216336698571
chr5	MFAP3	154134844	154134916	0	73	15637	7808	15637	7735	0.0	2.021590174531351
chr5	GALNT10	154376276	154376462	0	187	117497	10188	117497	10001	0.0	11.748525147485251
chr5	GALNT10	154356152	154356283	0	132	117497	10188	117497	10056	0.0	11.684268098647573
chr5	GALNT10	154412491	154412735	0	245	117497	10188	117497	9943	0.0	11.817057226189279
chr5	SAP30L	154451090	154451213	0	124	0	6350	0	6226	0.0	0.0
chr5	LARP1	154790644	154790710	0	67	282	8718	282	8651	0.0	0.03259738758525026
chr5	LARP1	154793799	154794000	0	202	282	8718	282	8516	0.0	0.033114138093001406
chr5	LARP1	154791945	154792013	0	69	282	8718	282	8649	0.0	0.03260492542490461
chr5	LARP1	154793799	154793922	0	124	282	8718	282	8594	0.0	0.032813590877356295
chr5	CNOT8	154863206	154863395	0	190	0	3723	0	3533	0.0	0.0
chr5	CNOT8	154865191	154865385	0	195	0	3723	0	3528	0.0	0.0
chr5	CNOT8	154870660	154870822	0	163	0	3723	0	3560	0.0	0.0
chr5	CNOT8	154859694	154859873	0	180	0	3723	0	3543	0.0	0.0
chr5	CNOT8	154867691	154867792	0	102	0	3723	0	3621	0.0	0.0
chr5	CNOT8	154859352	154859496	0	145	0	3723	0	3578	0.0	0.0
chr5	MRPL22	154950820	154950938	0	119	0	4098	0	3979	0.0	0.0
chr5	MRPL22	154950802	154950938	0	137	0	4098	0	3961	0.0	0.0
chr5	AC010476.2	155116550	155116678	0	129	0	6659	0	6530	0.0	0.0
chr5	SGCD	156329533	156329579	0	47	2078	10597	2078	10550	0.0	0.19696682464454976
chr5	SGCD	156393752	156393865	0	114	2078	10597	2078	10483	0.0	0.19822569875035773
chr5	ITK	157245725	157245790	0	66	298268	8492	298268	8426	0.0	35.39852836458581
chr5	ITK	157213566	157213697	56035	132	298268	8492	242233	8360	424.50757575757575	28.97523923444976
chr5	CYFIP2	157294782	157294860	0	79	629	10488	629	10409	0.0	0.06042847535786339
chr5	CYFIP2	157322941	157323016	0	76	629	10488	629	10412	0.0	0.060411064156742224
chr5	CYFIP2	157288611	157288659	0	49	629	10488	629	10439	0.0	0.06025481367947121
chr5	CYFIP2	157324770	157324900	0	131	629	10488	629	10357	0.0	0.06073187216375398
chr5	NIPAL4	157467048	157467105	0	58	0	4215	0	4157	0.0	0.0
chr5	NIPAL4	157460547	157460579	0	33	0	4215	0	4182	0.0	0.0
chr5	THG1L	157738621	157738734	0	114	0	3005	0	2891	0.0	0.0
chr5	AC091939.1	158502690	158502956	0	267	34642	2207	34642	1940	0.0	17.856701030927834
chr5	AC091939.1	158503152	158503382	0	231	34642	2207	34642	1976	0.0	17.531376518218625
chr5	AC008691.1	159392532	159392577	0	46	31509	13464	31509	13418	0.0	2.3482635266060514
chr5	FABP6	160228472	160228692	0	221	0	1096	0	875	0.0	0.0
chr5	GABRA1	161853665	161853727	0	63	51	6688	51	6625	0.0	0.00769811320754717
chr5	GABRA1	161850578	161850667	0	90	51	6688	51	6598	0.0	0.007729615034859048
chr5	GABRG2	162151729	162151753	0	25	918	19638	918	19613	0.0	0.04680569010350278
chr5	GABRG2	162068062	162068106	0	45	918	19638	918	19593	0.0	0.04685346807533303
chr5	GABRG2	162102553	162102673	0	121	918	19638	918	19517	0.0	0.04703591740533893
chr5	GABRG2	162103888	162104026	0	139	918	19638	918	19499	0.0	0.047079337401918046
chr5	GABRG2	162083500	162083621	0	122	918	19638	918	19516	0.0	0.047038327526132406
chr5	GABRG2	162129222	162129261	0	40	918	19638	918	19598	0.0	0.046841514440249005
chr5	GABRG2	162150994	162151753	0	760	918	19638	918	18878	0.0	0.048628032630575274
chr5	CCNG1	163442373	163442568	0	196	0	2779	0	2583	0.0	0.0
chr5	CCNG1	163439256	163439520	0	265	0	2779	0	2514	0.0	0.0
chr5	HMMR	163467700	163467748	0	49	0	3950	0	3901	0.0	0.0
chr5	HMMR	163467703	163467748	0	46	0	3950	0	3904	0.0	0.0
chr5	MAT2B	163513554	163513669	0	116	0	3962	0	3846	0.0	0.0
chr5	MAT2B	163512001	163512196	0	196	0	3962	0	3766	0.0	0.0
chr5	AC109466.1	164523946	164524004	0	59	102	9904	102	9845	0.0	0.010360589131538853
chr5	AC109466.1	164354140	164354224	0	85	102	9904	102	9819	0.0	0.010388023220287198
chr5	AC109466.1	164910706	164910758	0	53	102	9904	102	9851	0.0	0.010354278753426049
chr5	AC109466.1	164920134	164920195	0	62	102	9904	102	9842	0.0	0.010363747205852468
chr5	AC109466.1	164486673	164486741	0	69	102	9904	102	9835	0.0	0.010371123538383325
chr5	AC109466.1	164486668	164486741	0	74	102	9904	102	9830	0.0	0.010376398779247202
chr5	AC109466.1	164485952	164486097	0	146	102	9904	102	9758	0.0	0.010452961672473868
chr5	AC109466.1	164470058	164470468	0	411	102	9904	102	9493	0.0	0.010744759296323608
chr5	AC109466.1	164604817	164604892	0	76	102	9904	102	9828	0.0	0.010378510378510378
chr5	TENM2	168047426	168047549	0	124	57090	10863	57090	10739	0.0	5.316137442964894
chr5	TENM2	168211733	168211754	0	22	57090	10863	57090	10841	0.0	5.2661193616825015
chr5	TENM2	167875985	167876195	1736	211	57090	10863	55354	10652	8.227488151658768	5.196582801351859
chr5	WWC1	168406197	168406327	0	131	387	9685	387	9554	0.0	0.04050659409671342
chr5	WWC1	168441681	168441834	51	154	387	9685	336	9531	0.33116883116883117	0.03525338369531004
chr5	RARS1	168488152	168488270	0	119	0	3434	0	3315	0.0	0.0
chr5	RARS1	168493893	168494002	0	110	0	3434	0	3324	0.0	0.0
chr5	SLIT3-AS1	169017831	169017941	1336	111	46594	3135	45258	3024	12.036036036036036	14.966269841269842
chr5	SLIT3-AS1	169018392	169018641	4251	250	46594	3135	42343	2885	17.004	14.676949740034662
chr5	SLIT3-AS1	169022132	169022228	243	97	46594	3135	46351	3038	2.5051546391752577	15.25707702435813
chr5	SPDL1	169587198	169587372	0	175	8532	4769	8532	4594	0.0	1.8572050500653026
chr5	SPDL1	169587260	169587372	0	113	8532	4769	8532	4656	0.0	1.8324742268041236
chr5	SPDL1	169584087	169584166	0	80	8532	4769	8532	4689	0.0	1.8195777351247602
chr5	SPDL1	169590755	169590829	40	75	8532	4769	8492	4694	0.5333333333333333	1.8091180230080954
chr5	SPDL1	169590752	169590829	55	78	8532	4769	8477	4691	0.7051282051282052	1.8070773822212747
chr5	DOCK2	169708168	169708267	0	100	2766	11986	2766	11886	0.0	0.23271075214538112
chr5	DOCK2	169712119	169712223	0	105	2766	11986	2766	11881	0.0	0.2328086861375305
chr5	DOCK2	170008687	170008746	0	60	2766	11986	2766	11926	0.0	0.23193023645815863
chr5	DOCK2	169997973	169998024	0	52	2766	11986	2766	11934	0.0	0.2317747611865259
chr5	C5ORF58	170234114	170234198	0	85	245	2724	245	2639	0.0	0.09283819628647215
chr5	C5ORF58	170237270	170237365	0	96	245	2724	245	2628	0.0	0.09322678843226788
chr5	LINC01366	170332847	170332937	0	91	0	2997	0	2906	0.0	0.0
chr5	LINC01366	170332143	170332280	0	138	0	2997	0	2859	0.0	0.0
chr5	KCNIP1	170669498	170669660	0	163	4438	3382	4438	3219	0.0	1.3786890338614477
chr5	KCNIP1	170712853	170712886	0	34	4438	3382	4438	3348	0.0	1.3255675029868579
chr5	GABRP	170809567	170809755	0	189	7986	4637	7986	4448	0.0	1.7954136690647482
chr5	RANBP17	170896049	170896115	0	67	42796	9801	42796	9734	0.0	4.396548181631395
chr5	RANBP17	170918712	170918859	0	148	42796	9801	42796	9653	0.0	4.433440381228634
chr5	RANBP17	171028871	171028989	0	119	42796	9801	42796	9682	0.0	4.420161123734766
chr5	RANBP17	171284512	171284678	0	167	42796	9801	42796	9634	0.0	4.4421839319078265
chr5	RANBP17	171158333	171158494	0	162	42796	9801	42796	9639	0.0	4.43987965556593
chr5	RANBP17	171161406	171161466	0	61	42796	9801	42796	9740	0.0	4.3938398357289525
chr5	RANBP17	170983064	170983245	0	182	42796	9801	42796	9619	0.0	4.449111134213536
chr5	RANBP17	171183194	171183230	0	37	42796	9801	42796	9764	0.0	4.383039737812372
chr5	NPM1	171390050	171390130	1443	81	8229	6517	6786	6436	17.814814814814813	1.0543816034804225
chr5	NPM1	171400838	171400925	0	88	8229	6517	8229	6429	0.0	1.279981334577695
chr5	NPM1	171400152	171400210	0	59	8229	6517	8229	6458	0.0	1.274233508826262
chr5	NPM1	171406396	171407161	612	766	8229	6517	7617	5751	0.7989556135770235	1.3244653103808033
chr5	NPM1	171402813	171402900	0	88	8229	6517	8229	6429	0.0	1.279981334577695
chr5	NPM1	171407128	171407161	0	34	8229	6517	8229	6483	0.0	1.2693197593706618
chr5	NPM1	171390074	171390130	1443	57	8229	6517	6786	6460	25.31578947368421	1.0504643962848297
chr5	NEURL1B	172669784	172670330	204	547	1224	6432	1020	5885	0.37294332723948814	0.17332200509770604
chr5	NEURL1B	172683418	172684138	0	721	1224	6432	1224	5711	0.0	0.21432323586061985
chr5	AC110011.1	172818384	172818493	0	110	0	768	0	658	0.0	0.0
chr5	ERGIC1	172909666	172909761	0	96	2154	12376	2154	12280	0.0	0.1754071661237785
chr5	ERGIC1	172915517	172915690	0	174	2154	12376	2154	12202	0.0	0.17652843796099
chr5	ATP6V0E1	172994774	172994822	0	49	750709	1613	750709	1564	0.0	479.9929667519182
chr5	ATP6V0E1	173020237	173020367	816	131	750709	1613	749893	1482	6.229007633587786	506.00067476383265
chr5	BNIP1	173151565	173151694	0	130	0	2448	0	2318	0.0	0.0
chr5	BNIP1	173158743	173158845	0	103	0	2448	0	2345	0.0	0.0
chr5	AC016573.1	173439427	173439530	0	104	1696	1709	1696	1605	0.0	1.0566978193146417
chr5	AC016573.1	173385043	173385148	1208	106	1696	1709	488	1603	11.39622641509434	0.30442919525888956
chr5	AC016573.1	173424713	173424904	0	192	1696	1709	1696	1517	0.0	1.1179960448253132
chr5	AC016573.1	173444337	173444443	0	107	1696	1709	1696	1602	0.0	1.058676654182272
chr5	AC016573.1	173431676	173431720	0	45	1696	1709	1696	1664	0.0	1.0192307692307692
chr5	CPEB4	173932449	173932500	0	52	51	10457	51	10405	0.0	0.00490148966842864
chr5	CPEB4	173943025	173943049	0	25	51	10457	51	10432	0.0	0.0048888036809815955
chr5	CPEB4	173942883	173943049	0	167	51	10457	51	10290	0.0	0.004956268221574344
chr5	NSG2	174066203	174066279	0	77	56	3855	56	3778	0.0	0.014822657490735839
chr5	SFXN1	175491493	175491651	0	159	102	7421	102	7262	0.0	0.01404571743321399
chr5	HRH2	175691223	175691359	51	137	2754	5684	2703	5547	0.3722627737226277	0.4872904272579773
chr5	CPLX2	175805443	175805621	31793	179	40972	7033	9179	6854	177.6145251396648	1.339217974905165
chr5	CPLX2	175809332	175809392	72	61	40972	7033	40900	6972	1.180327868852459	5.866322432587493
chr5	FAM153B	176074635	176074829	16409	195	29499	5362	13090	5167	84.14871794871794	2.5333849429069093
chr5	FAM153B	176090369	176090394	0	26	29499	5362	29499	5336	0.0	5.5282983508245875
chr5	AC139491.5	176119814	176120001	0	188	0	4570	0	4382	0.0	0.0
chr5	FAM153B	176087111	176087255	0	145	29499	5362	29499	5217	0.0	5.654399079930995
chr5	FAM153B	176087111	176087205	0	95	29499	5362	29499	5267	0.0	5.600721473324473
chr5	AC139491.5	176123996	176124105	0	110	0	4570	0	4460	0.0	0.0
chr5	AC139491.5	176123996	176124120	0	125	0	4570	0	4445	0.0	0.0
chr5	SIMC1	176289653	176290955	0	1303	2335	5551	2335	4248	0.0	0.5496704331450094
chr5	CDHR2	176566945	176567114	102	170	6955	5382	6853	5212	0.6	1.3148503453568687
chr5	EIF4E1B	176637325	176637471	3499	147	5546	3096	2047	2949	23.802721088435373	0.6941336046117328
chr5	TSPAN17	176654894	176655020	0	127	714	4684	714	4557	0.0	0.15668202764976957
chr5	UNC5A	176869613	176869781	7735	169	148249	4335	140514	4166	45.76923076923077	33.72875660105617
chr5	ZNF346	177050702	177050936	1483	235	38365	6647	36882	6412	6.31063829787234	5.752027448533998
chr5	ZNF346	177044388	177044533	0	146	38365	6647	38365	6501	0.0	5.901399784648516
chr5	ZNF346	177050750	177050936	1231	187	38365	6647	37134	6460	6.5828877005347595	5.748297213622291
chr5	ZNF346	177023159	177023234	255	76	38365	6647	38110	6571	3.3552631578947367	5.799726069091462
chr5	FGFR4	177088238	177088514	245	277	6637	4774	6392	4497	0.8844765342960289	1.4213920391372026
chr5	FGFR4	177089857	177089940	0	84	6637	4774	6637	4690	0.0	1.415138592750533
chr5	NSD1	177238236	177238507	0	272	527	15548	527	15276	0.0	0.03449855983241686
chr5	NSD1	177169393	177169644	0	252	527	15548	527	15296	0.0	0.03445345188284519
chr5	NSD1	177169393	177169428	0	36	527	15548	527	15512	0.0	0.03397369778236204
chr5	NSD1	177229764	177229886	0	123	527	15548	527	15425	0.0	0.034165316045380874
chr5	RGS14	177371474	177371589	120	116	987	3486	867	3370	1.0344827586206897	0.25727002967359053
chr5	SLC34A1	177394027	177394195	0	169	34899	4414	34899	4245	0.0	8.221201413427561
chr5	GRK6	177432705	177432806	0	102	51	4375	51	4273	0.0	0.011935408378188626
chr5	PRR7	177453955	177454040	0	86	51	1759	51	1673	0.0	0.030484160191273164
chr5	B4GALT7	177601425	177601503	0	79	357	3050	357	2971	0.0	0.12016156176371592
chr5	AC106795.1	177836660	177836800	0	141	1917	3867	1917	3726	0.0	0.5144927536231884
chr5	FAM153CP	178052802	178052989	0	188	112828	18718	112828	18530	0.0	6.088936859147329
chr5	FAM153CP	178020259	178020453	0	195	112828	18718	112828	18523	0.0	6.091237920423257
chr5	FAM153CP	178016585	178016616	0	32	112828	18718	112828	18686	0.0	6.038103392914482
chr5	FAM153CP	178032742	178032886	2706	145	112828	18718	110122	18573	18.662068965517243	5.929144457007484
chr5	FAM153CP	178054737	178054807	72	71	112828	18718	112756	18647	1.0140845070422535	6.046870810318014
chr5	FAM153CP	178057648	178057818	255	171	112828	18718	112573	18547	1.4912280701754386	6.06960694451933
chr5	FAM153CP	178060874	178060994	0	121	112828	18718	112828	18597	0.0	6.067000053772114
chr5	FAM153CP	178023232	178023332	0	101	112828	18718	112828	18617	0.0	6.060482354836977
chr5	FAM153CP	178052908	178052989	0	82	112828	18718	112828	18636	0.0	6.054303498604851
chr5	FAM153CP	178054715	178054807	72	93	112828	18718	112756	18625	0.7741935483870968	6.054013422818792
chr5	RMND5B	178135172	178135312	0	141	7907	6205	7907	6064	0.0	1.3039248021108178
chr5	RMND5B	178138107	178138258	14	152	7907	6205	7893	6053	0.09210526315789473	1.3039814967784569
chr5	RMND5B	178133451	178133569	400	119	7907	6205	7507	6086	3.361344537815126	1.2334866907656918
chr5	RMND5B	178131236	178131376	0	141	7907	6205	7907	6064	0.0	1.3039248021108178
chr5	RMND5B	178136028	178136248	0	221	7907	6205	7907	5984	0.0	1.3213569518716577
chr5	HNRNPAB	178210131	178210272	0	142	0	2125	0	1983	0.0	0.0
chr5	ZFP2	178915684	178915771	0	88	0	2644	0	2556	0.0	0.0
chr5	RUFY1	179562546	179562664	0	119	0	5465	0	5346	0.0	0.0
chr5	RUFY1	179580946	179581012	0	67	0	5465	0	5398	0.0	0.0
chr5	RUFY1	179589545	179589647	0	103	0	5465	0	5362	0.0	0.0
chr5	RUFY1	179586330	179586475	0	146	0	5465	0	5319	0.0	0.0
chr5	RUFY1	179555649	179555790	0	142	0	5465	0	5323	0.0	0.0
chr5	AC136604.2	179662974	179663103	33127	130	36671	1529	3544	1399	254.8230769230769	2.5332380271622585
chr5	CANX	179707131	179707190	0	60	329794	6294	329794	6234	0.0	52.902470324029515
chr5	CANX	179699574	179699770	0	197	329794	6294	329794	6097	0.0	54.091192389699856
chr5	CANX	179705678	179705852	0	175	329794	6294	329794	6119	0.0	53.89671514953424
chr5	CANX	179704154	179704430	1375	277	329794	6294	328419	6017	4.963898916967509	54.581851420973905
chr5	CANX	179706257	179706331	165	75	329794	6294	329629	6219	2.2	53.003537546229296
chr5	CANX	179715898	179716000	0	103	329794	6294	329794	6191	0.0	53.26990793086739
chr5	SQSTM1	179821550	179821707	0	158	51	6804	51	6646	0.0	0.00767378874510984
chr5	CNOT6	180529274	180529388	0	115	0	6531	0	6416	0.0	0.0
chr5	CNOT6	180553385	180553471	0	87	0	6531	0	6444	0.0	0.0
chr5	CNOT6	180495420	180495588	0	169	0	6531	0	6362	0.0	0.0
chr5	CNOT6	180549930	180550117	0	188	0	6531	0	6343	0.0	0.0
chr5	LINC00847	180831758	180831941	153	184	510	5657	357	5473	0.8315217391304348	0.06522930750959255
chr5	LINC00847	180831735	180831806	0	72	510	5657	510	5585	0.0	0.09131602506714413
chr5	LINC00847	180832672	180832860	0	189	510	5657	510	5468	0.0	0.09326993416239941
chr5	LINC00847	180831735	180831941	153	207	510	5657	357	5450	0.7391304347826086	0.0655045871559633
chr5	LINC00847	180831758	180831806	0	49	510	5657	510	5608	0.0	0.09094151212553495
chr5	LINC00847	180832744	180832860	0	117	510	5657	510	5540	0.0	0.09205776173285199
chr5	BTNL8	180908585	180908933	0	349	3087	3933	3087	3584	0.0	0.861328125
chr5	BTNL8	180948354	180948375	0	22	3087	3933	3087	3911	0.0	0.789312196369215
chr5	BTNL8	180902345	180902396	80	52	3087	3933	3007	3881	1.5384615384615385	0.7748003091986602
chr5	BTNL9	181045466	181045598	0	133	0	5577	0	5444	0.0	0.0
chr5	TRIM41	181233412	181233435	0	24	0	9683	0	9659	0.0	0.0
chr5	SLC9A3	474882	475132	1419	251	639885	5771	638466	5520	5.653386454183267	115.6641304347826
chr5	ZDHHC11B	769954	770117	0	164	9851	5638	9851	5474	0.0	1.799598100109609
chr5	ZDHHC11B	783941	784124	0	184	9851	5638	9851	5454	0.0	1.8061972863953062
chr5	ZDHHC11	823388	823809	17212	422	56961	4756	39749	4334	40.78672985781991	9.17143516382095
chr5	ZDHHC11	823388	824093	27345	706	56961	4756	29616	4050	38.73229461756374	7.312592592592592
chr5	BRD9	868606	869119	6883	514	714915	9010	708032	8496	13.391050583657588	83.33709981167608
chr5	BRD9	883350	883450	2874	101	714915	9010	712041	8909	28.455445544554454	79.92378493658099
chr5	BRD9	888234	888407	357	174	714915	9010	714558	8836	2.0517241379310347	80.86894522408329
chr5	BRD9	881106	881182	73	77	714915	9010	714842	8933	0.948051948051948	80.0226127840591
chr5	BRD9	869244	869394	1336	151	714915	9010	713579	8859	8.847682119205299	80.54848176995147
chr5	BRD9	869244	869404	2026	161	714915	9010	712889	8849	12.583850931677018	80.56153237653972
chr5	BRD9	869037	869119	1581	83	714915	9010	713334	8927	19.048192771084338	79.90747171502184
chr5	BRD9	883937	884070	5539	134	714915	9010	709376	8876	41.33582089552239	79.9206849932402
chr5	SLC12A7	1056581	1056596	48	16	428489	6029	428441	6013	3.0	71.25245301846
chr5	TERT	1264403	1264592	3411	190	17557	5782	14146	5592	17.95263157894737	2.5296852646638053
chr5	LINC01511	1368319	1368391	0	73	3308	3376	3308	3303	0.0	1.0015137753557373
chr5	AC026412.1	1630408	1630566	1426	159	88401	3371	86975	3212	8.968553459119496	27.078144458281443
chr5	AC026412.1	1632643	1632751	541	109	88401	3371	87860	3262	4.963302752293578	26.934396076026978
chr5	AC026412.4	1640370	1640774	0	405	0	2235	0	1830	0.0	0.0
chr5	IRX4	1880065	1880143	0	79	663	2906	663	2827	0.0	0.23452423063318004
chr5	NSUN2	6605272	6605408	23422	137	738830	5525	715408	5388	170.96350364963504	132.7780252412769
chr5	NSUN2	6622015	6622100	1189	86	738830	5525	737641	5439	13.825581395348838	135.62070233498804
chr5	NSUN2	6631872	6631977	0	106	738830	5525	738830	5419	0.0	136.3406532570585
chr5	FASTKD3	7866645	7868196	53595	1552	78926	2765	25331	1213	34.532860824742265	20.882934872217643
chr5	TAS2R1	9659420	9659581	0	162	0	1281	0	1119	0.0	0.0
chr5	ATPSCKMT	10235210	10235261	207	52	107541	3292	107334	3240	3.980769230769231	33.12777777777778
chr5	ATPSCKMT	10244433	10244500	0	68	107541	3292	107541	3224	0.0	33.35638957816377
chr5	ATPSCKMT	10236837	10237040	0	204	107541	3292	107541	3088	0.0	34.825453367875646
chr5	CMBL	10282196	10282288	0	93	207365	4891	207365	4798	0.0	43.21904960400167
chr5	DAP	10683528	10683571	3	44	995623	3328	995620	3284	0.06818181818181818	303.17295980511574
chr5	CTNND2	10988110	10988242	0	133	0	7298	0	7165	0.0	0.0
chr5	CTNND2	11384664	11385229	0	566	0	7298	0	6732	0.0	0.0
chr5	CTNND2	10986637	10986741	0	105	0	7298	0	7193	0.0	0.0
chr5	CTNND2	11083880	11083955	0	76	0	7298	0	7222	0.0	0.0
chr5	CTNND2	11397030	11397203	0	174	0	7298	0	7124	0.0	0.0
chr5	DNAH5	13765975	13766179	0	205	24734	16556	24734	16351	0.0	1.5126903553299493
chr5	CTD-2350J17.1	15617179	15617341	0	163	0	1269	0	1106	0.0	0.0
chr5	MARCHF11	16090888	16091081	0	194	0	1882	0	1688	0.0	0.0
chr5	MYO10	16877608	16877707	0	100	441108	13792	441108	13692	0.0	32.21647677475898
chr5	MYO10	16738135	16738398	1173	264	441108	13792	439935	13528	4.443181818181818	32.520328208160855
chr5	AC106744.2	19037514	19037714	0	201	0	1160	0	959	0.0	0.0
chr5	CDH18	19981059	19981178	0	120	181	6506	181	6386	0.0	0.028343250861259005
chr5	CDH18	19878031	19878090	0	60	181	6506	181	6446	0.0	0.028079429103319887
chr5	AC093274.1	21339601	21339652	0	52	3793	6003	3793	5951	0.0	0.6373718702739035
chr5	CDH12	21854670	21854790	0	121	102	5671	102	5550	0.0	0.018378378378378378
chr5	CDH12	22405256	22405351	0	96	102	5671	102	5575	0.0	0.01829596412556054
chr5	CDH10	24505111	24505248	170	138	28272	3673	28102	3535	1.2318840579710144	7.94964639321075
chr5	LINC02228	25167527	25167588	0	62	33732	4908	33732	4846	0.0	6.960792406108131
chr5	CDH9	27028253	27028370	0	118	0	4220	0	4102	0.0	0.0
chr5	LINC02064	29381852	29381962	0	111	0	4274	0	4163	0.0	0.0
chr5	LINC02064	29354204	29354391	0	188	0	4274	0	4086	0.0	0.0
chr5	LINC02064	29389810	29389935	0	126	0	4274	0	4148	0.0	0.0
chr5	LINC02064	29363317	29363382	0	66	0	4274	0	4208	0.0	0.0
chr5	LINC02064	29389810	29389939	0	130	0	4274	0	4144	0.0	0.0
chr5	DROSHA	31515453	31515564	411	112	208717	7164	208306	7052	3.669642857142857	29.538570618264323
chr5	DROSHA	31521122	31521215	0	94	208717	7164	208717	7070	0.0	29.521499292786423
chr5	DROSHA	31531449	31531525	407	77	208717	7164	208310	7087	5.285714285714286	29.393255256102723
chr5	GOLPH3	32143748	32143880	23420	133	1643853	2746	1620433	2613	176.09022556390977	620.1427477994642
chr5	MTMR12	32234961	32235129	10222	169	469501	5541	459279	5372	60.485207100591715	85.49497393894266
chr5	MTMR12	32276681	32276742	0	62	469501	5541	469501	5479	0.0	85.69100200766563
chr5	MTMR12	32233772	32233934	9557	163	469501	5541	459944	5378	58.6319018404908	85.5232428412049
chr5	MTMR12	32296353	32296470	32	118	469501	5541	469469	5423	0.2711864406779661	86.56997971602433
chr5	ZFR	32380074	32380172	515	99	595181	5928	594666	5829	5.202020202020202	102.01852804940813
chr5	AC010343.3	33263499	33263666	92	168	1228	3258	1136	3090	0.5476190476190477	0.36763754045307445
chr5	SLC45A2	33963690	33964016	102	327	258	3230	156	2903	0.3119266055045872	0.05373751291767138
chr5	SLC45A2	33982235	33982412	0	178	258	3230	258	3052	0.0	0.08453473132372215
chr5	AMACR	34004573	34004734	9296	162	146800	2515	137504	2353	57.382716049382715	58.43773905652359
chr5	AMACR	33993947	33994120	0	174	146800	2515	146800	2341	0.0	62.70824434002563
chr5	AMACR	33994077	33994120	0	44	146800	2515	146800	2471	0.0	59.4091460946985
chr5	AC138409.2	34200820	34200921	0	102	24303	6582	24303	6480	0.0	3.750462962962963
chr5	RAD1	34913469	34913578	2456	110	366169	6562	363713	6452	22.327272727272728	56.372132672039676
chr5	RAD1	34913926	34914026	2309	101	366169	6562	363860	6461	22.861386138613863	56.316359696641385
chr5	AGXT2	35040574	35040663	0	90	402	3817	402	3727	0.0	0.1078615508451838
chr5	PRLR	35065948	35066102	1875	155	10163	3630	8288	3475	12.096774193548388	2.385035971223022
chr5	PRLR	35068778	35068878	0	101	10163	3630	10163	3529	0.0	2.8798526494757724
chr5	PRLR	35086207	35086340	0	134	10163	3630	10163	3496	0.0	2.9070366132723113
chr5	PRLR	35084469	35084639	0	171	10163	3630	10163	3459	0.0	2.9381324082104654
chr5	PRLR	35072574	35072744	126	171	10163	3630	10037	3459	0.7368421052631579	2.901705695287655
chr5	PRLR	35152786	35152973	0	188	10163	3630	10163	3442	0.0	2.952643811737362
chr5	PRLR	35195550	35195713	0	164	10163	3630	10163	3466	0.0	2.932198499711483
chr5	UGT3A1	35988449	35988551	0	103	0	8317	0	8214	0.0	0.0
chr5	UGT3A1	35961988	35962951	0	964	0	8317	0	7353	0.0	0.0
chr5	UGT3A2	36048888	36049420	1836	533	2448	2692	612	2159	3.444652908067542	0.28346456692913385
chr5	UGT3A2	36064248	36064350	0	103	2448	2692	2448	2589	0.0	0.9455388180764774
chr5	NADK2	36200226	36200280	0	55	373813	5032	373813	4977	0.0	75.10809724733775
chr5	NADK2	36207169	36207265	0	97	373813	5032	373813	4935	0.0	75.74731509625127
chr5	NADK2	36208624	36208690	0	67	373813	5032	373813	4965	0.0	75.2896273917422
chr5	RANBP3L	36268192	36268267	0	76	1053	4900	1053	4824	0.0	0.21828358208955223
chr5	CPLANE1	37139339	37139370	0	32	73165	20159	73165	20127	0.0	3.6351666915089185
chr5	CPLANE1	37206196	37206425	1071	230	73165	20159	72094	19929	4.656521739130435	3.617542275076522
chr5	CPLANE1	37243012	37243119	188	108	73165	20159	72977	20051	1.7407407407407407	3.639569098798065
chr5	CPLANE1	37244374	37244607	436	234	73165	20159	72729	19925	1.8632478632478633	3.650138017565872
chr5	CPLANE1	37157312	37157420	0	109	73165	20159	73165	20050	0.0	3.6491271820448876
chr5	CPLANE1	37206196	37206296	0	101	73165	20159	73165	20058	0.0	3.6476717519194337
chr5	CPLANE1	37230661	37230718	0	58	73165	20159	73165	20101	0.0	3.6398686632505846
chr5	NUP155	37310551	37310743	12182	193	405068	9160	392886	8967	63.119170984455955	43.814653730344595
chr5	GDNF	37824009	37824089	0	81	131158	4634	131158	4553	0.0	28.806940478805185
chr5	LIFR	38555004	38555065	0	62	46564	12186	46564	12124	0.0	3.840646651270208
chr5	OSMR-AS1	38715639	38715802	0	164	11550	4879	11550	4715	0.0	2.449628844114528
chr5	RICTOR	39074110	39074158	0	49	184173	12689	184173	12640	0.0	14.570648734177215
chr5	RICTOR	38949355	38949427	0	73	184173	12689	184173	12616	0.0	14.598367152821814
chr5	FYB1	39125997	39126135	0	139	4695	7176	4695	7037	0.0	0.6671877220406424
chr5	FYB1	39125971	39126135	0	165	4695	7176	4695	7011	0.0	0.6696619597774925
chr5	FYB1	39250670	39250806	0	137	4695	7176	4695	7039	0.0	0.6669981531467538
chr5	FYB1	39212677	39213017	0	341	4695	7176	4695	6835	0.0	0.6869056327724945
chr5	FYB1	39211057	39211091	0	35	4695	7176	4695	7141	0.0	0.6574709424450357
chr5	FYB1	39208863	39208964	0	102	4695	7176	4695	7074	0.0	0.6636980491942324
chr5	DAB2	39382617	39383271	91390	655	367498	7579	276108	6924	139.5267175572519	39.87694974003466
chr5	DAB2	39388304	39388367	576	64	367498	7579	366922	7515	9.0	48.82528276779774
chr5	DAB2	39423703	39423897	68	195	367498	7579	367430	7384	0.3487179487179487	49.76029252437703
chr5	DAB2	39417188	39417284	0	97	367498	7579	367498	7482	0.0	49.11761561079925
chr5	DAB2	39418180	39418345	0	166	367498	7579	367498	7413	0.0	49.57480102522595
chr5	TTC33	40728344	40728476	1742	133	127150	9717	125408	9584	13.097744360902256	13.085141903171953
chr5	TTC33	40730261	40730343	0	83	127150	9717	127150	9634	0.0	13.198048577953083
chr5	PRKAA1	40769415	40769503	42	89	853192	6430	853150	6341	0.47191011235955055	134.545024444094
chr5	PRKAA1	40774927	40774972	173	46	853192	6430	853019	6384	3.760869565217391	133.61826441102758
chr5	RPL37	40834180	40834265	170	86	365583	1105	365413	1019	1.9767441860465116	358.59960745829244
chr5	RPL37	40833960	40834037	1360	78	365583	1105	364223	1027	17.435897435897434	354.6475170399221
chr5	C6	41203577	41203734	0	158	0	4881	0	4723	0.0	0.0
chr5	SELENOP	42804655	42804773	0	119	204	5511	204	5392	0.0	0.037833827893175076
chr5	SELENOP	42806895	42807108	0	214	204	5511	204	5297	0.0	0.03851236548989995
chr5	SELENOP	42808150	42808366	48	217	204	5511	156	5294	0.22119815668202766	0.029467321496033247
chr5	SELENOP	42809759	42809788	0	30	204	5511	204	5481	0.0	0.037219485495347565
chr5	SELENOP	42810690	42810778	0	89	204	5511	204	5422	0.0	0.03762449280708226
chr5	AC025171.1	43016361	43016477	1972	117	193907	4315	191935	4198	16.854700854700855	45.72058122915674
chr5	HMGCS1	43307765	43307824	204	60	346908	6361	346704	6301	3.4	55.023647040152355
chr5	TMEM267	43476113	43476258	0	146	73773	1523	73773	1377	0.0	53.57516339869281
chr5	TMEM267	43453657	43454043	13011	387	73773	1523	60762	1136	33.62015503875969	53.48767605633803
chr5	TMEM267	43454454	43454605	1160	152	73773	1523	72613	1371	7.631578947368421	52.963530269876
chr5	TMEM267	43479889	43479987	723	99	73773	1523	73050	1424	7.303030303030303	51.299157303370784
chr5	C5ORF34	43502371	43502495	1382	125	108912	2821	107530	2696	11.056	39.88501483679525
chr5	C5ORF34	43509144	43509375	7504	232	108912	2821	101408	2589	32.3448275862069	39.168791039011204
chr5	C5ORF34	43508576	43508666	0	91	108912	2821	108912	2730	0.0	39.894505494505495
chr5	PAIP1	43529785	43529879	102	95	289038	3400	288936	3305	1.0736842105263158	87.42390317700453
chr5	PAIP1	43538923	43539035	1177	113	289038	3400	287861	3287	10.415929203539823	87.57560085184059
chr5	PAIP1	43555829	43555999	58801	171	289038	3400	230237	3229	343.8654970760234	71.30288014865283
chr5	PAIP1	43529796	43529879	102	84	289038	3400	288936	3316	1.2142857142857142	87.13389626055489
chr5	NNT-AS1	43583466	43583566	1487	101	309889	6365	308402	6264	14.722772277227723	49.23403575989783
chr5	LINC02224	44504292	44504472	0	181	0	1438	0	1257	0.0	0.0
chr5	MRPS30-DT	44777036	44777101	0	66	2543	1997	2543	1931	0.0	1.3169342309684102
chr5	MRPS30-DT	44747626	44747696	0	71	2543	1997	2543	1926	0.0	1.3203530633437175
chr5	MRPS30-DT	44777908	44777992	0	85	2543	1997	2543	1912	0.0	1.330020920502092
chr5	HCN1	45266514	45266563	0	50	3967	10283	3967	10233	0.0	0.38766735072803676
chr5	AC025180.1	52978267	52978399	855	133	969	2429	114	2296	6.428571428571429	0.04965156794425087
chr5	AC025180.1	52978251	52978399	969	149	969	2429	0	2280	6.503355704697986	0.0
chr5	MOCS2	53101358	53101509	0	152	459	5555	459	5403	0.0	0.084952803997779
chr5	MOCS2	53102096	53102224	51	129	459	5555	408	5426	0.3953488372093023	0.07519351271654995
chr5	LINC02105	53778267	53778377	0	111	55	1891	55	1780	0.0	0.03089887640449438
chr5	LINC02105	53816052	53816192	51	141	55	1891	4	1750	0.3617021276595745	0.002285714285714286
chr5	ESM1	54981996	54982146	0	151	7542	2697	7542	2546	0.0	2.96229379418696
chr5	AC034238.1	55023137	55023337	204	201	408	4159	204	3958	1.0149253731343284	0.05154118241536129
chr5	AC034238.1	55024946	55025111	0	166	408	4159	408	3993	0.0	0.10217881292261458
chr5	AC034238.1	55024946	55025041	0	96	408	4159	408	4063	0.0	0.100418410041841
chr5	AC034238.1	55023297	55023337	0	41	408	4159	408	4118	0.0	0.09907722195240408
chr5	AC034238.1	55023928	55024076	0	149	408	4159	408	4010	0.0	0.10174563591022444
chr5	AC034238.1	55025675	55025764	0	90	408	4159	408	4069	0.0	0.10027033669206194
chr5	AC034238.1	55028217	55028306	54	90	408	4159	354	4069	0.6	0.08699926271811256
chr5	CDC20B	55120424	55120550	0	127	51	4537	51	4410	0.0	0.011564625850340135
chr5	CDC20B	55172587	55172650	0	64	51	4537	51	4473	0.0	0.011401743796109993
chr5	CDC20B	55126353	55126439	0	87	51	4537	51	4450	0.0	0.01146067415730337
chr5	DHX29	55298590	55298664	335	75	15734	4731	15399	4656	4.466666666666667	3.3073453608247423
chr5	PLPP1	55475298	55475450	0	153	2856	1943	2856	1790	0.0	1.5955307262569833
chr5	PLPP1	55490959	55491114	0	156	2856	1943	2856	1787	0.0	1.5982092893116955
chr5	SLC38A9	55649206	55649314	0	109	833	8550	833	8441	0.0	0.09868498993010306
chr5	SLC38A9	55672562	55672695	0	134	833	8550	833	8416	0.0	0.09897813688212928
chr5	SLC38A9	55697845	55697992	0	148	833	8550	833	8402	0.0	0.0991430611759105
chr5	SLC38A9	55711451	55711499	0	49	833	8550	833	8501	0.0	0.09798847194447712
chr5	SLC38A9	55691188	55691292	0	105	833	8550	833	8445	0.0	0.09863824748371817
chr5	SLC38A9	55704321	55704434	0	114	833	8550	833	8436	0.0	0.09874348032242769
chr5	SLC38A9	55711351	55711499	0	149	833	8550	833	8401	0.0	0.0991548625163671
chr5	SLC38A9	55702738	55702894	0	157	833	8550	833	8393	0.0	0.09924937447873228
chr5	IL6ST	55954809	55954992	0	184	0	10136	0	9952	0.0	0.0
chr5	IL6ST	55957208	55957291	0	84	0	10136	0	10052	0.0	0.0
chr5	IL6ST	55982723	55982811	0	89	0	10136	0	10047	0.0	0.0
chr5	IL6ST	55948101	55948982	0	882	0	10136	0	9254	0.0	0.0
chr5	IL6ST	55959625	55959671	0	47	0	10136	0	10089	0.0	0.0
chr5	IL6ST	55948897	55948982	0	86	0	10136	0	10050	0.0	0.0
chr5	ANKRD55	56126921	56127106	0	186	408	2963	408	2777	0.0	0.14692113791861722
chr5	ANKRD55	56143800	56143929	0	130	408	2963	408	2833	0.0	0.14401694316978467
chr5	ANKRD55	56232855	56232946	0	92	408	2963	408	2871	0.0	0.14211076280041798
chr5	LINC01948	56464986	56465067	27	82	11171	4731	11144	4649	0.32926829268292684	2.397074639707464
chr5	MIER3	56938295	56938338	0	44	0	5712	0	5668	0.0	0.0
chr5	MIER3	56936893	56936936	0	44	0	5712	0	5668	0.0	0.0
chr5	MIER3	56950627	56950652	0	26	0	5712	0	5686	0.0	0.0
chr5	MIER3	56959385	56959520	0	136	0	5712	0	5576	0.0	0.0
chr5	PDE4D	59038858	59038971	0	114	107942	13868	107942	13754	0.0	7.848044205322088
chr5	PDE4D	59091081	59091125	0	45	107942	13868	107942	13823	0.0	7.808869275844607
chr5	PDE4D	60188295	60188418	6841	124	107942	13868	101101	13744	55.16935483870968	7.356009895227008
chr5	PDE4D	60127583	60127681	0	99	107942	13868	107942	13769	0.0	7.8394945166678776
chr5	DEPDC1B	60599074	60599260	0	187	3909	3820	3909	3633	0.0	1.0759702725020643
chr5	DEPDC1B	60688984	60689050	0	67	3909	3820	3909	3753	0.0	1.0415667466027179
chr5	DEPDC1B	60687724	60687838	0	115	3909	3820	3909	3705	0.0	1.0550607287449392
chr5	ELOVL7	60799179	60799230	0	52	4034	4475	4034	4423	0.0	0.9120506443590324
chr5	ELOVL7	60802626	60802665	0	40	4034	4475	4034	4435	0.0	0.9095828635851184
chr5	ELOVL7	60768645	60768690	3881	46	4034	4475	153	4429	84.3695652173913	0.03454504402799729
chr5	ERCC8	60924290	60924508	0	219	102	13538	102	13319	0.0	0.007658232600045048
chr5	ERCC8	60890272	60890401	0	130	102	13538	102	13408	0.0	0.007607398568019093
chr5	ERCC8	60924290	60924356	0	67	102	13538	102	13471	0.0	0.007571820948704624
chr5	ERCC8	60915185	60915286	0	102	102	13538	102	13436	0.0	0.00759154510270914
chr5	ERCC8	60909647	60909957	0	311	102	13538	102	13227	0.0	0.007711499206169199
chr5	ERCC8	60896458	60896515	0	58	102	13538	102	13480	0.0	0.0075667655786350145
chr5	ERCC8	60900650	60900840	0	191	102	13538	102	13347	0.0	0.007642166779051472
chr5	ERCC8	60932106	60932148	0	43	102	13538	102	13495	0.0	0.007558354946276399
chr5	ERCC8	60924290	60924367	0	78	102	13538	102	13460	0.0	0.007578008915304606
chr5	LINC02057	61264776	61264852	0	77	0	1494	0	1417	0.0	0.0
chr5	AC026746.1	61667756	61667877	0	122	60688	3482	60688	3360	0.0	18.061904761904763
chr5	ADAMTS6	65291328	65291470	1071	143	52350	8581	51279	8438	7.489510489510489	6.077150983645414
chr5	ADAMTS6	65297107	65297244	0	138	52350	8581	52350	8443	0.0	6.200402700461921
chr5	CENPK	65528918	65529017	0	100	847	3192	847	3092	0.0	0.2739327296248383
chr5	CENPK	65551105	65551242	0	138	847	3192	847	3054	0.0	0.2773411918795023
chr5	CENPK	65541354	65541436	0	83	847	3192	847	3109	0.0	0.2724348665165648
chr5	TRIM23	65618092	65618255	0	164	102	3039	102	2875	0.0	0.035478260869565216
chr5	TRIM23	65613726	65613855	0	130	102	3039	102	2909	0.0	0.035063595737366796
chr5	AC010280.1	68526813	68526919	458	107	520	792	62	685	4.280373831775701	0.0905109489051095
chr5	CCDC125	69292187	69292362	0	176	32914	7594	32914	7418	0.0	4.437045025613373
chr5	CCDC125	69313984	69314046	0	63	32914	7594	32914	7531	0.0	4.370468729252424
chr5	CCDC125	69294792	69294900	0	109	32914	7594	32914	7485	0.0	4.3973279893119575
chr5	CCDC125	69313984	69314043	0	60	32914	7594	32914	7534	0.0	4.368728431112291
chr5	TAF9	69366502	69366595	31186	94	102134	2120	70948	2026	331.7659574468085	35.018756169792695
chr5	NAIP	70979868	70980036	0	169	0	9217	0	9048	0.0	0.0
chr5	NAIP	70971448	70971571	0	124	0	9217	0	9093	0.0	0.0
chr5	NAIP	71011711	71011786	0	76	0	9217	0	9141	0.0	0.0
chr5	GTF2H2	71061271	71061308	0	38	0	5742	0	5704	0.0	0.0
chr5	GTF2H2	71065124	71065222	0	99	0	5742	0	5643	0.0	0.0
chr5	GTF2H2	71050216	71050305	0	90	0	5742	0	5652	0.0	0.0
chr5	MRPS27	72314080	72314158	0	79	4552	5031	4552	4952	0.0	0.9192245557350566
chr5	MRPS27	72241646	72241688	0	43	4552	5031	4552	4988	0.0	0.9125902165196471
chr5	ZNF366	72494222	72494293	0	72	0	5617	0	5545	0.0	0.0
chr5	ZNF366	72493586	72493660	0	75	0	5617	0	5542	0.0	0.0
chr5	AC063979.1	72693550	72693782	0	233	0	1828	0	1595	0.0	0.0
chr5	AC063979.1	72770627	72770866	0	240	0	1828	0	1588	0.0	0.0
chr5	AC063979.1	72770709	72770866	0	158	0	1828	0	1670	0.0	0.0
chr5	ANKRA2	73561129	73561288	0	160	0	2700	0	2540	0.0	0.0
chr5	LINC01331	74476337	74476452	0	116	153	3666	153	3550	0.0	0.043098591549295774
chr5	ENC1	74637564	74637701	0	138	59492	8243	59492	8105	0.0	7.340160394818014
chr5	ENC1	74637493	74640125	53616	2633	59492	8243	5876	5610	20.363083934675274	1.047415329768271
chr5	ENC1	74637493	74637618	0	126	59492	8243	59492	8117	0.0	7.329308857952445
chr5	GFM2	74725639	74725755	0	117	6812	3867	6812	3750	0.0	1.8165333333333333
chr5	GFM2	74730259	74730398	51	140	6812	3867	6761	3727	0.36428571428571427	1.8140595653340488
chr5	GFM2	74738501	74738642	0	142	6812	3867	6812	3725	0.0	1.8287248322147651
chr5	GFM2	74751367	74751493	0	127	6812	3867	6812	3740	0.0	1.8213903743315507
chr5	GFM2	74763679	74763766	0	88	6812	3867	6812	3779	0.0	1.8025932786451442
chr5	GFM2	74765034	74765152	0	119	6812	3867	6812	3748	0.0	1.8175026680896478
chr5	FAM169A	74813839	74814019	0	181	0	6891	0	6710	0.0	0.0
chr5	FAM169A	74834425	74834597	0	173	0	6891	0	6718	0.0	0.0
chr5	ANKRD31	75145986	75147505	0	1520	233	6335	233	4815	0.0	0.04839044652128764
chr5	ANKRD31	75144000	75144171	0	172	233	6335	233	6163	0.0	0.03780626318351452
chr5	CERT1	75379418	75379473	0	56	5	10692	5	10636	0.0	0.0004701015419330575
chr5	CERT1	75399309	75399387	0	79	5	10692	5	10613	0.0	0.000471120324130783
chr5	CERT1	75411010	75411103	0	94	5	10692	5	10598	0.0	0.0004717871296471032
chr5	CERT1	75389591	75389687	0	97	5	10692	5	10595	0.0	0.00047192071731949034
chr5	CERT1	75379336	75379473	0	138	5	10692	5	10554	0.0	0.0004737540269092287
chr5	CERT1	75402674	75402792	0	119	5	10692	5	10573	0.0	0.0004729026766291497
chr5	POC5	75677773	75677950	0	178	0	3430	0	3252	0.0	0.0
chr5	POC5	75705703	75705787	0	85	0	3430	0	3345	0.0	0.0
chr5	POC5	75707736	75707875	0	140	0	3430	0	3290	0.0	0.0
chr5	POC5	75712853	75712951	0	99	0	3430	0	3331	0.0	0.0
chr5	POC5	75712606	75712665	0	60	0	3430	0	3370	0.0	0.0
chr5	ZBED3	77078593	77078728	0	136	81753	6480	81753	6344	0.0	12.886664564943253
chr5	WDR41	77437335	77437424	0	90	19647	5048	19647	4958	0.0	3.962686567164179
chr5	WDR41	77453816	77453928	0	113	19647	5048	19647	4935	0.0	3.9811550151975683
chr5	WDR41	77464760	77464809	0	50	19647	5048	19647	4998	0.0	3.930972388955582
chr5	WDR41	77449759	77449860	0	102	19647	5048	19647	4946	0.0	3.9723008491710474
chr5	WDR41	77489456	77489572	0	117	19647	5048	19647	4931	0.0	3.984384506185358
chr5	WDR41	77453816	77453910	0	95	19647	5048	19647	4953	0.0	3.966686856450636
chr5	WDR41	77480080	77480189	0	110	19647	5048	19647	4938	0.0	3.9787363304981773
chr5	TBCA	77693265	77693352	0	88	5229	3121	5229	3033	0.0	1.7240356083086052
chr5	TBCA	77708241	77708347	0	107	5229	3121	5229	3014	0.0	1.7349037823490379
chr5	TBCA	77705565	77705634	0	70	5229	3121	5229	3051	0.0	1.7138643067846608
chr5	LHFPL2	78632263	78632368	0	106	1114	7990	1114	7884	0.0	0.141298833079655
chr5	MTX3	79985570	79985659	0	90	4383	7925	4383	7835	0.0	0.559412890874282
chr5	MTX3	79990593	79990663	0	71	4383	7925	4383	7854	0.0	0.5580595874713522
chr5	THBS4-AS1	80081767	80081940	0	174	0	5353	0	5179	0.0	0.0
chr5	SERINC5	80116137	80116323	0	187	765	7714	765	7527	0.0	0.10163411717815862
chr5	SERINC5	80114513	80114651	0	139	765	7714	765	7575	0.0	0.100990099009901
chr5	ANKRD34B	80564383	80564469	0	87	4757	3822	4757	3735	0.0	1.273627844712182
chr5	DHFR	80633876	80633992	0	117	153	2626	153	2509	0.0	0.06098047030689518
chr5	DHFR	80637882	80638009	0	128	153	2626	153	2498	0.0	0.061248999199359486
chr5	DHFR	80654007	80654057	0	51	153	2626	153	2575	0.0	0.05941747572815534
chr5	CKMT2-AS1	81223314	81223475	0	162	0	7683	0	7521	0.0	0.0
chr5	CKMT2-AS1	81246889	81246972	0	84	0	7683	0	7599	0.0	0.0
chr5	CKMT2-AS1	81250702	81250789	0	88	0	7683	0	7595	0.0	0.0
chr5	CKMT2-AS1	81240327	81240380	0	54	0	7683	0	7629	0.0	0.0
chr5	ACOT12	81342671	81342755	0	85	1756	2467	1756	2382	0.0	0.7371956339210747
chr5	SSBP2	81428584	81428683	0	100	3646	11043	3646	10943	0.0	0.3331810289682902
chr5	SSBP2	81489249	81489309	0	61	3646	11043	3646	10982	0.0	0.3319978146057184
chr5	SSBP2	81513627	81513717	0	91	3646	11043	3646	10952	0.0	0.3329072315558802
chr5	SSBP2	81710677	81710768	0	92	3646	11043	3646	10951	0.0	0.332937631266551
chr5	LINC01338	82854764	82854912	0	149	5917	3362	5917	3213	0.0	1.8415810768751946
chr5	TMEM167A	83065007	83065117	0	111	0	4871	0	4760	0.0	0.0
chr5	TMEM167A	83061876	83061911	0	36	0	4871	0	4835	0.0	0.0
chr5	HAPLN1	83675287	83675337	0	51	0	5774	0	5723	0.0	0.0
chr5	EDIL3	84229854	84229884	0	31	0	5839	0	5808	0.0	0.0
chr5	CCNH	87404843	87405007	0	165	0	4875	0	4710	0.0	0.0
chr5	CCNH	87394404	87394484	0	81	0	4875	0	4794	0.0	0.0
chr5	TMEM161B	88197668	88197765	0	98	11631	9091	11631	8993	0.0	1.2933392638719003
chr5	TMEM161B	88225768	88225866	0	99	11631	9091	11631	8992	0.0	1.2934830960854093
chr5	TMEM161B	88240812	88240916	0	105	11631	9091	11631	8986	0.0	1.294346761629201
chr5	TMEM161B	88221673	88221760	0	88	11631	9091	11631	9003	0.0	1.2919026991003
chr5	TMEM161B	88259231	88259363	0	133	11631	9091	11631	8958	0.0	1.298392498325519
chr5	LINC00461	88672964	88673028	0	65	0	11943	0	11878	0.0	0.0
chr5	LINC00461	88666790	88667591	0	802	0	11943	0	11141	0.0	0.0
chr5	LINC00461	88656624	88656707	0	84	0	11943	0	11859	0.0	0.0
chr5	LINC00461	88671035	88671085	0	51	0	11943	0	11892	0.0	0.0
chr5	LINC00461	88672964	88673090	0	127	0	11943	0	11816	0.0	0.0
chr5	MEF2C	88730210	88730234	0	25	0	5849	0	5824	0.0	0.0
chr5	MEF2C	88761184	88761328	0	145	0	5849	0	5704	0.0	0.0
chr5	MEF2C	88761268	88761328	0	61	0	5849	0	5788	0.0	0.0
chr5	MEF2C	88760987	88761125	0	139	0	5849	0	5710	0.0	0.0
chr5	MEF2C	88880923	88881022	0	100	0	5849	0	5749	0.0	0.0
chr5	MEF2C	88817804	88817831	0	28	0	5849	0	5821	0.0	0.0
chr5	LINC01339	90200466	90200528	0	63	0	2565	0	2502	0.0	0.0
chr5	LINC01339	90235428	90235535	0	108	0	2565	0	2457	0.0	0.0
chr5	LINC01339	90244610	90244755	0	146	0	2565	0	2419	0.0	0.0
chr5	CETN3	90396492	90396564	0	73	50	3096	50	3023	0.0	0.016539861065167052
chr5	LYSMD3	90526918	90527002	0	85	1887	4464	1887	4379	0.0	0.43092030143868465
chr5	LYSMD3	90520363	90520461	0	99	1887	4464	1887	4365	0.0	0.4323024054982818
chr5	LUCAT1	91195495	91195592	0	98	0	15454	0	15356	0.0	0.0
chr5	LUCAT1	91264662	91264713	0	52	0	15454	0	15402	0.0	0.0
chr5	LUCAT1	91303872	91303971	0	100	0	15454	0	15354	0.0	0.0
chr5	LUCAT1	91313637	91313777	0	141	0	15454	0	15313	0.0	0.0
chr5	LUCAT1	91313077	91313229	0	153	0	15454	0	15301	0.0	0.0
chr5	LUCAT1	91305679	91305771	0	93	0	15454	0	15361	0.0	0.0
chr5	LUCAT1	91312294	91312481	0	188	0	15454	0	15266	0.0	0.0
chr5	LUCAT1	91310855	91311032	0	178	0	15454	0	15276	0.0	0.0
chr5	LUCAT1	91312294	91312413	0	120	0	15454	0	15334	0.0	0.0
chr5	LUCAT1	91310737	91311032	0	296	0	15454	0	15158	0.0	0.0
chr5	LUCAT1	91312294	91312495	0	202	0	15454	0	15252	0.0	0.0
chr5	LUCAT1	91311645	91311737	0	93	0	15454	0	15361	0.0	0.0
chr5	LUCAT1	91306031	91306096	0	66	0	15454	0	15388	0.0	0.0
chr5	LUCAT1	91313961	91314052	0	92	0	15454	0	15362	0.0	0.0
chr5	LUCAT1	91313961	91314033	0	73	0	15454	0	15381	0.0	0.0
chr5	LUCAT1	91311645	91312413	0	769	0	15454	0	14685	0.0	0.0
chr5	ARRDC3	91376620	91376768	0	149	0	4954	0	4805	0.0	0.0
chr5	NR2F1-AS1	93544794	93544915	0	122	6927	22614	6927	22492	0.0	0.30797616930464167
chr5	NR2F1-AS1	93432364	93432460	0	97	6927	22614	6927	22517	0.0	0.30763423191366523
chr5	NR2F1-AS1	93497953	93498156	0	204	6927	22614	6927	22410	0.0	0.30910307898259703
chr5	NR2F1-AS1	93438702	93438741	0	40	6927	22614	6927	22574	0.0	0.3068574466200053
chr5	NR2F1-AS1	93569889	93570002	0	114	6927	22614	6927	22500	0.0	0.3078666666666667
chr5	NR2F1-AS1	93496056	93496103	0	48	6927	22614	6927	22566	0.0	0.306966232385004
chr5	NR2F1-AS1	93423154	93423244	0	91	6927	22614	6927	22523	0.0	0.3075522798916663
chr5	NR2F1-AS1	93569889	93570058	73	170	6927	22614	6854	22444	0.4294117647058823	0.3053822847977188
chr5	NR2F1-AS1	93543981	93544024	0	44	6927	22614	6927	22570	0.0	0.30691182986264953
chr5	NR2F1-AS1	93535184	93535243	0	60	6927	22614	6927	22554	0.0	0.3071295557329077
chr5	NR2F1-AS1	93580466	93580691	0	226	6927	22614	6927	22388	0.0	0.3094068250848669
chr5	NR2F1-AS1	93422309	93422421	41	113	6927	22614	6886	22501	0.36283185840707965	0.30603084307364115
chr5	NR2F1-AS1	93500956	93501160	10	205	6927	22614	6917	22409	0.04878048780487805	0.30867062341023693
chr5	NR2F1-AS1	93543688	93544024	0	337	6927	22614	6927	22277	0.0	0.31094851191812184
chr5	NR2F1-AS1	93504591	93506495	0	1905	6927	22614	6927	20709	0.0	0.33449224974648706
chr5	FAM172A	93958776	93958968	0	193	36	5269	36	5076	0.0	0.0070921985815602835
chr5	FAM172A	94050730	94050831	0	102	36	5269	36	5167	0.0	0.0069672924327462745
chr5	FAM172A	94074645	94074769	0	125	36	5269	36	5144	0.0	0.006998444790046656
chr5	FAM172A	93737811	93737940	0	130	36	5269	36	5139	0.0	0.0070052539404553416
chr5	KIAA0825	94582432	94582583	0	152	17920	6197	17920	6045	0.0	2.9644334160463193
chr5	MCTP1	94799012	94799132	51	121	13147	12122	13096	12001	0.4214876033057851	1.091242396466961
chr5	MCTP1	94917895	94917973	0	79	13147	12122	13147	12043	0.0	1.0916715104209915
chr5	MCTP1	94931952	94931991	0	40	13147	12122	13147	12082	0.0	1.0881476576725708
chr5	MCTP1	94923961	94924021	0	61	13147	12122	13147	12061	0.0	1.0900422850509908
chr5	MCTP1	95068784	95068829	4	46	13147	12122	13143	12076	0.08695652173913043	1.0883570718781053
chr5	TTC37	95543183	95543327	0	145	29	10468	29	10323	0.0	0.0028092608737770026
chr5	TTC37	95553006	95553228	0	223	29	10468	29	10245	0.0	0.0028306490971205466
chr5	SPATA9	95675411	95675639	0	229	0	2937	0	2708	0.0	0.0
chr5	SPATA9	95674685	95674788	0	104	0	2937	0	2833	0.0	0.0
chr5	AC008840.1	95716916	95717081	0	166	0	2200	0	2034	0.0	0.0
chr5	ELL2	95932631	95932713	0	83	11	7037	11	6954	0.0	0.0015818234109864827
chr5	PCSK1	96410773	96410986	0	214	11734	5374	11734	5160	0.0	2.274031007751938
chr5	ERAP1	96800861	96801000	0	140	27	6534	27	6394	0.0	0.004222708789490147
chr5	AC009126.1	96822936	96823117	0	182	0	4132	0	3950	0.0	0.0
chr5	AC009126.1	96848770	96848823	0	54	0	4132	0	4078	0.0	0.0
chr5	AC009126.1	96873514	96873672	0	159	0	4132	0	3973	0.0	0.0
chr5	LIX1	97137103	97137192	0	90	0	4003	0	3913	0.0	0.0
chr5	RIOK2	97166266	97166371	0	106	0	4454	0	4348	0.0	0.0
chr5	RGMB-AS1	98772621	98772798	0	178	0	963	0	785	0.0	0.0
chr5	RGMB-AS1	98772621	98772715	0	95	0	963	0	868	0.0	0.0
chr5	RGMB-AS1	98771655	98771766	0	112	0	963	0	851	0.0	0.0
chr5	CHD1	98859971	98860068	0	98	518	10309	518	10211	0.0	0.0507296053275879
chr5	CHD1	98863407	98863586	0	180	518	10309	518	10129	0.0	0.05114029025570145
chr5	CHD1	98869013	98869277	0	265	518	10309	518	10044	0.0	0.05157307845479889
chr5	AC021086.1	100526305	100526349	0	45	7	3518	7	3473	0.0	0.0020155485171321624
chr5	AC021086.1	100457056	100457124	0	69	7	3518	7	3449	0.0	0.002029573789504204
chr5	AC021086.1	100534079	100534152	0	74	7	3518	7	3444	0.0	0.0020325203252032522
chr5	ST8SIA4	100900314	100900463	0	150	0	7819	0	7669	0.0	0.0
chr5	SLCO6A1	102459655	102459777	0	123	564	2803	564	2680	0.0	0.21044776119402986
chr5	SLCO6A1	102477675	102477861	0	187	564	2803	564	2616	0.0	0.21559633027522937
chr5	SLCO6A1	102477675	102477690	0	16	564	2803	564	2787	0.0	0.2023681377825619
chr5	LINC00491	102617857	102617928	0	72	20523	2811	20523	2739	0.0	7.492880613362541
chr5	LINC00491	102611892	102611955	16708	64	20523	2811	3815	2747	261.0625	1.3887877684746996
chr5	LINC00491	102636142	102636291	0	150	20523	2811	20523	2661	0.0	7.712514092446448
chr5	GIN1	103106715	103106909	0	195	51	4178	51	3983	0.0	0.012804418779814211
chr5	AC099520.1	104638447	104638527	0	81	0	4954	0	4873	0.0	0.0
chr5	AC099520.1	104763279	104763383	0	105	0	4954	0	4849	0.0	0.0
chr5	AC099520.1	104754822	104755006	0	185	0	4954	0	4769	0.0	0.0
chr5	AC099520.1	104745362	104745446	0	85	0	4954	0	4869	0.0	0.0
chr5	AC099520.1	104744517	104744609	0	93	0	4954	0	4861	0.0	0.0
chr5	LINC01950	106969883	106969951	0	69	0	877	0	808	0.0	0.0
chr5	LINC01950	106980763	106980870	0	108	0	877	0	769	0.0	0.0
chr5	EFNA5	107387234	107387315	0	82	51	5752	51	5670	0.0	0.008994708994708995
chr5	TMEM232	110528587	110528835	13461	249	14147	10205	686	9956	54.06024096385542	0.06890317396544797
chr5	TMEM232	110667227	110667364	0	138	14147	10205	14147	10067	0.0	1.40528459322539
chr5	TMEM232	110610502	110610600	0	99	14147	10205	14147	10106	0.0	1.3998614684345934
chr5	TMEM232	110667694	110667729	0	36	14147	10205	14147	10169	0.0	1.3911889074638608
chr5	TMEM232	110726626	110726798	0	173	14147	10205	14147	10032	0.0	1.4101874003189792
chr5	STARD4	111501961	111502088	165	128	705400	5691	705235	5563	1.2890625	126.77242495056625
chr5	STARD4	111507328	111507442	0	115	705400	5691	705400	5576	0.0	126.50645624103299
chr5	STARD4	111505014	111505043	0	30	705400	5691	705400	5661	0.0	124.60695990107754
chr5	NREP	111755769	111755830	0	62	51	9126	51	9064	0.0	0.005626654898499559
chr5	NREP	111734669	111734742	0	74	51	9126	51	9052	0.0	0.005634114007954044
chr5	NREP	111755769	111755926	0	158	51	9126	51	8968	0.0	0.005686886708296164
chr5	REEP5	112887014	112887183	0	170	3857	3981	3857	3811	0.0	1.0120703227499344
chr5	REEP5	112902379	112902518	0	140	3857	3981	3857	3841	0.0	1.0041655818797188
chr5	REEP5	112892449	112892817	175	369	3857	3981	3682	3612	0.4742547425474255	1.0193798449612403
chr5	TRIM36	115163517	115163752	51	236	101324	6078	101273	5842	0.21610169491525424	17.335330366312906
chr5	TRIM36	115159640	115159670	0	31	101324	6078	101324	6047	0.0	16.756077393748967
chr5	PGGT1B	115221823	115222008	0	186	123881	9777	123881	9591	0.0	12.916379939526639
chr5	PGGT1B	115230975	115231021	112	47	123881	9777	123769	9730	2.382978723404255	12.720349434737924
chr5	CCDC112	115269702	115269798	0	97	0	3161	0	3064	0.0	0.0
chr5	CCDC112	115284786	115284908	0	123	0	3161	0	3038	0.0	0.0
chr5	CCDC112	115280351	115280480	0	130	0	3161	0	3031	0.0	0.0
chr5	ATG12	115837627	115837764	0	138	2130	7572	2130	7434	0.0	0.28652138821630346
chr5	ATG12	115840496	115840612	28	117	2130	7572	2102	7455	0.23931623931623933	0.2819584171696848
chr5	ATG12	115840817	115840934	0	118	2130	7572	2130	7454	0.0	0.28575261604507646
chr5	SEMA6A	116467582	116467747	0	166	24	10571	24	10405	0.0	0.0023065833733781835
chr5	SEMA6A	116478541	116478718	0	178	24	10571	24	10393	0.0	0.002309246608294044
chr5	SEMA6A	116472884	116472935	0	52	24	10571	24	10519	0.0	0.002281585702062934
chr5	LINC02208	118469080	118469148	61	69	5016	5937	4955	5868	0.8840579710144928	0.8444103612815269
chr5	LINC02208	118472062	118472189	0	128	5016	5937	5016	5809	0.0	0.8634876915131692
chr5	LINC02208	118472848	118472906	0	59	5016	5937	5016	5878	0.0	0.8533514800952705
chr5	LINC02208	118555046	118555139	660	94	5016	5937	4356	5843	7.0212765957446805	0.7455074448057505
chr5	LINC02208	118552352	118552549	0	198	5016	5937	5016	5739	0.0	0.8740198640878202
chr5	DTWD2	118928536	118928729	0	194	16824	5874	16824	5680	0.0	2.9619718309859153
chr5	DTWD2	118939195	118939290	0	96	16824	5874	16824	5778	0.0	2.9117341640706127
chr5	AC113418.1	120351751	120351867	0	117	0	944	0	827	0.0	0.0
chr5	LOX	122076892	122077001	0	110	51	5516	51	5406	0.0	0.009433962264150943
chr5	LOX	122070690	122070768	0	79	51	5516	51	5437	0.0	0.0093801728894611
chr5	MGC32805	122450546	122450666	0	121	0	2401	0	2280	0.0	0.0
chr5	CEP120	123422466	123422575	0	110	51	13045	51	12935	0.0	0.003942790877464244
chr5	CEP120	123403255	123403344	0	90	51	13045	51	12955	0.0	0.003936703975299112
chr5	CEP120	123409831	123409948	0	118	51	13045	51	12927	0.0	0.003945230912044558
chr5	CEP120	123422949	123423030	0	82	51	13045	51	12963	0.0	0.003934274473501504
chr5	CEP120	123403693	123403740	0	48	51	13045	51	12997	0.0	0.00392398245749019
chr5	CEP120	123358251	123358445	0	195	51	13045	51	12850	0.0	0.003968871595330739
chr5	LINC01170	124313589	124313700	0	112	0	3859	0	3747	0.0	0.0
chr5	ZNF608	124638781	124638823	0	43	0	6892	0	6849	0.0	0.0
chr5	ZNF608	124641251	124641405	0	155	0	6892	0	6737	0.0	0.0
chr5	ZNF608	124646678	124649133	0	2456	0	6892	0	4436	0.0	0.0
chr5	ZNF608	124644243	124644661	0	419	0	6892	0	6473	0.0	0.0
chr5	ALDH7A1	126552020	126552137	0	118	386	14624	386	14506	0.0	0.026609678753619193
chr5	ALDH7A1	126568258	126568356	0	99	386	14624	386	14525	0.0	0.02657487091222031
chr5	ALDH7A1	126582850	126582974	0	125	386	14624	386	14499	0.0	0.026622525691426997
chr5	ALDH7A1	126583931	126584012	0	82	386	14624	386	14542	0.0	0.026543804153486453
chr5	ALDH7A1	126592663	126592729	0	67	386	14624	386	14557	0.0	0.026516452565775915
chr5	ALDH7A1	126593350	126593404	0	55	386	14624	386	14569	0.0	0.026494611847072552
chr5	ALDH7A1	126594107	126594267	0	161	386	14624	386	14463	0.0	0.0266887920901611
chr5	ALDH7A1	126582104	126582149	0	46	386	14624	386	14578	0.0	0.026478254904650843
chr5	ALDH7A1	126593350	126593447	0	98	386	14624	386	14526	0.0	0.026573041442929917
chr5	ALDH7A1	126584362	126584495	0	134	386	14624	386	14490	0.0	0.026639061421670118
chr5	ALDH7A1	126564457	126564592	137	136	386	14624	249	14488	1.0073529411764706	0.017186637217007177
chr5	C5ORF63	127056396	127056506	0	111	115	6944	115	6833	0.0	0.016830089272647446
chr5	AC011416.4	127264501	127264718	57	218	465	7226	408	7008	0.26146788990825687	0.05821917808219178
chr5	AC011416.4	127282212	127282309	0	98	465	7226	465	7128	0.0	0.06523569023569023
chr5	LINC01184	128081972	128082191	0	220	204	12548	204	12328	0.0	0.01654769630110318
chr5	LINC01184	128062373	128062500	0	128	204	12548	204	12420	0.0	0.01642512077294686
chr5	LINC01184	128062369	128062500	0	132	204	12548	204	12416	0.0	0.01643041237113402
chr5	LINC01184	128081972	128082194	0	223	204	12548	204	12325	0.0	0.016551724137931035
chr5	LINC01184	128061143	128061244	0	102	204	12548	204	12446	0.0	0.016390808291820665
chr5	LINC01184	128076946	128077093	0	148	204	12548	204	12400	0.0	0.016451612903225808
chr5	LINC01184	128064736	128064850	0	115	204	12548	204	12433	0.0	0.01640794659374246
chr5	FBN2	128530594	128530693	0	100	306	13291	306	13191	0.0	0.02319763475096657
chr5	AC008591.1	129780327	129780481	0	155	295	8398	295	8243	0.0	0.035787941283513286
chr5	HINT1	131160655	131160844	0	190	49	6082	49	5892	0.0	0.008316361167684997
chr5	HINT1	131162063	131162477	0	415	49	6082	49	5667	0.0	0.008646550202929239
chr5	HINT1	131162028	131162503	0	476	49	6082	49	5606	0.0	0.008740635033892259
chr5	HINT1	131162028	131162477	0	450	49	6082	49	5632	0.0	0.00870028409090909
chr5	RAPGEF6	131428901	131429216	0	316	2972	11266	2972	10950	0.0	0.27141552511415523
chr5	RAPGEF6	131561977	131562047	0	71	2972	11266	2972	11195	0.0	0.2654756587762394
chr5	RAPGEF6	131450022	131450046	0	25	2972	11266	2972	11241	0.0	0.2643892892091451
chr5	RAPGEF6	131469800	131469815	0	16	2972	11266	2972	11250	0.0	0.2641777777777778
chr5	RAPGEF6	131440145	131440228	0	84	2972	11266	2972	11182	0.0	0.26578429619030586
chr5	RAPGEF6	131532100	131532194	2127	95	2972	11266	845	11171	22.389473684210525	0.07564228806731715
chr5	FNIP1	131730903	131731038	6219	136	50875	6738	44656	6602	45.72794117647059	6.764010905786125
chr5	FNIP1	131710577	131710661	0	85	50875	6738	50875	6653	0.0	7.64692619870735
chr5	MEIKIN	131851263	131851383	0	121	22610	1618	22610	1497	0.0	15.103540414161657
chr5	MEIKIN	131878977	131879048	0	72	22610	1618	22610	1546	0.0	14.6248382923674
chr5	ACSL6	131985406	131985458	84	53	77879	15803	77795	15750	1.5849056603773586	4.939365079365079
chr5	ACSL6	131971746	131971759	42	14	77879	15803	77837	15789	3.0	4.9298245614035086
chr5	ACSL6	132004314	132004663	0	350	77879	15803	77879	15453	0.0	5.039733385103216
chr5	ACSL6	131991744	131991813	0	70	77879	15803	77879	15733	0.0	4.950041314434628
chr5	ACSL6	131976183	131976240	270	58	77879	15803	77609	15745	4.655172413793103	4.929120355668466
chr5	ACSL6	131988555	131988600	0	46	77879	15803	77879	15757	0.0	4.942501745256076
chr5	P4HA2	132226696	132227221	1242	526	39997	9992	38755	9466	2.3612167300380227	4.09412634692584
chr5	P4HA2	132227085	132227258	714	174	39997	9992	39283	9818	4.103448275862069	4.001120391118354
chr5	P4HA2	132227085	132227221	476	137	39997	9992	39521	9855	3.4744525547445257	4.010248604769153
chr5	P4HA2	132226931	132227221	1191	291	39997	9992	38806	9701	4.092783505154639	4.000206164312957
chr5	MIR3936HG	132352488	132352631	0	144	849	2699	849	2555	0.0	0.33228962818003915
chr5	MIR3936HG	132365858	132366049	0	192	849	2699	849	2507	0.0	0.3386517750299162
chr5	IRF1	132486250	132486373	0	124	102	5641	102	5517	0.0	0.018488308863512777
chr5	IRF1	132487925	132488025	45	101	102	5641	57	5540	0.44554455445544555	0.010288808664259928
chr5	IRF1	132489391	132489483	0	93	102	5641	102	5548	0.0	0.018385003604902667
chr5	KIF3A	132702086	132702212	0	127	141	6880	141	6753	0.0	0.02087960906263883
chr5	KIF3A	132708906	132708978	0	73	141	6880	141	6807	0.0	0.020713970912296167
chr5	KIF3A	132706450	132706459	0	10	141	6880	141	6870	0.0	0.02052401746724891
chr5	SEPTIN8	132761799	132761896	0	98	0	4865	0	4767	0.0	0.0
chr5	SHROOM1	132824614	132824821	0	208	0	3735	0	3527	0.0	0.0
chr5	AFF4	132898229	132898392	0	164	0	11305	0	11141	0.0	0.0
chr5	AFF4	132927120	132927207	0	88	0	11305	0	11217	0.0	0.0
chr5	ZCCHC10	133000131	133000173	0	43	0	2555	0	2512	0.0	0.0
chr5	ZCCHC10	133022840	133022906	0	67	0	2555	0	2488	0.0	0.0
chr5	ZCCHC10	133000131	133000201	0	71	0	2555	0	2484	0.0	0.0
chr5	FSTL4	133224189	133224216	0	28	210576	6733	210576	6705	0.0	31.405816554809842
chr5	SKP1	134170950	134171038	0	89	90152	12086	90152	11997	0.0	7.514545302992415
chr5	SKP1	134174461	134174514	352	54	90152	12086	89800	12032	6.518518518518518	7.46343085106383
chr5	SKP1	134173700	134173766	0	67	90152	12086	90152	12019	0.0	7.500790415175971
chr5	CDKL3	134306608	134306702	84	95	63750	3167	63666	3072	0.8842105263157894	20.724609375
chr5	CDKL3	134308573	134308727	0	155	63750	3167	63750	3012	0.0	21.165338645418327
chr5	CDKL3	134312291	134312380	602	90	63750	3167	63148	3077	6.688888888888889	20.52258693532662
chr5	CDKL3	134302139	134302210	765	72	63750	3167	62985	3095	10.625	20.350565428109853
chr5	CDKL3	134319357	134319497	0	141	63750	3167	63750	3026	0.0	21.06741573033708
chr5	CDKL3	134299655	134299750	966	96	63750	3167	62784	3071	10.0625	20.444154998371864
chr5	SAR1B	134618191	134618313	0	123	204	10558	204	10435	0.0	0.0195495927168184
chr5	SAR1B	134632076	134632195	0	120	204	10558	204	10438	0.0	0.019543973941368076
chr5	SAR1B	134608975	134609133	0	159	204	10558	204	10399	0.0	0.01961727089143187
chr5	SAR1B	134625776	134625876	0	101	204	10558	204	10457	0.0	0.019508463230372
chr5	SAR1B	134632076	134632199	0	124	204	10558	204	10434	0.0	0.019551466359977
chr5	MACROH2A1	135352945	135353045	0	101	1635588	10783	1635588	10682	0.0	153.11627036135556
chr5	MACROH2A1	135388921	135389126	0	206	1635588	10783	1635588	10577	0.0	154.6362862815543
chr5	MACROH2A1	135350822	135350913	0	92	1635588	10783	1635588	10691	0.0	152.9873725563558
chr5	TRPC7	136274672	136274837	0	166	19	3780	19	3614	0.0	0.005257332595462092
chr5	TRPC7	136315596	136315779	0	184	19	3780	19	3596	0.0	0.0052836484983314795
chr5	TRPC7	136274656	136274837	0	182	19	3780	19	3598	0.0	0.0052807115063924406
chr5	TRPC7	136266219	136266436	0	218	19	3780	19	3562	0.0	0.005334081976417743
chr5	SPOCK1	137498372	137498558	663	187	2942	6218	2279	6031	3.5454545454545454	0.37788094843309566
chr5	KLHL3	137637293	137637395	5	103	265865	11404	265860	11301	0.04854368932038835	23.525351738784178
chr5	KLHL3	137720464	137720584	0	121	265865	11404	265865	11283	0.0	23.563325356731365
chr5	FAM13B	137946227	137946311	0	85	103	6607	103	6522	0.0	0.015792701625268322
chr5	FAM13B	138018954	138019146	21	193	103	6607	82	6414	0.10880829015544041	0.01278453383224197
chr5	FAM13B	137956476	137956542	0	67	103	6607	103	6540	0.0	0.015749235474006116
chr5	FAM13B	138033772	138033869	0	98	103	6607	103	6509	0.0	0.015824243355354126
chr5	FAM13B	138019880	138019977	0	98	103	6607	103	6509	0.0	0.015824243355354126
chr5	BRD8	138164713	138165166	0	454	130379	6939	130379	6485	0.0	20.104703161141096
chr5	BRD8	138166517	138166727	2460	211	130379	6939	127919	6728	11.658767772511847	19.012931034482758
chr5	BRD8	138172064	138172134	442	71	130379	6939	129937	6868	6.225352112676056	18.91919044845661
chr5	BRD8	138157641	138157894	0	254	130379	6939	130379	6685	0.0	19.503216155572176
chr5	BRD8	138168469	138168688	0	220	130379	6939	130379	6719	0.0	19.404524482809943
chr5	BRD8	138166517	138166610	1530	94	130379	6939	128849	6845	16.27659574468085	18.82381300219138
chr5	BRD8	138159554	138159599	0	46	130379	6939	130379	6893	0.0	18.914696068475266
chr5	BRD8	138163129	138163344	75399	216	130379	6939	54980	6723	349.06944444444446	8.177896772274282
chr5	BRD8	138163586	138163643	0	58	130379	6939	130379	6881	0.0	18.94768202296178
chr5	BRD8	138164086	138164133	0	48	130379	6939	130379	6891	0.0	18.920185749528372
chr5	BRD8	138172719	138172826	54	108	130379	6939	130325	6831	0.5	19.078465817596253
chr5	BRD8	138172719	138172851	54	133	130379	6939	130325	6806	0.40601503759398494	19.14854540111666
chr5	CDC23	138202112	138202155	0	44	3838	3956	3838	3912	0.0	0.9810838445807771
chr5	CDC23	138212990	138213063	0	74	3838	3956	3838	3882	0.0	0.988665636269964
chr5	GFRA3	138259556	138259649	0	94	6200	1996	6200	1902	0.0	3.259726603575184
chr5	CDC25C	138325814	138325904	0	91	808	3355	808	3264	0.0	0.24754901960784315
chr5	CDC25C	138329552	138329647	0	96	808	3355	808	3259	0.0	0.24792881251917767
chr5	CDC25C	138326020	138326054	0	35	808	3355	808	3320	0.0	0.2433734939759036
chr5	ETF1	138517560	138517700	0	141	4735	4549	4735	4408	0.0	1.0741833030852994
chr5	ETF1	138529554	138529678	456	125	4735	4549	4279	4424	3.648	0.9672242314647378
chr5	HSPA9	138557868	138557986	0	119	629	5786	629	5667	0.0	0.11099347097229574
chr5	HSPA9	138559863	138560091	51	229	629	5786	578	5557	0.22270742358078602	0.10401295663127587
chr5	HSPA9	138566625	138566718	0	94	629	5786	629	5692	0.0	0.11050597329585383
chr5	HSPA9	138567648	138567722	0	75	629	5786	629	5711	0.0	0.1101383295394852
chr5	HSPA9	138574067	138574126	0	60	629	5786	629	5726	0.0	0.10984980789381768
chr5	HSPA9	138574067	138574169	0	103	629	5786	629	5683	0.0	0.11068097835650184
chr5	HSPA9	138574067	138574121	0	55	629	5786	629	5731	0.0	0.10975396963880649
chr5	HSPA9	138560780	138560931	0	152	629	5786	629	5634	0.0	0.1116435924742634
chr5	SIL1	139026800	139026992	0	193	3050	3852	3050	3659	0.0	0.8335610822629134
chr5	SIL1	139196440	139196528	0	89	3050	3852	3050	3763	0.0	0.8105235184693064
chr5	SIL1	139137328	139137474	0	147	3050	3852	3050	3705	0.0	0.8232118758434548
chr5	SIL1	139133333	139133471	0	139	3050	3852	3050	3713	0.0	0.8214381901427417
chr5	SIL1	139127943	139128052	0	110	3050	3852	3050	3742	0.0	0.8150721539283805
chr5	SLC23A1	139379677	139379834	0	158	298	3085	298	2927	0.0	0.1018107277075504
chr5	SLC23A1	139380207	139380389	0	183	298	3085	298	2902	0.0	0.10268780151619572
chr5	MZB1	139388460	139388585	0	126	0	2030	0	1904	0.0	0.0
chr5	MZB1	139388460	139388601	0	142	0	2030	0	1888	0.0	0.0
chr5	MZB1	139388460	139388667	0	208	0	2030	0	1822	0.0	0.0
chr5	MZB1	139389326	139389420	0	95	0	2030	0	1935	0.0	0.0
chr5	SPATA24	139402627	139402693	0	67	38	942	38	875	0.0	0.04342857142857143
chr5	SPATA24	139397040	139397143	0	104	38	942	38	838	0.0	0.045346062052505964
chr5	DNAJC18	139422707	139422817	0	111	72	2652	72	2541	0.0	0.02833530106257379
chr5	DNAJC18	139428537	139428683	0	147	72	2652	72	2505	0.0	0.02874251497005988
chr5	DNAJC18	139437371	139437558	0	188	72	2652	72	2464	0.0	0.02922077922077922
chr5	DNAJC18	139418718	139418833	0	116	72	2652	72	2536	0.0	0.028391167192429023
chr5	DNAJC18	139442286	139442484	21	199	72	2652	51	2453	0.10552763819095477	0.02079086832450061
chr5	STING1	139477328	139477515	0	188	4462	4684	4462	4496	0.0	0.9924377224199288
chr5	STING1	139481477	139481704	255	228	4462	4684	4207	4456	1.118421052631579	0.9441202872531418
chr5	STING1	139479151	139479204	0	54	4462	4684	4462	4630	0.0	0.9637149028077754
chr5	STING1	139481477	139481550	0	74	4462	4684	4462	4610	0.0	0.9678958785249457
chr5	NRG2	139859888	139859912	125	25	12708	4616	12583	4591	5.0	2.7407972119363975
chr5	NRG2	139865114	139865173	0	60	12708	4616	12708	4556	0.0	2.7892888498683055
chr5	NRG2	139865548	139865625	0	78	12708	4616	12708	4538	0.0	2.8003525782282943
chr5	MALINC1	140106295	140106461	0	167	34339	7192	34339	7025	0.0	4.8881138790035585
chr5	MALINC1	140106295	140106490	0	196	34339	7192	34339	6996	0.0	4.908376214979989
chr5	PFDN1	140281448	140281533	0	86	3442	1745	3442	1659	0.0	2.0747438215792644
chr5	PFDN1	140300415	140300582	0	168	3442	1745	3442	1577	0.0	2.182625237793278
chr5	AC008438.1	140371412	140371755	0	344	0	988	0	644	0.0	0.0
chr5	SRA1	140551981	140552184	0	204	725	3400	725	3196	0.0	0.22684605757196497
chr5	APBB3	140560638	140560754	0	117	1560	3183	1560	3066	0.0	0.5088062622309197
chr5	APBB3	140561843	140561849	0	7	1560	3183	1560	3176	0.0	0.491183879093199
chr5	APBB3	140561843	140561995	255	153	1560	3183	1305	3030	1.6666666666666667	0.4306930693069307
chr5	HARS1	140675016	140675133	0	118	3264	12088	3264	11970	0.0	0.27268170426065164
chr5	HARS1	140677326	140677420	0	95	3264	12088	3264	11993	0.0	0.2721587592762445
chr5	HARS1	140677907	140678015	0	109	3264	12088	3264	11979	0.0	0.2724768344603055
chr5	HARS1	140683099	140683219	0	121	3264	12088	3264	11967	0.0	0.27275006267234897
chr5	HARS1	140677326	140677457	0	132	3264	12088	3264	11956	0.0	0.2730010036801606
chr5	HARS1	140687745	140687933	0	189	3264	12088	3264	11899	0.0	0.2743087654424742
chr5	HARS1	140683545	140683667	0	123	3264	12088	3264	11965	0.0	0.2727956539908065
chr5	HARS1	140683545	140683664	0	120	3264	12088	3264	11968	0.0	0.2727272727272727
chr5	HARS1	140687420	140687542	0	123	3264	12088	3264	11965	0.0	0.2727956539908065
chr5	AC005609.5	140792666	140792770	0	105	5944	5049	5944	4944	0.0	1.2022653721682848
chr5	AC244517.5	141057749	141057850	0	102	2	1905	2	1803	0.0	0.0011092623405435386
chr5	AC244517.5	141062410	141062533	0	124	2	1905	2	1781	0.0	0.0011229646266142617
chr5	AC244517.11	141241452	141241687	0	236	0	1533	0	1297	0.0	0.0
chr5	DIAPH1	141529602	141529697	81	96	262484	7015	262403	6919	0.84375	37.924989160283275
chr5	DIAPH1	141588223	141588250	0	28	262484	7015	262484	6987	0.0	37.56748246743953
chr5	DIAPH1	141518943	141518996	0	54	262484	7015	262484	6961	0.0	37.707800603361584
chr5	DIAPH1	141581914	141582056	0	143	262484	7015	262484	6872	0.0	38.19615832363213
chr5	HDAC3	141625684	141625764	0	81	306	3635	306	3554	0.0	0.08610016882386044
chr5	HDAC3	141626012	141626071	0	60	306	3635	306	3575	0.0	0.08559440559440559
chr5	HDAC3	141629172	141629306	0	135	306	3635	306	3500	0.0	0.08742857142857142
chr5	HDAC3	141629683	141629739	0	57	306	3635	306	3578	0.0	0.08552263834544438
chr5	HDAC3	141634810	141634953	0	144	306	3635	306	3491	0.0	0.0876539673446004
chr5	HDAC3	141630043	141630125	0	83	306	3635	306	3552	0.0	0.08614864864864864
chr5	FCHSD1	141642396	141642503	0	108	1057	5453	1057	5345	0.0	0.19775491113189897
chr5	FCHSD1	141643000	141643088	0	89	1057	5453	1057	5364	0.0	0.1970544369873229
chr5	ARAP3	141655361	141655400	0	40	5221	6227	5221	6187	0.0	0.8438661710037175
chr5	ARAP3	141662042	141662255	0	214	5221	6227	5221	6013	0.0	0.8682853816730417
chr5	PCDH1	141863231	141865427	306	2197	4131	5934	3825	3737	0.13928083750568956	1.0235483007760235
chr5	PCDH1	141856223	141856262	0	40	4131	5934	4131	5894	0.0	0.7008822531387852
chr5	PCDH1	141867469	141867614	765	146	4131	5934	3366	5788	5.239726027397261	0.5815480304077402
chr5	GNPDA1	142012287	142012339	0	53	102	3613	102	3560	0.0	0.028651685393258425
chr5	GNPDA1	142012287	142012377	0	91	102	3613	102	3522	0.0	0.028960817717206135
chr5	SPRY4	142319743	142319794	0	52	255	6560	255	6508	0.0	0.03918254456054087
chr5	SPRY4	142319732	142319794	0	63	255	6560	255	6497	0.0	0.03924888410035401
chr5	FGF1	142600701	142600805	0	105	4504	4780	4504	4675	0.0	0.9634224598930481
chr5	FGF1	142600701	142600800	0	100	4504	4780	4504	4680	0.0	0.9623931623931624
chr5	FGF1	142697621	142697715	0	95	4504	4780	4504	4685	0.0	0.9613660618996799
chr5	ARHGAP26-AS1	142860304	142860563	0	260	0	996	0	736	0.0	0.0
chr5	NR3C1	143433718	143433817	0	100	102	9176	102	9076	0.0	0.01123843102688409
chr5	YIPF5	144169845	144169965	0	121	0	3704	0	3583	0.0	0.0
chr5	PRELID2	145819378	145819414	0	37	17088	2724	17088	2687	0.0	6.359508745813175
chr5	PRELID2	145825997	145826200	0	204	17088	2724	17088	2520	0.0	6.780952380952381
chr5	LARS1	146139615	146139703	0	89	0	16674	0	16585	0.0	0.0
chr5	LARS1	146131018	146131109	0	92	0	16674	0	16582	0.0	0.0
chr5	LARS1	146168127	146168265	0	139	0	16674	0	16535	0.0	0.0
chr5	LARS1	146171909	146171990	0	82	0	16674	0	16592	0.0	0.0
chr5	LARS1	146181011	146181187	0	177	0	16674	0	16497	0.0	0.0
chr5	LARS1	146177546	146177665	0	120	0	16674	0	16554	0.0	0.0
chr5	LARS1	146119008	146119074	0	67	0	16674	0	16607	0.0	0.0
chr5	PPP2R2B	146878001	146878195	0	195	60	13227	60	13032	0.0	0.004604051565377533
chr5	PPP2R2B	146856498	146856583	0	86	60	13227	60	13141	0.0	0.004565862567536717
chr5	PPP2R2B	146592048	146592193	0	146	60	13227	60	13081	0.0	0.0045868052901154345
chr5	PPP2R2B	147054597	147054659	0	63	60	13227	60	13164	0.0	0.004557885141294439
chr5	PPP2R2B	147040716	147040805	0	90	60	13227	60	13137	0.0	0.004567252797442339
chr5	PPP2R2B	147035168	147035240	0	73	60	13227	60	13154	0.0	0.004561350159647256
chr5	DPYSL3	147397665	147397845	0	181	82	7196	82	7015	0.0	0.011689237348538845
chr5	DPYSL3	147400691	147400833	31	143	82	7196	51	7053	0.21678321678321677	0.007230965546575925
chr5	JAKMIP2	147601740	147601811	0	72	216	9225	216	9153	0.0	0.02359882005899705
chr5	JAKMIP2	147636221	147636284	0	64	216	9225	216	9161	0.0	0.023578211985591093
chr5	JAKMIP2	147640703	147640823	0	121	216	9225	216	9104	0.0	0.023725834797891036
chr5	JAKMIP2	147650337	147650547	0	211	216	9225	216	9014	0.0	0.0239627246505436
chr5	JAKMIP2	147671677	147671954	0	278	216	9225	216	8947	0.0	0.024142170559964232
chr5	AC011346.1	148308003	148308165	0	163	5439	13969	5439	13806	0.0	0.39395914819643635
chr5	AC011346.1	148290920	148290995	0	76	5439	13969	5439	13893	0.0	0.3914921183329734
chr5	AC011346.1	148377286	148377361	0	76	5439	13969	5439	13893	0.0	0.3914921183329734
chr5	AC011346.1	148290251	148290995	0	745	5439	13969	5439	13224	0.0	0.41129764065335755
chr5	HTR4	148461872	148461943	0	72	252	7064	252	6992	0.0	0.036041189931350116
chr5	HTR4	148465849	148465925	0	77	252	7064	252	6987	0.0	0.036066981537140406
chr5	HTR4	148484259	148484379	0	121	252	7064	252	6943	0.0	0.03629554947429065
chr5	HTR4	148490599	148490846	252	248	252	7064	0	6816	1.0161290322580645	0.0
chr5	SH3TC2	149003725	149003842	74	118	4883	12652	4809	12534	0.6271186440677966	0.3836764001914792
chr5	SH3TC2	149034390	149034520	153	131	4883	12652	4730	12521	1.16793893129771	0.37776535420493573
chr5	SH3TC2	149035392	149035602	0	211	4883	12652	4883	12441	0.0	0.39249256490635803
chr5	SH3TC2	149006133	149006251	0	119	4883	12652	4883	12533	0.0	0.3896114258357935
chr5	SH3TC2	149026059	149026200	0	142	4883	12652	4883	12510	0.0	0.3903277378097522
chr5	SH3TC2	149045893	149045961	0	69	4883	12652	4883	12583	0.0	0.38806325995390606
chr5	CSNK1A1	149511793	149511872	0	80	1936	8524	1936	8444	0.0	0.22927522501184272
chr5	CSNK1A1	149517793	149517877	0	85	1936	8524	1936	8439	0.0	0.22941106766204528
chr5	CSNK1A1	149525044	149525171	0	128	1936	8524	1936	8396	0.0	0.23058599333015722
chr5	CSNK1A1	149511065	149511158	0	94	1936	8524	1936	8430	0.0	0.22965599051008304
chr5	CSNK1A1	149515668	149515726	0	59	1936	8524	1936	8465	0.0	0.22870643827525103
chr5	CSNK1A1	149531393	149531511	0	119	1936	8524	1936	8405	0.0	0.23033908387864366
chr5	CSNK1A1	149529603	149529719	0	117	1936	8524	1936	8407	0.0	0.23028428690377067
chr5	PDE6A	149898362	149898506	306	145	91732	5965	91426	5820	2.110344827586207	15.70893470790378
chr5	CSF1R	150073300	150073493	1431	194	117437	5174	116006	4980	7.376288659793815	23.29437751004016
chr5	CSF1R	150059699	150059862	0	164	117437	5174	117437	5010	0.0	23.44051896207585
chr5	CSF1R	150086378	150086607	3108	230	117437	5174	114329	4944	13.513043478260869	23.124797734627833
chr5	CSF1R	150058154	150058271	3789	118	117437	5174	113648	5056	32.110169491525426	22.477848101265824
chr5	PDGFRB	150137007	150137053	0	47	8543	6271	8543	6224	0.0	1.3725899742930592
chr5	CAMK2A	150228191	150228286	0	96	108	6094	108	5998	0.0	0.01800600200066689
chr5	CAMK2A	150231304	150231380	0	77	108	6094	108	6017	0.0	0.01794914409174007
chr5	CAMK2A	150239703	150239736	0	34	108	6094	108	6060	0.0	0.01782178217821782
chr5	CAMK2A	150264955	150265015	0	61	108	6094	108	6033	0.0	0.01790154152163103
chr5	CD74	150403120	150403312	4094	193	15175	2965	11081	2772	21.212435233160623	3.9974747474747474
chr5	CD74	150406880	150406960	51	81	15175	2965	15124	2884	0.6296296296296297	5.244105409153953
chr5	CD74	150407151	150407324	51	174	15175	2965	15124	2791	0.29310344827586204	5.418846291651738
chr5	RPS14	150444478	150444641	31691	164	73367	2968	41676	2804	193.2378048780488	14.863052781740372
chr5	DCTN4	150742113	150742157	0	45	357	6234	357	6189	0.0	0.057682985942801746
chr5	DCTN4	150731885	150731906	0	22	357	6234	357	6212	0.0	0.05746941403734707
chr5	DCTN4	150755530	150755567	0	38	357	6234	357	6196	0.0	0.057617817947062624
chr5	DCTN4	150757920	150757948	0	29	357	6234	357	6205	0.0	0.057534246575342465
chr5	ZNF300	150903140	150903182	0	43	4168	4410	4168	4367	0.0	0.9544309594687428
chr5	ZNF300	150903328	150903383	200	56	4168	4410	3968	4354	3.5714285714285716	0.9113458888378503
chr5	TNIP1	151033607	151033799	0	193	372466	5576	372466	5383	0.0	69.19301504737136
chr5	TNIP1	151064959	151065131	51	173	372466	5576	372415	5403	0.2947976878612717	68.92744771423283
chr5	TNIP1	151032286	151032383	0	98	372466	5576	372466	5478	0.0	67.99306316173787
chr5	TNIP1	151033479	151033579	0	101	372466	5576	372466	5475	0.0	68.03031963470319
chr5	TNIP1	151080323	151080359	0	37	372466	5576	372466	5539	0.0	67.24426791839683
chr5	ANXA6	151110626	151110644	266	19	50620	5501	50354	5482	14.0	9.185333819773804
chr5	ANXA6	151147883	151147926	38	44	50620	5501	50582	5457	0.8636363636363636	9.269195528678761
chr5	ANXA6	151140326	151140555	0	230	50620	5501	50620	5271	0.0	9.603490798709922
chr5	CCDC69	151198996	151199084	0	89	678938	4952	678938	4863	0.0	139.61299609294673
chr5	CCDC69	151205399	151205475	0	77	678938	4952	678938	4875	0.0	139.26933333333332
chr5	SLC36A3	151288933	151289056	0	124	0	4990	0	4866	0.0	0.0
chr5	SLC36A2	151339059	151339144	0	86	1530	4280	1530	4194	0.0	0.3648068669527897
chr5	SLC36A2	151332428	151332525	0	98	1530	4280	1530	4182	0.0	0.36585365853658536
chr5	SPARC	151679073	151679299	0	227	0	4653	0	4426	0.0	0.0
chr5	GLRA1	151892310	151892438	0	129	249	2453	249	2324	0.0	0.10714285714285714
chr5	LINC01470	152623230	152623352	0	123	0	4499	0	4376	0.0	0.0
chr5	LINC01470	152631411	152631478	0	68	0	4499	0	4431	0.0	0.0
chr5	LINC01470	152971713	152971786	0	74	0	4499	0	4425	0.0	0.0
chr5	LINC01470	152967092	152967106	0	15	0	4499	0	4484	0.0	0.0
chr5	FAM114A2	154038387	154038434	0	48	867	6540	867	6492	0.0	0.13354898336414048
chr5	FAM114A2	154038292	154038434	0	143	867	6540	867	6397	0.0	0.13553228075660465
chr5	FAM114A2	154036241	154036385	0	145	867	6540	867	6395	0.0	0.13557466770914778
chr5	FAXDC2	154830800	154830922	0	123	18	6073	18	5950	0.0	0.0030252100840336134
chr5	FAXDC2	154834624	154834728	0	105	18	6073	18	5968	0.0	0.0030160857908847183
chr5	FAXDC2	154838130	154838178	18	49	18	6073	0	6024	0.3673469387755102	0.0
chr5	FAXDC2	154838562	154838939	0	378	18	6073	18	5695	0.0	0.003160667251975417
chr5	TIMD4	156948415	156948499	0	85	1192	1526	1192	1441	0.0	0.8272033310201249
chr5	HAVCR1	157032853	157032887	0	35	187	1934	187	1899	0.0	0.09847288046340179
chr5	HAVCR1	157032853	157032870	0	18	187	1934	187	1916	0.0	0.0975991649269311
chr5	HAVCR2	157104665	157104749	0	85	0	3220	0	3135	0.0	0.0
chr5	SOX30	157638229	157638722	0	494	0	3496	0	3002	0.0	0.0
chr5	CLINT1	157794897	157794972	0	76	2703	6158	2703	6082	0.0	0.44442617560013153
chr5	CLINT1	157790599	157790651	0	53	2703	6158	2703	6105	0.0	0.44275184275184276
chr5	EBF1	158712153	158712333	23345	181	110148	6353	86803	6172	128.97790055248618	14.06399870382372
chr5	EBF1	159073395	159073464	0	70	110148	6353	110148	6283	0.0	17.531115709056184
chr5	LINC01847	159704325	159704576	0	252	0	8584	0	8332	0.0	0.0
chr5	LINC01847	159748232	159748375	0	144	0	8584	0	8440	0.0	0.0
chr5	LINC01847	159866871	159867035	0	165	0	8584	0	8419	0.0	0.0
chr5	PWWP2A	160080650	160080770	0	121	52	4785	52	4664	0.0	0.011149228130360206
chr5	PWWP2A	160089505	160089610	1	106	52	4785	51	4679	0.009433962264150943	0.010899764907031416
chr5	PWWP2A	160108544	160108614	0	71	52	4785	52	4714	0.0	0.01103097157403479
chr5	CCNJL	160261080	160261337	51	258	204	9249	153	8991	0.19767441860465115	0.01701701701701702
chr5	CCNJL	160276268	160276412	0	145	204	9249	204	9104	0.0	0.02240773286467487
chr5	CCNJL	160254128	160254335	0	208	204	9249	204	9041	0.0	0.022563875677469307
chr5	CCNJL	160294727	160294963	0	237	204	9249	204	9012	0.0	0.022636484687083888
chr5	CCNJL	160274821	160274858	0	38	204	9249	204	9211	0.0	0.022147432417761372
chr5	ZBED8	160397441	160397515	0	75	0	2885	0	2810	0.0	0.0
chr5	SLU7	160417111	160417241	0	131	0	4786	0	4655	0.0	0.0
chr5	SLU7	160418595	160418685	0	91	0	4786	0	4695	0.0	0.0
chr5	ATP10B	160688759	160688943	0	185	0	9107	0	8922	0.0	0.0
chr5	ATP10B	160716908	160717034	0	127	0	9107	0	8980	0.0	0.0
chr5	GABRB2	161326367	161326481	0	115	0	17158	0	17043	0.0	0.0
chr5	GABRB2	161459623	161459844	0	222	0	17158	0	16936	0.0	0.0
chr5	GABRB2	161546321	161546413	0	93	0	17158	0	17065	0.0	0.0
chr5	GABRB2	161394720	161394761	0	42	0	17158	0	17116	0.0	0.0
chr5	AC113414.1	162591609	162591685	0	77	51	8813	51	8736	0.0	0.005837912087912088
chr5	AC113414.1	162660101	162660225	0	125	51	8813	51	8688	0.0	0.005870165745856353
chr5	HMMR-AS1	163489250	163489383	0	134	5	960	5	826	0.0	0.006053268765133172
chr5	LINC01938	165241085	165241268	0	184	0	3198	0	3014	0.0	0.0
chr5	PANK3	168563888	168564065	0	178	3570	10356	3570	10178	0.0	0.35075653370013754
chr5	PANK3	168578633	168578707	0	75	3570	10356	3570	10281	0.0	0.3472424861394806
chr5	LCP2	170266807	170266891	0	85	469	6844	469	6759	0.0	0.06938896286432904
chr5	FBXW11	171914342	171914405	0	64	1910	5539	1910	5475	0.0	0.34885844748858447
chr5	FBXW11	171957596	171957698	0	103	1910	5539	1910	5436	0.0	0.3513612950699043
chr5	FBXW11	171996889	171997051	0	163	1910	5539	1910	5376	0.0	0.3552827380952381
chr5	STK10	172107779	172107852	0	74	98986	8939	98986	8865	0.0	11.165933446136492
chr5	STK10	172045425	172045480	0	56	98986	8939	98986	8883	0.0	11.14330744117978
chr5	SH3PXD2B	172356690	172356774	2552	85	67095	7913	64543	7828	30.023529411764706	8.245145631067961
chr5	BOD1	173609237	173609434	0	198	51	2259	51	2061	0.0	0.024745269286754003
chr5	BOD1	173613130	173613255	0	126	51	2259	51	2133	0.0	0.02390998593530239
chr5	LINC01484	173711845	173711948	0	104	0	5287	0	5183	0.0	0.0
chr5	LINC01484	173718840	173719543	0	704	0	5287	0	4583	0.0	0.0
chr5	AC113423.2	174084098	174084158	0	61	0	884	0	823	0.0	0.0
chr5	AC113423.2	174084098	174084290	0	193	0	884	0	691	0.0	0.0
chr5	THOC3	175961050	175961151	1018	102	16819	2629	15801	2527	9.980392156862745	6.252869014641868
chr5	THOC3	175967110	175967267	924	158	16819	2629	15895	2471	5.848101265822785	6.432618373128288
chr5	AC139491.6	176146088	176146207	0	120	0	2756	0	2636	0.0	0.0
chr5	AC139493.2	176174973	176175060	0	88	71	3034	71	2946	0.0	0.024100475220638153
chr5	AC139493.2	176183230	176183301	0	72	71	3034	71	2962	0.0	0.02397029034436192
chr5	AC139491.6	176146770	176146863	0	94	0	2756	0	2662	0.0	0.0
chr5	AC139493.2	176177647	176177945	0	299	71	3034	71	2735	0.0	0.025959780621572212
chr5	KIAA1191	176359480	176359567	0	88	2475	3822	2475	3734	0.0	0.6628280664167113
chr5	KIAA1191	176359810	176359918	0	109	2475	3822	2475	3713	0.0	0.6665768920010773
chr5	KIAA1191	176355570	176355749	23	180	2475	3822	2452	3642	0.12777777777777777	0.6732564524986271
chr5	KIAA1191	176359461	176359567	0	107	2475	3822	2475	3715	0.0	0.6662180349932705
chr5	KIAA1191	176357175	176357273	0	99	2475	3822	2475	3723	0.0	0.6647864625302176
chr5	CLTB	176396478	176396532	1143	55	2978	1831	1835	1776	20.78181818181818	1.0332207207207207
chr5	CLTB	176406156	176406708	51	553	2978	1831	2927	1278	0.0922242314647378	2.2902973395931143
chr5	SNCB	176626719	176626761	34	43	102	1869	68	1826	0.7906976744186046	0.03723986856516977
chr5	SNCB	176629808	176629965	0	158	102	1869	102	1711	0.0	0.05961426066627703
chr5	UIMC1	176968554	176969291	6402	738	212848	3988	206446	3250	8.674796747967479	63.521846153846155
chr5	UIMC1	176969052	176969291	2730	240	212848	3988	210118	3748	11.375	56.06136606189968
chr5	UIMC1	177001416	177001501	0	86	212848	3988	212848	3902	0.0	54.54843669912865
chr5	UIMC1	177001997	177002111	0	115	212848	3988	212848	3873	0.0	54.956880970823654
chr5	RAB24	177302751	177302830	14288	80	74260	1931	59972	1851	178.6	32.39978390059427
chr5	MXD3	177310667	177310697	6687	31	525489	5032	518802	5001	215.70967741935485	103.73965206958609
chr5	F12	177404498	177404664	0	167	11	2581	11	2414	0.0	0.004556752278376139
chr5	DBN1	177472118	177472397	0	280	501	4984	501	4704	0.0	0.10650510204081633
chr5	DBN1	177459602	177459740	0	139	501	4984	501	4845	0.0	0.10340557275541795
chr5	PDLIM7	177489770	177489832	0	63	190	4294	190	4231	0.0	0.04490664145592058
chr5	PDLIM7	177491403	177491420	0	18	190	4294	190	4276	0.0	0.04443405051449953
chr5	PDLIM7	177491806	177491925	88	120	190	4294	102	4174	0.7333333333333333	0.024436990896023
chr5	PDLIM7	177489770	177490031	0	262	190	4294	190	4032	0.0	0.04712301587301587
chr5	PDLIM7	177491806	177491976	109	171	190	4294	81	4123	0.6374269005847953	0.019645888915837982
chr5	PDLIM7	177491806	177491995	128	190	190	4294	62	4104	0.6736842105263158	0.015107212475633527
chr5	DOK3	177508236	177508542	0	307	102	4236	102	3929	0.0	0.025960804275897174
chr5	DOK3	177510542	177510581	0	40	102	4236	102	4196	0.0	0.02430886558627264
chr5	DDX41	177515684	177515821	0	138	80	3376	80	3238	0.0	0.02470660901791229
chr5	DDX41	177514172	177514288	0	117	80	3376	80	3259	0.0	0.0245474071801166
chr5	FAM193B	177523162	177523265	0	104	11948	5341	11948	5237	0.0	2.28145885048692
chr5	FAM193B	177531952	177532200	0	249	11948	5341	11948	5092	0.0	2.3464257659073056
chr5	FAM193B	177552041	177552131	326	91	11948	5341	11622	5250	3.5824175824175826	2.2137142857142855
chr5	FAM193B	177531952	177532131	0	180	11948	5341	11948	5161	0.0	2.3150552218562295
chr5	FAM193B	177531281	177531521	0	241	11948	5341	11948	5100	0.0	2.3427450980392157
chr5	FAM193B	177523158	177523265	0	108	11948	5341	11948	5233	0.0	2.2832027517676283
chr5	FAM193B	177532155	177532200	0	46	11948	5341	11948	5295	0.0	2.2564683663833804
chr5	FAM193B	177547167	177547228	1363	62	11948	5341	10585	5279	21.983870967741936	2.005114605038833
chr5	FAM153A	177763316	177763510	0	195	16362	8568	16362	8373	0.0	1.9541383016839842
chr5	FAM153A	177750908	177751052	0	145	16362	8568	16362	8423	0.0	1.9425382880208952
chr5	FAM153A	177767149	177767180	0	32	16362	8568	16362	8536	0.0	1.9168228678537957
chr5	FAM153A	177750958	177751052	0	95	16362	8568	16362	8473	0.0	1.9310751799834769
chr5	NHP2	178150887	178150993	0	107	4392	1330	4392	1223	0.0	3.5911692559280457
chr5	PHYKPL	178212972	178213103	0	132	23	7715	23	7583	0.0	0.003033100356059607
chr5	PHYKPL	178215275	178215430	0	156	23	7715	23	7559	0.0	0.003042730519910041
chr5	PHYKPL	178231404	178231523	0	120	23	7715	23	7595	0.0	0.003028308097432521
chr5	PHYKPL	178229697	178229720	23	24	23	7715	0	7691	0.9583333333333334	0.0
chr5	PHYKPL	178231668	178231866	0	199	23	7715	23	7516	0.0	0.0030601383714741882
chr5	PHYKPL	178223319	178223451	0	133	23	7715	23	7582	0.0	0.0030335003956739647
chr5	CLK4	178608375	178608458	0	84	45809	7054	45809	6970	0.0	6.572309899569584
chr5	CLK4	178617343	178617434	1215	92	45809	7054	44594	6962	13.206521739130435	6.405343292157426
chr5	CLK4	178619837	178619896	907	60	45809	7054	44902	6994	15.116666666666667	6.4200743494423795
chr5	CLK4	178605824	178605865	0	42	45809	7054	45809	7012	0.0	6.532943525385054
chr5	CLK4	178622392	178622459	867	68	45809	7054	44942	6986	12.75	6.433152018322359
chr5	CLK4	178619837	178620673	16410	837	45809	7054	29399	6217	19.60573476702509	4.728808106803925
chr5	ZNF354A	178726074	178726227	0	154	823	2990	823	2836	0.0	0.290197461212976
chr5	AACSP1	178768469	178768664	0	196	2745	3397	2745	3201	0.0	0.8575445173383318
chr5	HNRNPH1	179615545	179615595	0	51	255	5593	255	5542	0.0	0.046012269938650305
chr5	HNRNPH1	179617050	179617110	0	61	255	5593	255	5532	0.0	0.04609544468546638
chr5	HNRNPH1	179619268	179619407	0	140	255	5593	255	5453	0.0	0.04676324958738309
chr5	HNRNPH1	179620891	179621035	0	145	255	5593	255	5448	0.0	0.04680616740088106
chr5	HNRNPH1	179621241	179621397	0	157	255	5593	255	5436	0.0	0.04690949227373068
chr5	HNRNPH1	179617059	179617110	0	52	255	5593	255	5541	0.0	0.0460205739036275
chr5	HNRNPH1	179618144	179618323	0	180	255	5593	255	5413	0.0	0.047108812118972845
chr5	HNRNPH1	179619268	179619360	0	93	255	5593	255	5500	0.0	0.046363636363636364
chr5	HNRNPH1	179621842	179621976	0	135	255	5593	255	5458	0.0	0.046720410406742394
chr5	HNRNPH1	179621370	179621397	0	28	255	5593	255	5565	0.0	0.04582210242587601
chr5	HNRNPH1	179623977	179624115	0	139	255	5593	255	5454	0.0	0.046754675467546754
chr5	HNRNPH1	179624096	179624202	0	107	255	5593	255	5486	0.0	0.04648195406489245
chr5	MGAT4B	179801333	179801467	0	135	77	5408	77	5273	0.0	0.014602692964157026
chr5	MGAT4B	179799202	179799250	0	49	77	5408	77	5359	0.0	0.014368352304534428
chr5	MRNIP	179844151	179844227	0	77	1734	7454	1734	7377	0.0	0.23505490036600243
chr5	MRNIP	179853196	179853276	0	81	1734	7454	1734	7373	0.0	0.2351824223518242
chr5	MRNIP	179847977	179848066	0	90	1734	7454	1734	7364	0.0	0.23546985334057577
chr5	MRNIP	179851242	179851337	0	96	1734	7454	1734	7358	0.0	0.23566186463712965
chr5	MRNIP	179851242	179851424	0	183	1734	7454	1734	7271	0.0	0.23848163938935496
chr5	TBC1D9B	179867444	179867495	0	52	409	10501	409	10449	0.0	0.03914250167480142
chr5	TBC1D9B	179899188	179899307	0	120	409	10501	409	10381	0.0	0.039398901839899816
chr5	RNF130	179963470	179963564	0	95	123402	12829	123402	12734	0.0	9.69074917543584
chr5	RASGEF1C	180115246	180115284	0	39	6173	3032	6173	2993	0.0	2.0624791179418644
chr5	MAPK9	180279795	180280036	874	242	131099	8972	130225	8730	3.6115702479338845	14.916953035509737
chr5	MAPK9	180247662	180247728	0	67	131099	8972	131099	8905	0.0	14.721953958450309
chr5	MAPK9	180286974	180287067	0	94	131099	8972	131099	8878	0.0	14.766726740256814
chr5	FLT4	180619020	180619109	1446	90	69799	8776	68353	8686	16.066666666666666	7.869329956251439
chr5	FLT4	180629258	180629427	0	170	69799	8776	69799	8606	0.0	8.11050429932605
chr5	MGAT1	180808647	180809066	0	420	612	11216	612	10796	0.0	0.05668766209707299
chr5	MGAT1	180795837	180795875	0	39	612	11216	612	11177	0.0	0.05475530106468641
chr5	MGAT1	180795655	180795875	0	221	612	11216	612	10995	0.0	0.05566166439290587
chr5	ZFP62	180851987	180852060	0	74	51	3131	51	3057	0.0	0.016683022571148183
chr5	OR2V1	181129519	181129575	0	57	0	2789	0	2732	0.0	0.0
chr5	RACK1	181237608	181237719	0	112	0	5102	0	4990	0.0	0.0
chr5	RACK1	181239066	181239177	0	112	0	5102	0	4990	0.0	0.0
chr5	RACK1	181241491	181241639	0	149	0	5102	0	4953	0.0	0.0
chr5	RACK1	181237224	181237319	0	96	0	5102	0	5006	0.0	0.0
chr5	RACK1	181238098	181238239	0	142	0	5102	0	4960	0.0	0.0
chr5	RACK1	181240215	181240327	0	113	0	5102	0	4989	0.0	0.0
chr5	RACK1	181240215	181240345	0	131	0	5102	0	4971	0.0	0.0
chr5	RACK1	181241491	181241563	0	73	0	5102	0	5029	0.0	0.0
chr5	RACK1	181243285	181243405	0	121	0	5102	0	4981	0.0	0.0
chr5	RACK1	181243253	181243405	0	153	0	5102	0	4949	0.0	0.0
chr6	DUSP22	311879	311962	5447	84	241469	4077	236022	3993	64.8452380952381	59.108940646130726
chr6	DUSP22	335113	335163	5209	51	241469	4077	236260	4026	102.13725490196079	58.68355688027819
chr6	DUSP22	304627	304661	4081	35	241469	4077	237388	4042	116.6	58.730331519049976
chr6	IRF4	393097	393368	0	272	0	5891	0	5619	0.0	0.0
chr6	IRF4	406765	406899	0	135	0	5891	0	5756	0.0	0.0
chr6	GMDS-DT	2398882	2399037	4883	156	50690	21506	45807	21350	31.30128205128205	2.145526932084309
chr6	GMDS-DT	2263600	2263684	0	85	50690	21506	50690	21421	0.0	2.3663694505391906
chr6	GMDS-DT	2397220	2397626	848	407	50690	21506	49842	21099	2.0835380835380835	2.3622920517560075
chr6	GMDS-DT	2360543	2360630	0	88	50690	21506	50690	21418	0.0	2.366700905780185
chr6	GMDS-DT	2398576	2398778	0	203	50690	21506	50690	21303	0.0	2.379477068957424
chr6	GMDS-DT	2398865	2399037	4988	173	50690	21506	45702	21333	28.832369942196532	2.1423147236675573
chr6	GMDS-DT	2269697	2269799	0	103	50690	21506	50690	21403	0.0	2.3683595757604072
chr6	NQO2	3003668	3003789	51	122	182198	4556	182147	4434	0.4180327868852459	41.07961208840776
chr6	NQO2	3015529	3015643	2485	115	182198	4556	179713	4441	21.608695652173914	40.466786759738795
chr6	NQO2	3002049	3002286	1305	238	182198	4556	180893	4318	5.483193277310924	41.89277443260769
chr6	NQO2	3004494	3004651	637	158	182198	4556	181561	4398	4.031645569620253	41.28262846748522
chr6	NQO2	3006815	3006935	780	121	182198	4556	181418	4435	6.446280991735537	40.905975197294254
chr6	RIPK1	3076763	3076987	0	225	427461	10181	427461	9956	0.0	42.93501406187224
chr6	RIPK1	3082546	3082660	2242	115	427461	10181	425219	10066	19.495652173913044	42.243095569242996
chr6	RIPK1	3064487	3064721	1365	235	427461	10181	426096	9946	5.808510638297872	42.84094108184195
chr6	RIPK1	3083084	3083313	2877	230	427461	10181	424584	9951	12.508695652173913	42.66747060596925
chr6	RIPK1	3080978	3081116	2408	139	427461	10181	425053	10042	17.323741007194243	42.327524397530375
chr6	RIPK1	3089580	3089657	811	78	427461	10181	426650	10103	10.397435897435898	42.23003068395526
chr6	RIPK1	3073638	3073802	3	165	427461	10181	427458	10016	0.01818181818181818	42.677515974440894
chr6	BPHL	3119284	3119512	306	229	456303	5789	455997	5560	1.3362445414847162	82.01384892086331
chr6	PSMG4	3263683	3263759	1731	77	282081	6322	280350	6245	22.48051948051948	44.89191353082466
chr6	PSMG4	3264208	3264325	2296	118	282081	6322	279785	6204	19.45762711864407	45.097517730496456
chr6	PSMG4	3264173	3264325	2447	153	282081	6322	279634	6169	15.993464052287582	45.32890257740314
chr6	PRPF4B	4062556	4062633	17	78	332939	7279	332922	7201	0.21794871794871795	46.23274545202055
chr6	PRPF4B	4062556	4062760	5069	205	332939	7279	327870	7074	24.726829268292683	46.348600508905854
chr6	C6ORF201	4087348	4087726	0	379	250103	3267	250103	2888	0.0	86.60076177285319
chr6	CDYL	4733158	4733248	0	91	374054	4577	374054	4486	0.0	83.38252340615247
chr6	CDYL	4891712	4892379	118638	668	374054	4577	255416	3909	177.60179640718562	65.34049629061141
chr6	LYRM4-AS1	5022428	5022576	0	149	30522	4630	30522	4481	0.0	6.811426020977461
chr6	LYRM4-AS1	5030772	5031022	115	251	30522	4630	30407	4379	0.4581673306772908	6.943822790591459
chr6	LYRM4-AS1	5030748	5031022	115	275	30522	4630	30407	4355	0.41818181818181815	6.982089552238806
chr6	LYRM4-AS1	5040629	5040687	0	59	30522	4630	30522	4571	0.0	6.6773134981404505
chr6	LYRM4-AS1	5030804	5031022	115	219	30522	4630	30407	4411	0.5251141552511416	6.893448197687599
chr6	FARS2	5272425	5272489	0	65	52711	4850	52711	4785	0.0	11.015882967607105
chr6	RREB1	7240437	7240602	1728	166	335847	16690	334119	16524	10.409638554216867	20.220225127087872
chr6	RREB1	7246423	7247221	27496	799	335847	16690	308351	15891	34.41301627033792	19.404128122836827
chr6	SNRNP48	7599672	7599680	0	9	522045	5846	522045	5837	0.0	89.43721089600822
chr6	AL355499.1	8260566	8260738	0	173	12195	4643	12195	4470	0.0	2.728187919463087
chr6	AL355499.1	8146509	8146599	0	91	12195	4643	12195	4552	0.0	2.679042179261863
chr6	AL355499.1	8302933	8303118	0	186	12195	4643	12195	4457	0.0	2.7361453892752974
chr6	AL355499.1	8323530	8323636	0	107	12195	4643	12195	4536	0.0	2.6884920634920637
chr6	HULC	8754785	8754892	0	108	31525	47611	31525	47503	0.0	0.6636422962760247
chr6	AL355499.1	8329654	8329923	0	270	12195	4643	12195	4373	0.0	2.7887034072718957
chr6	AL355499.1	8328004	8328277	0	274	12195	4643	12195	4369	0.0	2.791256580453193
chr6	HULC	8558584	8558643	0	60	31525	47611	31525	47551	0.0	0.6629723875417972
chr6	HULC	8577267	8577449	0	183	31525	47611	31525	47428	0.0	0.6646917432740154
chr6	HULC	8780248	8780367	0	120	31525	47611	31525	47491	0.0	0.6638099850497989
chr6	HULC	8547116	8547214	0	99	31525	47611	31525	47512	0.0	0.6635165852837178
chr6	HULC	8788821	8790434	8109	1614	31525	47611	23416	45997	5.0241635687732344	0.5090766789138422
chr6	HULC	8760376	8760495	0	120	31525	47611	31525	47491	0.0	0.6638099850497989
chr6	HULC	8788821	8788946	0	126	31525	47611	31525	47485	0.0	0.6638938612193325
chr6	HULC	8779886	8780007	0	122	31525	47611	31525	47489	0.0	0.6638379414180126
chr6	HULC	8759798	8759958	0	161	31525	47611	31525	47450	0.0	0.6643835616438356
chr6	HULC	8759837	8759958	0	122	31525	47611	31525	47489	0.0	0.6638379414180126
chr6	HULC	8788821	8788964	0	144	31525	47611	31525	47467	0.0	0.6641456169549371
chr6	HULC	8607007	8607168	0	162	31525	47611	31525	47449	0.0	0.6643975636999726
chr6	HULC	8469990	8470132	0	143	31525	47611	31525	47468	0.0	0.6641316255161371
chr6	HULC	8932841	8932885	0	45	31525	47611	31525	47566	0.0	0.662763318336627
chr6	HULC	8923685	8923832	0	148	31525	47611	31525	47463	0.0	0.6642015886058614
chr6	HULC	8831501	8831621	0	121	31525	47611	31525	47490	0.0	0.6638239629395662
chr6	HULC	9188865	9189035	0	171	31525	47611	31525	47440	0.0	0.6645236087689713
chr6	HULC	8925813	8925931	0	119	31525	47611	31525	47492	0.0	0.6637960077486734
chr6	HULC	8992164	8992294	0	131	31525	47611	31525	47480	0.0	0.6639637742207245
chr6	HULC	8858128	8858355	0	228	31525	47611	31525	47383	0.0	0.6653230061414431
chr6	HULC	8790271	8790434	1683	164	31525	47611	29842	47447	10.262195121951219	0.6289544122916095
chr6	HULC	8985729	8985847	0	119	31525	47611	31525	47492	0.0	0.6637960077486734
chr6	HULC	8789309	8789418	1020	110	31525	47611	30505	47501	9.272727272727273	0.642197006378813
chr6	HULC	8959635	8959748	0	114	31525	47611	31525	47497	0.0	0.6637261300713729
chr6	HULC	9023270	9023324	0	55	31525	47611	31525	47556	0.0	0.6629026831524939
chr6	HULC	8751004	8751067	0	64	31525	47611	31525	47547	0.0	0.6630281616085136
chr6	HULC	8850838	8850951	0	114	31525	47611	31525	47497	0.0	0.6637261300713729
chr6	HULC	8855977	8856105	0	129	31525	47611	31525	47482	0.0	0.663935807253275
chr6	HULC	8960706	8960815	0	110	31525	47611	31525	47501	0.0	0.6636702385212943
chr6	HULC	8961458	8961564	0	107	31525	47611	31525	47504	0.0	0.6636283260357022
chr6	HULC	9092216	9092308	0	93	31525	47611	31525	47518	0.0	0.6634328044109601
chr6	HULC	8937390	8937480	0	91	31525	47611	31525	47520	0.0	0.6634048821548821
chr6	HULC	9092593	9092752	0	160	31525	47611	31525	47451	0.0	0.6643695601778677
chr6	HULC	9090879	9091071	0	193	31525	47611	31525	47418	0.0	0.6648319203677928
chr6	HULC	9090879	9091080	0	202	31525	47611	31525	47409	0.0	0.6649581303128098
chr6	HULC	9044261	9044392	0	132	31525	47611	31525	47479	0.0	0.6639777585880073
chr6	GCNT2	10509086	10509158	0	73	115853	8968	115853	8895	0.0	13.024508150646431
chr6	GCNT2	10528630	10528841	2110	212	115853	8968	113743	8756	9.952830188679245	12.990292370945637
chr6	GCNT2	10528630	10529836	25228	1207	115853	8968	90625	7761	20.901408450704224	11.676974616673109
chr6	TMEM14C	10724555	10724633	3169	79	1508952	1327	1505783	1248	40.11392405063291	1206.556891025641
chr6	TMEM14C	10724569	10724633	2370	65	1508952	1327	1506582	1262	36.46153846153846	1193.8050713153725
chr6	TMEM14C	10724960	10725037	4858	78	1508952	1327	1504094	1249	62.282051282051285	1204.238590872698
chr6	TMEM14B	10751132	10751234	2214	103	892819	4830	890605	4727	21.49514563106796	188.40808123545588
chr6	TMEM14B	10749201	10749268	2074	68	892819	4830	890745	4762	30.5	187.05270894582108
chr6	TMEM14B	10827696	10827824	306	129	892819	4830	892513	4701	2.372093023255814	189.85598808764092
chr6	SYCP2L	10910823	10910869	0	47	34252	3997	34252	3950	0.0	8.67139240506329
chr6	TMEM14B	10749621	10749698	117	78	892819	4830	892702	4752	1.5	187.85816498316498
chr6	TMEM14B	10755141	10755232	3472	92	892819	4830	889347	4738	37.73913043478261	187.70514985225833
chr6	TMEM14B	10826563	10826612	535	50	892819	4830	892284	4780	10.7	186.6702928870293
chr6	SYCP2L	10922690	10922790	0	101	34252	3997	34252	3896	0.0	8.791581108829568
chr6	ELOVL2-AS1	11049108	11049219	0	112	5592	2521	5592	2409	0.0	2.3212951432129514
chr6	ELOVL2-AS1	11073454	11073545	0	92	5592	2521	5592	2429	0.0	2.3021819678880195
chr6	AL445430.1	11461284	11461467	0	184	0	1436	0	1252	0.0	0.0
chr6	AL445430.1	11466431	11466605	0	175	0	1436	0	1261	0.0	0.0
chr6	AL445430.2	11490312	11490464	0	153	0	1661	0	1508	0.0	0.0
chr6	HIVEP1	12129758	12129892	0	135	48602	11019	48602	10884	0.0	4.465453877251011
chr6	HIVEP1	12135790	12135892	0	103	48602	11019	48602	10916	0.0	4.452363503114694
chr6	HIVEP1	12020247	12020418	0	172	48602	11019	48602	10847	0.0	4.480685903936572
chr6	PHACTR1	12717508	12717553	0	46	1122	11593	1122	11547	0.0	0.09716809560924916
chr6	PHACTR1	12717508	12717743	0	236	1122	11593	1122	11357	0.0	0.09879369551818262
chr6	PHACTR1	13184798	13185005	0	208	1122	11593	1122	11385	0.0	0.09855072463768116
chr6	SIRT5	13596962	13597016	0	55	226203	6538	226203	6483	0.0	34.891716797778805
chr6	SIRT5	13588330	13588464	240	135	226203	6538	225963	6403	1.7777777777777777	35.290176479775106
chr6	SIRT5	13584986	13585127	0	142	226203	6538	226203	6396	0.0	35.36632270168855
chr6	RNF182	13961479	13961562	0	84	628322	4104	628322	4020	0.0	156.29900497512438
chr6	RNF182	13974209	13974364	0	156	628322	4104	628322	3948	0.0	159.14944275582573
chr6	MYLIP	16130556	16130747	0	192	4901	3079	4901	2887	0.0	1.6976099757533771
chr6	RBM24	17290848	17290893	1244	46	193755	3435	192511	3389	27.043478260869566	56.80466214222484
chr6	CAP2	17462995	17463073	36	79	279812	3361	279776	3282	0.45569620253164556	85.24558196221815
chr6	CAP2	17536237	17536341	27	105	279812	3361	279785	3256	0.2571428571428571	85.92905405405405
chr6	CAP2	17507168	17507312	526	145	279812	3361	279286	3216	3.627586206896552	86.84266169154229
chr6	CAP2	17493378	17493595	663	218	279812	3361	279149	3143	3.041284403669725	88.81609926821508
chr6	CDKAL1	20535086	20535199	3521	114	85744	4621	82223	4507	30.885964912280702	18.243399156867095
chr6	CASC15	22056545	22056690	0	146	2767	32553	2767	32407	0.0	0.0853827876693307
chr6	CASC15	22110746	22110920	0	175	2767	32553	2767	32378	0.0	0.08545926246216567
chr6	CASC15	22191566	22191656	0	91	2767	32553	2767	32462	0.0	0.08523812457642782
chr6	CASC15	21978944	21979062	0	119	2767	32553	2767	32434	0.0	0.08531170993401986
chr6	CASC15	22020338	22020542	0	205	2767	32553	2767	32348	0.0	0.085538518610115
chr6	CASC15	22110746	22110818	0	73	2767	32553	2767	32480	0.0	0.08519088669950739
chr6	CASC15	21802656	21802740	0	85	2767	32553	2767	32468	0.0	0.08522237279783171
chr6	CASC15	22173997	22174062	0	66	2767	32553	2767	32487	0.0	0.08517253055068182
chr6	CASC15	22113916	22114037	0	122	2767	32553	2767	32431	0.0	0.08531960161573802
chr6	CASC15	22063019	22063240	0	222	2767	32553	2767	32331	0.0	0.0855834957161857
chr6	CASC15	21999070	21999212	0	143	2767	32553	2767	32410	0.0	0.08537488429497068
chr6	CASC15	21909469	21909603	0	135	2767	32553	2767	32418	0.0	0.08535381578135603
chr6	CASC15	22083582	22083718	0	137	2767	32553	2767	32416	0.0	0.085359081934847
chr6	CASC15	22043630	22043894	0	265	2767	32553	2767	32288	0.0	0.08569747274529237
chr6	CASC15	22051477	22051590	0	114	2767	32553	2767	32439	0.0	0.08529856037485742
chr6	CASC15	21977321	21977530	0	210	2767	32553	2767	32343	0.0	0.08555174226262252
chr6	CASC15	21977777	21977927	0	151	2767	32553	2767	32402	0.0	0.0853959632121474
chr6	CASC15	22181322	22181475	0	154	2767	32553	2767	32399	0.0	0.08540387048982993
chr6	CASC15	22036830	22036941	0	112	2767	32553	2767	32441	0.0	0.08529330168613791
chr6	CASC15	21915208	21915238	0	31	2767	32553	2767	32522	0.0	0.08508086833528074
chr6	CASC15	21977777	21977953	0	177	2767	32553	2767	32376	0.0	0.08546454163577959
chr6	CASC15	21905544	21905605	0	62	2767	32553	2767	32491	0.0	0.0851620448739651
chr6	CASC15	22142900	22142951	0	52	2767	32553	2767	32501	0.0	0.0851358419740931
chr6	CASC15	22088566	22088783	0	218	2767	32553	2767	32335	0.0	0.08557290861295809
chr6	CASC15	22043646	22043894	0	249	2767	32553	2767	32304	0.0	0.08565502724120852
chr6	CASC15	22029424	22029562	0	139	2767	32553	2767	32414	0.0	0.08536434873819955
chr6	CASC15	21900914	21901180	0	267	2767	32553	2767	32286	0.0	0.08570278139131512
chr6	CASC15	22181664	22181762	0	99	2767	32553	2767	32454	0.0	0.08525913600788809
chr6	CASC15	22194044	22194446	0	403	2767	32553	2767	32150	0.0	0.08606531881804043
chr6	CASC15	22214306	22215702	306	1397	2767	32553	2461	31156	0.21904080171796708	0.07898960071896265
chr6	MRS2	24409460	24409573	0	114	176854	5145	176854	5031	0.0	35.15285231564302
chr6	MRS2	24408407	24408444	0	38	176854	5145	176854	5107	0.0	34.62972390836107
chr6	ALDH5A1	24515166	24515310	0	145	120531	7575	120531	7430	0.0	16.22220726783311
chr6	ALDH5A1	24502522	24502606	0	85	120531	7575	120531	7490	0.0	16.092256341789053
chr6	ALDH5A1	24511829	24511868	0	40	120531	7575	120531	7535	0.0	15.996151293961512
chr6	ALDH5A1	24515124	24515310	0	187	120531	7575	120531	7388	0.0	16.314428803465077
chr6	ALDH5A1	24502522	24502763	94	242	120531	7575	120437	7333	0.3884297520661157	16.42397381699168
chr6	ACOT13	24687404	24687693	2142	290	220553	4398	218411	4108	7.386206896551724	53.16723466407011
chr6	LINC02828	24748995	24749148	0	154	102	868	102	714	0.0	0.14285714285714285
chr6	CARMIL1	25507478	25507490	0	13	46567	6896	46567	6883	0.0	6.765509225628359
chr6	CARMIL1	25576975	25576993	0	19	46567	6896	46567	6877	0.0	6.771411952886433
chr6	CARMIL1	25612739	25612886	0	148	46567	6896	46567	6748	0.0	6.900859513930054
chr6	SCGN	25681950	25682006	0	57	0	1493	0	1436	0.0	0.0
chr6	SCGN	25653381	25653452	0	72	0	1493	0	1421	0.0	0.0
chr6	SLC17A4	25768335	25768435	0	101	0	4570	0	4469	0.0	0.0
chr6	U91328.1	25993996	25994142	0	147	73081	3639	73081	3492	0.0	20.928121420389463
chr6	U91328.1	25993168	25993236	0	69	73081	3639	73081	3570	0.0	20.470868347338936
chr6	HFE	26092684	26092960	1875	277	158811	5638	156936	5361	6.768953068592058	29.273642977056518
chr6	HFE	26090909	26091104	2472	196	158811	5638	156339	5442	12.612244897959183	28.728224917309813
chr6	HFE	26091313	26091589	9616	277	158811	5638	149195	5361	34.714801444043324	27.829695952247715
chr6	HFE	26090840	26091104	2697	265	158811	5638	156114	5373	10.177358490566037	29.055276381909547
chr6	HFE	26092608	26092641	176	34	158811	5638	158635	5604	5.176470588235294	28.307458957887224
chr6	HFE	26094185	26094218	0	34	158811	5638	158811	5604	0.0	28.338865096359743
chr6	BTN3A2	26367989	26368050	0	62	133873	5358	133873	5296	0.0	25.278134441087612
chr6	BTN3A2	26370321	26370603	5795	283	133873	5358	128078	5075	20.47703180212014	25.23704433497537
chr6	BTN3A2	26372896	26373097	1734	202	133873	5358	132139	5156	8.584158415841584	25.62820015515904
chr6	BTN3A2	26368177	26368267	38	91	133873	5358	133835	5267	0.4175824175824176	25.410100626542622
chr6	BTN3A2	26368182	26368267	38	86	133873	5358	133835	5272	0.4418604651162791	25.386001517450683
chr6	BTN3A2	26368564	26368608	0	45	133873	5358	133873	5313	0.0	25.19725202333898
chr6	BTN2A2	26385014	26385362	8496	349	206870	4365	198374	4016	24.34383954154728	49.39591633466136
chr6	BTN2A2	26388012	26388294	7561	283	206870	4365	199309	4082	26.71731448763251	48.82631063204312
chr6	BTN2A2	26383791	26383915	1452	125	206870	4365	205418	4240	11.616	48.447641509433964
chr6	BTN2A2	26385142	26385362	8496	221	206870	4365	198374	4144	38.44343891402715	47.870173745173744
chr6	BTN3A1	26404134	26404227	358	94	119071	4719	118713	4625	3.8085106382978724	25.667675675675675
chr6	BTN2A3P	26427870	26428107	801	238	113609	4185	112808	3947	3.365546218487395	28.58069419812516
chr6	BTN2A3P	26423398	26423759	18471	362	113609	4185	95138	3823	51.02486187845304	24.885691865027464
chr6	BTN3A3	26443569	26443659	9	91	36900	3974	36891	3883	0.0989010989010989	9.500643832088592
chr6	BTN3A3	26443381	26443442	0	62	36900	3974	36900	3912	0.0	9.432515337423313
chr6	BTN3A3	26443640	26443659	9	20	36900	3974	36891	3954	0.45	9.330045523520486
chr6	BTN3A3	26448616	26448637	454	22	36900	3974	36446	3952	20.636363636363637	9.222165991902834
chr6	BTN3A3	26443366	26443442	0	77	36900	3974	36900	3897	0.0	9.468822170900692
chr6	BTN2A1	26458606	26458718	0	113	353035	3758	353035	3645	0.0	96.85459533607681
chr6	BTN2A1	26462796	26462897	1463	102	353035	3758	351572	3656	14.343137254901961	96.16301969365426
chr6	PRSS16	27248846	27248946	0	101	102	3595	102	3494	0.0	0.02919290211791643
chr6	PRSS16	27254692	27254872	0	181	102	3595	102	3414	0.0	0.029876977152899824
chr6	PRSS16	27252807	27252949	0	143	102	3595	102	3452	0.0	0.02954808806488992
chr6	PRSS16	27251749	27252040	51	292	102	3595	51	3303	0.17465753424657535	0.015440508628519528
chr6	PRSS16	27249099	27249229	0	131	102	3595	102	3464	0.0	0.029445727482678985
chr6	PRSS16	27251041	27251119	0	79	102	3595	102	3516	0.0	0.02901023890784983
chr6	PRSS16	27250682	27250806	0	125	102	3595	102	3470	0.0	0.029394812680115272
chr6	ZNF391	27395016	27395095	0	80	357	4840	357	4760	0.0	0.075
chr6	LINC01012	27710123	27710225	0	103	0	3778	0	3675	0.0	0.0
chr6	LINC01012	27707338	27707416	0	79	0	3778	0	3699	0.0	0.0
chr6	ZKSCAN8	28144330	28144424	0	95	40	7588	40	7493	0.0	0.005338315761377286
chr6	ZNF192P1	28162942	28163100	0	159	93	2377	93	2218	0.0	0.04192966636609558
chr6	ZSCAN9	28230335	28230488	0	154	1785	3599	1785	3445	0.0	0.5181422351233672
chr6	ZSCAN9	28230401	28230488	0	88	1785	3599	1785	3511	0.0	0.5084021646254628
chr6	ZKSCAN3	28359524	28359988	0	465	927	4811	927	4346	0.0	0.21329958582604694
chr6	ZKSCAN3	28350271	28350388	430	118	927	4811	497	4693	3.6440677966101696	0.10590240784146601
chr6	GPX5	28531777	28531895	0	119	51	2056	51	1937	0.0	0.02632937532266391
chr6	OR2J3	29109455	29109657	0	203	0	3825	0	3622	0.0	0.0
chr6	MOG	29659323	29659666	0	344	0	2643	0	2299	0.0	0.0
chr6	MOG	29670280	29670397	0	118	0	2643	0	2525	0.0	0.0
chr6	MOG	29659318	29659666	0	349	0	2643	0	2294	0.0	0.0
chr6	MOG	29666151	29666265	0	115	0	2643	0	2528	0.0	0.0
chr6	MOG	29670173	29670221	0	49	0	2643	0	2594	0.0	0.0
chr6	MOG	29670700	29670721	0	22	0	2643	0	2621	0.0	0.0
chr6	MOG	29664629	29664767	0	139	0	2643	0	2504	0.0	0.0
chr6	HLA-F	29725030	29725306	0	277	0	3641	0	3364	0.0	0.0
chr6	HLA-G	29828542	29828818	0	277	50	1771	50	1494	0.0	0.03346720214190094
chr6	HLA-G	29829417	29829693	0	277	50	1771	50	1494	0.0	0.03346720214190094
chr6	HLA-G	29830552	29830600	0	49	50	1771	50	1722	0.0	0.029036004645760744
chr6	HLA-A	29944499	29944616	135	118	459	2718	324	2600	1.1440677966101696	0.12461538461538461
chr6	HLA-A	29944499	29944634	153	136	459	2718	306	2582	1.125	0.1185127807900852
chr6	HLA-J	30006799	30007069	0	271	0	1955	0	1684	0.0	0.0
chr6	HLA-J	30008584	30008701	0	118	0	1955	0	1837	0.0	0.0
chr6	HLA-J	30009319	30009367	0	49	0	1955	0	1906	0.0	0.0
chr6	HLA-J	30007317	30007593	0	277	0	1955	0	1678	0.0	0.0
chr6	POLR1H	30061916	30062017	0	102	0	1070	0	968	0.0	0.0
chr6	PPP1R11	30068278	30068353	0	76	510	2327	510	2251	0.0	0.22656597067969791
chr6	TRIM39	30327651	30327696	0	46	0	4237	0	4191	0.0	0.0
chr6	TRIM39	30340271	30340361	0	91	0	4237	0	4146	0.0	0.0
chr6	TRIM39	30327646	30327696	0	51	0	4237	0	4186	0.0	0.0
chr6	RPP21	30345490	30345573	0	84	0	1107	0	1023	0.0	0.0
chr6	RPP21	30345466	30345573	0	108	0	1107	0	999	0.0	0.0
chr6	RPP21	30345297	30345398	0	102	0	1107	0	1005	0.0	0.0
chr6	PRR3	30558149	30558212	1059	64	57305	2594	56246	2530	16.546875	22.231620553359683
chr6	ABCF1	30577408	30577455	0	48	212567	4261	212567	4213	0.0	50.45502017564681
chr6	ABCF1	30582393	30582507	304	115	212567	4261	212263	4146	2.643478260869565	51.197057404727445
chr6	ATAT1	30640534	30640603	14002	70	1239687	3818	1225685	3748	200.02857142857144	327.02374599786555
chr6	ATAT1	30642767	30643011	0	245	1239687	3818	1239687	3573	0.0	346.9596977329975
chr6	C6ORF136	30649750	30649959	11384	210	474596	2035	463212	1825	54.20952380952381	253.81479452054793
chr6	C6ORF136	30652647	30652717	27978	71	474596	2035	446618	1964	394.056338028169	227.4022403258656
chr6	C6ORF136	30649557	30649959	16690	403	474596	2035	457906	1632	41.41439205955335	280.5796568627451
chr6	C6ORF136	30650993	30651082	1693	90	474596	2035	472903	1945	18.81111111111111	243.13778920308482
chr6	C6ORF136	30647605	30647846	6676	242	474596	2035	467920	1793	27.58677685950413	260.9704406023424
chr6	C6ORF136	30652647	30652728	41037	82	474596	2035	433559	1953	500.4512195121951	221.99641577060933
chr6	HCG20	30790888	30790956	0	69	0	1580	0	1511	0.0	0.0
chr6	DDR1	30880897	30881125	35632	229	224154	8326	188522	8097	155.59825327510916	23.282944300358157
chr6	DDR1	30891379	30891479	663	101	224154	8326	223491	8225	6.564356435643564	27.172158054711247
chr6	DDR1	30884537	30884710	3948	174	224154	8326	220206	8152	22.689655172413794	27.01251226692836
chr6	DDR1	30885624	30885680	860	57	224154	8326	223294	8269	15.087719298245615	27.003748941830935
chr6	DDR1	30895403	30895514	2717	112	224154	8326	221437	8214	24.258928571428573	26.958485512539568
chr6	DDR1	30881926	30881993	57	68	224154	8326	224097	8258	0.8382352941176471	27.136958101235166
chr6	DDR1	30896620	30896865	0	246	224154	8326	224154	8080	0.0	27.741831683168318
chr6	DDR1	30883263	30883326	0	64	224154	8326	224154	8262	0.0	27.130718954248366
chr6	DDR1	30884057	30884145	103	89	224154	8326	224051	8237	1.1573033707865168	27.200558455748453
chr6	VARS2	30921924	30921995	0	72	0	6416	0	6344	0.0	0.0
chr6	VARS2	30914809	30915037	0	229	0	6416	0	6187	0.0	0.0
chr6	VARS2	30914804	30915037	0	234	0	6416	0	6182	0.0	0.0
chr6	PSORS1C1	31138655	31138779	208	125	228413	3835	228205	3710	1.664	61.51078167115903
chr6	PSORS1C1	31125738	31125839	0	102	228413	3835	228413	3733	0.0	61.1875167425663
chr6	MICA	31411243	31411359	0	117	0	3859	0	3742	0.0	0.0
chr6	MICA	31411071	31411359	0	289	0	3859	0	3570	0.0	0.0
chr6	HCP5	31463370	31463508	0	139	452408	10617	452408	10478	0.0	43.17694216453522
chr6	NFKBIL1	31556696	31556783	0	88	1224	1758	1224	1670	0.0	0.732934131736527
chr6	LST1	31587943	31587966	24	24	25558	1224	25534	1200	1.0	21.278333333333332
chr6	LST1	31587640	31587733	1557	94	25558	1224	24001	1130	16.56382978723404	21.23982300884956
chr6	LST1	31587948	31587966	19	19	25558	1224	25539	1205	1.0	21.194190871369294
chr6	CSNK2B	31669318	31669508	0	191	56959	2558	56959	2367	0.0	24.063793831854667
chr6	AL662899.2	31670972	31671008	1424	37	8849	2533	7425	2496	38.486486486486484	2.9747596153846154
chr6	MPIG6B	31724141	31724232	13921	92	379876	2943	365955	2851	151.31521739130434	128.36022448263768
chr6	MPIG6B	31724586	31724627	2298	42	379876	2943	377578	2901	54.714285714285715	130.15442950706654
chr6	MSH5	31745236	31745319	4064	84	246797	5859	242733	5775	48.38095238095238	42.03168831168831
chr6	MSH5	31758547	31758620	154	74	246797	5859	246643	5785	2.081081081081081	42.634917891097665
chr6	MSH5	31760689	31760839	30749	151	246797	5859	216048	5708	203.63576158940398	37.850035038542394
chr6	MSH5	31740193	31740220	0	28	246797	5859	246797	5831	0.0	42.32498713771223
chr6	MSH5-SAPCD1	31764265	31764355	0	91	199233	3610	199233	3519	0.0	56.61636828644501
chr6	MSH5	31760787	31760839	15308	53	246797	5859	231489	5806	288.8301886792453	39.87065105063727
chr6	MSH5	31758532	31758620	484	89	246797	5859	246313	5770	5.438202247191011	42.688561525129984
chr6	MSH5-SAPCD1	31762789	31763168	22678	380	199233	3610	176555	3230	59.67894736842105	54.6609907120743
chr6	MSH5	31761749	31761780	0	32	246797	5859	246797	5827	0.0	42.35404153080487
chr6	SNHG32	31835410	31835451	0	42	0	1649	0	1607	0.0	0.0
chr6	SNHG32	31836423	31836517	0	95	0	1649	0	1554	0.0	0.0
chr6	SNHG32	31836298	31836517	0	220	0	1649	0	1429	0.0	0.0
chr6	SNHG32	31835410	31835455	0	46	0	1649	0	1603	0.0	0.0
chr6	SNHG32	31836294	31836517	0	224	0	1649	0	1425	0.0	0.0
chr6	C2	31942958	31943099	36	142	524436	5539	524400	5397	0.2535211267605634	97.1650917176209
chr6	C2	31944979	31945029	0	51	524436	5539	524436	5488	0.0	95.56049562682216
chr6	C2	31933866	31933965	0	100	524436	5539	524436	5439	0.0	96.42140099282956
chr6	C2	31935922	31936061	1556	140	524436	5539	522880	5399	11.114285714285714	96.84756436377107
chr6	C2	31934165	31934299	0	135	524436	5539	524436	5404	0.0	97.04589193190229
chr6	C2	31927954	31928164	67271	211	524436	5539	457165	5328	318.81990521327015	85.80424174174175
chr6	C2	31928731	31928917	11975	187	524436	5539	512461	5352	64.03743315508021	95.75130792227205
chr6	C2	31942914	31943099	459	186	524436	5539	523977	5353	2.467741935483871	97.88473753035682
chr6	SKIV2L	31961195	31961386	1	192	15115	4787	15114	4595	0.005208333333333333	3.289227421109902
chr6	STK19	31972620	31972757	0	138	6986	3774	6986	3636	0.0	1.9213421342134214
chr6	STK19	31979413	31979553	0	141	6986	3774	6986	3633	0.0	1.9229287090558767
chr6	C4B	32033789	32033892	0	104	51	6663	51	6559	0.0	0.007775575545052599
chr6	CYP21A2	32038721	32038811	0	91	0	2688	0	2597	0.0	0.0
chr6	CYP21A2	32040004	32040205	0	202	0	2688	0	2486	0.0	0.0
chr6	PPT2	32154195	32154404	10885	210	197343	2809	186458	2599	51.833333333333336	71.74220854174682
chr6	PPT2	32155029	32155183	80034	155	197343	2809	117309	2654	516.3483870967742	44.200828937452904
chr6	PPT2	32157839	32157924	42	86	197343	2809	197301	2723	0.4883720930232558	72.45721630554536
chr6	PPT2	32153998	32154404	41727	407	197343	2809	155616	2402	102.52334152334153	64.78601165695254
chr6	PPT2-EGFL8	32164578	32164657	0	80	233123	5532	233123	5452	0.0	42.75917094644167
chr6	PPT2-EGFL8	32164578	32164681	0	104	233123	5532	233123	5428	0.0	42.94823139277819
chr6	TSBP1-AS1	32389268	32389421	0	154	204	8215	204	8061	0.0	0.02530703386676591
chr6	TSBP1-AS1	32365779	32365839	0	61	204	8215	204	8154	0.0	0.025018395879323033
chr6	TSBP1-AS1	32262611	32262809	0	199	204	8215	204	8016	0.0	0.025449101796407185
chr6	TSBP1-AS1	32349511	32349997	0	487	204	8215	204	7728	0.0	0.026397515527950312
chr6	HLA-DQA1	32642609	32642784	0	176	306	6330	306	6154	0.0	0.049723756906077346
chr6	HLA-DQA1	32638911	32639905	153	995	306	6330	153	5335	0.15376884422110554	0.02867853795688847
chr6	AL662789.1	32718405	32718440	0	36	0	1019	0	983	0.0	0.0
chr6	PSMB8-AS1	32844644	32844870	0	227	0	1878	0	1651	0.0	0.0
chr6	PSMB8-AS1	32844569	32844870	0	302	0	1878	0	1576	0.0	0.0
chr6	PSMB8-AS1	32844809	32844870	0	62	0	1878	0	1816	0.0	0.0
chr6	BRD2	32975020	32975112	0	93	0	7303	0	7210	0.0	0.0
chr6	BRD2	32971594	32972927	0	1334	0	7303	0	5969	0.0	0.0
chr6	BRD2	32979089	32979194	0	106	0	7303	0	7197	0.0	0.0
chr6	SLC39A7	33201241	33201656	51	416	102	2852	51	2436	0.12259615384615384	0.020935960591133004
chr6	KIFC1	33400391	33400514	13175	124	168582	3042	155407	2918	106.25	53.25805346127485
chr6	PHF1	33415234	33415329	829	96	216149	3035	215320	2939	8.635416666666666	73.26301463082682
chr6	SYNGAP1	33442452	33442494	0	43	39613	8100	39613	8057	0.0	4.916594265855777
chr6	SYNGAP1	33448788	33448868	0	81	39613	8100	39613	8019	0.0	4.93989275470757
chr6	HMGA1	34237203	34237317	51	115	9948	2333	9897	2218	0.4434782608695652	4.462128043282236
chr6	AL354740.1	34277907	34278182	0	276	100783	6489	100783	6213	0.0	16.221310156124254
chr6	SNRPC	34757911	34757954	0	44	51	1248	51	1204	0.0	0.04235880398671096
chr6	ANKS1A	34972580	34972643	0	64	58698	8524	58698	8460	0.0	6.938297872340425
chr6	ANKS1A	35086269	35086368	0	100	58698	8524	58698	8424	0.0	6.967948717948718
chr6	ZNF76	35293750	35293915	0	166	68160	6025	68160	5859	0.0	11.633384536610343
chr6	PPARD	35410986	35411217	0	232	71531	4466	71531	4234	0.0	16.894426074633916
chr6	PPARD	35397497	35397593	0	97	71531	4466	71531	4369	0.0	16.372396429388875
chr6	FANCE	35463847	35463980	0	134	1915	2720	1915	2586	0.0	0.7405259087393659
chr6	CLPSL2	35777458	35777581	0	124	0	611	0	487	0.0	0.0
chr6	CLPSL2	35777850	35777929	0	80	0	611	0	531	0.0	0.0
chr6	MAPK14	36102570	36102649	0	80	42637	6770	42637	6690	0.0	6.373243647234679
chr6	BRPF3	36222167	36222265	0	99	62744	6627	62744	6528	0.0	9.611519607843137
chr6	BRPF3	36225266	36225364	0	99	62744	6627	62744	6528	0.0	9.611519607843137
chr6	BRPF3	36225270	36225364	0	95	62744	6627	62744	6532	0.0	9.605633802816902
chr6	KCTD20	36479590	36479711	47	122	63409	6251	63362	6129	0.38524590163934425	10.33806493718388
chr6	KCTD20	36474788	36475062	0	275	63409	6251	63409	5976	0.0	10.610609103078982
chr6	KCTD20	36465600	36465698	10212	99	63409	6251	53197	6152	103.15151515151516	8.647106631989598
chr6	KCTD20	36443417	36443530	0	114	63409	6251	63409	6137	0.0	10.332247026234317
chr6	KCTD20	36479120	36479223	188	104	63409	6251	63221	6147	1.8076923076923077	10.28485440052058
chr6	KCTD20	36470051	36470257	3724	207	63409	6251	59685	6044	17.99033816425121	9.875082726671078
chr6	SRSF3	36598428	36598526	0	99	153	6059	153	5960	0.0	0.025671140939597315
chr6	SRSF3	36599820	36600276	0	457	153	6059	153	5602	0.0	0.027311674401999286
chr6	CDKN1A	36677901	36677933	0	33	7	3000	7	2967	0.0	0.0023592854735422987
chr6	CDKN1A	36682639	36682730	0	92	7	3000	7	2908	0.0	0.002407152682255846
chr6	C6ORF89	36892765	36892856	8907	92	17601	7343	8694	7251	96.81521739130434	1.199007033512619
chr6	C6ORF89	36894503	36894603	7725	101	17601	7343	9876	7242	76.48514851485149	1.363711681855841
chr6	RNF8	37359182	37359342	357	161	4296	6384	3939	6223	2.217391304347826	0.6329744496223686
chr6	RNF8	37374619	37374709	0	91	4296	6384	4296	6293	0.0	0.6826632766566025
chr6	RNF8	37381149	37381354	0	206	4296	6384	4296	6178	0.0	0.6953706701197798
chr6	RNF8	37361337	37361558	0	222	4296	6384	4296	6162	0.0	0.697176241480039
chr6	ZFAND3	38082391	38082457	48	67	4664	3819	4616	3752	0.7164179104477612	1.2302771855010661
chr6	ZFAND3	38003690	38003783	0	94	4664	3819	4664	3725	0.0	1.2520805369127517
chr6	DNAH8	38729901	38729986	0	86	299	15442	299	15356	0.0	0.019471216462620473
chr6	DNAH8	38866768	38866876	0	109	299	15442	299	15333	0.0	0.019500423922259178
chr6	DAAM2	39886420	39886447	0	28	7824	11330	7824	11302	0.0	0.6922668554238188
chr6	DAAM2	39861122	39861328	0	207	7824	11330	7824	11123	0.0	0.7034073541310798
chr6	TSPO2	41043556	41043698	255	143	4508	1079	4253	936	1.7832167832167831	4.543803418803419
chr6	NFYA	41080810	41080897	0	88	2391	3821	2391	3733	0.0	0.640503616394321
chr6	ADCY10P1	41105891	41106035	2236	145	7723	5583	5487	5438	15.420689655172414	1.009010665685914
chr6	TREML4	41232362	41232504	0	143	0	2699	0	2556	0.0	0.0
chr6	NCR2	41342917	41343024	0	108	0	1274	0	1166	0.0	0.0
chr6	LINC01276	41506224	41506371	315	148	1248	2076	933	1928	2.1283783783783785	0.48392116182572614
chr6	MDFI	41646125	41646308	0	184	3447	2542	3447	2358	0.0	1.4618320610687023
chr6	MDFI	41638139	41638375	0	237	3447	2542	3447	2305	0.0	1.4954446854663774
chr6	BYSL	41930131	41930270	0	140	51	1944	51	1804	0.0	0.02827050997782705
chr6	TAF8	42071346	42071468	0	123	7330	9297	7330	9174	0.0	0.7989971659036407
chr6	AL096814.2	42162919	42163095	0	177	64368	2281	64368	2104	0.0	30.59315589353612
chr6	AL096814.2	42162919	42163466	1167	548	64368	2281	63201	1733	2.1295620437956204	36.469128678592035
chr6	RPL7L1	42880860	42880966	0	107	417	7235	417	7128	0.0	0.0585016835016835
chr6	PTCRA	42923026	42923347	425	322	702992	1176	702567	854	1.3198757763975155	822.6779859484777
chr6	PPP2R5D	43008692	43008746	10644	55	299511	3567	288867	3512	193.52727272727273	82.25142369020502
chr6	KLHDC3	43017852	43017968	8884	117	163503	1665	154619	1548	75.93162393162393	99.88307493540051
chr6	KLC4	43062885	43063147	102	263	20930	5760	20828	5497	0.38783269961977185	3.788975804984537
chr6	KLC4	43071566	43071619	0	54	20930	5760	20930	5706	0.0	3.668068699614441
chr6	KLC4	43071851	43071922	0	72	20930	5760	20930	5688	0.0	3.679676511954993
chr6	KLC4	43061310	43061593	0	284	20930	5760	20930	5476	0.0	3.8221329437545655
chr6	KLC4	43062916	43063147	102	232	20930	5760	20828	5528	0.4396551724137931	3.767727930535456
chr6	KLC4	43062982	43063147	102	166	20930	5760	20828	5594	0.6144578313253012	3.7232749374329637
chr6	PTK7	43130229	43130420	0	192	637106	8336	637106	8144	0.0	78.23010805500982
chr6	PTK7	43139405	43139525	336	121	637106	8336	636770	8215	2.7768595041322315	77.51308581862446
chr6	PTK7	43145199	43145432	0	234	637106	8336	637106	8102	0.0	78.63564551962479
chr6	CUL9	43187245	43187439	2348	195	55009	10593	52661	10398	12.04102564102564	5.064531640700134
chr6	CUL9	43206320	43206510	0	191	55009	10593	55009	10402	0.0	5.288309940396077
chr6	SLC22A7	43299091	43299097	0	7	110630	3540	110630	3533	0.0	31.313331446362863
chr6	SLC22A7	43299091	43299274	0	184	110630	3540	110630	3356	0.0	32.964839094159714
chr6	TJAP1	43478658	43478718	0	61	247335	6659	247335	6598	0.0	37.48635950287966
chr6	TJAP1	43478086	43478232	0	147	247335	6659	247335	6512	0.0	37.98141891891892
chr6	TJAP1	43502587	43502617	43	31	247335	6659	247292	6628	1.3870967741935485	37.310199155099575
chr6	TJAP1	43478136	43478232	0	97	247335	6659	247335	6562	0.0	37.69201462968607
chr6	POLR1C	43520065	43520185	0	121	73457	5100	73457	4979	0.0	14.753364129343241
chr6	POLR1C	43520624	43520774	144	151	73457	5100	73313	4949	0.9536423841059603	14.81369973732067
chr6	POLR1C	43521181	43521317	19549	137	73457	5100	53908	4963	142.6934306569343	10.861978641950433
chr6	POLR1C	43529248	43529359	0	112	73457	5100	73457	4988	0.0	14.726744186046512
chr6	POLR1C	43550967	43551011	0	45	73457	5100	73457	5055	0.0	14.531552917903067
chr6	POLH	43582315	43582456	22944	142	53252	8308	30308	8166	161.57746478873239	3.7114866519715894
chr6	RSPH9	43666423	43666520	0	98	414	2648	414	2550	0.0	0.1623529411764706
chr6	VEGFA	43781955	43782087	0	133	0	7921	0	7788	0.0	0.0
chr6	VEGFA	43781955	43782052	0	98	0	7921	0	7823	0.0	0.0
chr6	VEGFA	43780731	43780785	0	55	0	7921	0	7866	0.0	0.0
chr6	VEGFA	43780731	43780854	0	124	0	7921	0	7797	0.0	0.0
chr6	VEGFA	43780731	43780803	0	73	0	7921	0	7848	0.0	0.0
chr6	VEGFA	43778888	43778918	0	31	0	7921	0	7890	0.0	0.0
chr6	C6ORF223	44001016	44001143	0	128	1428	5569	1428	5441	0.0	0.26245175519206027
chr6	C6ORF223	44000973	44001143	0	171	1428	5569	1428	5398	0.0	0.26454242311967396
chr6	TMEM63B	44135327	44135366	0	40	0	4452	0	4412	0.0	0.0
chr6	TMEM63B	44154072	44154188	0	117	0	4452	0	4335	0.0	0.0
chr6	CAPN11	44168941	44169031	0	91	0	3486	0	3395	0.0	0.0
chr6	CAPN11	44161789	44161924	0	136	0	3486	0	3350	0.0	0.0
chr6	CAPN11	44182940	44183019	0	80	0	3486	0	3406	0.0	0.0
chr6	SLC29A1	44226060	44226167	1378	108	715395	4176	714017	4068	12.75925925925926	175.52040314650935
chr6	SLC29A1	44227262	44227342	1504	81	715395	4176	713891	4095	18.567901234567902	174.33235653235653
chr6	SLC29A1	44227259	44227342	1594	84	715395	4176	713801	4092	18.976190476190474	174.43817204301075
chr6	SLC29A1	44221585	44221685	279500	101	715395	4176	435895	4075	2767.3267326732675	106.9680981595092
chr6	SLC29A1	44225924	44226167	1894	244	715395	4176	713501	3932	7.762295081967213	181.46007121057986
chr6	SLC29A1	44225972	44226167	1674	196	715395	4176	713721	3980	8.540816326530612	179.32688442211057
chr6	RUNX2	45491940	45492114	564	175	666	8204	102	8029	3.222857142857143	0.012703948187819156
chr6	RUNX2	45545216	45545282	0	67	666	8204	666	8137	0.0	0.08184834705665478
chr6	RUNX2	45422592	45422957	0	366	666	8204	666	7838	0.0	0.0849706557795356
chr6	RUNX2	45513449	45513653	0	205	666	8204	666	7999	0.0	0.08326040755094387
chr6	SLC25A27	46664773	46664886	0	114	0	2558	0	2444	0.0	0.0
chr6	TDRD6	46697997	46698087	0	91	51	9046	51	8955	0.0	0.005695142378559464
chr6	TDRD6	46700998	46701062	0	65	51	9046	51	8981	0.0	0.005678654938202873
chr6	C6ORF141	49552976	49553207	0	232	0	2362	0	2130	0.0	0.0
chr6	AL121974.1	49802984	49803073	0	90	0	1303	0	1213	0.0	0.0
chr6	AL121974.1	49802984	49803057	0	74	0	1303	0	1229	0.0	0.0
chr6	AL121974.1	49801706	49801760	0	55	0	1303	0	1248	0.0	0.0
chr6	AL121974.1	49811475	49811593	0	119	0	1303	0	1184	0.0	0.0
chr6	AL121974.1	49802984	49803105	0	122	0	1303	0	1181	0.0	0.0
chr6	AL138826.1	50095709	50095909	0	201	0	1720	0	1519	0.0	0.0
chr6	TFAP2B	50822133	50822160	0	28	0	6163	0	6135	0.0	0.0
chr6	EFHC1	52438303	52438591	0	289	19269	16238	19269	15949	0.0	1.2081635212239012
chr6	EFHC1	52464894	52465115	0	222	19269	16238	19269	16016	0.0	1.2031093906093906
chr6	EFHC1	52429968	52430131	0	164	19269	16238	19269	16074	0.0	1.1987681970884658
chr6	EFHC1	52423686	52423814	51	129	19269	16238	19218	16109	0.3953488372093023	1.192997703147309
chr6	EFHC1	52430227	52430374	0	148	19269	16238	19269	16090	0.0	1.1975761342448725
chr6	EFHC1	52423686	52423828	51	143	19269	16238	19218	16095	0.35664335664335667	1.1940354147250698
chr6	EFHC1	52437561	52437678	0	118	19269	16238	19269	16120	0.0	1.195347394540943
chr6	EFHC1	52438303	52438454	0	152	19269	16238	19269	16086	0.0	1.1978739276389407
chr6	TRAM2-AS1	52578501	52578594	0	94	51	8437	51	8343	0.0	0.006112909025530385
chr6	FBXO9	53067904	53068006	0	103	2450	7972	2450	7869	0.0	0.31134832888550007
chr6	FBXO9	53094691	53094841	0	151	2450	7972	2450	7821	0.0	0.3132591740186677
chr6	MLIP	54121446	54121602	0	157	0	7315	0	7158	0.0	0.0
chr6	MLIP	54136714	54138286	0	1573	0	7315	0	5742	0.0	0.0
chr6	MLIP	54160515	54160599	0	85	0	7315	0	7230	0.0	0.0
chr6	MLIP	54149055	54149127	0	73	0	7315	0	7242	0.0	0.0
chr6	MLIP	54230713	54230917	0	205	0	7315	0	7110	0.0	0.0
chr6	MLIP	54160739	54160799	0	61	0	7315	0	7254	0.0	0.0
chr6	MLIP	54257307	54257361	0	55	0	7315	0	7260	0.0	0.0
chr6	MLIP	54160366	54160432	0	67	0	7315	0	7248	0.0	0.0
chr6	BEND6	57014461	57014525	0	65	9214	5621	9214	5556	0.0	1.6583873290136788
chr6	KIAA1586	57050773	57050854	61	82	167124	3113	167063	3031	0.7439024390243902	55.11811283404817
chr6	ZNF451	57090810	57090894	0	85	233	14830	233	14745	0.0	0.015801966768396066
chr6	ZNF451	57099468	57099568	0	101	233	14830	233	14729	0.0	0.01581913232398669
chr6	ZNF451	57150718	57150862	0	145	233	14830	233	14685	0.0	0.015866530473272047
chr6	ZNF451	57090832	57090894	0	63	233	14830	233	14767	0.0	0.01577842486625584
chr6	AL445250.1	57965516	57965743	0	228	1122	10037	1122	9809	0.0	0.11438474870017332
chr6	AL445250.1	57962130	57962248	0	119	1122	10037	1122	9918	0.0	0.11312764670296431
chr6	AL445250.1	57962180	57962248	0	69	1122	10037	1122	9968	0.0	0.11256019261637239
chr6	AL445250.1	58162609	58162749	0	141	1122	10037	1122	9896	0.0	0.1133791430881164
chr6	AL445250.1	57965665	57965743	0	79	1122	10037	1122	9958	0.0	0.11267322755573408
chr6	AL445250.1	58300738	58300811	0	74	1122	10037	1122	9963	0.0	0.11261668172237278
chr6	AL445250.1	58072214	58072267	0	54	1122	10037	1122	9983	0.0	0.1123910648101773
chr6	AC244258.1	60425366	60425439	0	74	0	3028	0	2954	0.0	0.0
chr6	PTP4A1	63532336	63532530	0	195	0	5534	0	5339	0.0	0.0
chr6	PTP4A1	63579256	63579331	0	76	0	5534	0	5458	0.0	0.0
chr6	PTP4A1	63550299	63550493	0	195	0	5534	0	5339	0.0	0.0
chr6	PHF3	63646526	63646795	0	270	561	20948	561	20678	0.0	0.027130283392978044
chr6	PHF3	63684128	63685911	0	1784	561	20948	561	19164	0.0	0.029273638071383844
chr6	PHF3	63679999	63680161	0	163	561	20948	561	20785	0.0	0.026990618234303584
chr6	PHF3	63646618	63646795	0	178	561	20948	561	20770	0.0	0.027010110736639385
chr6	PHF3	63678827	63679020	0	194	561	20948	561	20754	0.0	0.027030933795894767
chr6	FAM135A	70415290	70415376	59986	87	60184	9960	198	9873	689.4942528735633	0.020054694621695533
chr6	FAM135A	70426438	70426532	0	95	60184	9960	60184	9865	0.0	6.100760263558033
chr6	FAM135A	70418374	70418492	0	119	60184	9960	60184	9841	0.0	6.115638654608271
chr6	FAM135A	70426569	70426709	0	141	60184	9960	60184	9819	0.0	6.1293410734290665
chr6	FAM135A	70486166	70486244	0	79	60184	9960	60184	9881	0.0	6.09088148972776
chr6	SMAP1	70859328	70859416	0	89	51	4171	51	4082	0.0	0.012493875551200392
chr6	SMAP1	70791688	70791769	0	82	51	4171	51	4089	0.0	0.012472487160674981
chr6	RIMS1	72265959	72266049	0	91	153	12828	153	12737	0.0	0.01201224778205229
chr6	RIMS1	72260704	72260767	0	64	153	12828	153	12764	0.0	0.01198683798182388
chr6	RIMS1	72398248	72398350	0	103	153	12828	153	12725	0.0	0.012023575638506876
chr6	RIMS1	72274348	72274432	0	85	153	12828	153	12743	0.0	0.012006591854351408
chr6	RIMS1	72265389	72265503	0	115	153	12828	153	12713	0.0	0.012034924880044049
chr6	RIMS1	72290678	72290861	0	184	153	12828	153	12644	0.0	0.012100601075608985
chr6	RIMS1	72264974	72265052	0	79	153	12828	153	12749	0.0	0.01200094125029414
chr6	RIMS1	72284046	72284118	0	73	153	12828	153	12755	0.0	0.011995295962367699
chr6	RIMS1	72295936	72295966	0	31	153	12828	153	12797	0.0	0.011955927170430569
chr6	KCNQ5	73124485	73124512	0	28	255	8128	255	8100	0.0	0.03148148148148148
chr6	KCNQ5	73129792	73129849	0	58	255	8128	255	8070	0.0	0.031598513011152414
chr6	AC019205.1	73270397	73270527	0	131	51	10457	51	10326	0.0	0.004938988959907031
chr6	AC019205.1	73284635	73284734	0	100	51	10457	51	10357	0.0	0.004924205851115188
chr6	MTO1	73473364	73473654	0	291	3330	11827	3330	11536	0.0	0.2886615811373093
chr6	MTO1	73480996	73481116	0	121	3330	11827	3330	11706	0.0	0.28446950281906713
chr6	MTO1	73497735	73497896	0	162	3330	11827	3330	11665	0.0	0.28546935276468066
chr6	MTO1	73482039	73482244	0	206	3330	11827	3330	11621	0.0	0.2865502108252302
chr6	MTO1	73480292	73480367	576	76	3330	11827	2754	11751	7.578947368421052	0.23436303293336738
chr6	MTO1	73471459	73471557	0	99	3330	11827	3330	11728	0.0	0.28393587994542974
chr6	MTO1	73481000	73481116	0	117	3330	11827	3330	11710	0.0	0.2843723313407344
chr6	MTO1	73480317	73480367	576	51	3330	11827	2754	11776	11.294117647058824	0.23386548913043478
chr6	MTO1	73486597	73486761	0	165	3330	11827	3330	11662	0.0	0.285542788543989
chr6	AL121972.1	73525885	73526002	0	118	0	809	0	691	0.0	0.0
chr6	CD109	73730343	73730574	0	232	3997	9817	3997	9585	0.0	0.4170057381324987
chr6	TMEM30A-DT	75293492	75293594	0	103	0	9457	0	9354	0.0	0.0
chr6	AL445465.1	75360666	75360719	0	54	0	2251	0	2197	0.0	0.0
chr6	AL445465.1	75361851	75362013	0	163	0	2251	0	2088	0.0	0.0
chr6	AL445465.1	75360812	75360916	0	105	0	2251	0	2146	0.0	0.0
chr6	AL445465.1	75362765	75362956	0	192	0	2251	0	2059	0.0	0.0
chr6	SENP6	75702644	75703072	0	429	255	11017	255	10588	0.0	0.024083868530411785
chr6	SENP6	75640683	75640704	0	22	255	11017	255	10995	0.0	0.023192360163710776
chr6	SENP6	75622750	75622858	0	109	255	11017	255	10908	0.0	0.023377337733773377
chr6	SENP6	75640686	75640704	0	19	255	11017	255	10998	0.0	0.0231860338243317
chr6	MYO6	75844896	75844977	0	82	3867	9887	3867	9805	0.0	0.39439061703212647
chr6	MYO6	75898372	75898411	0	40	3867	9887	3867	9847	0.0	0.3927084391185133
chr6	MYO6	75911671	75911698	0	28	3867	9887	3867	9859	0.0	0.3922304493356324
chr6	MYO6	75871294	75871392	0	99	3867	9887	3867	9788	0.0	0.39507560277891296
chr6	MYO6	75867430	75867523	0	94	3867	9887	3867	9793	0.0	0.3948738895129174
chr6	MYO6	75846967	75846976	0	10	3867	9887	3867	9877	0.0	0.3915156424015389
chr6	MYO6	75813598	75813688	0	91	3867	9887	3867	9796	0.0	0.39475296039199675
chr6	MYO6	75894813	75894840	0	28	3867	9887	3867	9859	0.0	0.3922304493356324
chr6	MYO6	75777452	75777570	0	119	3867	9887	3867	9768	0.0	0.39588452088452086
chr6	MYO6	75819772	75819872	0	101	3867	9887	3867	9786	0.0	0.3951563458001226
chr6	MYO6	75757998	75758120	0	123	3867	9887	3867	9764	0.0	0.39604670217124127
chr6	MYO6	75834249	75834376	0	128	3867	9887	3867	9759	0.0	0.39624961573931755
chr6	IRAK1BP1	78898063	78898298	0	236	867	2777	867	2541	0.0	0.3412042502951594
chr6	TTK	80006104	80006175	0	72	0	4604	0	4532	0.0	0.0
chr6	AL359715.1	80454109	80454227	0	119	0	6274	0	6155	0.0	0.0
chr6	DOP1A	83125165	83125195	0	31	49	9967	49	9936	0.0	0.004931561996779388
chr6	DOP1A	83164659	83164719	0	61	49	9967	49	9906	0.0	0.004946497072481324
chr6	TBX18-AS1	84706558	84706695	0	138	51	2085	51	1947	0.0	0.026194144838212634
chr6	TBX18-AS1	84699643	84699800	51	158	51	2085	0	1927	0.3227848101265823	0.0
chr6	NT5E	85490507	85490657	0	151	14175	4543	14175	4392	0.0	3.2274590163934427
chr6	ZNF292	87249311	87249466	0	156	153	9852	153	9696	0.0	0.01577970297029703
chr6	SMIM8	87330691	87330950	0	260	283	7986	283	7726	0.0	0.03662956251617914
chr6	SMIM8	87330691	87330712	0	22	283	7986	283	7964	0.0	0.035534907081868405
chr6	SLC35A1	87508419	87508596	0	178	0	2003	0	1825	0.0	0.0
chr6	SLC35A1	87506381	87506448	0	68	0	2003	0	1935	0.0	0.0
chr6	ORC3	87601783	87601881	0	99	142	3712	142	3613	0.0	0.03930251868253529
chr6	ANKRD6	89566833	89567096	0	264	1355	8004	1355	7740	0.0	0.17506459948320413
chr6	ANKRD6	89595915	89596014	29	100	1355	8004	1326	7904	0.29	0.16776315789473684
chr6	ANKRD6	89606006	89606105	0	100	1355	8004	1355	7904	0.0	0.17143218623481782
chr6	ANKRD6	89617953	89618031	0	79	1355	8004	1355	7925	0.0	0.17097791798107256
chr6	ANKRD6	89621921	89622026	0	106	1355	8004	1355	7898	0.0	0.17156242086604204
chr6	ANKRD6	89624538	89624691	0	154	1355	8004	1355	7850	0.0	0.17261146496815286
chr6	ANKRD6	89616873	89616956	0	84	1355	8004	1355	7920	0.0	0.1710858585858586
chr6	AL132996.1	90345220	90345391	28450	172	208783	8959	180333	8787	165.40697674418604	20.522703994537384
chr6	AL132996.1	90345260	90345391	25783	132	208783	8959	183000	8827	195.32575757575756	20.731845474113516
chr6	AL132996.1	90355763	90355818	460	56	208783	8959	208323	8903	8.214285714285714	23.39919128383691
chr6	FHL5	96563124	96563355	0	232	0	2142	0	1910	0.0	0.0
chr6	KLHL32	97064627	97064726	0	100	204	4138	204	4038	0.0	0.05052005943536404
chr6	KLHL32	97113782	97114509	0	728	204	4138	204	3410	0.0	0.05982404692082111
chr6	KLHL32	97041491	97041599	0	109	204	4138	204	4029	0.0	0.05063291139240506
chr6	KLHL32	97062332	97062503	0	172	204	4138	204	3966	0.0	0.05143721633888049
chr6	KLHL32	97085125	97085341	0	217	204	4138	204	3921	0.0	0.05202754399387911
chr6	KLHL32	97105442	97105521	0	80	204	4138	204	4058	0.0	0.05027106949236077
chr6	AL589740.1	97373847	97373914	0	68	17226	12047	17226	11979	0.0	1.43801652892562
chr6	AL589740.1	97433617	97433662	0	46	17226	12047	17226	12001	0.0	1.4353803849679194
chr6	AL589740.1	97309981	97310059	0	79	17226	12047	17226	11968	0.0	1.4393382352941178
chr6	AL589740.1	97423468	97423662	0	195	17226	12047	17226	11852	0.0	1.4534255821802227
chr6	AL589740.1	98099185	98099270	0	86	17226	12047	17226	11961	0.0	1.440180586907449
chr6	AL589740.1	97423468	97423566	0	99	17226	12047	17226	11948	0.0	1.441747572815534
chr6	AL589740.1	97972525	97972670	0	146	17226	12047	17226	11901	0.0	1.4474413914797075
chr6	AL589740.1	97633487	97633603	0	117	17226	12047	17226	11930	0.0	1.4439228834870075
chr6	AL589740.1	97618125	97618231	0	107	17226	12047	17226	11940	0.0	1.442713567839196
chr6	AL589740.1	97972576	97972670	0	95	17226	12047	17226	11952	0.0	1.4412650602409638
chr6	AL589740.1	98076066	98076145	0	80	17226	12047	17226	11967	0.0	1.4394585109049887
chr6	AL589740.1	97769541	97769698	0	158	17226	12047	17226	11889	0.0	1.44890234670704
chr6	AL589740.1	97479170	97479219	0	50	17226	12047	17226	11997	0.0	1.4358589647411852
chr6	AL589740.1	97616835	97616931	138	97	17226	12047	17088	11950	1.422680412371134	1.429958158995816
chr6	AL589740.1	97628900	97628961	0	62	17226	12047	17226	11985	0.0	1.4372966207759699
chr6	AL589740.1	97769541	97769702	0	162	17226	12047	17226	11885	0.0	1.4493899873790492
chr6	AL589740.1	98113798	98113860	0	63	17226	12047	17226	11984	0.0	1.4374165554072096
chr6	AL589740.1	98117238	98117321	0	84	17226	12047	17226	11963	0.0	1.439939814427819
chr6	AL589740.1	97612167	97612339	0	173	17226	12047	17226	11874	0.0	1.450732693279434
chr6	AL589740.1	97969405	97969466	0	62	17226	12047	17226	11985	0.0	1.4372966207759699
chr6	AL589740.1	97998858	97998907	0	50	17226	12047	17226	11997	0.0	1.4358589647411852
chr6	AL589740.1	98034494	98034562	0	69	17226	12047	17226	11978	0.0	1.438136583736851
chr6	AL589740.1	98270566	98270656	0	91	17226	12047	17226	11956	0.0	1.4407828705252592
chr6	AL589740.1	98270597	98270656	0	60	17226	12047	17226	11987	0.0	1.4370568115458413
chr6	AL589740.1	98361337	98361412	0	76	17226	12047	17226	11971	0.0	1.4389775290284854
chr6	AL589740.1	98276073	98276189	0	117	17226	12047	17226	11930	0.0	1.4439228834870075
chr6	AL589740.1	98364717	98364772	0	56	17226	12047	17226	11991	0.0	1.436577433074806
chr6	AL589740.1	98133351	98133456	0	106	17226	12047	17226	11941	0.0	1.442592747676074
chr6	AL589740.1	98041418	98041512	0	95	17226	12047	17226	11952	0.0	1.4412650602409638
chr6	AL589740.1	98279755	98279859	0	105	17226	12047	17226	11942	0.0	1.442471947747446
chr6	TSTD3	99526063	99526109	0	47	204	16121	204	16074	0.0	0.01269130272489735
chr6	TSTD3	99531362	99531536	0	175	204	16121	204	15946	0.0	0.01279317697228145
chr6	MCHR2-AS1	99996161	99996330	1882	170	4418	1443	2536	1273	11.070588235294117	1.9921445404556166
chr6	MCHR2-AS1	100007434	100007464	788	31	4418	1443	3630	1412	25.419354838709676	2.5708215297450425
chr6	GRIK2	101686179	101686353	0	175	102	7955	102	7780	0.0	0.013110539845758355
chr6	GRIK2	102065796	102065928	0	133	102	7955	102	7822	0.0	0.013040143185885963
chr6	GRIK2	102063961	102064048	0	88	102	7955	102	7867	0.0	0.01296555230710563
chr6	GRIK2	101495966	101496182	0	217	102	7955	102	7738	0.0	0.013181700697854742
chr6	BVES-AS1	105154393	105154491	0	99	0	6708	0	6609	0.0	0.0
chr6	BVES-AS1	105166543	105166702	0	160	0	6708	0	6548	0.0	0.0
chr6	BVES-AS1	105166605	105166702	0	98	0	6708	0	6610	0.0	0.0
chr6	AL096794.1	105456629	105457094	0	466	0	4203	0	3737	0.0	0.0
chr6	MTRES1	107030024	107030107	0	84	10548	2300	10548	2216	0.0	4.759927797833935
chr6	AFG1L	108401995	108402054	0	60	2037	5866	2037	5806	0.0	0.3508439545297968
chr6	AFG1L	108510211	108510352	0	142	2037	5866	2037	5724	0.0	0.3558700209643606
chr6	LINC00222	108760301	108760403	0	103	531	2909	531	2806	0.0	0.18923734853884533
chr6	LINC00222	108766995	108767269	42	275	531	2909	489	2634	0.15272727272727274	0.1856492027334852
chr6	ARMC2	108858198	108858271	0	74	2427	4275	2427	4201	0.0	0.577719590573673
chr6	CEP57L1	109106034	109106090	0	57	15055	16746	15055	16689	0.0	0.9020911977949547
chr6	CEP57L1	109145218	109145381	0	164	15055	16746	15055	16582	0.0	0.9079121939452418
chr6	CEP57L1	109146757	109146937	0	181	15055	16746	15055	16565	0.0	0.9088439480833082
chr6	CEP57L1	109140420	109140675	0	256	15055	16746	15055	16490	0.0	0.9129775621588841
chr6	CEP57L1	109100191	109100286	0	96	15055	16746	15055	16650	0.0	0.9042042042042042
chr6	CEP57L1	109130735	109130836	0	102	15055	16746	15055	16644	0.0	0.9045301610189859
chr6	CEP57L1	109155790	109155877	0	88	15055	16746	15055	16658	0.0	0.9037699603793973
chr6	CEP57L1	109124990	109125031	0	42	15055	16746	15055	16704	0.0	0.9012811302681992
chr6	CEP57L1	109158599	109158718	0	120	15055	16746	15055	16626	0.0	0.9055094430410201
chr6	CEP57L1	109129303	109129492	0	190	15055	16746	15055	16556	0.0	0.9093380043488766
chr6	CCDC162P	109300230	109300369	0	140	17596	10064	17596	9924	0.0	1.773075372833535
chr6	CCDC162P	109341301	109341433	0	133	17596	10064	17596	9931	0.0	1.771825596616655
chr6	CCDC162P	109352786	109352914	0	129	17596	10064	17596	9935	0.0	1.771112229491696
chr6	CCDC162P	109298579	109298631	0	53	17596	10064	17596	10011	0.0	1.7576665667765459
chr6	CCDC162P	109352838	109352914	0	77	17596	10064	17596	9987	0.0	1.7618904575948733
chr6	FIG4	109716444	109716568	0	125	543882	19865	543882	19740	0.0	27.55227963525836
chr6	FIG4	109727108	109727265	0	158	543882	19865	543882	19707	0.0	27.59841680621099
chr6	FIG4	109738324	109738453	0	130	543882	19865	543882	19735	0.0	27.559260197618446
chr6	FIG4	109760249	109760383	2051	135	543882	19865	541831	19730	15.192592592592593	27.46229092752154
chr6	FIG4	109776921	109777060	666	140	543882	19865	543216	19725	4.757142857142857	27.539467680608364
chr6	FIG4	109785670	109785769	1305	100	543882	19865	542577	19765	13.05	27.45140399696433
chr6	FIG4	109796764	109796851	0	88	543882	19865	543882	19777	0.0	27.500733174900137
chr6	FIG4	109743109	109743272	34	164	543882	19865	543848	19701	0.2073170731707317	27.605096188010762
chr6	FIG4	109741443	109741544	155	102	543882	19865	543727	19763	1.5196078431372548	27.512371603501492
chr6	FIG4	109788797	109788956	2305	160	543882	19865	541577	19705	14.40625	27.48424257802588
chr6	FIG4	109715077	109715176	0	100	543882	19865	543882	19765	0.0	27.517429800151785
chr6	FIG4	109695398	109695474	933	77	543882	19865	542949	19788	12.116883116883116	27.438295936931475
chr6	FIG4	109695829	109695904	961	76	543882	19865	542921	19789	12.644736842105264	27.43549446662287
chr6	FIG4	109727157	109727265	0	109	543882	19865	543882	19756	0.0	27.52996558007694
chr6	FIG4	109744666	109744761	0	96	543882	19865	543882	19769	0.0	27.511862006171278
chr6	FIG4	109788797	109788913	1793	117	543882	19865	542089	19748	15.324786324786325	27.450324083451488
chr6	AMD1	110892160	110892203	0	44	102	9630	102	9586	0.0	0.010640517421239308
chr6	AMD1	110887504	110887591	0	88	102	9630	102	9542	0.0	0.010689582896667365
chr6	RPF2	110988987	110989065	0	79	4578	3933	4578	3854	0.0	1.187856772184743
chr6	RPF2	110989027	110989065	0	39	4578	3933	4578	3894	0.0	1.1756548536209552
chr6	SLC16A10	111193292	111193324	0	33	2642	11246	2642	11213	0.0	0.23561937037367342
chr6	MFSD4B	111263829	111263946	0	118	34765	13087	34765	12969	0.0	2.6806230241344746
chr6	MFSD4B	111273329	111273422	0	94	34765	13087	34765	12993	0.0	2.675671515431386
chr6	MFSD4B	111265383	111265437	0	55	34765	13087	34765	13032	0.0	2.6676642111724984
chr6	MFSD4B	111262256	111262425	0	170	34765	13087	34765	12917	0.0	2.691414415111868
chr6	TRAF3IP2-AS1	111484117	111484145	0	29	27070	4826	27070	4797	0.0	5.643110277256619
chr6	TRAF3IP2-AS1	111484743	111484861	0	119	27070	4826	27070	4707	0.0	5.751009135330359
chr6	TRAF3IP2-AS1	111574620	111574802	0	183	27070	4826	27070	4643	0.0	5.830282145164764
chr6	CCN6	112066968	112067032	0	65	0	1796	0	1731	0.0	0.0
chr6	Z99289.1	112162028	112162239	0	212	0	1518	0	1306	0.0	0.0
chr6	LAMA4-AS1	112277179	112277311	0	133	0	4143	0	4010	0.0	0.0
chr6	LAMA4-AS1	112283297	112283527	0	231	0	4143	0	3912	0.0	0.0
chr6	LAMA4-AS1	112258357	112258552	0	196	0	4143	0	3947	0.0	0.0
chr6	LAMA4-AS1	112283053	112283192	0	140	0	4143	0	4003	0.0	0.0
chr6	LAMA4-AS1	112279120	112279238	0	119	0	4143	0	4024	0.0	0.0
chr6	AL365214.2	112343397	112343778	0	382	51	1443	51	1061	0.0	0.04806786050895382
chr6	AL365214.2	112345112	112345159	0	48	51	1443	51	1395	0.0	0.03655913978494624
chr6	LINC02880	113916942	113917052	0	111	0	2265	0	2154	0.0	0.0
chr6	HDAC2-AS2	114230156	114230323	0	168	43589	8080	43589	7912	0.0	5.50922649140546
chr6	NT5DC1	116237458	116237639	0	182	612	7321	612	7139	0.0	0.08572629219778681
chr6	DSE	116367008	116367217	0	210	21321	19215	21321	19005	0.0	1.1218626677190213
chr6	DSE	116433342	116433550	0	209	21321	19215	21321	19006	0.0	1.1218036409554877
chr6	DSE	116430953	116431193	984	241	21321	19215	20337	18974	4.08298755186722	1.0718351428270265
chr6	CALHM6	116461871	116462454	0	584	56	1190	56	606	0.0	0.0924092409240924
chr6	CALHM4	116554284	116554351	0	68	14243	1903	14243	1835	0.0	7.761852861035423
chr6	CALHM4	116554190	116554351	0	162	14243	1903	14243	1741	0.0	8.180930499712808
chr6	RWDD1	116572857	116572985	13261	129	109264	5877	96003	5748	102.7984496124031	16.70198329853862
chr6	RWDD1	116574057	116574171	14781	115	109264	5877	94483	5762	128.5304347826087	16.39760499826449
chr6	RWDD1	116572421	116572478	10217	58	109264	5877	99047	5819	176.1551724137931	17.02130950335109
chr6	RSPH4A	116627628	116628369	306	742	306	2846	0	2104	0.4123989218328841	0.0
chr6	RSPH4A	116629566	116629702	0	137	306	2846	306	2709	0.0	0.11295681063122924
chr6	KPNA5	116681446	116681552	287	107	1885	2297	1598	2190	2.682242990654206	0.7296803652968037
chr6	VGLL2	117270542	117271064	0	523	0	2235	0	1712	0.0	0.0
chr6	DCBLD1	117464055	117464165	0	111	495	6214	495	6103	0.0	0.0811076519744388
chr6	DCBLD1	117525361	117525434	0	74	495	6214	495	6140	0.0	0.08061889250814332
chr6	DCBLD1	117540667	117540815	0	149	495	6214	495	6065	0.0	0.08161582852431987
chr6	DCBLD1	117543123	117543211	495	89	495	6214	0	6125	5.561797752808989	0.0
chr6	HSF2	122427902	122427956	0	55	209	2710	209	2655	0.0	0.07871939736346516
chr6	PKIB	122701439	122701500	0	62	0	3448	0	3386	0.0	0.0
chr6	PKIB	122675077	122675144	0	68	0	3448	0	3380	0.0	0.0
chr6	PKIB	122701061	122701224	0	164	0	3448	0	3284	0.0	0.0
chr6	SMPDL3A	122795676	122795890	0	215	169	2357	169	2142	0.0	0.07889822595704948
chr6	CLVS2	122997218	122998166	0	949	0	11225	0	10276	0.0	0.0
chr6	TRDN-AS1	123462246	123462358	0	113	0	7284	0	7171	0.0	0.0
chr6	TRDN-AS1	123442000	123442147	0	148	0	7284	0	7136	0.0	0.0
chr6	TRDN-AS1	123489504	123489605	0	102	0	7284	0	7182	0.0	0.0
chr6	TRDN-AS1	123469636	123470058	0	423	0	7284	0	6861	0.0	0.0
chr6	AL445259.1	123533299	123533533	0	235	0	2875	0	2640	0.0	0.0
chr6	NKAIN2	124121877	124121941	0	65	0	4468	0	4403	0.0	0.0
chr6	NKAIN2	124819085	124819174	0	90	0	4468	0	4378	0.0	0.0
chr6	RNF217	125082448	125082563	0	116	204	12571	204	12455	0.0	0.01637896427137696
chr6	RNF217	124971500	124971598	0	99	204	12571	204	12472	0.0	0.0163566388710712
chr6	RNF217	125006075	125006177	0	103	204	12571	204	12468	0.0	0.016361886429258902
chr6	RNF217	125009173	125009282	0	110	204	12571	204	12461	0.0	0.01637107776261937
chr6	RNF217	125048151	125048259	0	109	204	12571	204	12462	0.0	0.01636976408281175
chr6	TPD52L1	125252021	125252036	0	16	102	4105	102	4089	0.0	0.024944974321349962
chr6	TPD52L1	125257097	125257158	0	62	102	4105	102	4043	0.0	0.0252287905021024
chr6	TPD52L1	125253716	125253755	0	40	102	4105	102	4065	0.0	0.025092250922509225
chr6	TPD52L1	125257097	125257180	0	84	102	4105	102	4021	0.0	0.02536682417309127
chr6	NCOA7	125855019	125855240	0	222	408	7669	408	7447	0.0	0.05478716261581845
chr6	NCOA7	125928173	125928247	0	75	408	7669	408	7594	0.0	0.05372662628390835
chr6	NCOA7	125796679	125796797	0	119	408	7669	408	7550	0.0	0.05403973509933775
chr6	TRMT11	125998052	125998134	0	83	3018	5422	3018	5339	0.0	0.5652743959542985
chr6	TRMT11	126009334	126009434	0	101	3018	5422	3018	5321	0.0	0.5671866190565683
chr6	TRMT11	126006841	126006954	0	114	3018	5422	3018	5308	0.0	0.5685757347400151
chr6	TRMT11	126008656	126008745	0	90	3018	5422	3018	5332	0.0	0.5660165041260315
chr6	RNF146	127286049	127286177	0	129	0	3139	0	3010	0.0	0.0
chr6	RNF146	127280515	127280604	0	90	0	3139	0	3049	0.0	0.0
chr6	RNF146	127282286	127282395	0	110	0	3139	0	3029	0.0	0.0
chr6	RNF146	127285207	127285348	0	142	0	3139	0	2997	0.0	0.0
chr6	LAMA2	129475389	129475401	13	13	4153	10427	4140	10414	1.0	0.3975417706932975
chr6	LAMA2	129292802	129293066	0	265	4153	10427	4153	10162	0.0	0.40867939382011415
chr6	L3MBTL3	130049755	130049830	0	76	98	5138	98	5062	0.0	0.01935993678387989
chr6	L3MBTL3	130049650	130049830	0	181	98	5138	98	4957	0.0	0.019770022190841233
chr6	L3MBTL3	130022226	130022305	0	80	98	5138	98	5058	0.0	0.01937524713325425
chr6	TMEM200A	130385172	130385236	0	65	3337	5863	3337	5798	0.0	0.5755432907899276
chr6	AKAP7	131169112	131169273	0	162	14657	4154	14657	3992	0.0	3.6715931863727453
chr6	AKAP7	131199460	131199573	6561	114	14657	4154	8096	4040	57.55263157894737	2.003960396039604
chr6	AKAP7	131253036	131253105	0	70	14657	4154	14657	4084	0.0	3.588883447600392
chr6	ARG1	131576662	131576735	0	74	102	2170	102	2096	0.0	0.04866412213740458
chr6	ENPP3	131638450	131638576	0	127	0	3912	0	3785	0.0	0.0
chr6	ENPP3	131652830	131652891	0	62	0	3912	0	3850	0.0	0.0
chr6	ENPP3	131733587	131733723	0	137	0	3912	0	3775	0.0	0.0
chr6	ENPP3	131638446	131638576	0	131	0	3912	0	3781	0.0	0.0
chr6	ENPP1	131852174	131852235	0	62	476	9693	476	9631	0.0	0.04942373585297477
chr6	ENPP1	131869357	131869489	0	133	476	9693	476	9560	0.0	0.0497907949790795
chr6	ENPP1	131826021	131826115	51	95	476	9693	425	9598	0.5368421052631579	0.04428005834548864
chr6	ENPP1	131851141	131851267	0	127	476	9693	476	9566	0.0	0.04975956512648965
chr6	LINC01013	132146219	132146412	0	194	0	6796	0	6602	0.0	0.0
chr6	LINC01013	132160766	132160914	0	149	0	6796	0	6647	0.0	0.0
chr6	LINC01013	132134271	132134483	0	213	0	6796	0	6583	0.0	0.0
chr6	LINC01013	132161958	132162131	0	174	0	6796	0	6622	0.0	0.0
chr6	LINC01013	132154655	132154777	0	123	0	6796	0	6673	0.0	0.0
chr6	LINC01013	132160766	132161006	0	241	0	6796	0	6555	0.0	0.0
chr6	LINC01013	132163896	132164193	0	298	0	6796	0	6498	0.0	0.0
chr6	LINC01013	132162000	132162131	0	132	0	6796	0	6664	0.0	0.0
chr6	LINC01013	132166193	132166291	0	99	0	6796	0	6697	0.0	0.0
chr6	LINC01013	132162015	132162131	0	117	0	6796	0	6679	0.0	0.0
chr6	LINC00326	133087779	133088577	0	799	2601	6021	2601	5222	0.0	0.4980850248946764
chr6	LINC00326	133100006	133100184	0	179	2601	6021	2601	5842	0.0	0.44522423827456353
chr6	LINC00326	133096509	133096563	0	55	2601	6021	2601	5966	0.0	0.4359704994971505
chr6	LINC00326	133088817	133090069	0	1253	2601	6021	2601	4768	0.0	0.545511744966443
chr6	LINC00326	133098269	133098318	0	50	2601	6021	2601	5971	0.0	0.4356054262267627
chr6	LINC00326	133098269	133098369	0	101	2601	6021	2601	5920	0.0	0.4393581081081081
chr6	LINC00326	133098269	133098520	0	252	2601	6021	2601	5769	0.0	0.45085803432137284
chr6	LINC00326	133088817	133088931	0	115	2601	6021	2601	5906	0.0	0.44039959363359293
chr6	LINC00326	133089893	133090069	0	177	2601	6021	2601	5844	0.0	0.4450718685831622
chr6	LINC00326	133100047	133100184	0	138	2601	6021	2601	5883	0.0	0.44212136664966856
chr6	LINC00326	133098269	133098382	0	114	2601	6021	2601	5907	0.0	0.44032503809040124
chr6	LINC00326	133098269	133098374	0	106	2601	6021	2601	5915	0.0	0.4397295012679628
chr6	EYA4	133448110	133448179	0	70	153	7266	153	7196	0.0	0.021261812117843247
chr6	EYA4	133456555	133456648	0	94	153	7266	153	7172	0.0	0.021332961517010595
chr6	TBPL1	133984576	133984671	0	96	1240	5049	1240	4953	0.0	0.25035332121946297
chr6	TBPL1	133953184	133953425	0	242	1240	5049	1240	4807	0.0	0.25795714582899937
chr6	TBPL1	133968854	133968957	0	104	1240	5049	1240	4945	0.0	0.25075834175935285
chr6	LINC01010	134470908	134471026	0	119	648	4158	648	4039	0.0	0.1604357514236197
chr6	LINC01010	134467813	134467944	0	132	648	4158	648	4026	0.0	0.16095380029806258
chr6	LINC01010	134476747	134476930	0	184	648	4158	648	3974	0.0	0.16305988928032208
chr6	LINC01010	134476898	134476930	0	33	648	4158	648	4125	0.0	0.1570909090909091
chr6	LINC01010	134500433	134500574	0	142	648	4158	648	4016	0.0	0.16135458167330677
chr6	LINC01010	134497410	134497471	0	62	648	4158	648	4096	0.0	0.158203125
chr6	MYB	135187833	135187905	0	73	1476	5517	1476	5444	0.0	0.27112417340191036
chr6	MYB	135190126	135190347	0	222	1476	5517	1476	5295	0.0	0.27875354107648725
chr6	MYB	135194355	135194460	102	106	1476	5517	1374	5411	0.9622641509433962	0.2539271853631491
chr6	MYB	135196960	135197323	0	364	1476	5517	1476	5153	0.0	0.2864350863574617
chr6	MYB	135201638	135201749	0	112	1476	5517	1476	5405	0.0	0.2730804810360777
chr6	MYB	135194355	135194451	102	97	1476	5517	1374	5420	1.0515463917525774	0.25350553505535056
chr6	MYB	135195747	135196002	0	256	1476	5517	1476	5261	0.0	0.28055502756130013
chr6	MYB	135199525	135199581	0	57	1476	5517	1476	5460	0.0	0.2703296703296703
chr6	MYB	135202413	135202669	1326	257	1476	5517	150	5260	5.159533073929961	0.028517110266159697
chr6	MYB	135194959	135195081	0	123	1476	5517	1476	5394	0.0	0.27363737486095663
chr6	MYB	135196725	135196908	0	184	1476	5517	1476	5333	0.0	0.27676729795612226
chr6	MYB	135202947	135202949	0	3	1476	5517	1476	5514	0.0	0.2676822633297062
chr6	MYB	135202413	135202673	1326	261	1476	5517	150	5256	5.080459770114943	0.028538812785388126
chr6	MYB	135195747	135195917	0	171	1476	5517	1476	5346	0.0	0.2760942760942761
chr6	MYB	135196725	135197323	0	599	1476	5517	1476	4918	0.0	0.30012200081333873
chr6	LINC00271	135518592	135518830	0	239	15968	13702	15968	13463	0.0	1.1860655128871722
chr6	LINC00271	135499351	135499441	0	91	15968	13702	15968	13611	0.0	1.1731687605613108
chr6	LINC00271	135518592	135518642	0	51	15968	13702	15968	13651	0.0	1.1697311552267233
chr6	LINC00271	135498403	135498517	0	115	15968	13702	15968	13587	0.0	1.1752410392286745
chr6	PEX7	136870731	136870839	0	109	4086	3423	4086	3314	0.0	1.2329511164755582
chr6	HEBP2	138412082	138412256	52588	175	367022	10358	314434	10183	300.5028571428571	30.87832662280271
chr6	ECT2L	138812837	138812977	0	141	765	4663	765	4522	0.0	0.16917293233082706
chr6	FILNC1	139771072	139771123	0	52	204	1857	204	1805	0.0	0.11301939058171745
chr6	FILNC1	139745385	139745439	0	55	204	1857	204	1802	0.0	0.11320754716981132
chr6	AL357146.1	140087763	140087989	0	227	0	2548	0	2321	0.0	0.0
chr6	AL357146.1	140083096	140083228	0	133	0	2548	0	2415	0.0	0.0
chr6	AL357146.1	140083096	140083257	0	162	0	2548	0	2386	0.0	0.0
chr6	AL357146.1	140087763	140088007	0	245	0	2548	0	2303	0.0	0.0
chr6	AL357146.1	140086681	140086761	0	81	0	2548	0	2467	0.0	0.0
chr6	VTA1	142166227	142166322	0	96	153	7266	153	7170	0.0	0.021338912133891212
chr6	VTA1	142203984	142204065	0	82	153	7266	153	7184	0.0	0.021297327394209354
chr6	ADGRG6	142383759	142383843	0	85	30	8466	30	8381	0.0	0.003579525116334566
chr6	ADGRG6	142440907	142440953	0	47	30	8466	30	8419	0.0	0.003563368571089203
chr6	ADGRG6	142405342	142405391	0	50	30	8466	30	8416	0.0	0.003564638783269962
chr6	AL355304.1	142955252	142955397	0	146	0	3273	0	3127	0.0	0.0
chr6	AIG1	143136834	143136990	12	157	702	8203	690	8046	0.07643312101910828	0.08575689783743475
chr6	PEX3	143459084	143459216	0	133	306	2842	306	2709	0.0	0.11295681063122924
chr6	VDAC1P8	143505339	143505457	0	119	0	4338	0	4219	0.0	0.0
chr6	VDAC1P8	143494519	143494705	0	187	0	4338	0	4151	0.0	0.0
chr6	VDAC1P8	143503393	143504142	0	750	0	4338	0	3588	0.0	0.0
chr6	VDAC1P8	143504522	143504597	0	76	0	4338	0	4262	0.0	0.0
chr6	PHACTR2	143753753	143753912	1479	160	1449082	11240	1447603	11080	9.24375	130.65009025270757
chr6	PHACTR2	143760400	143760640	0	241	1449082	11240	1449082	10999	0.0	131.74670424584053
chr6	PHACTR2	143712015	143712183	0	169	1449082	11240	1449082	11071	0.0	130.8898925119682
chr6	UTRN	144827347	144827386	0	40	558575	14685	558575	14645	0.0	38.14100375554797
chr6	FBXO30-DT	145828360	145828420	0	61	0	8517	0	8456	0.0	0.0
chr6	FBXO30-DT	145881578	145881648	0	71	0	8517	0	8446	0.0	0.0
chr6	FBXO30-DT	145828360	145828456	0	97	0	8517	0	8420	0.0	0.0
chr6	FBXO30-DT	145862634	145862721	0	88	0	8517	0	8429	0.0	0.0
chr6	GRM1	146426558	146426643	0	86	1632	7383	1632	7297	0.0	0.22365355625599562
chr6	ADGB	146600332	146600363	0	32	0	7809	0	7777	0.0	0.0
chr6	ADGB	146715381	146715415	0	35	0	7809	0	7774	0.0	0.0
chr6	ADGB	146784617	146784794	0	178	0	7809	0	7631	0.0	0.0
chr6	ADGB	146784617	146784673	0	57	0	7809	0	7752	0.0	0.0
chr6	AL138916.1	146861960	146862041	0	82	0	1320	0	1238	0.0	0.0
chr6	STXBP5	147353322	147353373	0	52	372	6303	372	6251	0.0	0.059510478323468244
chr6	STXBP5	147339336	147339384	0	49	372	6303	372	6254	0.0	0.05948193156379917
chr6	STXBP5	147339178	147339238	0	61	372	6303	372	6242	0.0	0.059596283242550466
chr6	STXBP5	147328698	147328782	0	85	372	6303	372	6218	0.0	0.0598263107108395
chr6	SASH1	148531525	148531661	0	137	120	10733	120	10596	0.0	0.011325028312570781
chr6	AL031056.1	149229931	149229995	0	65	153	2858	153	2793	0.0	0.05477980665950591
chr6	TAB2	149379933	149380143	0	211	50304	5937	50304	5726	0.0	8.785190359762487
chr6	PCMT1	149771161	149771266	0	106	3162	2845	3162	2739	0.0	1.154435925520263
chr6	PCMT1	149789953	149790058	0	106	3162	2845	3162	2739	0.0	1.154435925520263
chr6	PCMT1	149772047	149772247	0	201	3162	2845	3162	2644	0.0	1.1959152798789712
chr6	PCMT1	149772013	149772247	0	235	3162	2845	3162	2610	0.0	1.2114942528735633
chr6	PCMT1	149772554	149772684	0	131	3162	2845	3162	2714	0.0	1.1650700073691969
chr6	PCMT1	149765690	149765753	0	64	3162	2845	3162	2781	0.0	1.1370010787486515
chr6	IYD	150395454	150395566	0	113	0	9466	0	9353	0.0	0.0
chr6	IYD	150395393	150395566	0	174	0	9466	0	9292	0.0	0.0
chr6	IYD	150395393	150395454	0	62	0	9466	0	9404	0.0	0.0
chr6	PLEKHG1	150638079	150638125	0	47	0	8413	0	8366	0.0	0.0
chr6	MTHFD1L	150887841	150887981	0	141	62	4923	62	4782	0.0	0.012965286491007947
chr6	MTHFD1L	150887844	150887981	0	138	62	4923	62	4785	0.0	0.012957157784743992
chr6	ARMT1	151454547	151454653	0	107	0	2824	0	2717	0.0	0.0
chr6	ESR1	151842596	151842787	0	192	255	13546	255	13354	0.0	0.01909540212670361
chr6	ESR1	151944172	151944508	0	337	255	13546	255	13209	0.0	0.019305019305019305
chr6	ESR1	151880654	151880771	0	118	255	13546	255	13428	0.0	0.01899016979445934
chr6	ESR1	152011655	152011794	0	140	255	13546	255	13406	0.0	0.01902133373116515
chr6	MYCT1	152721741	152722253	0	513	0	2524	0	2011	0.0	0.0
chr6	OPRM1	154039410	154039834	0	425	255	20919	255	20494	0.0	0.012442666146189128
chr6	OPRM1	154039160	154039305	0	146	255	20919	255	20773	0.0	0.012275549992779088
chr6	OPRM1	154089825	154090178	0	354	255	20919	255	20565	0.0	0.012399708242159009
chr6	OPRM1	154094209	154094318	0	110	255	20919	255	20809	0.0	0.012254313037627949
chr6	SCAF8	154741955	154742018	0	64	12424	5450	12424	5386	0.0	2.3067211288525806
chr6	TIAM2	155211203	155211307	221	105	31366	11505	31145	11400	2.104761904761905	2.7320175438596492
chr6	TIAM2	155016240	155016361	0	122	31366	11505	31366	11383	0.0	2.7555126065184923
chr6	TIAM2	155168844	155168916	0	73	31366	11505	31366	11432	0.0	2.74370188943317
chr6	TIAM2	155250537	155250624	0	88	31366	11505	31366	11417	0.0	2.747306647981081
chr6	ARID1B	156871613	156871652	0	40	3785	37651	3785	37611	0.0	0.10063545239424636
chr6	ARID1B	157110471	157110561	0	91	3785	37651	3785	37560	0.0	0.10077209797657082
chr6	ARID1B	157133027	157133207	0	181	3785	37651	3785	37470	0.0	0.10101414464905258
chr6	ARID1B	157174846	157175005	0	160	3785	37651	3785	37491	0.0	0.10095756314848897
chr6	ARID1B	157036834	157036876	11	43	3785	37651	3774	37608	0.2558139534883721	0.10035098915124442
chr6	ARID1B	157150724	157150853	51	130	3785	37651	3734	37521	0.3923076923076923	0.09951760347538711
chr6	ARID1B	157164638	157164748	0	111	3785	37651	3785	37540	0.0	0.10082578582844966
chr6	GTF2H5	158187039	158187121	0	83	510	7569	510	7486	0.0	0.06812717071867486
chr6	TULP4	158489587	158489732	7710	146	129995	12302	122285	12156	52.80821917808219	10.059641329384666
chr6	TULP4	158501677	158504178	44538	2502	129995	12302	85457	9800	17.80095923261391	8.720102040816327
chr6	C6ORF99	158908733	158908895	207	163	6553	1833	6346	1670	1.2699386503067485	3.8
chr6	C6ORF99	158873527	158873621	0	95	6553	1833	6553	1738	0.0	3.7704257767548905
chr6	C6ORF99	158873529	158873621	0	93	6553	1833	6553	1740	0.0	3.7660919540229885
chr6	AL035530.2	159040918	159041055	2306	138	86811	11394	84505	11256	16.71014492753623	7.5075515280739165
chr6	AL035530.2	159042522	159042676	7074	155	86811	11394	79737	11239	45.63870967741936	7.094670344336685
chr6	FNDC1	159229814	159230003	459	190	245797	6874	245338	6684	2.4157894736842107	36.70526630760024
chr6	LINC02529	159393516	159393609	1479	94	12849	1353	11370	1259	15.73404255319149	9.030976965845909
chr6	LINC02529	159396060	159396174	1097	115	12849	1353	11752	1238	9.539130434782608	9.492730210016155
chr6	PNLDC1	159801112	159801186	0	75	0	2094	0	2019	0.0	0.0
chr6	PNLDC1	159811700	159811786	0	87	0	2094	0	2007	0.0	0.0
chr6	IGF2R	160046891	160047057	918	167	6431254	22665	6430336	22498	5.497005988023952	285.8181171659703
chr6	IGF2R	160068844	160069014	0	171	6431254	22665	6431254	22494	0.0	285.909753712101
chr6	SLC22A1	160130103	160130207	57	105	11903	2297	11846	2192	0.5428571428571428	5.404197080291971
chr6	SLC22A1	160139652	160139867	2811	216	11903	2297	9092	2081	13.01388888888889	4.36905333974051
chr6	SLC22A1	160154797	160154910	288	114	11903	2297	11615	2183	2.526315789473684	5.320659642693541
chr6	SLC22A1	160155974	160156074	113	101	11903	2297	11790	2196	1.118811881188119	5.368852459016393
chr6	MAP3K4	161098277	161098427	0	151	237	7415	237	7264	0.0	0.03262665198237885
chr6	MAP3K4	161067198	161067296	0	99	237	7415	237	7316	0.0	0.03239475123018043
chr6	MAP3K4	161108950	161109041	0	92	237	7415	237	7323	0.0	0.032363785333879555
chr6	PACRG	163312778	163312895	0	118	1326	2627	1326	2509	0.0	0.5284974093264249
chr6	PACRG	162997405	162997544	0	140	1326	2627	1326	2487	0.0	0.5331724969843185
chr6	QKI	163455278	163455421	0	144	2805	12507	2805	12363	0.0	0.22688667799077894
chr6	QKI	163478779	163478896	0	118	2805	12507	2805	12389	0.0	0.22641052546613932
chr6	QKI	163457380	163457551	0	172	2805	12507	2805	12335	0.0	0.22740170247263883
chr6	AL078602.1	163709359	163709501	0	143	1479	6195	1479	6052	0.0	0.2443820224719101
chr6	CEP43	167013507	167013567	0	61	123974	9903	123974	9842	0.0	12.596423491160333
chr6	CEP43	167010812	167010893	0	82	123974	9903	123974	9821	0.0	12.62335811017208
chr6	TCP10L2	167149956	167150073	0	118	510	4322	510	4204	0.0	0.12131303520456709
chr6	HPAT5	167232478	167232560	0	83	0	990	0	907	0.0	0.0
chr6	UNC93A	167297944	167298070	0	127	4	2703	4	2576	0.0	0.0015527950310559005
chr6	TTLL2	167338646	167338803	0	158	3198	3838	3198	3680	0.0	0.8690217391304348
chr6	TTLL2	167328003	167328384	0	382	3198	3838	3198	3456	0.0	0.9253472222222222
chr6	AFDN	167893861	167893906	0	46	51	13403	51	13357	0.0	0.003818222654787752
chr6	AFDN	167954457	167954493	0	37	51	13403	51	13366	0.0	0.00381565165344905
chr6	AFDN	167913402	167913423	0	22	51	13403	51	13381	0.0	0.0038113743367461325
chr6	AFDN	167954460	167954493	0	34	51	13403	51	13369	0.0	0.0038147954222454935
chr6	KIF25	168042560	168042716	0	157	0	4641	0	4484	0.0	0.0
chr6	SMOC2	168655395	168655490	0	96	1773	4047	1773	3951	0.0	0.44874715261959
chr6	AL109924.2	169068282	169068299	0	18	51	772	51	754	0.0	0.06763925729442971
chr6	ERMARD	169753286	169753372	0	87	193	4289	193	4202	0.0	0.04593050928129462
chr6	ERMARD	169755287	169755422	0	136	193	4289	193	4153	0.0	0.04647242956898628
chr6	ERMARD	169756337	169756439	0	103	193	4289	193	4186	0.0	0.04610606784519828
chr6	ERMARD	169753943	169754032	0	90	193	4289	193	4199	0.0	0.0459633246010955
chr6	ERMARD	169755282	169755422	0	141	193	4289	193	4148	0.0	0.04652844744455159
chr6	ERMARD	169753863	169754032	0	170	193	4289	193	4119	0.0	0.046856033017722745
chr6	ERMARD	169766637	169766667	0	31	193	4289	193	4258	0.0	0.04532644434006576
chr6	ERMARD	169776333	169776411	0	79	193	4289	193	4210	0.0	0.04584323040380048
chr6	ERMARD	169776454	169776673	0	220	193	4289	193	4069	0.0	0.047431801425411646
chr6	ERMARD	169753316	169753372	0	57	193	4289	193	4232	0.0	0.04560491493383743
chr6	ERMARD	169753037	169753181	0	145	193	4289	193	4144	0.0	0.04657335907335907
chr6	TBP	170556881	170557083	0	203	0	2328	0	2125	0.0	0.0
chr6	TBP	170556878	170557083	0	206	0	2328	0	2122	0.0	0.0
chr6	TBP	170567225	170567505	0	281	0	2328	0	2047	0.0	0.0
chr6	LINC01622	998365	998472	0	108	0	5705	0	5597	0.0	0.0
chr6	LINC01600	2631276	2631417	0	142	1030	3082	1030	2940	0.0	0.35034013605442177
chr6	SERPINB9P1	2857910	2857995	0	86	153	4429	153	4343	0.0	0.03522910430577941
chr6	SERPINB9P1	2872816	2873086	0	271	153	4429	153	4158	0.0	0.0367965367965368
chr6	SERPINB9P1	2857910	2857991	0	82	153	4429	153	4347	0.0	0.035196687370600416
chr6	SERPINB6	2960260	2960378	2795	119	530962	6054	528167	5935	23.48739495798319	88.99191238416175
chr6	SERPINB6	2959167	2959342	2427	176	530962	6054	528535	5878	13.789772727272727	89.91748894181694
chr6	SERPINB6	2968778	2968913	1247	136	530962	6054	529715	5918	9.169117647058824	89.50912470429199
chr6	SERPINB6	2961893	2962029	2288	137	530962	6054	528674	5917	16.7007299270073	89.34831840459692
chr6	SERPINB6	2968778	2969102	13466	325	530962	6054	517496	5729	41.433846153846154	90.32920230406702
chr6	SERPINB6	2956695	2956814	3881	120	530962	6054	527081	5934	32.34166666666667	88.82389619143916
chr6	SERPINB6	2960969	2961096	1822	128	530962	6054	529140	5926	14.234375	89.29125885926426
chr6	SERPINB6	2970695	2970824	4597	130	530962	6054	526365	5924	35.36153846153846	88.85297096556381
chr6	SERPINB6	2966399	2966590	6242	192	530962	6054	524720	5862	32.510416666666664	89.51211190719891
chr6	NQO2-AS1	2998616	2998669	0	54	3264	1462	3264	1408	0.0	2.3181818181818183
chr6	LINC02525	3190826	3191257	0	432	0	1654	0	1222	0.0	0.0
chr6	LINC02525	3190826	3191230	0	405	0	1654	0	1249	0.0	0.0
chr6	SLC22A23	3284935	3284959	0	25	97638	6133	97638	6108	0.0	15.985265225933203
chr6	SLC22A23	3323265	3323318	144	54	97638	6133	97494	6079	2.6666666666666665	16.037835170258266
chr6	SLC22A23	3432093	3432338	0	246	97638	6133	97638	5887	0.0	16.58535756752166
chr6	AL033523.1	3663659	3663905	0	247	2499	14663	2499	14416	0.0	0.1733490566037736
chr6	AL033523.1	3595566	3595661	0	96	2499	14663	2499	14567	0.0	0.1715521383950024
chr6	AL033523.1	3632028	3632189	0	162	2499	14663	2499	14501	0.0	0.17233294255568582
chr6	AL033523.1	3653220	3654795	918	1576	2499	14663	1581	13087	0.5824873096446701	0.12080690761824711
chr6	AL033523.1	3634018	3634059	0	42	2499	14663	2499	14621	0.0	0.17091854182340468
chr6	AL033523.1	3623647	3623943	0	297	2499	14663	2499	14366	0.0	0.17395238758179035
chr6	AL033523.1	3609379	3609549	0	171	2499	14663	2499	14492	0.0	0.17243996687827767
chr6	AL033523.1	3631925	3632189	0	265	2499	14663	2499	14398	0.0	0.17356577302403112
chr6	AL033523.1	3607104	3607594	0	491	2499	14663	2499	14172	0.0	0.17633361558001692
chr6	AL033523.1	3609026	3609109	0	84	2499	14663	2499	14579	0.0	0.171410933534536
chr6	AL033523.1	3611056	3611152	0	97	2499	14663	2499	14566	0.0	0.17156391596869422
chr6	AL033523.1	3653600	3654795	918	1196	2499	14663	1581	13467	0.7675585284280937	0.11739808420583649
chr6	FAM217A	4074442	4074456	0	15	354	3144	354	3129	0.0	0.11313518696069032
chr6	FAM217A	4077354	4077448	0	95	354	3144	354	3049	0.0	0.11610364053788128
chr6	FAM217A	4074576	4074661	0	86	354	3144	354	3058	0.0	0.1157619359058208
chr6	ECI2	4130178	4130249	278	72	260689	4584	260411	4512	3.861111111111111	57.71520390070922
chr6	RPP40	4998715	4998841	51	127	50530	1987	50479	1860	0.4015748031496063	27.13924731182796
chr6	RPP40	5000562	5000631	0	70	50530	1987	50530	1917	0.0	26.35889410537298
chr6	RPP40	5001093	5001130	0	38	50530	1987	50530	1949	0.0	25.926115956900976
chr6	LYRM4	5216617	5216738	0	122	143427	3829	143427	3707	0.0	38.69085513892635
chr6	LYRM4	5144137	5144262	0	126	143427	3829	143427	3703	0.0	38.732649203348636
chr6	LYRM4	5113070	5113417	0	348	143427	3829	143427	3481	0.0	41.202815282964664
chr6	AL021328.1	5456952	5457028	0	77	0	1336	0	1259	0.0	0.0
chr6	LY86-AS1	6569417	6569489	0	73	102	9672	102	9599	0.0	0.010626106886133972
chr6	LY86-AS1	6492892	6493138	0	247	102	9672	102	9425	0.0	0.010822281167108753
chr6	LY86-AS1	6591155	6591479	0	325	102	9672	102	9347	0.0	0.010912592275596449
chr6	LY86-AS1	6620754	6621383	0	630	102	9672	102	9042	0.0	0.0112806901128069
chr6	SSR1	7295087	7295102	9	16	180513	2851	180504	2835	0.5625	63.66984126984127
chr6	SSR1	7287861	7287922	17040	62	180513	2851	163473	2789	274.83870967741933	58.61348153460022
chr6	CAGE1	7356024	7356129	0	106	357	3526	357	3420	0.0	0.10438596491228071
chr6	CAGE1	7378616	7379020	0	405	357	3526	357	3121	0.0	0.1143864146107017
chr6	CAGE1	7386978	7387196	0	219	357	3526	357	3307	0.0	0.10795282733595404
chr6	CAGE1	7365803	7365884	0	82	357	3526	357	3444	0.0	0.10365853658536585
chr6	CAGE1	7378621	7379020	0	400	357	3526	357	3126	0.0	0.11420345489443379
chr6	CAGE1	7386978	7387175	0	198	357	3526	357	3328	0.0	0.10727163461538461
chr6	BLOC1S5	8041138	8041268	0	131	153260	3306	153260	3175	0.0	48.270866141732284
chr6	BLOC1S5	8027206	8027399	96	194	153260	3306	153164	3112	0.4948453608247423	49.217223650385606
chr6	BLOC1S5	8054269	8054372	0	104	153260	3306	153260	3202	0.0	47.86383510306059
chr6	EEF1E1	8095377	8095495	0	119	43795	2096	43795	1977	0.0	22.152250885179566
chr6	AL359378.1	8378738	8378844	0	107	51	1434	51	1327	0.0	0.03843255463451394
chr6	AL359378.1	8362719	8362832	0	114	51	1434	51	1320	0.0	0.038636363636363635
chr6	SLC35B3	8434384	8434430	1157	47	79418	3823	78261	3776	24.617021276595743	20.725900423728813
chr6	SLC35B3	8418743	8418885	1575	143	79418	3823	77843	3680	11.013986013986013	21.152989130434783
chr6	OFCC1	9900325	9900489	0	165	0	4816	0	4651	0.0	0.0
chr6	OFCC1	9809576	9809714	0	139	0	4816	0	4677	0.0	0.0
chr6	OFCC1	9819403	9819424	0	22	0	4816	0	4794	0.0	0.0
chr6	OFCC1	9850397	9850469	0	73	0	4816	0	4743	0.0	0.0
chr6	OFCC1	9896870	9897003	0	134	0	4816	0	4682	0.0	0.0
chr6	OFCC1	9903372	9903441	0	70	0	4816	0	4746	0.0	0.0
chr6	OFCC1	9841931	9842023	0	93	0	4816	0	4723	0.0	0.0
chr6	OFCC1	9903372	9903406	0	35	0	4816	0	4781	0.0	0.0
chr6	OFCC1	9921908	9921920	0	13	0	4816	0	4803	0.0	0.0
chr6	TFAP2A	10400447	10400589	1532	143	977458	7421	975926	7278	10.713286713286713	134.092607859302
chr6	TFAP2A	10409900	10410335	62480	436	977458	7421	914978	6985	143.30275229357798	130.9918396564066
chr6	LINC00518	10434247	10434363	0	117	0	2040	0	1923	0.0	0.0
chr6	LINC00518	10433027	10433253	0	227	0	2040	0	1813	0.0	0.0
chr6	C6ORF52	10684848	10684923	0	76	1599	892	1599	816	0.0	1.9595588235294117
chr6	C6ORF52	10686965	10687164	0	200	1599	892	1599	692	0.0	2.310693641618497
chr6	C6ORF52	10687479	10687561	120	83	1599	892	1479	809	1.4457831325301205	1.8281829419035847
chr6	C6ORF52	10672546	10672636	0	91	1599	892	1599	801	0.0	1.99625468164794
chr6	MAK	10770110	10770230	61	121	37465	4411	37404	4290	0.5041322314049587	8.71888111888112
chr6	MAK	10830547	10830877	102	331	37465	4411	37363	4080	0.3081570996978852	9.157598039215687
chr6	MAK	10773033	10773108	25	76	37465	4411	37440	4335	0.32894736842105265	8.636678200692042
chr6	MAK	10779325	10779497	3369	173	37465	4411	34096	4238	19.473988439306357	8.045304388862672
chr6	MAK	10784819	10784924	1106	106	37465	4411	36359	4305	10.433962264150944	8.445760743321719
chr6	NEDD9	11213280	11213727	452	448	4304	8413	3852	7965	1.0089285714285714	0.48361581920903957
chr6	NEDD9	11200270	11200421	0	152	4304	8413	4304	8261	0.0	0.5210022999636847
chr6	NEDD9	11305065	11305159	0	95	4304	8413	4304	8318	0.0	0.5174320750180332
chr6	NEDD9	11251563	11251726	0	164	4304	8413	4304	8249	0.0	0.5217602133591951
chr6	NEDD9	11334500	11334561	0	62	4304	8413	4304	8351	0.0	0.5153873787570351
chr6	NEDD9	11249138	11249214	0	77	4304	8413	4304	8336	0.0	0.5163147792706334
chr6	ADTRP	11717308	11717414	0	107	24593	3963	24593	3856	0.0	6.3778526970954355
chr6	ADTRP	11770030	11770084	0	55	24593	3963	24593	3908	0.0	6.292988741044012
chr6	ADTRP	11770030	11770089	0	60	24593	3963	24593	3903	0.0	6.301050473994363
chr6	TBC1D7	13316570	13316708	1228	139	21281	6125	20053	5986	8.83453237410072	3.3499832943534913
chr6	TBC1D7	13325093	13325174	348	82	21281	6125	20933	6043	4.2439024390243905	3.464007943074632
chr6	MCUR1	13803729	13804315	0	587	342507	4201	342507	3614	0.0	94.77227448810183
chr6	LINC01108	14283944	14284180	0	237	0	3700	0	3463	0.0	0.0
chr6	AL138720.1	15053030	15053186	0	157	0	3665	0	3508	0.0	0.0
chr6	AL138720.1	14997415	14997475	0	61	0	3665	0	3604	0.0	0.0
chr6	DTNBP1	15651312	15651363	10	52	92767	2096	92757	2044	0.19230769230769232	45.38013698630137
chr6	DTNBP1	15651312	15651408	110	97	92767	2096	92657	1999	1.134020618556701	46.35167583791896
chr6	DTNBP1	15652086	15652140	0	55	92767	2096	92767	2041	0.0	45.45173934345909
chr6	DTNBP1	15660382	15660521	1209	140	92767	2096	91558	1956	8.635714285714286	46.80879345603272
chr6	ATXN1	16754042	16754091	0	50	157548	17696	157548	17646	0.0	8.92825569534172
chr6	ATXN1	16753232	16753347	0	116	157548	17696	157548	17580	0.0	8.961774744027304
chr6	NUP153	17639938	17640064	0	127	395258	6144	395258	6017	0.0	65.69021106863886
chr6	NUP153	17651833	17651926	0	94	395258	6144	395258	6050	0.0	65.33190082644629
chr6	KIF13A	17794248	17794395	880	148	293805	10432	292925	10284	5.945945945945946	28.483566705562037
chr6	KIF13A	17898167	17898180	0	14	293805	10432	293805	10418	0.0	28.201670186216166
chr6	KIF13A	17771113	17771218	153	106	293805	10432	293652	10326	1.4433962264150944	28.43811737361999
chr6	KIF13A	17789871	17789910	0	40	293805	10432	293805	10392	0.0	28.272228637413395
chr6	KIF13A	17821785	17821905	0	121	293805	10432	293805	10311	0.0	28.49432644748327
chr6	DEK	18258303	18258405	0	103	770698	4668	770698	4565	0.0	168.8276013143483
chr6	DEK	18263842	18263996	225	155	770698	4668	770473	4513	1.4516129032258065	170.7230223797917
chr6	DEK	18244507	18244603	910	97	770698	4668	769788	4571	9.381443298969073	168.40691314810763
chr6	LNC-LBCS	19785392	19785440	0	49	32612	12676	32612	12627	0.0	2.58271956917716
chr6	LNC-LBCS	19600835	19600948	0	114	32612	12676	32612	12562	0.0	2.596083426206018
chr6	LNC-LBCS	19639262	19639454	0	193	32612	12676	32612	12483	0.0	2.6125130177040776
chr6	LNC-LBCS	19675358	19675425	0	68	32612	12676	32612	12608	0.0	2.5866116751269037
chr6	LNC-LBCS	19784467	19784589	0	123	32612	12676	32612	12553	0.0	2.5979447144108976
chr6	LNC-LBCS	19802086	19802156	48	71	32612	12676	32564	12605	0.676056338028169	2.58341927806426
chr6	LNC-LBCS	19749647	19749758	0	112	32612	12676	32612	12564	0.0	2.5956701687360715
chr6	LNC-LBCS	19690923	19691023	0	101	32612	12676	32612	12575	0.0	2.593399602385686
chr6	LNC-LBCS	19803507	19803910	16245	404	32612	12676	16367	12272	40.210396039603964	1.333686440677966
chr6	LNC-LBCS	19744030	19744134	0	105	32612	12676	32612	12571	0.0	2.594224803118288
chr6	LNC-LBCS	19804170	19804277	0	108	32612	12676	32612	12568	0.0	2.5948440483768302
chr6	AL132775.2	20332380	20332489	0	110	0	1994	0	1884	0.0	0.0
chr6	PRL	22290173	22290353	0	181	0	1437	0	1256	0.0	0.0
chr6	GPLD1	24486074	24486130	0	57	24928	7249	24928	7192	0.0	3.4660734149054506
chr6	KIAA0319	24600618	24600709	0	92	11683	7093	11683	7001	0.0	1.6687616054849308
chr6	RIPOR2	24847541	24847691	0	151	0	9468	0	9317	0.0	0.0
chr6	RIPOR2	24898400	24898566	0	167	0	9468	0	9301	0.0	0.0
chr6	CMAHP	25091895	25092012	0	118	2811	7466	2811	7348	0.0	0.3825530756668481
chr6	CMAHP	25084652	25084832	0	181	2811	7466	2811	7285	0.0	0.3858613589567605
chr6	CMAHP	25119133	25119230	0	98	2811	7466	2811	7368	0.0	0.38151465798045603
chr6	SLC17A1	25812830	25812992	0	163	0	2032	0	1869	0.0	0.0
chr6	SLC17A1	25813094	25813213	0	120	0	2032	0	1912	0.0	0.0
chr6	SLC17A3	25861795	25862029	0	235	0	3608	0	3373	0.0	0.0
chr6	SLC17A3	25861623	25861711	0	89	0	3608	0	3519	0.0	0.0
chr6	SLC17A2	25915498	25915646	0	149	0	2580	0	2431	0.0	0.0
chr6	ZNF322	26643658	26643728	0	71	117659	5066	117659	4995	0.0	23.555355355355356
chr6	ZNF322	26658557	26658646	0	90	117659	5066	117659	4976	0.0	23.645297427652732
chr6	ZNF322	26658776	26658851	0	76	117659	5066	117659	4990	0.0	23.578957915831662
chr6	GUSBP2	26887963	26888051	0	89	0	2081	0	1992	0.0	0.0
chr6	ZSCAN16-AS1	28125622	28125819	11507	198	136921	5751	125414	5553	58.11616161616162	22.584909058166758
chr6	ZSCAN31	28329302	28329778	0	477	33084	3678	33084	3201	0.0	10.33552014995314
chr6	ZSCAN31	28337755	28337893	1202	139	33084	3678	31882	3539	8.647482014388489	9.008759536592258
chr6	ZSCAN31	28341745	28341792	48	48	33084	3678	33036	3630	1.0	9.100826446280992
chr6	ZSCAN31	28332284	28332393	2481	110	33084	3678	30603	3568	22.554545454545455	8.57707399103139
chr6	ZSCAN31	28341745	28341795	49	51	33084	3678	33035	3627	0.9607843137254902	9.108078301626689
chr6	ZSCAN31	28329302	28329714	0	413	33084	3678	33084	3265	0.0	10.13292496171516
chr6	ZSCAN31	28337798	28337893	1202	96	33084	3678	31882	3582	12.520833333333334	8.900614182021217
chr6	ZSCAN23	28435459	28435607	0	149	52	3288	52	3139	0.0	0.01656578528193692
chr6	ZSCAN23	28435858	28436343	0	486	52	3288	52	2802	0.0	0.018558172733761598
chr6	GPX6	28505702	28505802	0	101	0	2026	0	1925	0.0	0.0
chr6	TRIM27	28907491	28907563	0	73	426	5195	426	5122	0.0	0.08317063647012886
chr6	GABBR1	29609228	29609379	0	152	191883	8494	191883	8342	0.0	23.00203788060417
chr6	GABBR1	29630521	29630643	0	123	191883	8494	191883	8371	0.0	22.922350973599332
chr6	GABBR1	29630457	29630643	0	187	191883	8494	191883	8307	0.0	23.098952690501985
chr6	ZFP57	29676880	29677366	0	487	0	2090	0	1603	0.0	0.0
chr6	ZNRD1ASP	30021666	30021761	162	96	55898	9881	55736	9785	1.6875	5.696065406234032
chr6	ZNRD1ASP	30060740	30060995	0	256	55898	9881	55898	9625	0.0	5.807584415584415
chr6	ZNRD1ASP	30057090	30057717	0	628	55898	9881	55898	9253	0.0	6.041067761806982
chr6	TRIM26	30204655	30204765	0	111	221	3810	221	3699	0.0	0.05974587726412544
chr6	TRIM26	30201034	30201138	0	105	221	3810	221	3705	0.0	0.05964912280701754
chr6	HCG18	30294470	30294964	5875	495	130230	15541	124355	15046	11.868686868686869	8.26498737205902
chr6	HCG18	30314268	30314482	21652	215	130230	15541	108578	15326	100.70697674418605	7.084562181913089
chr6	HCG18	30291536	30292599	306	1064	130230	15541	129924	14477	0.287593984962406	8.974511293776334
chr6	HCG18	30291536	30291982	255	447	130230	15541	129975	15094	0.5704697986577181	8.611037498343713
chr6	HCG18	30291536	30294964	32672	3429	130230	15541	97558	12112	9.52814231554389	8.054656538969617
chr6	HCG18	30326150	30326263	0	114	130230	15541	130230	15427	0.0	8.44169313541194
chr6	HCG18	30296131	30296237	1161	107	130230	15541	129069	15434	10.850467289719626	8.362640922638331
chr6	HCG18	30294852	30294964	674	113	130230	15541	129556	15428	5.964601769911504	8.397459165154265
chr6	PPP1R18	30684407	30684544	44	138	37109	4135	37065	3997	0.3188405797101449	9.273204903677758
chr6	PPP1R18	30684407	30686046	8165	1640	37109	4135	28944	2495	4.978658536585366	11.600801603206413
chr6	NRM	30689275	30689452	3700	178	8422812	2051	8419112	1873	20.786516853932586	4494.987720234917
chr6	NRM	30690046	30690243	7486	198	8422812	2051	8415326	1853	37.80808080808081	4541.4603345925525
chr6	MDC1	30707565	30708357	343321	793	1238783	7574	895462	6781	432.9394703656999	132.05456422356585
chr6	FLOT1	30741613	30741704	0	92	2151	3108	2151	3016	0.0	0.7131962864721485
chr6	FLOT1	30741791	30741867	0	77	2151	3108	2151	3031	0.0	0.7096667766413725
chr6	FLOT1	30741661	30741704	0	44	2151	3108	2151	3064	0.0	0.702023498694517
chr6	CCHCR1	31143261	31143413	2909	153	11185	4266	8276	4113	19.013071895424837	2.012156576707999
chr6	CCHCR1	31154495	31154799	0	305	11185	4266	11185	3961	0.0	2.8237818732643274
chr6	CCHCR1	31157022	31157089	0	68	11185	4266	11185	4198	0.0	2.664363982848976
chr6	CCHCR1	31157022	31157155	0	134	11185	4266	11185	4132	0.0	2.706921587608906
chr6	CCHCR1	31148891	31148984	0	94	11185	4266	11185	4172	0.0	2.6809683604985617
chr6	CCHCR1	31148891	31148987	0	97	11185	4266	11185	4169	0.0	2.6828975773566803
chr6	CCHCR1	31157384	31157500	0	117	11185	4266	11185	4149	0.0	2.6958303205591707
chr6	CCHCR1	31157357	31157500	0	144	11185	4266	11185	4122	0.0	2.7134885977680736
chr6	HLA-B	31355106	31355223	0	118	1275	2543	1275	2425	0.0	0.5257731958762887
chr6	DDX39B	31541152	31541327	0	176	671	3454	671	3278	0.0	0.20469798657718122
chr6	LTB	31581813	31581859	0	47	0	1356	0	1309	0.0	0.0
chr6	BAG6	31639499	31639646	2000	148	67628	5364	65628	5216	13.513513513513514	12.582055214723926
chr6	BAG6	31640384	31640528	916	145	67628	5364	66712	5219	6.317241379310345	12.782525388005364
chr6	BAG6	31644524	31644602	307	79	67628	5364	67321	5285	3.8860759493670884	12.738126773888363
chr6	BAG6	31647590	31647826	0	237	67628	5364	67628	5127	0.0	13.190559781548664
chr6	BAG6	31648910	31648964	224	55	67628	5364	67404	5309	4.072727272727272	12.696176304388773
chr6	BAG6	31644081	31644194	0	114	67628	5364	67628	5250	0.0	12.88152380952381
chr6	BAG6	31644306	31644414	0	109	67628	5364	67628	5255	0.0	12.869267364414844
chr6	BAG6	31644524	31644629	1472	106	67628	5364	66156	5258	13.88679245283019	12.581970330924305
chr6	ABHD16A	31696947	31697033	1250	87	10334	3670	9084	3583	14.367816091954023	2.5353056098241695
chr6	ABHD16A	31701273	31701340	358	68	10334	3670	9976	3602	5.264705882352941	2.7695724597445865
chr6	ABHD16A	31702073	31702130	612	58	10334	3670	9722	3612	10.551724137931034	2.6915836101882613
chr6	LY6G6C	31720952	31721063	15038	112	68335	1008	53297	896	134.26785714285714	59.48325892857143
chr6	DDAH2	31728450	31728524	21822	75	389676	2151	367854	2076	290.96	177.1936416184971
chr6	DDAH2	31728864	31729221	11551	358	389676	2151	378125	1793	32.26536312849162	210.88957055214723
chr6	DDAH2	31728864	31729225	11551	362	389676	2151	378125	1789	31.908839779005525	211.36109558412522
chr6	LSM2	31798476	31798507	0	32	391338	1066	391338	1034	0.0	378.47001934235976
chr6	LSM2	31797989	31798049	135	61	391338	1066	391203	1005	2.2131147540983607	389.25671641791047
chr6	LSM2	31806074	31806142	2883	69	391338	1066	388455	997	41.78260869565217	389.6238716148445
chr6	SLC44A4	31870602	31870702	590	101	26482	3391	25892	3290	5.841584158415841	7.869908814589666
chr6	SLC44A4	31874720	31874846	0	127	26482	3391	26482	3264	0.0	8.113357843137255
chr6	EHMT2	31888968	31889070	0	103	5043	6358	5043	6255	0.0	0.8062350119904077
chr6	NELFE	31957317	31957435	0	119	2391	2493	2391	2374	0.0	1.0071609098567817
chr6	DXO	31971319	31971725	0	407	1708	1879	1708	1472	0.0	1.1603260869565217
chr6	DXO	31971319	31971681	0	363	1708	1879	1708	1516	0.0	1.1266490765171504
chr6	TNXB	32087250	32087991	69574	742	361727	15410	292153	14668	93.7654986522911	19.917712026179437
chr6	PRRT1	32150367	32150583	14139	217	326436	2230	312297	2013	65.15668202764977	155.14008941877793
chr6	PRRT1	32150367	32150906	22516	540	326436	2230	303920	1690	41.696296296296296	179.8343195266272
chr6	AL662884.3	32152971	32153172	74652	202	288164	1064	213512	862	369.56435643564356	247.6937354988399
chr6	AGER	32181605	32181632	0	28	0	1715	0	1687	0.0	0.0
chr6	NOTCH4	32212823	32212911	0	89	185	9201	185	9112	0.0	0.02030289727831431
chr6	TSBP1	32315771	32315792	0	22	49583	2235	49583	2213	0.0	22.40533212833258
chr6	TSBP1	32343237	32343258	0	22	49583	2235	49583	2213	0.0	22.40533212833258
chr6	TSBP1	32366166	32366187	0	22	49583	2235	49583	2213	0.0	22.40533212833258
chr6	TSBP1	32316393	32316414	0	22	49583	2235	49583	2213	0.0	22.40533212833258
chr6	TSBP1	32324655	32324679	0	25	49583	2235	49583	2210	0.0	22.435746606334842
chr6	TSBP1	32366386	32366419	0	34	49583	2235	49583	2201	0.0	22.527487505679236
chr6	HLA-DQB1	32664797	32665067	0	271	0	3879	0	3608	0.0	0.0
chr6	HLA-DQB1	32660858	32660882	0	25	0	3879	0	3854	0.0	0.0
chr6	HLA-DQB1	32661346	32661457	0	112	0	3879	0	3767	0.0	0.0
chr6	HLA-DQB2	32757280	32757304	0	25	0	2031	0	2006	0.0	0.0
chr6	HLA-DQB2	32757772	32757883	0	112	0	2031	0	1919	0.0	0.0
chr6	HLA-DMB	32935341	32935377	761	37	12053	2610	11292	2573	20.56756756756757	4.388651379712398
chr6	HLA-DMB	32935535	32935652	1130	118	12053	2610	10923	2492	9.576271186440678	4.38322632423756
chr6	HLA-DMA	32950518	32950803	561	286	68150	2526	67589	2240	1.9615384615384615	30.173660714285713
chr6	HLA-DMA	32952283	32952461	0	179	68150	2526	68150	2347	0.0	29.03706859821048
chr6	HLA-DPA1	33073470	33073669	0	200	0	3195	0	2995	0.0	0.0
chr6	HLA-DPA1	33073470	33073772	0	303	0	3195	0	2892	0.0	0.0
chr6	COL11A2	33184991	33185054	0	64	1124403	6807	1124403	6743	0.0	166.75114934005634
chr6	COL11A2	33184144	33184324	0	181	1124403	6807	1124403	6626	0.0	169.69559311801993
chr6	COL11A2	33185700	33185778	0	79	1124403	6807	1124403	6728	0.0	167.12291914387635
chr6	RXRB	33199168	33199416	0	249	51	3784	51	3535	0.0	0.014427157001414427
chr6	VPS52	33269998	33270051	127	54	1417843	3958	1417716	3904	2.3518518518518516	363.14446721311475
chr6	RGL2	33296027	33296325	0	299	153	4078	153	3779	0.0	0.04048690129663932
chr6	RGL2	33298454	33298651	0	198	153	4078	153	3880	0.0	0.03943298969072165
chr6	TAPBP	33313216	33313477	0	262	102	4844	102	4582	0.0	0.022261021388040158
chr6	TAPBP	33313693	33313864	0	172	102	4844	102	4672	0.0	0.02183219178082192
chr6	TAPBP	33308104	33308158	0	55	102	4844	102	4789	0.0	0.021298809772395073
chr6	DAXX	33320735	33321567	25	833	25	2984	0	2151	0.030012004801920768	0.0
chr6	DAXX	33321718	33321977	0	260	25	2984	25	2724	0.0	0.009177679882525698
chr6	DAXX	33321718	33321974	0	257	25	2984	25	2727	0.0	0.009167583425009167
chr6	DAXX	33321718	33322008	0	291	25	2984	25	2693	0.0	0.00928332714444857
chr6	CUTA	33416919	33416969	1679	51	154924	1281	153245	1230	32.92156862745098	124.58943089430895
chr6	BAK1	33574505	33574525	0	21	0	2219	0	2198	0.0	0.0
chr6	UQCC2	33701345	33701420	0	76	51	2323	51	2247	0.0	0.022696929238985315
chr6	IP6K3	33739132	33739261	47041	130	47464	2801	423	2671	361.8538461538462	0.15836765256458255
chr6	IP6K3	33746587	33746633	0	47	47464	2801	47464	2754	0.0	17.234567901234566
chr6	LINC01016	33892316	33892451	0	136	0	1879	0	1743	0.0	0.0
chr6	GRM4	34056543	34056684	0	142	112	14402	112	14260	0.0	0.00785413744740533
chr6	GRM4	34091882	34092099	0	218	112	14402	112	14184	0.0	0.007896221094190638
chr6	SMIM29	34247466	34247492	2196	27	161731	1694	159535	1667	81.33333333333333	95.70185962807439
chr6	RPS10-NUDT3	34341861	34341972	0	112	7917	5240	7917	5128	0.0	1.5438767550702028
chr6	RPS10	34417797	34417897	70	101	153	2123	83	2022	0.693069306930693	0.0410484668644906
chr6	SPDEF	34539514	34539562	0	49	94662	1920	94662	1871	0.0	50.59433458043827
chr6	ILRUN	34646600	34646798	0	199	1683	4557	1683	4358	0.0	0.3861863240018357
chr6	TAF11	34879625	34879736	0	112	0	1995	0	1883	0.0	0.0
chr6	TAF11	34879966	34880063	0	98	0	1995	0	1897	0.0	0.0
chr6	TCP11	35136106	35136203	0	98	0	3084	0	2986	0.0	0.0
chr6	TCP11	35129061	35129182	0	122	0	3084	0	2962	0.0	0.0
chr6	TCP11	35140814	35140884	0	71	0	3084	0	3013	0.0	0.0
chr6	TCP11	35136106	35136218	0	113	0	3084	0	2971	0.0	0.0
chr6	TCP11	35140019	35140225	0	207	0	3084	0	2877	0.0	0.0
chr6	TCP11	35140746	35140884	0	139	0	3084	0	2945	0.0	0.0
chr6	TCP11	35128282	35128419	0	138	0	3084	0	2946	0.0	0.0
chr6	TCP11	35140505	35140597	0	93	0	3084	0	2991	0.0	0.0
chr6	TCP11	35128579	35128791	0	213	0	3084	0	2871	0.0	0.0
chr6	TCP11	35137690	35137852	0	163	0	3084	0	2921	0.0	0.0
chr6	TULP1	35506273	35506279	0	7	35	2931	35	2924	0.0	0.011969904240766074
chr6	TULP1	35511647	35511806	0	160	35	2931	35	2771	0.0	0.012630819198845183
chr6	FKBP5	35591129	35591220	0	92	153	10641	153	10549	0.0	0.01450374443075173
chr6	CLPS	35795730	35795853	24	124	24	605	0	481	0.1935483870967742	0.0
chr6	SRPK1	35870280	35870494	0	215	17256	6252	17256	6037	0.0	2.8583733642537683
chr6	SRPK1	35904878	35904974	0	97	17256	6252	17256	6155	0.0	2.80357432981316
chr6	ETV7	36371329	36371560	0	232	0	2383	0	2151	0.0	0.0
chr6	ETV7	36375870	36376035	0	166	0	2383	0	2217	0.0	0.0
chr6	ETV7	36385533	36385669	0	137	0	2383	0	2246	0.0	0.0
chr6	ETV7	36375829	36376035	0	207	0	2383	0	2176	0.0	0.0
chr6	CPNE5	36753033	36753095	0	63	23166	5796	23166	5733	0.0	4.040816326530612
chr6	CPNE5	36792395	36792446	0	52	23166	5796	23166	5744	0.0	4.033077994428969
chr6	CPNE5	36792395	36792443	0	49	23166	5796	23166	5747	0.0	4.030972681398991
chr6	MTCH1	36976497	36976598	0	102	0	3138	0	3036	0.0	0.0
chr6	TMEM217	37218425	37219041	102	617	839	2617	737	2000	0.16531604538087522	0.3685
chr6	TMEM217	37213210	37213319	0	110	839	2617	839	2507	0.0	0.33466294375747907
chr6	TMEM217	37215197	37215282	23	86	839	2617	816	2531	0.26744186046511625	0.32240221256420387
chr6	TMEM217	37218474	37219041	102	568	839	2617	737	2049	0.1795774647887324	0.35968765251342116
chr6	TMEM217	37215940	37215966	0	27	839	2617	839	2590	0.0	0.3239382239382239
chr6	MDGA1	37645932	37645956	0	25	306	12747	306	12722	0.0	0.024052821883351675
chr6	BTBD9	38612833	38613033	339	201	1153	9553	814	9352	1.6865671641791045	0.08704020530367836
chr6	BTBD9	38504493	38504562	0	70	1153	9553	1153	9483	0.0	0.12158599599282928
chr6	BTBD9	38402816	38402903	0	88	1153	9553	1153	9465	0.0	0.12181722134178552
chr6	KCNK17	39300372	39300523	0	152	0	2085	0	1933	0.0	0.0
chr6	KCNK16	39316301	39316442	0	142	0	1981	0	1839	0.0	0.0
chr6	KIF6	39346475	39346526	0	52	0	11899	0	11847	0.0	0.0
chr6	DAAM2-AS1	39891622	39891763	0	142	6073	6427	6073	6285	0.0	0.9662688941925219
chr6	DAAM2-AS1	39891305	39891379	0	75	6073	6427	6073	6352	0.0	0.9560768261964736
chr6	MOCS1	39909039	39909102	0	64	0	5101	0	5037	0.0	0.0
chr6	MOCS1	39909054	39909102	0	49	0	5101	0	5052	0.0	0.0
chr6	MOCS1	39927328	39927455	0	128	0	5101	0	4973	0.0	0.0
chr6	MOCS1	39927183	39927455	0	273	0	5101	0	4828	0.0	0.0
chr6	UNC5CL	41031680	41031748	0	69	125044	3165	125044	3096	0.0	40.388888888888886
chr6	OARD1	41068840	41068953	790	114	491684	6234	490894	6120	6.9298245614035086	80.21143790849673
chr6	OARD1	41071595	41071675	156	81	491684	6234	491528	6153	1.9259259259259258	79.88428408906225
chr6	OARD1	41070075	41070134	1047	60	491684	6234	490637	6174	17.45	79.46825396825396
chr6	TREML1	41153757	41154090	0	334	0	1489	0	1155	0.0	0.0
chr6	TREML1	41150260	41150313	0	54	0	1489	0	1435	0.0	0.0
chr6	TREM2	41158872	41159106	51	235	51	1100	0	865	0.2170212765957447	0.0
chr6	TREM2	41158872	41159066	51	195	51	1100	0	905	0.26153846153846155	0.0
chr6	TREM1	41280960	41281153	0	194	153	5896	153	5702	0.0	0.02683269028411084
chr6	TFEB	41690662	41690917	0	256	51	5743	51	5487	0.0	0.009294696555494806
chr6	TFEB	41732648	41732739	0	92	51	5743	51	5651	0.0	0.009024951336046718
chr6	TFEB	41732648	41732767	0	120	51	5743	51	5623	0.0	0.009069891516983817
chr6	USP49	41803805	41804010	0	206	31836	10934	31836	10728	0.0	2.9675615212527964
chr6	USP49	41891793	41891875	8	83	31836	10934	31828	10851	0.0963855421686747	2.9331858814855774
chr6	MED20	41916784	41916939	0	156	47397	3286	47397	3130	0.0	15.142811501597444
chr6	MED20	41917794	41917916	0	123	47397	3286	47397	3163	0.0	14.984824533670565
chr6	CCND3	41936558	41936695	0	138	83971	5772	83971	5634	0.0	14.904330848420305
chr6	CCND3	42030008	42030190	51	183	83971	5772	83920	5589	0.2786885245901639	15.015208445160136
chr6	CCND3	41940369	41940585	0	217	83971	5772	83971	5555	0.0	15.116291629162916
chr6	CCND3	41940951	41941161	0	211	83971	5772	83971	5561	0.0	15.099982017622729
chr6	TRERF1	42263259	42263568	0	310	28107	7750	28107	7440	0.0	3.7778225806451613
chr6	TRERF1	42263319	42263568	0	250	28107	7750	28107	7500	0.0	3.7476
chr6	MRPL2	43055544	43055618	0	75	2127	1897	2127	1822	0.0	1.1673984632272227
chr6	CRIP3	43306066	43306124	8796	59	118435	2357	109639	2298	149.08474576271186	47.710617928633596
chr6	CRIP3	43306445	43306517	3544	73	118435	2357	114891	2284	48.54794520547945	50.302539404553414
chr6	YIPF3	43515594	43515701	0	108	57826	2603	57826	2495	0.0	23.176753507014027
chr6	YIPF3	43515605	43515701	0	97	57826	2603	57826	2506	0.0	23.075019952114925
chr6	YIPF3	43515192	43515306	0	115	57826	2603	57826	2488	0.0	23.241961414790996
chr6	XPO5	43558500	43558591	0	92	104719	7753	104719	7661	0.0	13.66910325022843
chr6	XPO5	43547315	43547453	0	139	104719	7753	104719	7614	0.0	13.753480430785395
chr6	MRPS18A	43675201	43675271	0	71	0	1390	0	1319	0.0	0.0
chr6	LINC02537	43851588	43851886	0	299	0	2071	0	1772	0.0	0.0
chr6	AL109615.3	44000590	44000715	0	126	9662	2900	9662	2774	0.0	3.4830569574621486
chr6	SLC35B2	44256684	44256878	0	195	0	2369	0	2174	0.0	0.0
chr6	SLC35B2	44256341	44256496	0	156	0	2369	0	2213	0.0	0.0
chr6	NFKBIE	44262559	44262662	0	104	622	2060	622	1956	0.0	0.3179959100204499
chr6	TCTE1	44282109	44282559	29	451	58378	3091	58349	2640	0.06430155210643015	22.10189393939394
chr6	CLIC5	45883752	45883828	0	77	51	6919	51	6842	0.0	0.007453960830166618
chr6	CLIC5	45913777	45913812	0	36	51	6919	51	6883	0.0	0.007409559784977481
chr6	AL035701.1	46122947	46123109	0	163	20	1897	20	1734	0.0	0.011534025374855825
chr6	ENPP5	46170052	46170114	0	63	0	4280	0	4217	0.0	0.0
chr6	CYP39A1	46630962	46631070	0	109	7842	3125	7842	3016	0.0	2.600132625994695
chr6	CYP39A1	46639493	46639668	0	176	7842	3125	7842	2949	0.0	2.659206510681587
chr6	ADGRF1	47016616	47016768	0	153	306	10686	306	10533	0.0	0.02905155226431216
chr6	ADGRF1	47027703	47027761	0	59	306	10686	306	10627	0.0	0.028794579843794108
chr6	ADGRF1	47028992	47029104	0	113	306	10686	306	10573	0.0	0.028941643809703963
chr6	ADGRF1	47018479	47018582	0	104	306	10686	306	10582	0.0	0.028917028917028915
chr6	RHAG	49606847	49606921	0	75	0	2083	0	2008	0.0	0.0
chr6	RHAG	49611023	49611145	0	123	0	2083	0	1960	0.0	0.0
chr6	RHAG	49606728	49606921	0	194	0	2083	0	1889	0.0	0.0
chr6	CRISP2	49697675	49697780	0	106	51	1529	51	1423	0.0	0.035839775122979624
chr6	CRISP2	49711284	49711321	0	38	51	1529	51	1491	0.0	0.03420523138832998
chr6	CRISP1	49838436	49838525	0	90	0	2016	0	1926	0.0	0.0
chr6	AL135908.1	50599464	50599517	0	54	70	833	70	779	0.0	0.08985879332477535
chr6	MCM3	52283293	52283406	0	114	31482	3663	31482	3549	0.0	8.870667793744717
chr6	MCM3	52265234	52265385	153	152	31482	3663	31329	3511	1.006578947368421	8.923098832241527
chr6	GSTA1	52796181	52796314	0	134	0	1269	0	1135	0.0	0.0
chr6	GSTA1	52797585	52797637	0	53	0	1269	0	1216	0.0	0.0
chr6	GSTA5	52836235	52836368	0	134	0	898	0	764	0.0	0.0
chr6	GSTA3	52903675	52903727	0	53	96	905	96	852	0.0	0.11267605633802817
chr6	GSTA3	52905747	52905855	0	109	96	905	96	796	0.0	0.12060301507537688
chr6	GSTA9P	52945006	52945104	0	99	5945	896	5945	797	0.0	7.459222082810539
chr6	GSTA4	52985450	52985583	0	134	0	2109	0	1975	0.0	0.0
chr6	GSTA4	52987356	52987408	0	53	0	2109	0	2056	0.0	0.0
chr6	CILK1	53060935	53061046	0	112	816	6317	816	6205	0.0	0.13150684931506848
chr6	ELOVL5	53273219	53273344	0	126	0	3826	0	3700	0.0	0.0
chr6	ELOVL5	53287861	53287942	0	82	0	3826	0	3744	0.0	0.0
chr6	GCLC	53516108	53516222	0	115	4106	8525	4106	8410	0.0	0.4882282996432818
chr6	GCLC	53516108	53516240	0	133	4106	8525	4106	8392	0.0	0.4892755004766444
chr6	GCLC	53516108	53516217	0	110	4106	8525	4106	8415	0.0	0.4879382055852644
chr6	AL033397.1	53573199	53573275	0	77	0	3858	0	3781	0.0	0.0
chr6	AL033397.1	53569422	53569605	0	184	0	3858	0	3674	0.0	0.0
chr6	AL033397.1	53569479	53569605	0	127	0	3858	0	3731	0.0	0.0
chr6	AL033397.1	53569422	53569584	0	163	0	3858	0	3695	0.0	0.0
chr6	AL590652.1	53746515	53746603	0	89	3906	4495	3906	4406	0.0	0.8865183840217885
chr6	MLIP-AS1	54032376	54032436	0	61	0	4048	0	3987	0.0	0.0
chr6	MLIP-AS1	54030618	54030659	0	42	0	4048	0	4006	0.0	0.0
chr6	MLIP-AS1	54045537	54045825	0	289	0	4048	0	3759	0.0	0.0
chr6	MLIP-AS1	54043351	54043427	0	77	0	4048	0	3971	0.0	0.0
chr6	MLIP-AS1	54057946	54058000	0	55	0	4048	0	3993	0.0	0.0
chr6	HMGCLL1	55516507	55516603	0	97	306	4792	306	4695	0.0	0.06517571884984026
chr6	HMGCLL1	55577077	55577167	0	91	306	4792	306	4701	0.0	0.0650925335035099
chr6	HMGCLL1	55563818	55563914	0	97	306	4792	306	4695	0.0	0.06517571884984026
chr6	HMGCLL1	55566503	55566628	0	126	306	4792	306	4666	0.0	0.06558079725675096
chr6	HMGCLL1	55495418	55495607	0	190	306	4792	306	4602	0.0	0.06649282920469361
chr6	COL21A1	56078092	56078188	0	97	0	6096	0	5999	0.0	0.0
chr6	COL21A1	56156886	56156949	0	64	0	6096	0	6032	0.0	0.0
chr6	COL21A1	56164813	56164822	0	10	0	6096	0	6086	0.0	0.0
chr6	COL21A1	56231060	56231134	0	75	0	6096	0	6021	0.0	0.0
chr6	COL21A1	56225859	56225911	0	53	0	6096	0	6043	0.0	0.0
chr6	DST	56463045	56463156	0	112	19950	43263	19950	43151	0.0	0.4623299575907858
chr6	DST	56468981	56468999	49	19	19950	43263	19901	43244	2.5789473684210527	0.46020257145499954
chr6	DST	56529447	56529774	0	328	19950	43263	19950	42935	0.0	0.4646558751601258
chr6	DST	56464684	56464756	0	73	19950	43263	19950	43190	0.0	0.4619124797406807
chr6	DST	56617985	56620715	102	2731	19950	43263	19848	40532	0.0373489564262175	0.4896871607618672
chr6	ZNF451-AS1	57134146	57134215	50	70	101	4544	51	4474	0.7142857142857143	0.011399195350916406
chr6	ZNF451-AS1	57116037	57116127	0	91	101	4544	101	4453	0.0	0.022681338423534696
chr6	ZNF451-AS1	57116425	57116547	0	123	101	4544	101	4421	0.0	0.022845510065596018
chr6	ZNF451-AS1	57115455	57115563	0	109	101	4544	101	4435	0.0	0.022773393461104848
chr6	ZNF451-AS1	57151822	57151906	0	85	101	4544	101	4459	0.0	0.022650818569185917
chr6	ZNF451-AS1	57151027	57151195	0	169	101	4544	101	4375	0.0	0.023085714285714286
chr6	ZNF451-AS1	57150902	57150946	0	45	101	4544	101	4499	0.0	0.022449433207379417
chr6	AL021368.4	57929044	57929132	0	89	0	682	0	593	0.0	0.0
chr6	LINC00680	57961151	57961224	0	74	153	2185	153	2111	0.0	0.07247749881572714
chr6	LINC00680	57949858	57950011	0	154	153	2185	153	2031	0.0	0.07533234859675036
chr6	KHDRBS2	61707329	61707403	0	75	0	2413	0	2338	0.0	0.0
chr6	EYS	63741912	63741975	0	64	1173	17124	1173	17060	0.0	0.06875732708089097
chr6	EYS	65491356	65491589	0	234	1173	17124	1173	16890	0.0	0.069449378330373
chr6	AL713998.1	67886967	67887398	0	432	102	5335	102	4903	0.0	0.020803589638996534
chr6	AL713998.1	67883603	67883876	0	274	102	5335	102	5061	0.0	0.02015411973918198
chr6	AL713998.1	67886967	67888821	102	1855	102	5335	0	3480	0.05498652291105121	0.0
chr6	AL713998.1	67886967	67887069	0	103	102	5335	102	5232	0.0	0.0194954128440367
chr6	AL713998.1	67886986	67887398	0	413	102	5335	102	4922	0.0	0.02072328321820398
chr6	AL713998.1	67883705	67883876	0	172	102	5335	102	5163	0.0	0.019755955839628123
chr6	AL606923.2	68512788	68512876	0	89	0	2614	0	2525	0.0	0.0
chr6	AL606923.2	68467166	68467249	0	84	0	2614	0	2530	0.0	0.0
chr6	LMBRD1	69749340	69749408	0	69	0	8302	0	8233	0.0	0.0
chr6	LMBRD1	69752258	69752356	0	99	0	8302	0	8203	0.0	0.0
chr6	LMBRD1	69708849	69709231	0	383	0	8302	0	7919	0.0	0.0
chr6	LMBRD1	69743987	69744047	0	61	0	8302	0	8241	0.0	0.0
chr6	LMBRD1	69824488	69824552	0	65	0	8302	0	8237	0.0	0.0
chr6	LMBRD1	69835856	69836035	0	180	0	8302	0	8122	0.0	0.0
chr6	LMBRD1	69755557	69755585	0	29	0	8302	0	8273	0.0	0.0
chr6	LMBRD1	69755472	69755585	0	114	0	8302	0	8188	0.0	0.0
chr6	LMBRD1	69705500	69705619	0	120	0	8302	0	8182	0.0	0.0
chr6	LMBRD1	69748223	69748289	0	67	0	8302	0	8235	0.0	0.0
chr6	LMBRD1	69743783	69743881	0	99	0	8302	0	8203	0.0	0.0
chr6	LMBRD1	69709156	69709231	0	76	0	8302	0	8226	0.0	0.0
chr6	LMBRD1	69798114	69798289	0	176	0	8302	0	8126	0.0	0.0
chr6	LMBRD1	69710424	69710444	0	21	0	8302	0	8281	0.0	0.0
chr6	LMBRD1	69796153	69796229	0	77	0	8302	0	8225	0.0	0.0
chr6	COL9A1	70241963	70242035	0	73	51	6308	51	6235	0.0	0.00817963111467522
chr6	COL9A1	70270313	70270367	0	55	51	6308	51	6253	0.0	0.008156085079162002
chr6	COL9A1	70279515	70279620	0	106	51	6308	51	6202	0.0	0.008223153821347952
chr6	AL589935.1	71302969	71303045	556	77	12425	5018	11869	4941	7.220779220779221	2.402145314713621
chr6	AL589935.1	71304347	71304390	0	44	12425	5018	12425	4974	0.0	2.497989545637314
chr6	AL589935.1	71295710	71295813	0	104	12425	5018	12425	4914	0.0	2.5284900284900287
chr6	AL589935.1	71313053	71313146	0	94	12425	5018	12425	4924	0.0	2.5233549959382615
chr6	AL589935.1	71313844	71314164	0	321	12425	5018	12425	4697	0.0	2.645305514157973
chr6	AL589935.1	71326329	71326620	0	292	12425	5018	12425	4726	0.0	2.6290732120186204
chr6	AL589935.1	71314706	71314785	0	80	12425	5018	12425	4938	0.0	2.516200891049008
chr6	AL589935.1	71313844	71314189	0	346	12425	5018	12425	4672	0.0	2.659460616438356
chr6	LINC00472	71346173	71346400	0	228	31399	11340	31399	11112	0.0	2.825683945284377
chr6	LINC00472	71348526	71348610	0	85	31399	11340	31399	11255	0.0	2.789782318969347
chr6	LINC00472	71418688	71418754	168	67	31399	11340	31231	11273	2.5074626865671643	2.7704249090747806
chr6	KCNQ5-AS1	73136093	73136159	51	67	51	4669	0	4602	0.7611940298507462	0.0
chr6	AL356277.3	74602278	74602453	0	176	21204	1486	21204	1310	0.0	16.186259541984732
chr6	COL12A1	75138319	75138340	0	22	275	12551	275	12529	0.0	0.021949078138718173
chr6	COX7A2	75240300	75240385	0	86	0	1928	0	1842	0.0	0.0
chr6	COX7A2	75241175	75241265	0	91	0	1928	0	1837	0.0	0.0
chr6	COX7A2	75241122	75241265	0	144	0	1928	0	1784	0.0	0.0
chr6	COX7A2	75240276	75240385	0	110	0	1928	0	1818	0.0	0.0
chr6	COX7A2	75241821	75241938	0	118	0	1928	0	1810	0.0	0.0
chr6	TMEM30A	75265230	75265338	0	109	357	5513	357	5404	0.0	0.06606217616580311
chr6	TMEM30A	75267640	75267748	0	109	357	5513	357	5404	0.0	0.06606217616580311
chr6	TMEM30A	75260121	75260402	0	282	357	5513	357	5231	0.0	0.0682469891034219
chr6	IMPG1	76041892	76042126	0	235	193757	3821	193757	3586	0.0	54.03151143335192
chr6	HMGN3	79202062	79202155	0	94	0	1021	0	927	0.0	0.0
chr6	LINC02542	82059590	82059679	0	90	447	2815	447	2725	0.0	0.16403669724770642
chr6	IBTK	82214226	82214829	0	604	1972	7325	1972	6721	0.0	0.29340871894063386
chr6	IBTK	82174897	82175002	0	106	1972	7325	1972	7219	0.0	0.27316802881285496
chr6	UBE3D	83049708	83049772	0	65	4308	6416	4308	6351	0.0	0.6783183750590458
chr6	UBE3D	83032241	83032310	0	70	4308	6416	4308	6346	0.0	0.6788528206744406
chr6	UBE3D	83063152	83063245	0	94	4308	6416	4308	6322	0.0	0.6814299272382157
chr6	PGM3	83171936	83172059	0	124	51	5939	51	5815	0.0	0.008770421324161651
chr6	PGM3	83175961	83176060	0	100	51	5939	51	5839	0.0	0.008734372324028086
chr6	PGM3	83179809	83179967	0	159	51	5939	51	5780	0.0	0.008823529411764706
chr6	PGM3	83190808	83191014	0	207	51	5939	51	5732	0.0	0.00889741800418702
chr6	PGM3	83178672	83178756	0	85	51	5939	51	5854	0.0	0.008711991800478306
chr6	PGM3	83191186	83191323	0	138	51	5939	51	5801	0.0	0.008791587657300466
chr6	SNAP91	83556142	83556245	0	104	4577	6360	4577	6256	0.0	0.7316176470588235
chr6	SNAP91	83592454	83592538	0	85	4577	6360	4577	6275	0.0	0.7294023904382471
chr6	SNAP91	83593181	83593259	0	79	4577	6360	4577	6281	0.0	0.728705620124184
chr6	SNAP91	83614856	83614862	0	7	4577	6360	4577	6353	0.0	0.7204470328978435
chr6	SNAP91	83623300	83623342	0	43	4577	6360	4577	6317	0.0	0.7245527940478075
chr6	SNAP91	83661501	83661604	0	104	4577	6360	4577	6256	0.0	0.7316176470588235
chr6	SNAP91	83665438	83665581	0	144	4577	6360	4577	6216	0.0	0.7363256113256114
chr6	SNAP91	83591210	83591294	0	85	4577	6360	4577	6275	0.0	0.7294023904382471
chr6	CEP162	84217798	84217860	0	63	0	5511	0	5448	0.0	0.0
chr6	CEP162	84226336	84226452	0	117	0	5511	0	5394	0.0	0.0
chr6	CEP162	84219102	84219214	0	113	0	5511	0	5398	0.0	0.0
chr6	LINC01611	84463677	84463787	0	111	0	747	0	636	0.0	0.0
chr6	SNX14	85514069	85514234	0	166	337	7137	337	6971	0.0	0.048343135848515274
chr6	SNX14	85538837	85538864	0	28	337	7137	337	7109	0.0	0.047404698269798845
chr6	SNX14	85557975	85558060	0	86	337	7137	337	7051	0.0	0.0477946390582896
chr6	SNX14	85567533	85567577	0	45	337	7137	337	7092	0.0	0.047518330513254374
chr6	SNX14	85565331	85565419	0	89	337	7137	337	7048	0.0	0.047814982973893305
chr6	SYNCRIP	85637242	85637356	0	115	0	9811	0	9696	0.0	0.0
chr6	SYNCRIP	85641291	85641451	0	161	0	9811	0	9650	0.0	0.0
chr6	SYNCRIP	85642796	85642890	0	95	0	9811	0	9716	0.0	0.0
chr6	SYNCRIP	85637268	85637356	0	89	0	9811	0	9722	0.0	0.0
chr6	SYNCRIP	85636966	85637143	0	178	0	9811	0	9633	0.0	0.0
chr6	SNHG5	85677423	85677492	0	70	51	7815	51	7745	0.0	0.006584893479664299
chr6	SNHG5	85677953	85678032	0	80	51	7815	51	7735	0.0	0.006593406593406593
chr6	SNHG5	85677794	85677875	0	82	51	7815	51	7733	0.0	0.006595111858269753
chr6	SNHG5	85666003	85666147	0	145	51	7815	51	7670	0.0	0.006649282920469361
chr6	SNHG5	85677092	85677191	0	100	51	7815	51	7715	0.0	0.00661049902786779
chr6	SNHG5	85677794	85677868	0	75	51	7815	51	7740	0.0	0.006589147286821705
chr6	SNHG5	85676984	85677191	0	208	51	7815	51	7607	0.0	0.006704351255422637
chr6	SNHG5	85668112	85668274	0	163	51	7815	51	7652	0.0	0.006664924202822792
chr6	SNHG5	85677423	85678032	0	610	51	7815	51	7205	0.0	0.007078417765440667
chr6	SNHG5	85677794	85678032	0	239	51	7815	51	7576	0.0	0.0067317845828933475
chr6	SNHG5	85677790	85677875	0	86	51	7815	51	7729	0.0	0.006598525035580282
chr6	SNHG5	85677423	85677875	0	453	51	7815	51	7362	0.0	0.0069274653626731865
chr6	SNHG5	85677794	85677899	0	106	51	7815	51	7709	0.0	0.0066156440524062785
chr6	SNHG5	85677790	85678032	0	243	51	7815	51	7572	0.0	0.006735340729001585
chr6	CGA	87094828	87094880	0	53	0	1990	0	1937	0.0	0.0
chr6	CGA	87086516	87086609	0	94	0	1990	0	1896	0.0	0.0
chr6	CGA	87088868	87089167	0	300	0	1990	0	1690	0.0	0.0
chr6	RARS2	87564543	87564662	0	120	247	2991	247	2871	0.0	0.086032741205155
chr6	CNR1	88147663	88147806	0	144	765	2313	765	2169	0.0	0.35269709543568467
chr6	RNGTT	88801563	88801632	0	70	0	5204	0	5134	0.0	0.0
chr6	AL353135.2	89132335	89132478	0	144	0	1763	0	1619	0.0	0.0
chr6	GABRR1	89203434	89203485	0	52	102	3789	102	3737	0.0	0.027294621354027295
chr6	GABRR1	89204595	89204694	0	100	102	3789	102	3689	0.0	0.027649769585253458
chr6	RRAGD	89387294	89387590	102	297	102	5103	0	4806	0.3434343434343434	0.0
chr6	BACH2	90252512	90252590	0	79	3874	9799	3874	9720	0.0	0.398559670781893
chr6	BACH2	90271848	90271941	0	94	3874	9799	3874	9705	0.0	0.39917568263781555
chr6	MAP3K7	90544551	90544632	730	82	18001	7270	17271	7188	8.902439024390244	2.402754590984975
chr6	MAP3K7	90518446	90518562	0	117	18001	7270	18001	7153	0.0	2.5165664756046415
chr6	UFL1-AS1	96460485	96460612	0	128	0	6546	0	6418	0.0	0.0
chr6	UFL1-AS1	96519294	96519375	0	82	0	6546	0	6464	0.0	0.0
chr6	MMS22L	97233860	97233980	0	121	3267	18577	3267	18456	0.0	0.17701560468140443
chr6	MMS22L	97263334	97263448	0	115	3267	18577	3267	18462	0.0	0.1769580760480988
chr6	MMS22L	97270106	97270283	0	178	3267	18577	3267	18399	0.0	0.17756399804337192
chr6	FBXL4	98934761	98934879	0	119	255	8128	255	8009	0.0	0.03183918092146335
chr6	COQ3	99375939	99376182	68	244	575	1456	507	1212	0.2786885245901639	0.4183168316831683
chr6	PNISR	99403828	99403882	0	55	0	5565	0	5510	0.0	0.0
chr6	PNISR	99416348	99416428	0	81	0	5565	0	5484	0.0	0.0
chr6	USP45	99464603	99464747	0	145	0	7638	0	7493	0.0	0.0
chr6	USP45	99466671	99466763	0	93	0	7638	0	7545	0.0	0.0
chr6	USP45	99482752	99482883	0	132	0	7638	0	7506	0.0	0.0
chr6	USP45	99468099	99468170	0	72	0	7638	0	7566	0.0	0.0
chr6	USP45	99468536	99468618	0	83	0	7638	0	7555	0.0	0.0
chr6	CCNC	99561596	99561681	0	86	0	5627	0	5541	0.0	0.0
chr6	CCNC	99562841	99562948	0	108	0	5627	0	5519	0.0	0.0
chr6	CCNC	99549311	99549399	0	89	0	5627	0	5538	0.0	0.0
chr6	CCNC	99544178	99544273	0	96	0	5627	0	5531	0.0	0.0
chr6	CCNC	99544205	99544273	0	69	0	5627	0	5558	0.0	0.0
chr6	CCNC	99566897	99567038	0	142	0	5627	0	5485	0.0	0.0
chr6	ASCC3	100864063	100864214	0	152	1376	11774	1376	11622	0.0	0.11839614524178282
chr6	HACE1	104750340	104750472	0	133	153	9266	153	9133	0.0	0.01675243622030001
chr6	HACE1	104833041	104833173	0	133	153	9266	153	9133	0.0	0.01675243622030001
chr6	HACE1	104780352	104780457	0	106	153	9266	153	9160	0.0	0.016703056768558953
chr6	HACE1	104824813	104824907	0	95	153	9266	153	9171	0.0	0.016683022571148183
chr6	HACE1	104858393	104858532	51	140	153	9266	102	9126	0.36428571428571427	0.011176857330703484
chr6	LIN28B-AS1	104939327	104939536	0	210	69	5056	69	4846	0.0	0.014238547255468428
chr6	LINC02836	105619333	105619462	0	130	0	740	0	610	0.0	0.0
chr6	ATG5	106248149	106248244	0	96	51	5668	51	5572	0.0	0.009152907394113424
chr6	ATG5	106308363	106308491	0	129	51	5668	51	5539	0.0	0.009207438165733887
chr6	ATG5	106217463	106217601	0	139	51	5668	51	5529	0.0	0.009224091155724362
chr6	LINC02532	106733575	106733663	0	89	17855	11311	17855	11222	0.0	1.5910711103190163
chr6	LINC02532	106739700	106739770	138	71	17855	11311	17717	11240	1.943661971830986	1.5762455516014235
chr6	LINC02532	106725341	106725389	0	49	17855	11311	17855	11262	0.0	1.585419996448233
chr6	LINC02532	106726361	106726501	0	141	17855	11311	17855	11170	0.0	1.598478066248881
chr6	LINC02532	106749633	106749788	0	156	17855	11311	17855	11155	0.0	1.600627521290901
chr6	LINC02532	106747213	106747288	0	76	17855	11311	17855	11235	0.0	1.5892300845571874
chr6	LINC02532	106772237	106772361	0	125	17855	11311	17855	11186	0.0	1.5961916681566244
chr6	LINC02532	106756104	106756261	1533	158	17855	11311	16322	11153	9.70253164556962	1.4634627454496547
chr6	LINC02532	106774776	106775000	0	225	17855	11311	17855	11086	0.0	1.6105899332491431
chr6	LINC02532	106765017	106765219	0	203	17855	11311	17855	11108	0.0	1.6074000720201655
chr6	LINC02532	106765017	106765196	0	180	17855	11311	17855	11131	0.0	1.6040786991285598
chr6	LINC02532	106754293	106754422	0	130	17855	11311	17855	11181	0.0	1.5969054646274932
chr6	LINC02532	106755869	106755990	0	122	17855	11311	17855	11189	0.0	1.5957636964876218
chr6	LINC02532	106756416	106756457	0	42	17855	11311	17855	11269	0.0	1.5844351761469517
chr6	LINC02532	106774776	106774921	0	146	17855	11311	17855	11165	0.0	1.599193909538737
chr6	CD24	106974577	106974754	0	178	762	1798	762	1620	0.0	0.4703703703703704
chr6	SCML4	107772171	107772386	0	216	401	8568	401	8352	0.0	0.048012452107279696
chr6	SCML4	107755570	107755664	0	95	401	8568	401	8473	0.0	0.04732680278531807
chr6	SEC63	107955964	107956106	0	143	3957	8629	3957	8486	0.0	0.46629743106292715
chr6	SNX3	108222949	108223045	0	97	10784	1833	10784	1736	0.0	6.211981566820277
chr6	SNX3	108222233	108222320	0	88	10784	1833	10784	1745	0.0	6.179942693409743
chr6	CD164	109370410	109370467	0	58	1466	6868	1466	6810	0.0	0.21527165932452277
chr6	CD164	109376073	109376112	0	40	1466	6868	1466	6828	0.0	0.21470415934387815
chr6	CD164	109368921	109369017	650	97	1466	6868	816	6771	6.701030927835052	0.12051395657953035
chr6	PPIL6	109400034	109400170	0	137	3915	4492	3915	4355	0.0	0.8989667049368542
chr6	PPIL6	109436103	109436199	0	97	3915	4492	3915	4395	0.0	0.8907849829351536
chr6	PPIL6	109404928	109405048	357	121	3915	4492	3558	4371	2.950413223140496	0.8140013726835964
chr6	PPIL6	109403030	109403108	0	79	3915	4492	3915	4413	0.0	0.8871515975526852
chr6	MICAL1	109450299	109450557	0	259	7794	5222	7794	4963	0.0	1.5704211162603263
chr6	AK9	109641517	109641616	0	100	7672	10140	7672	10040	0.0	0.7641434262948207
chr6	AK9	109675628	109675756	0	129	7672	10140	7672	10011	0.0	0.7663570072919789
chr6	WASF1	110160634	110160732	0	99	168	3135	168	3036	0.0	0.05533596837944664
chr6	WASF1	110178597	110178742	0	146	168	3135	168	2989	0.0	0.05620608899297424
chr6	WASF1	110177146	110177186	0	41	168	3135	168	3094	0.0	0.05429864253393665
chr6	DDO	110404773	110404950	0	178	0	2148	0	1970	0.0	0.0
chr6	DDO	110408333	110408442	0	110	0	2148	0	2038	0.0	0.0
chr6	SLC22A16	110456537	110456803	0	267	7510	2809	7510	2542	0.0	2.954366640440598
chr6	CDK19	110746125	110746201	0	77	0	7662	0	7585	0.0	0.0
chr6	CDK19	110632029	110632161	0	133	0	7662	0	7529	0.0	0.0
chr6	CDK19	110638648	110638706	0	59	0	7662	0	7603	0.0	0.0
chr6	CDK19	110773875	110773937	0	63	0	7662	0	7599	0.0	0.0
chr6	REV3L	111308013	111308245	102	233	17251	12462	17149	12229	0.43776824034334766	1.402322348515823
chr6	REV3L	111358821	111359014	0	194	17251	12462	17251	12268	0.0	1.4061786762308446
chr6	REV3L	111460299	111460406	0	108	17251	12462	17251	12354	0.0	1.3963898332523879
chr6	REV3L	111472012	111472140	0	129	17251	12462	17251	12333	0.0	1.3987675342576826
chr6	TRAF3IP2	111562964	111563039	0	76	18262	7884	18262	7808	0.0	2.3388831967213113
chr6	TRAF3IP2	111601195	111601306	0	112	18262	7884	18262	7772	0.0	2.349716932578487
chr6	TRAF3IP2	111601195	111601318	0	124	18262	7884	18262	7760	0.0	2.3533505154639176
chr6	TRAF3IP2	111595702	111595820	7344	119	18262	7884	10918	7765	61.714285714285715	1.406052801030264
chr6	FYN	111699514	111699670	0	157	11959	6971	11959	6814	0.0	1.7550631053712944
chr6	FYN	111780565	111780635	0	71	11959	6971	11959	6900	0.0	1.7331884057971014
chr6	FYN	111846588	111846629	0	42	11959	6971	11959	6929	0.0	1.725934478279694
chr6	FYN	111700103	111700268	0	166	11959	6971	11959	6805	0.0	1.7573842762674503
chr6	FYN	111740980	111741093	0	114	11959	6971	11959	6857	0.0	1.7440571678576637
chr6	FYN	111740980	111741097	0	118	11959	6971	11959	6853	0.0	1.7450751495695316
chr6	FYN	111754433	111754677	0	245	11959	6971	11959	6726	0.0	1.7780255724055902
chr6	FYN	111813891	111814107	0	217	11959	6971	11959	6754	0.0	1.7706544270062186
chr6	TUBE1	112084188	112084246	0	59	204	6165	204	6106	0.0	0.033409760890926954
chr6	LAMA4	112122013	112122201	0	189	851	11935	851	11746	0.0	0.07245019581134003
chr6	LINC02541	113623739	113623822	0	84	51	2418	51	2334	0.0	0.021850899742930592
chr6	LINC02541	113649403	113649821	0	419	51	2418	51	1999	0.0	0.025512756378189096
chr6	HDAC2	113962366	113962394	0	29	1989	12521	1989	12492	0.0	0.15922190201729106
chr6	HDAC2	113968633	113968696	0	64	1989	12521	1989	12457	0.0	0.1596692622621819
chr6	AL138830.1	114535715	114536066	0	352	0	826	0	474	0.0	0.0
chr6	LINC02534	115634139	115634347	0	209	0	634	0	425	0.0	0.0
chr6	LINC02534	115643109	115643142	0	34	0	634	0	600	0.0	0.0
chr6	ZUP1	116656683	116656852	0	170	102	2667	102	2497	0.0	0.0408490188225871
chr6	GPRC6A	116800583	116800796	0	214	102	2914	102	2700	0.0	0.03777777777777778
chr6	ROS1	117414518	117414545	0	28	37	8935	37	8907	0.0	0.004154036151341641
chr6	GOPC	117569571	117569736	0	166	1071	4637	1071	4471	0.0	0.23954372623574144
chr6	GOPC	117577447	117577471	0	25	1071	4637	1071	4612	0.0	0.23222029488291412
chr6	CEP85L	118664410	118664521	0	112	0	9448	0	9336	0.0	0.0
chr6	MCM9	118827926	118828130	318	205	675	12510	357	12305	1.551219512195122	0.029012596505485575
chr6	MCM9	118856370	118856545	0	176	675	12510	675	12334	0.0	0.054726771525863464
chr6	MCM9	118932606	118932740	0	135	675	12510	675	12375	0.0	0.05454545454545454
chr6	FAM184A	118974427	118974574	0	148	1644	7735	1644	7587	0.0	0.2166864373270067
chr6	FAM184A	118964666	118964771	0	106	1644	7735	1644	7629	0.0	0.2154935116004719
chr6	FAM184A	118960768	118960863	0	96	1644	7735	1644	7639	0.0	0.21521141510668937
chr6	FAM184A	118961760	118961963	102	204	1644	7735	1542	7531	0.5	0.20475368476961892
chr6	TBC1D32	121205074	121205163	0	90	255	6953	255	6863	0.0	0.037155762785953665
chr6	TBC1D32	121170404	121170527	0	124	255	6953	255	6829	0.0	0.03734075267242642
chr6	TBC1D32	121139773	121139836	0	64	255	6953	255	6889	0.0	0.037015532007548264
chr6	TBC1D32	121192374	121192542	0	169	255	6953	255	6784	0.0	0.03758844339622641
chr6	TBC1D32	121224362	121224451	0	90	255	6953	255	6863	0.0	0.037155762785953665
chr6	TBC1D32	121129868	121129924	0	57	255	6953	255	6896	0.0	0.036977958236658934
chr6	TRDN	123497192	123497252	0	61	28	9810	28	9749	0.0	0.0028720894450712893
chr6	RNF217-AS1	124682870	124683022	0	153	102	11186	102	11033	0.0	0.009244992295839754
chr6	RNF217-AS1	124931695	124931738	0	44	102	11186	102	11142	0.0	0.009154550350026925
chr6	RNF217-AS1	124947930	124948098	0	169	102	11186	102	11017	0.0	0.009258418807297813
chr6	RNF217-AS1	124941389	124941524	0	136	102	11186	102	11050	0.0	0.009230769230769232
chr6	RNF217-AS1	124744395	124744472	0	78	102	11186	102	11108	0.0	0.009182571119913576
chr6	RNF217-AS1	124945298	124945439	0	142	102	11186	102	11044	0.0	0.009235784136182543
chr6	RNF217-AS1	124826227	124826547	0	321	102	11186	102	10865	0.0	0.009387942936033134
chr6	RNF217-AS1	124941389	124941604	0	216	102	11186	102	10970	0.0	0.009298085688240657
chr6	HDDC2	125298713	125298816	0	104	559	4375	559	4271	0.0	0.1308826972605947
chr6	AL450332.1	125438079	125438236	0	158	38252	4796	38252	4638	0.0	8.247520482966795
chr6	AL450332.1	125408493	125408622	1071	130	38252	4796	37181	4666	8.238461538461538	7.968495499357051
chr6	AL450332.1	125404857	125404938	3138	82	38252	4796	35114	4714	38.26829268292683	7.448875689435724
chr6	AL365259.1	125657428	125657466	0	39	2522	4118	2522	4079	0.0	0.6182887962735965
chr6	AL356534.1	126717332	126717474	0	143	4351	36890	4351	36747	0.0	0.11840422347402509
chr6	AL356534.1	126888215	126888338	0	124	4351	36890	4351	36766	0.0	0.11834303432519175
chr6	AL356534.1	126943385	126943608	0	224	4351	36890	4351	36666	0.0	0.11866579392352589
chr6	AL356534.1	127004184	127004398	51	215	4351	36890	4300	36675	0.2372093023255814	0.11724608043626449
chr6	AL356534.1	126894281	126894385	0	105	4351	36890	4351	36785	0.0	0.11828190838657061
chr6	AL356534.1	126910950	126911018	0	69	4351	36890	4351	36821	0.0	0.11816626381684366
chr6	AL356534.1	126701943	126702106	0	164	4351	36890	4351	36726	0.0	0.11847192724500354
chr6	AL356534.1	127000282	127000383	27	102	4351	36890	4324	36788	0.2647058823529412	0.11753832771555942
chr6	AL356534.1	126873151	126873270	0	120	4351	36890	4351	36770	0.0	0.1183301604568942
chr6	AL356534.1	127071011	127071086	0	76	4351	36890	4351	36814	0.0	0.11818873254740045
chr6	AL356534.1	127022010	127022081	0	72	4351	36890	4351	36818	0.0	0.11817589222662828
chr6	AL356534.1	127072001	127072119	0	119	4351	36890	4351	36771	0.0	0.11832694242745642
chr6	AL356534.1	126819391	126819514	0	124	4351	36890	4351	36766	0.0	0.11834303432519175
chr6	AL356534.1	127029088	127029121	0	34	4351	36890	4351	36856	0.0	0.1180540481875407
chr6	ECHDC1	127316449	127316502	0	54	0	5138	0	5084	0.0	0.0
chr6	ECHDC1	127330808	127331030	0	223	0	5138	0	4915	0.0	0.0
chr6	ECHDC1	127315134	127315138	0	5	0	5138	0	5133	0.0	0.0
chr6	ECHDC1	127331829	127331867	0	39	0	5138	0	5099	0.0	0.0
chr6	ECHDC1	127315933	127316081	0	149	0	5138	0	4989	0.0	0.0
chr6	ECHDC1	127315933	127315974	0	42	0	5138	0	5096	0.0	0.0
chr6	ECHDC1	127326495	127326574	0	80	0	5138	0	5058	0.0	0.0
chr6	ECHDC1	127341568	127341638	0	71	0	5138	0	5067	0.0	0.0
chr6	ECHDC1	127329821	127329882	0	62	0	5138	0	5076	0.0	0.0
chr6	KIAA0408	127451281	127451317	0	37	1020	8707	1020	8670	0.0	0.11764705882352941
chr6	SOGA3	127517518	127517766	918	249	1234	4333	316	4084	3.6867469879518073	0.07737512242899118
chr6	THEMIS	127829475	127829934	4182	460	8568	4317	4386	3857	9.091304347826087	1.1371532278973295
chr6	THEMIS	127900841	127901081	0	241	8568	4317	8568	4076	0.0	2.1020608439646713
chr6	THEMIS	127807215	127807332	0	118	8568	4317	8568	4199	0.0	2.0404858299595143
chr6	PTPRK	128322038	128322310	0	273	7632	7983	7632	7710	0.0	0.9898832684824903
chr6	PTPRK	127995248	127995266	0	19	7632	7983	7632	7964	0.0	0.958312405826218
chr6	PTPRK	128001195	128001207	0	13	7632	7983	7632	7970	0.0	0.9575909661229611
chr6	PTPRK	128003196	128003232	0	37	7632	7983	7632	7946	0.0	0.9604832620186258
chr6	PTPRK	128006025	128006055	0	31	7632	7983	7632	7952	0.0	0.959758551307847
chr6	PTPRK	128008045	128008087	0	43	7632	7983	7632	7940	0.0	0.9612090680100756
chr6	PTPRK	128491731	128491849	0	119	7632	7983	7632	7864	0.0	0.970498474059003
chr6	PTPRK	128409293	128409332	0	40	7632	7983	7632	7943	0.0	0.9608460279491376
chr6	AL356124.1	129532915	129532971	0	57	680	6842	680	6785	0.0	0.10022107590272661
chr6	AL356124.1	129546394	129546628	51	235	680	6842	629	6607	0.2170212765957447	0.09520205842288482
chr6	AL356124.1	129532915	129532969	0	55	680	6842	680	6787	0.0	0.10019154265507588
chr6	AL356124.1	129546394	129546492	17	99	680	6842	663	6743	0.1717171717171717	0.09832418804686341
chr6	AL355581.1	130143009	130143116	0	108	0	3172	0	3064	0.0	0.0
chr6	AL355581.1	130143749	130144051	0	303	0	3172	0	2869	0.0	0.0
chr6	SAMD3	130145339	130145422	0	84	66	6681	66	6597	0.0	0.010004547521600727
chr6	SAMD3	130221636	130221775	0	140	66	6681	66	6541	0.0	0.01009020027518728
chr6	EPB41L2	130865535	130865634	0	100	45	10058	45	9958	0.0	0.004518979714802169
chr6	EPB41L2	130867458	130867581	0	124	45	10058	45	9934	0.0	0.004529897322327361
chr6	EPB41L2	130869811	130870126	0	316	45	10058	45	9742	0.0	0.004619174707452269
chr6	EPB41L2	130869562	130870126	0	565	45	10058	45	9493	0.0	0.00474033498367218
chr6	EPB41L2	130880143	130880206	0	64	45	10058	45	9994	0.0	0.004502701620972584
chr6	EPB41L2	130872370	130872538	0	169	45	10058	45	9889	0.0	0.004550510668419456
chr6	EPB41L2	130876673	130876775	0	103	45	10058	45	9955	0.0	0.0045203415369161224
chr6	MED23	131615323	131615341	0	19	8011	7132	8011	7113	0.0	1.1262477154505834
chr6	VNN3	132726721	132727012	0	292	510	5404	510	5112	0.0	0.09976525821596244
chr6	VNN3	132728740	132728933	0	194	510	5404	510	5210	0.0	0.09788867562380038
chr6	VNN3	132728740	132728979	0	240	510	5404	510	5164	0.0	0.09876065065840434
chr6	VNN3	132726721	132726838	0	118	510	5404	510	5286	0.0	0.09648127128263337
chr6	VNN3	132731374	132731527	0	154	510	5404	510	5250	0.0	0.09714285714285714
chr6	VNN2	132752672	132752749	0	78	102	2606	102	2528	0.0	0.040348101265822785
chr6	VNN2	132752460	132752749	0	290	102	2606	102	2316	0.0	0.04404145077720207
chr6	VNN2	132752460	132752577	0	118	102	2606	102	2488	0.0	0.0409967845659164
chr6	VNN2	132755842	132756035	0	194	102	2606	102	2412	0.0	0.04228855721393035
chr6	VNN2	132751144	132751518	0	375	102	2606	102	2231	0.0	0.04571940833706858
chr6	VNN2	132751144	132751278	0	135	102	2606	102	2471	0.0	0.04127883447996762
chr6	VNN2	132753417	132753491	0	75	102	2606	102	2531	0.0	0.040300276570525484
chr6	VNN2	132760631	132760803	0	173	102	2606	102	2433	0.0	0.04192355117139334
chr6	SLC18B1	132790784	132790865	0	82	24463	2862	24463	2780	0.0	8.799640287769785
chr6	SLC18B1	132807043	132807168	0	126	24463	2862	24463	2736	0.0	8.941154970760234
chr6	AL591115.1	133092597	133092682	0	86	328	2024	328	1938	0.0	0.1692466460268318
chr6	TARID	133760184	133760260	0	77	0	8097	0	8020	0.0	0.0
chr6	TARID	133538071	133538192	0	122	0	8097	0	7975	0.0	0.0
chr6	TARID	133888603	133889212	0	610	0	8097	0	7487	0.0	0.0
chr6	TARID	133888603	133888743	0	141	0	8097	0	7956	0.0	0.0
chr6	TARID	133889125	133889212	0	88	0	8097	0	8009	0.0	0.0
chr6	TARID	133888603	133889430	0	828	0	8097	0	7269	0.0	0.0
chr6	SGK1	134173022	134173154	0	133	0	6257	0	6124	0.0	0.0
chr6	SGK1	134317391	134317542	0	152	0	6257	0	6105	0.0	0.0
chr6	CT69	134447933	134448001	0	69	306	3481	306	3412	0.0	0.08968347010550996
chr6	CT69	134447935	134448001	0	67	306	3481	306	3414	0.0	0.08963093145869948
chr6	CT69	134439059	134439175	0	117	306	3481	306	3364	0.0	0.09096313912009513
chr6	AL078590.2	134540574	134540623	0	50	431	3122	431	3072	0.0	0.14029947916666666
chr6	AL078590.2	134532033	134532090	39	58	431	3122	392	3064	0.6724137931034483	0.1279373368146214
chr6	AL078590.2	134532033	134532095	44	63	431	3122	387	3059	0.6984126984126984	0.12651193200392286
chr6	AL078590.2	134629872	134629958	0	87	431	3122	431	3035	0.0	0.14200988467874795
chr6	ALDH8A1	134929053	134929215	0	163	51	2824	51	2661	0.0	0.019165727170236752
chr6	ALDH8A1	134939265	134939415	0	151	51	2824	51	2673	0.0	0.019079685746352413
chr6	ALDH8A1	134940180	134940221	0	42	51	2824	51	2782	0.0	0.01833213515456506
chr6	HBS1L	135039572	135039767	0	196	0	10065	0	9869	0.0	0.0
chr6	HBS1L	135042000	135042126	0	127	0	10065	0	9938	0.0	0.0
chr6	HBS1L	135050581	135050647	0	67	0	10065	0	9998	0.0	0.0
chr6	HBS1L	135026853	135026863	0	11	0	10065	0	10054	0.0	0.0
chr6	HBS1L	135037810	135038026	0	217	0	10065	0	9848	0.0	0.0
chr6	AHI1	135290422	135290525	21437	104	48565	8731	27128	8627	206.125	3.144546192187319
chr6	AHI1	135323161	135323324	0	164	48565	8731	48565	8567	0.0	5.668845570211276
chr6	AHI1	135467580	135467634	0	55	48565	8731	48565	8676	0.0	5.5976256339326875
chr6	AHI1	135495813	135495898	0	86	48565	8731	48565	8645	0.0	5.617698091382302
chr6	AHI1	135497187	135497249	0	63	48565	8731	48565	8668	0.0	5.602791878172589
chr6	AHI1	135286398	135286548	7018	151	48565	8731	41547	8580	46.47682119205298	4.842307692307692
chr6	AHI1	135297431	135297492	507	62	48565	8731	48058	8669	8.17741935483871	5.543661321951782
chr6	AHI1	135435156	135435232	0	77	48565	8731	48565	8654	0.0	5.611855789230414
chr6	AL138828.1	136117069	136117172	0	104	0	7340	0	7236	0.0	0.0
chr6	AL138828.1	136162017	136162144	0	128	0	7340	0	7212	0.0	0.0
chr6	AL138828.1	136110995	136111101	0	107	0	7340	0	7233	0.0	0.0
chr6	AL138828.1	136097997	136098072	0	76	0	7340	0	7264	0.0	0.0
chr6	AL138828.1	136165511	136165665	0	155	0	7340	0	7185	0.0	0.0
chr6	AL138828.1	136166319	136166400	0	82	0	7340	0	7258	0.0	0.0
chr6	MTFR2	136249036	136249153	0	118	513	2171	513	2053	0.0	0.24987822698490014
chr6	MTFR2	136247460	136247560	0	101	513	2171	513	2070	0.0	0.24782608695652175
chr6	BCLAF1	136267028	136267175	0	148	4009	7393	4009	7245	0.0	0.5533471359558316
chr6	BCLAF1	136269140	136269303	0	164	4009	7393	4009	7229	0.0	0.5545718633282611
chr6	BCLAF1	136270322	136270383	84	62	4009	7393	3925	7331	1.3548387096774193	0.5353976265175283
chr6	BCLAF1	136273962	136274189	0	228	4009	7393	4009	7165	0.0	0.5595254710397767
chr6	BCLAF1	136276467	136276508	0	42	4009	7393	4009	7351	0.0	0.5453679771459665
chr6	MAP7	136383670	136383781	0	112	2027	5468	2027	5356	0.0	0.378454070201643
chr6	MAP7	136525831	136525971	0	141	2027	5468	2027	5327	0.0	0.3805143608034541
chr6	IL20RA	137011273	137011452	0	180	496	4311	496	4131	0.0	0.12006778019849915
chr6	IL22RA2	137147721	137147891	51	171	7131	2904	7080	2733	0.2982456140350877	2.5905598243688255
chr6	IL22RA2	137156758	137156854	0	97	7131	2904	7131	2807	0.0	2.540434627716423
chr6	IFNGR1	137209849	137209984	0	136	8577	2945	8577	2809	0.0	3.0533997864008544
chr6	IFNGR1	137209849	137209972	0	124	8577	2945	8577	2821	0.0	3.040411201701524
chr6	IFNGR1	137215266	137215377	26	112	8577	2945	8551	2833	0.23214285714285715	3.0183551006000706
chr6	LINC02539	137731211	137731245	0	35	0	1059	0	1024	0.0	0.0
chr6	NHSL1	138441982	138442114	0	133	357	8431	357	8298	0.0	0.04302241503976862
chr6	REPS1	138907494	138907600	0	107	1246	6039	1246	5932	0.0	0.2100472016183412
chr6	REPS1	138911275	138911371	0	97	1246	6039	1246	5942	0.0	0.20969370582295524
chr6	REPS1	138926400	138926481	561	82	1246	6039	685	5957	6.841463414634147	0.11499076716468021
chr6	REPS1	138943512	138943576	0	65	1246	6039	1246	5974	0.0	0.20857047204553064
chr6	REPS1	138926400	138926478	561	79	1246	6039	685	5960	7.10126582278481	0.11493288590604027
chr6	REPS1	138934224	138934326	0	103	1246	6039	1246	5936	0.0	0.2099056603773585
chr6	AL031772.1	139151080	139151275	1	196	4365	5167	4364	4971	0.00510204081632653	0.8778917722792194
chr6	AL031772.1	139201674	139201783	0	110	4365	5167	4365	5057	0.0	0.8631599762705161
chr6	AL031772.1	139237379	139237505	509	127	4365	5167	3856	5040	4.0078740157480315	0.765079365079365
chr6	AL031772.1	139203574	139203635	0	62	4365	5167	4365	5105	0.0	0.8550440744368266
chr6	AL158850.1	139268975	139269170	17870	196	27556	1908	9686	1712	91.1734693877551	5.6577102803738315
chr6	AL158850.1	139244594	139244690	0	97	27556	1908	27556	1811	0.0	15.21590281612369
chr6	AL158850.1	139251451	139251622	0	172	27556	1908	27556	1736	0.0	15.873271889400922
chr6	LINC01625	139443482	139443589	0	108	3820	7136	3820	7028	0.0	0.543540125213432
chr6	LINC01625	139470349	139470460	0	112	3820	7136	3820	7024	0.0	0.5438496583143508
chr6	AL359313.1	142596299	142596536	0	238	2400	2561	2400	2323	0.0	1.0331467929401636
chr6	HIVEP2	142783520	142783615	0	96	8511	10566	8511	10470	0.0	0.8128939828080229
chr6	LINC01277	142986044	142986130	0	87	0	4191	0	4104	0.0	0.0
chr6	LINC01277	142985468	142985581	0	114	0	4191	0	4077	0.0	0.0
chr6	LINC01277	142970987	142971041	0	55	0	4191	0	4136	0.0	0.0
chr6	LINC01277	143022823	143023115	0	293	0	4191	0	3898	0.0	0.0
chr6	PHACTR2-AS1	143557530	143557741	0	212	0	2119	0	1907	0.0	0.0
chr6	PLAGL1	143947984	143948460	0	477	1173	8363	1173	7886	0.0	0.14874461070251077
chr6	PLAGL1	143964786	143966230	0	1445	1173	8363	1173	6918	0.0	0.16955767562879445
chr6	PLAGL1	143964786	143964818	0	33	1173	8363	1173	8330	0.0	0.14081632653061224
chr6	PLAGL1	143966157	143966198	0	42	1173	8363	1173	8321	0.0	0.14096863357769499
chr6	PLAGL1	143985134	143985174	0	41	1173	8363	1173	8322	0.0	0.14095169430425378
chr6	PLAGL1	143965179	143965303	0	125	1173	8363	1173	8238	0.0	0.1423889293517844
chr6	PLAGL1	143965179	143965279	0	101	1173	8363	1173	8262	0.0	0.1419753086419753
chr6	PLAGL1	143960468	143960556	0	89	1173	8363	1173	8274	0.0	0.14176939811457578
chr6	PLAGL1	143965849	143966198	0	350	1173	8363	1173	8013	0.0	0.1463871209284912
chr6	PLAGL1	143965107	143965313	0	207	1173	8363	1173	8156	0.0	0.14382050024521825
chr6	PLAGL1	143960468	143960542	0	75	1173	8363	1173	8288	0.0	0.14152992277992277
chr6	PLAGL1	143966157	143966212	0	56	1173	8363	1173	8307	0.0	0.14120621162874683
chr6	PLAGL1	143966157	143966285	0	129	1173	8363	1173	8234	0.0	0.1424581005586592
chr6	PLAGL1	143966157	143966230	0	74	1173	8363	1173	8289	0.0	0.14151284835323924
chr6	EPM2A	145686121	145686296	0	176	0	17587	0	17411	0.0	0.0
chr6	EPM2A	145635244	145635486	0	243	0	17587	0	17344	0.0	0.0
chr6	EPM2A	145720900	145721155	0	256	0	17587	0	17331	0.0	0.0
chr6	EPM2A	145671238	145671399	0	162	0	17587	0	17425	0.0	0.0
chr6	SHPRH	145951790	145951923	0	134	3736	17722	3736	17588	0.0	0.2124175574255174
chr6	STXBP5-AS1	146860617	146860743	0	127	683	11664	683	11537	0.0	0.05920083210540002
chr6	STXBP5-AS1	146911551	146911665	0	115	683	11664	683	11549	0.0	0.05913931942159494
chr6	STXBP5-AS1	146911551	146911663	0	113	683	11664	683	11551	0.0	0.05912907973335642
chr6	STXBP5-AS1	146858222	146858416	0	195	683	11664	683	11469	0.0	0.05955183538233499
chr6	STXBP5-AS1	147001440	147001543	0	104	683	11664	683	11560	0.0	0.059083044982698965
chr6	STXBP5-AS1	146850824	146851331	0	508	683	11664	683	11156	0.0	0.06122266045177483
chr6	STXBP5-AS1	146972044	146972070	0	27	683	11664	683	11637	0.0	0.05869210277562946
chr6	STXBP5-AS1	146864383	146864602	0	220	683	11664	683	11444	0.0	0.05968192939531632
chr6	STXBP5-AS1	147074804	147074847	0	44	683	11664	683	11620	0.0	0.058777969018932875
chr6	STXBP5-AS1	147108471	147108610	0	140	683	11664	683	11524	0.0	0.05926761541131551
chr6	STXBP5-AS1	147170012	147170083	0	72	683	11664	683	11592	0.0	0.05891994478951001
chr6	STXBP5-AS1	146857115	146857235	0	121	683	11664	683	11543	0.0	0.05917005977648791
chr6	STXBP5-AS1	146962390	146962566	0	177	683	11664	683	11487	0.0	0.05945851832506312
chr6	KATNA1	149597062	149597189	0	128	3687	2267	3687	2139	0.0	1.723702664796634
chr6	KATNA1	149604660	149604782	28	123	3687	2267	3659	2144	0.22764227642276422	1.7066231343283582
chr6	KATNA1	149603267	149603373	0	107	3687	2267	3687	2160	0.0	1.7069444444444444
chr6	LATS1	149701778	149702266	0	489	3070	8502	3070	8013	0.0	0.383127417945838
chr6	LATS1	149697091	149697186	0	96	3070	8502	3070	8406	0.0	0.3652153223887699
chr6	NUP43	149738642	149738778	0	137	28112	4429	28112	4292	0.0	6.549860205032619
chr6	NUP43	149742389	149742570	0	182	28112	4429	28112	4247	0.0	6.619260654579703
chr6	NUP43	149736470	149736622	0	153	28112	4429	28112	4276	0.0	6.574368568755847
chr6	RMND1	151422540	151422605	0	66	1072083	4190	1072083	4124	0.0	259.9619301648885
chr6	RMND1	151427481	151427582	0	102	1072083	4190	1072083	4088	0.0	262.2512230919765
chr6	RMND1	151445307	151445825	0	519	1072083	4190	1072083	3671	0.0	292.0411332062108
chr6	RMND1	151408642	151408900	0	259	1072083	4190	1072083	3931	0.0	272.7252607479013
chr6	SYNE1	152130719	152130778	0	60	534	42788	534	42728	0.0	0.012497659614304437
chr6	SYNE1	152300640	152300781	0	142	534	42788	534	42646	0.0	0.012521690193687568
chr6	SYNE1	152368971	152369127	0	157	534	42788	534	42631	0.0	0.012526096033402923
chr6	SYNE1	152456667	152456802	0	136	534	42788	534	42652	0.0	0.012519928725499391
chr6	SYNE1	152498741	152498792	0	52	534	42788	534	42736	0.0	0.012495320104829653
chr6	SYNE1	152145486	152145555	0	70	534	42788	534	42718	0.0	0.012500585233391077
chr6	SYNE1	152318080	152318263	0	184	534	42788	534	42604	0.0	0.012534034362970613
chr6	SYNE1	152359314	152359458	0	145	534	42788	534	42643	0.0	0.01252257111366461
chr6	SYNE1	152455885	152456044	0	160	534	42788	534	42628	0.0	0.012526977573425918
chr6	SYNE1	152511570	152511591	0	22	534	42788	534	42766	0.0	0.012486554739746528
chr6	SYNE1	152347058	152347235	0	178	534	42788	534	42610	0.0	0.012532269420323868
chr6	SYNE1	152350167	152350335	0	169	534	42788	534	42619	0.0	0.012529622938126189
chr6	SYNE1	152136272	152136314	0	43	534	42788	534	42745	0.0	0.012492689203415603
chr6	SYNE1	152319898	152320216	0	319	534	42788	534	42469	0.0	0.012573877416468484
chr6	SYNE1	152542159	152542240	0	82	534	42788	534	42706	0.0	0.012504097784854586
chr6	LINC02840	152831052	152831268	0	217	0	8955	0	8738	0.0	0.0
chr6	LINC02840	152765987	152766062	0	76	0	8955	0	8879	0.0	0.0
chr6	MTRF1L	152991184	152991321	0	138	0	4304	0	4166	0.0	0.0
chr6	CNKSR3	154422914	154422983	0	70	255	21595	255	21525	0.0	0.011846689895470384
chr6	IPCEF1	154306694	154306762	0	69	51	3968	51	3899	0.0	0.013080276994101052
chr6	SERAC1	158117726	158117821	0	96	153	9775	153	9679	0.0	0.015807418121706787
chr6	SERAC1	158128107	158128270	0	164	153	9775	153	9611	0.0	0.015919259182187076
chr6	SERAC1	158130372	158130486	0	115	153	9775	153	9660	0.0	0.015838509316770187
chr6	SERAC1	158146781	158146913	0	133	153	9775	153	9642	0.0	0.015868077162414437
chr6	SERAC1	158148864	158148954	0	91	153	9775	153	9684	0.0	0.015799256505576207
chr6	SERAC1	158155314	158155351	0	38	153	9775	153	9737	0.0	0.015713258703912908
chr6	SERAC1	158117531	158117575	0	45	153	9775	153	9730	0.0	0.015724563206577596
chr6	SERAC1	158162147	158162152	0	6	153	9775	153	9769	0.0	0.01566178728631385
chr6	SERAC1	158150452	158150587	0	136	153	9775	153	9639	0.0	0.015873015873015872
chr6	TAGAP	159042077	159042244	5911	168	106518	4099	100607	3931	35.18452380952381	25.593233273976086
chr6	SOD2	159684853	159685033	0	181	28748	6793	28748	6612	0.0	4.347852389594676
chr6	SOD2	159688125	159688242	0	118	28748	6793	28748	6675	0.0	4.306816479400749
chr6	TCP1	159779626	159779790	0	165	0	4725	0	4560	0.0	0.0
chr6	TCP1	159785899	159785997	0	99	0	4725	0	4626	0.0	0.0
chr6	TCP1	159788057	159788143	0	87	0	4725	0	4638	0.0	0.0
chr6	TCP1	159787742	159787871	0	130	0	4725	0	4595	0.0	0.0
chr6	TCP1	159785899	159786020	0	122	0	4725	0	4603	0.0	0.0
chr6	TCP1	159788609	159788696	0	88	0	4725	0	4637	0.0	0.0
chr6	SLC22A2	160256613	160256717	0	105	9727	4746	9727	4641	0.0	2.0958845076492136
chr6	LPAL2	160467540	160467719	111568	180	886038	4767	774470	4587	619.8222222222222	168.84020056681928
chr6	LPAL2	160491362	160491520	87	159	886038	4767	885951	4608	0.5471698113207547	192.263671875
chr6	AL391361.2	160900223	160900399	0	177	0	897	0	720	0.0	0.0
chr6	AGPAT4	161166247	161166417	0	171	0	14246	0	14075	0.0	0.0
chr6	AGPAT4	161165576	161165713	0	138	0	14246	0	14108	0.0	0.0
chr6	PRKN	161360087	161360205	0	119	397	12056	397	11937	0.0	0.03325793750523582
chr6	PRKN	162054090	162054174	0	85	397	12056	397	11971	0.0	0.033163478406148195
chr6	PRKN	162201130	162201252	0	123	397	12056	397	11933	0.0	0.033269085728651636
chr6	PRKN	162262524	162262765	51	242	397	12056	346	11814	0.21074380165289255	0.029287286270526493
chr6	PRKN	162443309	162443473	0	165	397	12056	397	11891	0.0	0.03338659490370869
chr6	PRKN	161442893	161442979	0	87	397	12056	397	11969	0.0	0.03316901996825131
chr6	PRKN	162695037	162695066	0	30	397	12056	397	12026	0.0	0.03301180774987527
chr6	PACRG-AS2	163044648	163044746	0	99	0	1548	0	1449	0.0	0.0
chr6	PACRG-AS3	163187672	163187850	0	179	204	8368	204	8189	0.0	0.02491146660153865
chr6	PACRG-AS3	163183974	163184142	0	169	204	8368	204	8199	0.0	0.024881083058909622
chr6	PACRG-AS3	163187672	163187933	0	262	204	8368	204	8106	0.0	0.025166543301258327
chr6	PACRG-AS3	163187672	163187962	0	291	204	8368	204	8077	0.0	0.025256902315216045
chr6	PACRG-AS3	163188463	163188595	0	133	204	8368	204	8235	0.0	0.02477231329690346
chr6	AL450345.2	164815159	164815236	0	78	0	3937	0	3859	0.0	0.0
chr6	AL450345.2	164813831	164814042	0	212	0	3937	0	3725	0.0	0.0
chr6	AL450345.2	164806065	164806198	0	134	0	3937	0	3803	0.0	0.0
chr6	PDE10A	165454577	165454695	0	119	264	23062	264	22943	0.0	0.01150677766639062
chr6	PDE10A	165482314	165482343	0	30	264	23062	264	23032	0.0	0.011462313303230288
chr6	PDE10A	165576411	165576449	0	39	264	23062	264	23023	0.0	0.011466794075489728
chr6	PDE10A	165466419	165466532	0	114	264	23062	264	22948	0.0	0.011504270524664458
chr6	PDE10A	165418352	165418507	0	156	264	23062	264	22906	0.0	0.01152536453331005
chr6	PDE10A	165418352	165418551	0	200	264	23062	264	22862	0.0	0.01154754614644388
chr6	PDE10A	165828529	165828701	0	173	264	23062	264	22889	0.0	0.011533924592599065
chr6	PDE10A	165711018	165711153	0	136	264	23062	264	22926	0.0	0.011515310128238681
chr6	TBXT	166162446	166162623	0	178	0	2612	0	2434	0.0	0.0
chr6	TBXT	166162446	166162620	0	175	0	2612	0	2437	0.0	0.0
chr6	MPC1	166366968	166367184	307	217	307	1554	0	1337	1.4147465437788018	0.0
chr6	RPS6KA2	166770862	166770913	0	52	1864	8285	1864	8233	0.0	0.22640592736548038
chr6	RNASET2	166955494	166955627	0	134	483	14460	483	14326	0.0	0.033714923914560935
chr6	TCP10L3	167376545	167376704	1209	160	23875	8397	22666	8237	7.55625	2.7517299987859656
chr6	TCP10L3	167384165	167384215	0	51	23875	8397	23875	8346	0.0	2.8606518092499402
chr6	FRMD1	168062670	168062739	0	70	0	7718	0	7648	0.0	0.0
chr6	FRMD1	168057504	168057723	0	220	0	7718	0	7498	0.0	0.0
chr6	FRMD1	168067068	168067129	0	62	0	7718	0	7656	0.0	0.0
chr6	LINC01615	169161067	169161214	0	148	51	2249	51	2101	0.0	0.02427415516420752
chr6	LINC01615	169159044	169159136	0	93	51	2249	51	2156	0.0	0.02365491651205937
chr6	THBS2	169234733	169234907	0	175	2550	5550	2550	5375	0.0	0.4744186046511628
chr6	THBS2	169237624	169237795	0	172	2550	5550	2550	5378	0.0	0.4741539605801413
chr6	THBS2	169237609	169237795	0	187	2550	5550	2550	5363	0.0	0.47548014171172853
chr6	WDR27	169458220	169458464	0	245	16846	10533	16846	10288	0.0	1.6374416796267497
chr6	WDR27	169613558	169613656	329	99	16846	10533	16517	10434	3.323232323232323	1.5829978915085299
chr6	WDR27	169572418	169572540	1122	123	16846	10533	15724	10410	9.121951219512194	1.5104707012487992
chr6	WDR27	169636370	169636504	218	135	16846	10533	16628	10398	1.614814814814815	1.599153683400654
chr6	WDR27	169659085	169659207	0	123	16846	10533	16846	10410	0.0	1.6182516810758885
chr6	WDR27	169659450	169659518	0	69	16846	10533	16846	10464	0.0	1.609900611620795
chr6	WDR27	169667981	169668185	0	205	16846	10533	16846	10328	0.0	1.6310999225406662
chr6	WDR27	169689126	169689308	0	183	16846	10533	16846	10350	0.0	1.6276328502415458
chr6	WDR27	169665485	169665556	0	72	16846	10533	16846	10461	0.0	1.610362298059459
chr6	WDR27	169638538	169638660	0	123	16846	10533	16846	10410	0.0	1.6182516810758885
chr6	WDR27	169667135	169668776	0	1642	16846	10533	16846	8891	0.0	1.894725002811832
chr6	WDR27	169663562	169663649	0	88	16846	10533	16846	10445	0.0	1.6128291048348493
chr6	WDR27	169667135	169667187	0	53	16846	10533	16846	10480	0.0	1.6074427480916031
chr6	WDR27	169663562	169663878	0	317	16846	10533	16846	10216	0.0	1.648981989036805
chr6	WDR27	169663562	169663706	0	145	16846	10533	16846	10388	0.0	1.6216788602233345
chr6	WDR27	169670568	169670693	0	126	16846	10533	16846	10407	0.0	1.618718170462189
chr6	WDR27	169667981	169668095	0	115	16846	10533	16846	10418	0.0	1.6170090228450757
chr6	PHF10	169714732	169714842	0	111	0	5914	0	5803	0.0	0.0
chr6	PDCD2	170580001	170580105	51	105	51	5759	0	5654	0.4857142857142857	0.0
chr7	AC093627.4	152440	152547	4117	108	143313	3520	139196	3412	38.120370370370374	40.79601406799531
chr7	AC093627.4	151810	151995	529	186	143313	3520	142784	3334	2.8440860215053765	42.826634673065385
chr7	DNAAF5	729662	729847	0	186	70436	7106	70436	6920	0.0	10.178612716763006
chr7	DNAAF5	729724	729847	0	124	70436	7106	70436	6982	0.0	10.088226869091951
chr7	SUN1	832504	832601	51	98	268134	10878	268083	10780	0.5204081632653061	24.868552875695734
chr7	SUN1	817279	817499	1981	221	268134	10878	266153	10657	8.963800904977376	24.974476869663132
chr7	SUN1	854919	855006	112	88	268134	10878	268022	10790	1.2727272727272727	24.83985171455051
chr7	SUN1	832019	832101	1043	83	268134	10878	267091	10795	12.566265060240964	24.742102825382123
chr7	SUN1	851383	851482	0	100	268134	10878	268134	10778	0.0	24.87789942475413
chr7	SUN1	848417	848615	0	199	268134	10878	268134	10679	0.0	25.10853076130724
chr7	SUN1	849922	850033	0	112	268134	10878	268134	10766	0.0	24.905628831506593
chr7	SUN1	849519	849603	3	85	268134	10878	268131	10793	0.03529411764705882	24.843046418975263
chr7	GPER1	1088197	1088321	828	125	28926	2840	28098	2715	6.624	10.349171270718232
chr7	ZFAND2A-DT	1163451	1163495	0	45	897	2348	897	2303	0.0	0.3894919669995658
chr7	ZFAND2A-DT	1162961	1163217	0	257	897	2348	897	2091	0.0	0.42898134863701576
chr7	ZFAND2A-DT	1162961	1163495	0	535	897	2348	897	1813	0.0	0.4947600661886376
chr7	ZFAND2A-DT	1162961	1163207	0	247	897	2348	897	2101	0.0	0.42693955259400285
chr7	PSMG3-AS1	1583161	1583269	0	109	7766	5168	7766	5059	0.0	1.5350859853726033
chr7	PSMG3-AS1	1579286	1579404	0	119	7766	5168	7766	5049	0.0	1.5381263616557734
chr7	EIF3B	2366524	2366591	0	68	8419	6692	8419	6624	0.0	1.2709842995169083
chr7	IQCE	2567115	2567163	699	49	97738	9142	97039	9093	14.26530612244898	10.671835477840096
chr7	IQCE	2568953	2568999	0	47	97738	9142	97738	9095	0.0	10.746344145134689
chr7	IQCE	2572713	2572821	612	109	97738	9142	97126	9033	5.614678899082569	10.752352485331562
chr7	TTYH3	2647958	2648054	0	97	25969	6110	25969	6013	0.0	4.318809246632297
chr7	TTYH3	2659939	2660040	0	102	25969	6110	25969	6008	0.0	4.322403462050599
chr7	AMZ1	2709074	2709244	510	171	211395	6968	210885	6797	2.982456140350877	31.02618802412829
chr7	SDK1	4175774	4175834	0	61	153	12307	153	12246	0.0	0.012493875551200392
chr7	AP5Z1	4781174	4781312	0	139	107876	8341	107876	8202	0.0	13.152401853206536
chr7	AP5Z1	4781567	4781754	1032	188	107876	8341	106844	8153	5.48936170212766	13.104869373236845
chr7	AP5Z1	4790458	4790591	0	134	107876	8341	107876	8207	0.0	13.144388936273913
chr7	RNF216P1	4986566	4986631	0	66	1139	3552	1139	3486	0.0	0.32673551348250146
chr7	RNF216P1	4989062	4989177	0	116	1139	3552	1139	3436	0.0	0.33149010477299184
chr7	RNF216P1	4981640	4981857	0	218	1139	3552	1139	3334	0.0	0.3416316736652669
chr7	RNF216P1	4995474	4995582	44	109	1139	3552	1095	3443	0.4036697247706422	0.31803659599186757
chr7	RNF216P1	4989033	4989177	0	145	1139	3552	1139	3407	0.0	0.3343117111828588
chr7	RBAK	5063694	5063755	0	62	28326	6964	28326	6902	0.0	4.104027818023761
chr7	WIPI2	5193117	5193171	0	55	22245	7716	22245	7661	0.0	2.9036679284688685
chr7	ZNF815P	5831180	5831283	0	104	100	2310	100	2206	0.0	0.04533091568449683
chr7	ZNF815P	5839069	5839204	0	136	100	2310	100	2174	0.0	0.045998160073597055
chr7	CCZ1	5900472	5900566	0	95	482	4269	482	4174	0.0	0.11547676090081456
chr7	AIMP2	6015145	6015352	1963	208	82851	1834	80888	1626	9.4375	49.74661746617466
chr7	AIMP2	6012678	6013140	79998	463	82851	1834	2853	1371	172.78185745140388	2.0809628008752736
chr7	USP42	6115322	6115523	0	202	16583	7092	16583	6890	0.0	2.406821480406386
chr7	USP42	6128137	6128230	0	94	16583	7092	16583	6998	0.0	2.3696770505858815
chr7	USP42	6111796	6111951	23	156	16583	7092	16560	6936	0.14743589743589744	2.387543252595156
chr7	RAC1	6398661	6398718	0	58	169	3109	169	3051	0.0	0.05539167486070141
chr7	ZDHHC4	6577589	6577720	0	132	0	3565	0	3433	0.0	0.0
chr7	C7ORF26	6602663	6602752	37	90	37	2732	0	2642	0.4111111111111111	0.0
chr7	PMS2CL	6730633	6730727	894	95	38037	3894	37143	3799	9.410526315789474	9.777046591208213
chr7	PMS2CL	6740173	6740324	3623	152	38037	3894	34414	3742	23.835526315789473	9.19668626402993
chr7	RSPH10B2	6765705	6765791	0	87	50333	4899	50333	4812	0.0	10.459891936824604
chr7	RSPH10B2	6780808	6780888	0	81	50333	4899	50333	4818	0.0	10.446865919468658
chr7	RSPH10B2	6786877	6787021	51	145	50333	4899	50282	4754	0.35172413793103446	10.576777450567942
chr7	RSPH10B2	6791903	6791997	11244	95	50333	4899	39089	4804	118.3578947368421	8.13676103247294
chr7	RSPH10B2	6779609	6779724	0	116	50333	4899	50333	4783	0.0	10.523311729040351
chr7	MIOS	7568025	7568123	0	99	25795	6728	25795	6629	0.0	3.891235480464625
chr7	MIOS	7567606	7567688	0	83	25795	6728	25795	6645	0.0	3.8818660647103087
chr7	UMAD1	7676101	7676208	2446	108	2546	3764	100	3656	22.64814814814815	0.02735229759299781
chr7	UMAD1	7868329	7868608	0	280	2546	3764	2546	3484	0.0	0.7307692307692307
chr7	UMAD1	7868329	7868533	0	205	2546	3764	2546	3559	0.0	0.715369485810621
chr7	UMAD1	7738710	7738891	0	182	2546	3764	2546	3582	0.0	0.7107761027359017
chr7	GLCCI1	8084896	8085017	51	122	174	6051	123	5929	0.4180327868852459	0.02074548827795581
chr7	GLCCI1	8022482	8022569	0	88	174	6051	174	5963	0.0	0.02917994298172061
chr7	AC060834.2	9757673	9757898	0	226	0	1505	0	1279	0.0	0.0
chr7	AC010991.1	9984404	9984439	0	36	0	1562	0	1526	0.0	0.0
chr7	PHF14	10982371	10983159	51	789	21544	9108	21493	8319	0.06463878326996197	2.5836037985334777
chr7	AC004160.1	11240536	11240731	41	196	41	5088	0	4892	0.20918367346938777	0.0
chr7	TMEM106B	12215603	12215804	0	202	0	13848	0	13646	0.0	0.0
chr7	TMEM106B	12214200	12214394	0	195	0	13848	0	13653	0.0	0.0
chr7	AC013470.2	12522970	12523426	0	457	1756	3214	1756	2757	0.0	0.636924192963366
chr7	AC013470.2	12525819	12525904	0	86	1756	3214	1756	3128	0.0	0.5613810741687979
chr7	SCIN	12571544	12571625	0	82	0	11649	0	11567	0.0	0.0
chr7	SCIN	12644137	12644315	0	179	0	11649	0	11470	0.0	0.0
chr7	SCIN	12577541	12577759	0	219	0	11649	0	11430	0.0	0.0
chr7	SCIN	12596269	12596426	0	158	0	11649	0	11491	0.0	0.0
chr7	ARL4A	12687634	12687728	0	95	0	3588	0	3493	0.0	0.0
chr7	AC011287.1	13636645	13636732	0	88	8	12535	8	12447	0.0	0.0006427251546557404
chr7	AC011287.1	13702315	13702376	0	62	8	12535	8	12473	0.0	0.000641385392447687
chr7	AC011287.1	13172678	13172743	0	66	8	12535	8	12469	0.0	0.0006415911460421846
chr7	CRPPA-AS1	16237308	16237410	0	103	0	2784	0	2681	0.0	0.0
chr7	CRPPA-AS1	16216332	16216569	0	238	0	2784	0	2546	0.0	0.0
chr7	CRPPA-AS1	16216383	16216569	0	187	0	2784	0	2597	0.0	0.0
chr7	CRPPA-AS1	16235901	16235979	0	79	0	2784	0	2705	0.0	0.0
chr7	LRRC72	16532670	16532821	0	152	0	1452	0	1300	0.0	0.0
chr7	BZW2	16685904	16686040	3437	137	9881	3675	6444	3538	25.087591240875913	1.821368004522329
chr7	BZW2	16694833	16695004	0	172	9881	3675	9881	3503	0.0	2.8207250927776193
chr7	BZW2	16665436	16665501	0	66	9881	3675	9881	3609	0.0	2.7378775284012193
chr7	BZW2	16685923	16686040	443	118	9881	3675	9438	3557	3.7542372881355934	2.6533595726736015
chr7	HDAC9	18395114	18395183	0	70	782	16740	782	16670	0.0	0.04691061787642471
chr7	HDAC9	18502580	18502639	0	60	782	16740	782	16680	0.0	0.04688249400479616
chr7	HDAC9	18629349	18629481	0	133	782	16740	782	16607	0.0	0.04708857710603962
chr7	AC005083.1	20217787	20217858	0	72	0	906	0	834	0.0	0.0
chr7	AC099342.1	20300058	20300226	0	169	0	2149	0	1980	0.0	0.0
chr7	SP4	21428676	21428792	0	117	1479	6231	1479	6114	0.0	0.24190382728164866
chr7	SP4	21429288	21430843	0	1556	1479	6231	1479	4675	0.0	0.31636363636363635
chr7	DNAH11	21564185	21564397	0	213	76	16261	76	16048	0.0	0.004735792622133599
chr7	DNAH11	21681678	21681684	0	7	76	16261	76	16254	0.0	0.004675772117632582
chr7	DNAH11	21681721	21681727	0	7	76	16261	76	16254	0.0	0.004675772117632582
chr7	IL6	22727443	22727634	43	192	51	2074	8	1882	0.22395833333333334	0.004250797024442083
chr7	IL6	22727512	22727634	0	123	51	2074	51	1951	0.0	0.026140440799589954
chr7	SNHG26	22856972	22857016	487	45	152555	5723	152068	5678	10.822222222222223	26.7819654808031
chr7	SNHG26	22858570	22858830	1479	261	152555	5723	151076	5462	5.666666666666667	27.65946539729037
chr7	SNHG26	22858570	22858795	1341	226	152555	5723	151214	5497	5.933628318584071	27.50845915954157
chr7	KLHL7	23117833	23117964	0	132	16209	7081	16209	6949	0.0	2.332565836811052
chr7	KLHL7	23123776	23123879	0	104	16209	7081	16209	6977	0.0	2.32320481582342
chr7	NUP42	23185069	23185298	11	230	6885	3660	6874	3430	0.04782608695652174	2.0040816326530613
chr7	NUP42	23197172	23197230	0	59	6885	3660	6885	3601	0.0	1.9119688975284643
chr7	NUP42	23197172	23197247	0	76	6885	3660	6885	3584	0.0	1.9210379464285714
chr7	GPNMB	23261481	23261565	0	85	9312	5924	9312	5839	0.0	1.5947936290460696
chr7	CCDC126	23597966	23598051	0	86	1071	3555	1071	3469	0.0	0.3087345056212165
chr7	CCDC126	23604085	23604279	51	195	1071	3555	1020	3360	0.26153846153846155	0.30357142857142855
chr7	FAM221A	23684498	23684672	0	175	1331	5529	1331	5354	0.0	0.24859917818453492
chr7	FAM221A	23686288	23688987	51	2700	1331	5529	1280	2829	0.01888888888888889	0.4524566984800283
chr7	FAM221A	23692182	23692253	0	72	1331	5529	1331	5457	0.0	0.24390690855781566
chr7	FAM221A	23688227	23688323	0	97	1331	5529	1331	5432	0.0	0.24502945508100146
chr7	FAM221A	23698191	23698299	0	109	1331	5529	1331	5420	0.0	0.2455719557195572
chr7	STK31	23815143	23815212	0	70	22765	5113	22765	5043	0.0	4.514178068609954
chr7	NPY	24284874	24285076	0	203	0	898	0	695	0.0	0.0
chr7	MPP6	24623662	24623784	51	123	52431	9386	52380	9263	0.4146341463414634	5.65475547878657
chr7	MPP6	24623665	24623784	51	120	52431	9386	52380	9266	0.425	5.652924670839629
chr7	MPP6	24620051	24620220	0	170	52431	9386	52431	9216	0.0	5.689127604166667
chr7	MPP6	24624061	24624156	0	96	52431	9386	52431	9290	0.0	5.643810548977395
chr7	MPP6	24666864	24666982	0	119	52431	9386	52431	9267	0.0	5.6578180640984135
chr7	SNX10	26357006	26357127	0	122	2755	3619	2755	3497	0.0	0.7878181298255648
chr7	SNX10	26354056	26354184	0	129	2755	3619	2755	3490	0.0	0.7893982808022922
chr7	AC004540.1	26440369	26440505	0	137	477	6357	477	6220	0.0	0.07668810289389068
chr7	AC004540.1	26412184	26412239	324	56	477	6357	153	6301	5.785714285714286	0.024281860022218694
chr7	AC004540.1	26403395	26403517	0	123	477	6357	477	6234	0.0	0.07651588065447545
chr7	AC004540.1	26440312	26440505	0	194	477	6357	477	6163	0.0	0.07739737141002759
chr7	AC004540.1	26495808	26495881	0	74	477	6357	477	6283	0.0	0.07591914690434506
chr7	AC004540.1	26492832	26493023	0	192	477	6357	477	6165	0.0	0.07737226277372262
chr7	AC004947.1	26554808	26554919	0	112	2	2731	2	2619	0.0	0.0007636502481863307
chr7	HOTAIRM1	27099097	27099366	0	270	0	1243	0	973	0.0	0.0
chr7	HOTAIRM1	27099073	27099366	0	294	0	1243	0	949	0.0	0.0
chr7	HOXA-AS2	27109194	27109263	0	70	1908	4914	1908	4844	0.0	0.3938893476465731
chr7	HOXA10-AS	27169306	27169764	0	459	5521	1657	5521	1198	0.0	4.608514190317195
chr7	HOXA11-AS	27186108	27186263	0	156	204	3018	204	2862	0.0	0.07127882599580712
chr7	HOXA11-AS	27186071	27186263	0	193	204	3018	204	2825	0.0	0.07221238938053097
chr7	HOXA11-AS	27186682	27186891	0	210	204	3018	204	2808	0.0	0.07264957264957266
chr7	EVX1	27244466	27244518	0	53	0	3173	0	3120	0.0	0.0
chr7	AC004009.1	27384402	27384636	0	235	3	1330	3	1095	0.0	0.0027397260273972603
chr7	TAX1BP1	27765833	27766021	0	189	26589	9188	26589	8999	0.0	2.954661629069897
chr7	TAX1BP1	27803108	27803180	0	73	26589	9188	26589	9115	0.0	2.9170597915523864
chr7	JAZF1-AS1	28217242	28217349	0	108	0	4249	0	4141	0.0	0.0
chr7	JAZF1-AS1	28239731	28240106	0	376	0	4249	0	3873	0.0	0.0
chr7	JAZF1-AS1	28217242	28217344	0	103	0	4249	0	4146	0.0	0.0
chr7	CREB5	28818760	28818789	0	30	51	11466	51	11436	0.0	0.004459601259181532
chr7	CHN2	29146848	29146960	0	113	54	6384	54	6271	0.0	0.00861106681549992
chr7	CHN2	29480278	29480356	0	79	54	6384	54	6305	0.0	0.008564631245043617
chr7	CHN2	29499866	29500040	0	175	54	6384	54	6209	0.0	0.008697052665485585
chr7	CHN2	29507227	29507365	0	139	54	6384	54	6245	0.0	0.008646917534027222
chr7	AC005232.1	29126855	29126939	0	85	0	1148	0	1063	0.0	0.0
chr7	AC005232.1	29127453	29127579	0	127	0	1148	0	1021	0.0	0.0
chr7	CHN2	29292924	29292963	0	40	54	6384	54	6344	0.0	0.008511979823455234
chr7	CHN2	29509300	29509406	0	107	54	6384	54	6277	0.0	0.008602835749561893
chr7	FKBP14-AS1	29988889	29989224	0	336	4192	2840	4192	2504	0.0	1.6741214057507987
chr7	PLEKHA8	30074070	30074132	0	63	55324	10896	55324	10833	0.0	5.106987907320225
chr7	MTURN	30146176	30146299	0	124	16998	6361	16998	6237	0.0	2.7253487253487254
chr7	GARS1	30626233	30626319	88	87	127003	11228	126915	11141	1.0114942528735633	11.39170631002603
chr7	GARS1	30631447	30631541	2729	95	127003	11228	124274	11133	28.726315789473684	11.162669541004222
chr7	GARS1	30598795	30598897	561	103	127003	11228	126442	11125	5.446601941747573	11.365573033707864
chr7	GARS1	30595823	30595933	1063	111	127003	11228	125940	11117	9.576576576576576	11.328595844202573
chr7	GARS1	30613444	30613597	4273	154	127003	11228	122730	11074	27.746753246753247	11.082716272349648
chr7	GARS1	30606325	30606397	867	73	127003	11228	126136	11155	11.876712328767123	11.307575078440161
chr7	GARS1	30599423	30599545	1803	123	127003	11228	125200	11105	14.658536585365853	11.274200810445745
chr7	GARS1	30608407	30608483	1459	77	127003	11228	125544	11151	18.948051948051948	11.258541834813022
chr7	GARS1	30631447	30631559	3023	113	127003	11228	123980	11115	26.75221238938053	11.15429599640126
chr7	GARS1	30627056	30627190	2888	135	127003	11228	124115	11093	21.392592592592592	11.188587397457857
chr7	GARS1	30595107	30595143	238	37	127003	11228	126765	11191	6.4324324324324325	11.327405951210794
chr7	INMT-MINDY4	30766344	30766561	0	218	28	2900	28	2682	0.0	0.010439970171513796
chr7	GHRHR	30973984	30974138	0	155	647	3152	647	2997	0.0	0.21588254921588254
chr7	GHRHR	30977280	30977322	0	43	647	3152	647	3109	0.0	0.2081055001608234
chr7	ADCYAP1R1	31100126	31100210	0	85	0	7004	0	6919	0.0	0.0
chr7	ADCYAP1R1	31095666	31095750	0	85	0	7004	0	6919	0.0	0.0
chr7	ITPRID1	31549425	31549499	0	75	326	7265	326	7190	0.0	0.04534075104311544
chr7	ITPRID1	31553001	31553187	0	187	326	7265	326	7078	0.0	0.04605820853348404
chr7	PPP1R17	31695468	31695621	0	154	0	1797	0	1643	0.0	0.0
chr7	AVL9	32580218	32580272	983	55	68538	13146	67555	13091	17.87272727272727	5.1604155526697735
chr7	AVL9	32575954	32576072	69	119	68538	13146	68469	13027	0.5798319327731093	5.255929991555999
chr7	FKBP9	32963543	32963702	2450	160	18194	5161	15744	5001	15.3125	3.1481703659268145
chr7	FKBP9	32974616	32974762	324	147	18194	5161	17870	5014	2.204081632653061	3.564020741922617
chr7	BBS9	33352858	33352873	0	16	6982	8800	6982	8784	0.0	0.7948542805100182
chr7	BBS9	33351026	33351323	0	298	6982	8800	6982	8502	0.0	0.8212185368148671
chr7	BBS9	33351218	33351323	0	106	6982	8800	6982	8694	0.0	0.8030825856912813
chr7	BBS9	33146241	33146364	16	124	6982	8800	6966	8676	0.12903225806451613	0.8029045643153527
chr7	BBS9	33154485	33154608	0	124	6982	8800	6982	8676	0.0	0.8047487321346243
chr7	BBS9	33146268	33146364	16	97	6982	8800	6966	8703	0.16494845360824742	0.8004136504653567
chr7	BBS9	33568170	33568286	0	117	6982	8800	6982	8683	0.0	0.8040999654497294
chr7	BBS9	33346226	33346370	0	145	6982	8800	6982	8655	0.0	0.8067013287117273
chr7	BBS9	33604864	33604975	0	112	6982	8800	6982	8688	0.0	0.8036372007366482
chr7	BMPER	33937288	33937388	0	101	49284	8014	49284	7913	0.0	6.228232023252875
chr7	BMPER	34046305	34046405	0	101	49284	8014	49284	7913	0.0	6.228232023252875
chr7	BMPER	34058058	34058163	0	106	49284	8014	49284	7908	0.0	6.23216995447648
chr7	BMPER	34078856	34079186	0	331	49284	8014	49284	7683	0.0	6.414681764935572
chr7	BMPER	34143229	34143360	0	132	49284	8014	49284	7882	0.0	6.252727734077645
chr7	BMPER	34051860	34051970	0	111	49284	8014	49284	7903	0.0	6.236112868530937
chr7	BMPER	34062001	34062047	0	47	49284	8014	49284	7967	0.0	6.1860173214509855
chr7	BMPER	34078984	34079186	0	203	49284	8014	49284	7811	0.0	6.309563436179746
chr7	BMPER	33939951	33940021	0	71	49284	8014	49284	7943	0.0	6.204708548407403
chr7	BMPER	33976997	33977115	2367	119	49284	8014	46917	7895	19.89075630252101	5.942621912602913
chr7	BMPER	33944191	33944308	95	118	49284	8014	49189	7896	0.8050847457627118	6.2296099290780145
chr7	NPSR1	34778461	34778565	0	105	0	2708	0	2603	0.0	0.0
chr7	NPSR1	34811769	34811863	0	95	0	2708	0	2613	0.0	0.0
chr7	NPSR1	34778494	34778565	0	72	0	2708	0	2636	0.0	0.0
chr7	NPSR1	34849322	34849422	0	101	0	2708	0	2607	0.0	0.0
chr7	AC018647.1	35717030	35717128	0	99	15970	6731	15970	6632	0.0	2.408021712907117
chr7	AC018647.1	35717006	35717128	36	123	15970	6731	15934	6608	0.2926829268292683	2.411319612590799
chr7	AC018647.1	35717027	35717128	0	102	15970	6731	15970	6629	0.0	2.409111479861216
chr7	SEPTIN7	35831491	35831496	72	6	32142	11676	32070	11670	12.0	2.7480719794344473
chr7	SEPTIN7	35832797	35832900	0	104	32142	11676	32142	11572	0.0	2.777566539923954
chr7	SEPTIN7	35832792	35832900	0	109	32142	11676	32142	11567	0.0	2.7787671825019453
chr7	SEPTIN7	35832803	35832900	0	98	32142	11676	32142	11578	0.0	2.7761271376749006
chr7	SEPTIN7	35831352	35831496	348	145	32142	11676	31794	11531	2.4	2.757263030092793
chr7	SEPTIN7	35832797	35832893	0	97	32142	11676	32142	11579	0.0	2.7758873823300805
chr7	SEPTIN7	35831424	35831496	348	73	32142	11676	31794	11603	4.767123287671233	2.740153408601224
chr7	ANLN	36411058	36411166	0	109	14132	5237	14132	5128	0.0	2.7558502340093605
chr7	ANLN	36415757	36415884	0	128	14132	5237	14132	5109	0.0	2.7660990409082014
chr7	ANLN	36417079	36417190	0	112	14132	5237	14132	5125	0.0	2.757463414634146
chr7	ANLN	36428306	36428360	0	55	14132	5237	14132	5182	0.0	2.7271323813199535
chr7	GPR141	37685178	37685298	0	121	0	2321	0	2200	0.0	0.0
chr7	NME8	37848823	37849056	0	234	229	2400	229	2166	0.0	0.10572483841181902
chr7	EPDR1	37948839	37949048	0	210	0	2786	0	2576	0.0	0.0
chr7	STARD3NL	38217024	38217078	0	55	0	2309	0	2254	0.0	0.0
chr7	STARD3NL	38179089	38179145	0	57	0	2309	0	2252	0.0	0.0
chr7	STARD3NL	38202069	38202197	0	129	0	2309	0	2180	0.0	0.0
chr7	STARD3NL	38201713	38201966	0	254	0	2309	0	2055	0.0	0.0
chr7	STARD3NL	38198210	38198365	0	156	0	2309	0	2153	0.0	0.0
chr7	POU6F2	39406599	39406740	0	142	64	8328	64	8186	0.0	0.007818226239921818
chr7	POU6F2	39451532	39451701	0	170	64	8328	64	8158	0.0	0.007845060063741112
chr7	POU6F2	39006756	39006867	0	112	64	8328	64	8216	0.0	0.007789678675754625
chr7	RALA	39697407	39697510	27	104	300	3587	273	3483	0.25961538461538464	0.07838070628768304
chr7	LINC00265	39763547	39763671	0	125	5202	6805	5202	6680	0.0	0.7787425149700599
chr7	LINC00265	39779270	39779385	0	116	5202	6805	5202	6689	0.0	0.7776947226790253
chr7	LINC00265	39742049	39742177	0	129	5202	6805	5202	6676	0.0	0.7792091072498503
chr7	LINC00265	39744291	39744384	0	94	5202	6805	5202	6711	0.0	0.7751452838623156
chr7	CDK13	40085698	40085746	0	49	85076	22505	85076	22456	0.0	3.788564303526897
chr7	CDK13	40073617	40073692	0	76	85076	22505	85076	22429	0.0	3.7931249721342906
chr7	SUGCT	40180946	40180998	0	53	7181	2849	7181	2796	0.0	2.5683118741058655
chr7	SUGCT	40274512	40274656	0	145	7181	2849	7181	2704	0.0	2.6556952662721893
chr7	SUGCT	40684055	40684133	0	79	7181	2849	7181	2770	0.0	2.592418772563177
chr7	SUGCT	40141823	40141873	0	51	7181	2849	7181	2798	0.0	2.5664760543245175
chr7	INHBA-AS1	41772895	41772994	0	100	0	4865	0	4765	0.0	0.0
chr7	MRPL32	42937163	42937241	0	79	30802	3362	30802	3283	0.0	9.382272311909839
chr7	HECW1	43243874	43243932	0	59	20192	13972	20192	13913	0.0	1.451304535326673
chr7	HECW1	43114156	43114391	0	236	20192	13972	20192	13736	0.0	1.470005824111823
chr7	HECW1	43450827	43450929	0	103	20192	13972	20192	13869	0.0	1.4559088614896531
chr7	BLVRA	43760016	43760110	0	95	983	1831	983	1736	0.0	0.5662442396313364
chr7	UBE2D4	43942825	43942857	1741	33	55691	4694	53950	4661	52.75757575757576	11.574769362797683
chr7	UBE2D4	43950598	43950692	180	95	55691	4694	55511	4599	1.894736842105263	12.070232659273755
chr7	UBE2D4	43928013	43928111	0	99	55691	4694	55691	4595	0.0	12.119912948857454
chr7	UBE2D4	43947158	43947229	8	72	55691	4694	55683	4622	0.1111111111111111	12.047382085677196
chr7	UBE2D4	43942953	43943031	644	79	55691	4694	55047	4615	8.151898734177216	11.927843986998917
chr7	DBNL	44050224	44050280	26	57	73320	12166	73294	12109	0.45614035087719296	6.052853249649021
chr7	DBNL	44059353	44059449	0	97	73320	12166	73320	12069	0.0	6.075068356947551
chr7	DBNL	44051829	44051942	4175	114	73320	12166	69145	12052	36.62280701754386	5.737222037836044
chr7	DBNL	44052866	44052941	1980	76	73320	12166	71340	12090	26.05263157894737	5.900744416873449
chr7	DBNL	44056756	44056903	360	148	73320	12166	72960	12018	2.4324324324324325	6.070893659510734
chr7	DBNL	44052866	44052951	2244	86	73320	12166	71076	12080	26.093023255813954	5.883774834437086
chr7	DBNL	44057972	44057992	0	21	73320	12166	73320	12145	0.0	6.037052284890901
chr7	YKT6	44211022	44211124	0	103	0	4921	0	4818	0.0	0.0
chr7	YKT6	44208794	44211124	0	2331	0	4921	0	2590	0.0	0.0
chr7	YKT6	44208406	44211124	0	2719	0	4921	0	2202	0.0	0.0
chr7	YKT6	44205582	44205631	0	50	0	4921	0	4871	0.0	0.0
chr7	YKT6	44211553	44211604	0	52	0	4921	0	4869	0.0	0.0
chr7	YKT6	44210841	44210931	0	91	0	4921	0	4830	0.0	0.0
chr7	OGDH	44673786	44673941	0	156	24460	5234	24460	5078	0.0	4.816857030326901
chr7	OGDH	44656317	44656362	0	46	24460	5234	24460	5188	0.0	4.714726291441789
chr7	OGDH	44622805	44622875	188	71	24460	5234	24272	5163	2.647887323943662	4.701142746465234
chr7	ZMIZ2	44760150	44760228	0	79	11588	6855	11588	6776	0.0	1.7101534828807556
chr7	PPIA	44799391	44799480	5386	90	570720	5460	565334	5370	59.84444444444444	105.27635009310987
chr7	PPIA	44798747	44798904	7563	158	570720	5460	563157	5302	47.86708860759494	106.21595624292719
chr7	PPIA	44798747	44798814	220	68	570720	5460	570500	5392	3.235294117647059	105.80489614243324
chr7	PPIA	44797519	44797621	14600	103	570720	5460	556120	5357	141.74757281553397	103.81183498226619
chr7	PPIA	44800423	44800543	918	121	570720	5460	569802	5339	7.586776859504132	106.72448023974528
chr7	CCM2	45063917	45064001	124	85	12818	7220	12694	7135	1.4588235294117646	1.7791170287316047
chr7	CCM2	45068442	45068579	32	138	12818	7220	12786	7082	0.2318840579710145	1.8054221971194577
chr7	CCM2	45072725	45072783	0	59	12818	7220	12818	7161	0.0	1.7899734673928223
chr7	CCM2	45038252	45038426	0	175	12818	7220	12818	7045	0.0	1.8194464158977999
chr7	CCM2	45069825	45069961	0	137	12818	7220	12818	7083	0.0	1.809685161654666
chr7	CCM2	45070093	45070168	0	76	12818	7220	12818	7144	0.0	1.7942329227323628
chr7	CCM2	45071749	45071872	12	124	12818	7220	12806	7096	0.0967741935483871	1.8046786922209697
chr7	IGFBP1	45891931	45892060	0	130	0	1640	0	1510	0.0	0.0
chr7	AC073115.2	45977518	45977678	0	161	0	1652	0	1491	0.0	0.0
chr7	C7ORF69	47813425	47813569	0	145	0	812	0	667	0.0	0.0
chr7	C7ORF57	48036292	48036363	0	72	102	2284	102	2212	0.0	0.0461121157323689
chr7	C7ORF57	48054594	48054606	0	13	102	2284	102	2271	0.0	0.04491413474240423
chr7	C7ORF57	48036207	48036363	0	157	102	2284	102	2127	0.0	0.047954866008462625
chr7	UPP1	48099669	48099787	0	119	204	4559	204	4440	0.0	0.04594594594594595
chr7	UPP1	48089211	48089418	0	208	204	4559	204	4351	0.0	0.04688577338542864
chr7	UPP1	48089508	48089636	0	129	204	4559	204	4430	0.0	0.04604966139954853
chr7	UPP1	48103296	48103411	0	116	204	4559	204	4443	0.0	0.04591492234976367
chr7	UPP1	48101823	48101870	0	48	204	4559	204	4511	0.0	0.045222788738638886
chr7	ABCA13	48242987	48243084	0	98	74	19141	74	19043	0.0	0.0038859423410176966
chr7	ABCA13	48466955	48467045	0	91	74	19141	74	19050	0.0	0.003884514435695538
chr7	ABCA13	48466952	48467045	0	94	74	19141	74	19047	0.0	0.0038851262666036645
chr7	IKZF1	50391728	50391863	0	136	0	10578	0	10442	0.0	0.0
chr7	IKZF1	50376532	50376793	0	262	0	10578	0	10316	0.0	0.0
chr7	IKZF1	50387344	50387470	0	127	0	10578	0	10451	0.0	0.0
chr7	IKZF1	50368005	50368065	0	61	0	10578	0	10517	0.0	0.0
chr7	IKZF1	50382539	50382707	0	169	0	10578	0	10409	0.0	0.0
chr7	AC004830.2	51018356	51018411	0	56	0	916	0	860	0.0	0.0
chr7	LINC01445	54339129	54339220	0	92	51	8479	51	8387	0.0	0.006080839394300703
chr7	LINC01445	54334227	54334296	0	70	51	8479	51	8409	0.0	0.006064930431680342
chr7	LINC01445	54343640	54344342	0	703	51	8479	51	7776	0.0	0.006558641975308642
chr7	VSTM2A	54553866	54554073	0	208	102	5394	102	5186	0.0	0.019668337832626302
chr7	EGFR	55146605	55146740	0	136	182470	12548	182470	12412	0.0	14.70109571382533
chr7	LANCL2	55379646	55379833	42	188	6060	5248	6018	5060	0.22340425531914893	1.1893280632411067
chr7	ZNF713	55918041	55918297	0	257	255	5679	255	5422	0.0	0.04703061600885282
chr7	NIPSNAP2	55978349	55978395	0	47	5693	3190	5693	3143	0.0	1.8113267578746421
chr7	NIPSNAP2	55982209	55982280	0	72	5693	3190	5693	3118	0.0	1.8258499037844773
chr7	NIPSNAP2	55979759	55979886	194	128	5693	3190	5499	3062	1.515625	1.7958850424559112
chr7	NIPSNAP2	55979762	55979886	72	125	5693	3190	5621	3065	0.576	1.833931484502447
chr7	NIPSNAP2	55991827	55991884	1377	58	5693	3190	4316	3132	23.74137931034483	1.3780332056194124
chr7	CCT6A	56054368	56054503	5621	136	114197	3861	108576	3725	41.330882352941174	29.14791946308725
chr7	SUMF2	56068481	56068638	51	158	56386	3936	56335	3778	0.3227848101265823	14.91132874536792
chr7	SUMF2	56074585	56074736	51	152	56386	3936	56335	3784	0.3355263157894737	14.887684989429175
chr7	SUMF2	56078363	56078508	3118	146	56386	3936	53268	3790	21.356164383561644	14.054881266490765
chr7	SUMF2	56074173	56074218	0	46	56386	3936	56386	3890	0.0	14.495115681233933
chr7	SUMF2	56068481	56068647	51	167	56386	3936	56335	3769	0.30538922155688625	14.946935526664898
chr7	SUMF2	56078921	56079039	35160	119	56386	3936	21226	3817	295.4621848739496	5.560911710767619
chr7	SUMF2	56076833	56076889	0	57	56386	3936	56386	3879	0.0	14.536220675431812
chr7	SUMF2	56072996	56073111	28	116	56386	3936	56358	3820	0.2413793103448276	14.753403141361257
chr7	SUMF2	56074585	56074639	40	55	56386	3936	56346	3881	0.7272727272727273	14.518423086833291
chr7	SUMF2	56074113	56074218	0	106	56386	3936	56386	3830	0.0	14.72219321148825
chr7	AC237221.1	57407073	57407170	0	98	0	4007	0	3909	0.0	0.0
chr7	AC237221.1	57407482	57407550	0	69	0	4007	0	3938	0.0	0.0
chr7	AC237221.1	57407482	57407558	0	77	0	4007	0	3930	0.0	0.0
chr7	AC237221.1	57406038	57406221	0	184	0	4007	0	3823	0.0	0.0
chr7	AC006455.5	63350918	63351014	0	97	0	2294	0	2197	0.0	0.0
chr7	LINC02848	63903521	63903590	0	70	51	5075	51	5005	0.0	0.01018981018981019
chr7	LINC02848	63917518	63917567	0	50	51	5075	51	5025	0.0	0.010149253731343283
chr7	ZNF107	64691864	64691960	0	97	13515	7169	13515	7072	0.0	1.9110576923076923
chr7	ZNF107	64669036	64669178	408	143	13515	7169	13107	7026	2.8531468531468533	1.8654995730145174
chr7	ZNF107	64690398	64690525	0	128	13515	7169	13515	7041	0.0	1.9194716659565403
chr7	ZNF107	64679176	64679336	0	161	13515	7169	13515	7008	0.0	1.9285102739726028
chr7	ZNF138	64830939	64831076	0	138	2037	2856	2037	2718	0.0	0.7494481236203091
chr7	ZNF138	64815575	64815653	0	79	2037	2856	2037	2777	0.0	0.7335253871083903
chr7	ZNF138	64814917	64815044	99	128	2037	2856	1938	2728	0.7734375	0.7104105571847508
chr7	ZNF138	64815571	64815653	0	83	2037	2856	2037	2773	0.0	0.7345834835917778
chr7	ZNF138	64814058	64814147	0	90	2037	2856	2037	2766	0.0	0.7364425162689805
chr7	ZNF273	64917029	64917118	0	90	452	8661	452	8571	0.0	0.05273597013183993
chr7	CCT6P3	65072144	65072247	0	104	0	3062	0	2958	0.0	0.0
chr7	INTS4P1	65192158	65192248	1752	91	21714	3924	19962	3833	19.252747252747252	5.207931124445604
chr7	INTS4P1	65150252	65150341	0	90	21714	3924	21714	3834	0.0	5.663536776212832
chr7	INTS4P1	65202516	65202637	271	122	21714	3924	21443	3802	2.221311475409836	5.639926354550236
chr7	ZNF92	65387901	65388028	0	128	6453	3517	6453	3389	0.0	1.904101504868693
chr7	ZNF92	65388805	65388901	0	97	6453	3517	6453	3420	0.0	1.8868421052631579
chr7	INTS4P2	65656934	65657023	0	90	54	2034	54	1944	0.0	0.027777777777777776
chr7	INTS4P2	65708413	65708544	0	132	54	2034	54	1902	0.0	0.028391167192429023
chr7	CCT6P1	65757602	65757717	0	116	284	1684	284	1568	0.0	0.18112244897959184
chr7	CCT6P1	65761645	65761748	102	104	284	1684	182	1580	0.9807692307692307	0.11518987341772152
chr7	CCT6P1	65752163	65752310	65	148	284	1684	219	1536	0.4391891891891892	0.142578125
chr7	VKORC1L1	65948670	65948780	0	111	97252	6095	97252	5984	0.0	16.252005347593585
chr7	ASL	66089275	66089335	0	61	10965	5629	10965	5568	0.0	1.9692887931034482
chr7	ASL	66081802	66081997	0	196	10965	5629	10965	5433	0.0	2.0182219768083933
chr7	ASL	66086743	66086821	0	79	10965	5629	10965	5550	0.0	1.9756756756756757
chr7	CRCP	66130743	66130842	1914	100	55628	3326	53714	3226	19.14	16.650340979541227
chr7	CRCP	66130126	66130248	598	123	55628	3326	55030	3203	4.861788617886178	17.1807680299719
chr7	TPST1	66205793	66205921	245	129	107077	2816	106832	2687	1.8992248062015504	39.75883885374023
chr7	TPST1	66240324	66241270	7635	947	107077	2816	99442	1869	8.062302006335797	53.2059925093633
chr7	TPST1	66209852	66209904	216	53	107077	2816	106861	2763	4.0754716981132075	38.67571480275063
chr7	KCTD7	66633274	66633444	0	171	10236	3297	10236	3126	0.0	3.27447216890595
chr7	RABGEF1	66773690	66773810	2182	121	21971	5517	19789	5396	18.03305785123967	3.667346182357302
chr7	RABGEF1	66783674	66783841	0	168	21971	5517	21971	5349	0.0	4.1074967283604416
chr7	KCTD7	66639127	66639228	0	102	10236	3297	10236	3195	0.0	3.203755868544601
chr7	AC006001.2	66665169	66665287	0	119	781	2686	781	2567	0.0	0.3042462017919751
chr7	AC006001.2	66667397	66667610	156	214	781	2686	625	2472	0.7289719626168224	0.25283171521035597
chr7	AC006001.2	66666113	66666202	0	90	781	2686	781	2596	0.0	0.3008474576271186
chr7	RABGEF1	66770322	66770467	130	146	21971	5517	21841	5371	0.8904109589041096	4.0664680692608455
chr7	RABGEF1	66768830	66769025	56	196	21971	5517	21915	5321	0.2857142857142857	4.118586731817327
chr7	TMEM248	66950951	66951135	51	185	102	5095	51	4910	0.2756756756756757	0.010386965376782077
chr7	TMEM248	66922148	66922246	0	99	102	5095	102	4996	0.0	0.020416333066453164
chr7	TYW1	66998816	66998954	0	139	0	3755	0	3616	0.0	0.0
chr7	TYW1	67014366	67014561	0	196	0	3755	0	3559	0.0	0.0
chr7	TYW1	67055834	67055887	0	54	0	3755	0	3701	0.0	0.0
chr7	STAG3L4	67308576	67308652	0	77	0	3202	0	3125	0.0	0.0
chr7	AC092637.1	68028880	68028994	0	115	0	849	0	734	0.0	0.0
chr7	AUTS2	70768023	70768068	0	46	2648	24173	2648	24127	0.0	0.1097525593733162
chr7	AUTS2	70774027	70774099	0	73	2648	24173	2648	24100	0.0	0.10987551867219918
chr7	AUTS2	70775356	70775386	0	31	2648	24173	2648	24142	0.0	0.10968436749233701
chr7	AUTS2	70093231	70093303	0	73	2648	24173	2648	24100	0.0	0.10987551867219918
chr7	AUTS2	70145305	70145444	0	140	2648	24173	2648	24033	0.0	0.11018183331252861
chr7	SBDSP1	72833763	72833928	510	166	16984	1244	16474	1078	3.072289156626506	15.28200371057514
chr7	SBDSP1	72830691	72830813	0	123	16984	1244	16984	1121	0.0	15.150758251561106
chr7	POM121	72913764	72913828	0	65	489700	9840	489700	9775	0.0	50.09718670076726
chr7	FKBP6	73329359	73329449	0	91	204	4736	204	4645	0.0	0.04391819160387513
chr7	FKBP6	73331656	73331776	102	121	204	4736	102	4615	0.8429752066115702	0.02210184182015168
chr7	FKBP6	73329359	73329834	0	476	204	4736	204	4260	0.0	0.04788732394366197
chr7	BUD23	73690915	73691012	0	98	7144	5292	7144	5194	0.0	1.3754331921447824
chr7	BUD23	73686998	73687095	0	98	7144	5292	7144	5194	0.0	1.3754331921447824
chr7	BUD23	73693991	73694050	0	60	7144	5292	7144	5232	0.0	1.3654434250764527
chr7	BUD23	73697465	73697516	0	52	7144	5292	7144	5240	0.0	1.3633587786259542
chr7	TMEM270	73861468	73861591	0	124	127	978	127	854	0.0	0.148711943793911
chr7	ELN	74036554	74036584	0	31	1129	6338	1129	6307	0.0	0.17900745203741875
chr7	ELN	74041215	74041251	0	37	1129	6338	1129	6301	0.0	0.1791779082685288
chr7	ELN	74046187	74046217	0	31	1129	6338	1129	6307	0.0	0.17900745203741875
chr7	ELN	74047674	74047716	320	43	1129	6338	809	6295	7.441860465116279	0.1285146942017474
chr7	ELN	74057639	74057696	0	58	1129	6338	1129	6280	0.0	0.17977707006369426
chr7	ELN	74060139	74060184	0	46	1129	6338	1129	6292	0.0	0.17943420216147488
chr7	ELN	74045221	74045293	0	73	1129	6338	1129	6265	0.0	0.1802075019952115
chr7	ELN	74065943	74065997	0	55	1129	6338	1129	6283	0.0	0.17969123030399492
chr7	ELN	74043544	74043778	0	235	1129	6338	1129	6103	0.0	0.1849909880386695
chr7	EIF4H	74187610	74187798	0	189	47241	4839	47241	4650	0.0	10.159354838709678
chr7	EIF4H	74190246	74190306	0	61	47241	4839	47241	4778	0.0	9.887191293428213
chr7	EIF4H	74179337	74179418	0	82	47241	4839	47241	4757	0.0	9.930838763926845
chr7	EIF4H	74178655	74178826	0	172	47241	4839	47241	4667	0.0	10.122348403685452
chr7	LAT2	74214821	74215010	129	190	4986	4561	4857	4371	0.6789473684210526	1.1111873713109128
chr7	LAT2	74221636	74221692	0	57	4986	4561	4986	4504	0.0	1.1070159857904085
chr7	LAT2	74214821	74214917	51	97	4986	4561	4935	4464	0.5257731958762887	1.105510752688172
chr7	LAT2	74214821	74215099	354	279	4986	4561	4632	4282	1.2688172043010753	1.0817375058383933
chr7	LAT2	74214821	74214940	51	120	4986	4561	4935	4441	0.425	1.1112362080612475
chr7	CLIP2	74372931	74373036	6	106	2272	6823	2266	6717	0.05660377358490566	0.3373529849635254
chr7	CLIP2	74401504	74401567	0	64	2272	6823	2272	6759	0.0	0.33614440005918034
chr7	CLIP2	74381581	74381630	0	50	2272	6823	2272	6773	0.0	0.33544957921157537
chr7	GTF2IRD1	74547102	74547286	435	185	49701	5259	49266	5074	2.3513513513513513	9.709499408750492
chr7	GTF2IRD1	74555392	74555494	0	103	49701	5259	49701	5156	0.0	9.639449185415051
chr7	GTF2IRD1	74555437	74555494	0	58	49701	5259	49701	5201	0.0	9.55604691405499
chr7	GTF2I	74714856	74714916	137	61	2890	11341	2753	11280	2.2459016393442623	0.24406028368794327
chr7	GTF2I	74718878	74718941	0	64	2890	11341	2890	11277	0.0	0.2562738316928261
chr7	GTF2I	74689123	74689227	70	105	2890	11341	2820	11236	0.6666666666666666	0.25097899608401564
chr7	GTF2I	74744138	74744250	0	113	2890	11341	2890	11228	0.0	0.25739223370146064
chr7	NCF1	74779081	74779157	18	77	31538	3153	31520	3076	0.23376623376623376	10.24707412223667
chr7	NCF1	74778306	74778399	0	94	31538	3153	31538	3059	0.0	10.309905197777052
chr7	NCF1	74780156	74780226	1267	71	31538	3153	30271	3082	17.845070422535212	9.821868916288125
chr7	NCF1	74779256	74779422	0	167	31538	3153	31538	2986	0.0	10.561955793703952
chr7	GTF2IRD2B	75093850	75095029	408	1180	33435	6408	33027	5228	0.34576271186440677	6.317329762815608
chr7	GTF2IRD2B	75126341	75126385	1193	45	33435	6408	32242	6363	26.511111111111113	5.067106710671067
chr7	NSUN5P1	75410605	75410726	0	122	217	2136	217	2014	0.0	0.10774577954319761
chr7	NSUN5P1	75415591	75415778	0	188	217	2136	217	1948	0.0	0.11139630390143737
chr7	NSUN5P1	75411407	75411574	0	168	217	2136	217	1968	0.0	0.11026422764227642
chr7	NSUN5P1	75414639	75414798	0	160	217	2136	217	1976	0.0	0.10981781376518218
chr7	NSUN5P1	75415591	75415770	0	180	217	2136	217	1956	0.0	0.11094069529652352
chr7	RHBDD2	75881364	75881486	0	123	73	2398	73	2275	0.0	0.03208791208791209
chr7	POR	75981047	75981172	0	126	43202	5746	43202	5620	0.0	7.687188612099644
chr7	POR	75915660	75915767	2351	108	43202	5746	40851	5638	21.76851851851852	7.245654487406882
chr7	MDH2	76060372	76060498	0	127	32743	3651	32743	3524	0.0	9.291430192962542
chr7	MDH2	76054829	76054998	0	170	32743	3651	32743	3481	0.0	9.40620511347314
chr7	HSPB1	76303801	76303865	0	65	0	1152	0	1087	0.0	0.0
chr7	HSPB1	76303801	76303888	0	88	0	1152	0	1064	0.0	0.0
chr7	HSPB1	76303806	76303865	0	60	0	1152	0	1092	0.0	0.0
chr7	HSPB1	76303776	76303865	0	90	0	1152	0	1062	0.0	0.0
chr7	HSPB1	76303801	76303844	0	44	0	1152	0	1108	0.0	0.0
chr7	HSPB1	76303801	76303882	0	82	0	1152	0	1070	0.0	0.0
chr7	HSPB1	76303697	76303727	0	31	0	1152	0	1121	0.0	0.0
chr7	DTX2	76463653	76463709	0	57	184	5061	184	5004	0.0	0.03677058353317346
chr7	DTX2	76477113	76477178	0	66	184	5061	184	4995	0.0	0.036836836836836834
chr7	DTX2	76463444	76463709	0	266	184	5061	184	4795	0.0	0.0383733055265902
chr7	DTX2	76476942	76477178	0	237	184	5061	184	4824	0.0	0.03814262023217247
chr7	DTX2	76470299	76470419	0	121	184	5061	184	4940	0.0	0.03724696356275304
chr7	DTX2	76497336	76497477	184	142	184	5061	0	4919	1.295774647887324	0.0
chr7	DTX2	76463544	76463709	0	166	184	5061	184	4895	0.0	0.03758937691521961
chr7	DTX2	76480420	76480777	0	358	184	5061	184	4703	0.0	0.039123963427599405
chr7	DTX2	76501266	76501292	0	27	184	5061	184	5034	0.0	0.03655145013905443
chr7	UPK3B	76513083	76513163	0	81	0	2542	0	2461	0.0	0.0
chr7	AC007003.1	76916590	76916843	442	254	1003	1239	561	985	1.7401574803149606	0.5695431472081218
chr7	DTX2P1-UPK3BP1-PMS2P11	77006978	77007059	0	82	408	5347	408	5265	0.0	0.07749287749287749
chr7	DTX2P1-UPK3BP1-PMS2P11	76968398	76968518	0	121	408	5347	408	5226	0.0	0.07807118254879448
chr7	DTX2P1-UPK3BP1-PMS2P11	76995454	76995595	0	142	408	5347	408	5205	0.0	0.07838616714697406
chr7	DTX2P1-UPK3BP1-PMS2P11	77003288	77003449	0	162	408	5347	408	5185	0.0	0.07868852459016394
chr7	CCDC146	77273693	77273789	0	97	48415	4481	48415	4384	0.0	11.043567518248175
chr7	PTPN12	77581426	77581503	0	78	3084	5154	3084	5076	0.0	0.607565011820331
chr7	PTPN12	77583554	77583650	0	97	3084	5154	3084	5057	0.0	0.6098477358117461
chr7	PTPN12	77592184	77592256	0	73	3084	5154	3084	5081	0.0	0.6069671324542413
chr7	PTPN12	77632347	77632425	0	79	3084	5154	3084	5075	0.0	0.6076847290640394
chr7	PTPN12	77563935	77564195	51	261	3084	5154	3033	4893	0.19540229885057472	0.6198651134273452
chr7	PTPN12	77538764	77538845	0	82	3084	5154	3084	5072	0.0	0.6080441640378549
chr7	PTPN12	77604878	77604935	0	58	3084	5154	3084	5096	0.0	0.6051805337519623
chr7	PHTF2	77854732	77854834	0	103	124	8667	124	8564	0.0	0.014479215319943952
chr7	PHTF2	77893981	77893993	0	13	124	8667	124	8654	0.0	0.014328634157614976
chr7	PHTF2	77937709	77937838	0	130	124	8667	124	8537	0.0	0.014525008785287572
chr7	PHTF2	77940527	77940659	0	133	124	8667	124	8534	0.0	0.014530114834778533
chr7	PHTF2	77949677	77949833	0	157	124	8667	124	8510	0.0	0.014571092831962397
chr7	AC004990.1	77990983	77991182	0	200	45	2237	45	2037	0.0	0.022091310751104567
chr7	RPL13AP17	78348376	78348425	0	50	0	2160	0	2110	0.0	0.0
chr7	MAGI2-AS3	79454865	79455007	0	143	0	16832	0	16689	0.0	0.0
chr7	MAGI2-AS3	79470593	79470679	0	87	0	16832	0	16745	0.0	0.0
chr7	MAGI2-AS3	79453586	79453655	0	70	0	16832	0	16762	0.0	0.0
chr7	MAGI2-AS3	79454885	79455007	0	123	0	16832	0	16709	0.0	0.0
chr7	MAGI2-AS3	79459406	79459453	0	48	0	16832	0	16784	0.0	0.0
chr7	MAGI2-AS3	79458658	79458730	0	73	0	16832	0	16759	0.0	0.0
chr7	MAGI2-AS3	79455889	79456180	0	292	0	16832	0	16540	0.0	0.0
chr7	MAGI2-AS3	79454885	79458730	0	3846	0	16832	0	12986	0.0	0.0
chr7	MAGI2-AS3	79456089	79456180	0	92	0	16832	0	16740	0.0	0.0
chr7	GNAI1	80134417	80134568	0	152	102	23932	102	23780	0.0	0.004289318755256518
chr7	GNAI1	80134417	80134588	0	172	102	23932	102	23760	0.0	0.004292929292929293
chr7	GNAI1	80134399	80134568	0	170	102	23932	102	23762	0.0	0.004292567965659457
chr7	GNAI1	80180594	80180754	0	161	102	23932	102	23771	0.0	0.004290942745361996
chr7	CD36	80662989	80663169	0	181	1612	9692	1612	9511	0.0	0.1694879613079592
chr7	CD36	80670976	80671164	204	189	1612	9692	1408	9503	1.0793650793650793	0.14816373776702094
chr7	CD36	80639843	80639929	0	87	1612	9692	1612	9605	0.0	0.16782925559604372
chr7	CACNA2D1-AS1	82021121	82021205	0	85	51	2656	51	2571	0.0	0.019836639439906652
chr7	GRM3	86765005	86765613	0	609	19283	4481	19283	3872	0.0	4.980113636363637
chr7	GRM3	86838838	86839905	1837	1068	19283	4481	17446	3413	1.7200374531835205	5.111631995312043
chr7	DMTF1	87163494	87163617	0	124	0	7275	0	7151	0.0	0.0
chr7	DMTF1	87164933	87165050	0	118	0	7275	0	7157	0.0	0.0
chr7	DMTF1	87166482	87166605	0	124	0	7275	0	7151	0.0	0.0
chr7	DMTF1	87184396	87184625	0	230	0	7275	0	7045	0.0	0.0
chr7	DMTF1	87194683	87194828	0	146	0	7275	0	7129	0.0	0.0
chr7	DMTF1	87188091	87188301	0	211	0	7275	0	7064	0.0	0.0
chr7	DMTF1	87163238	87163332	0	95	0	7275	0	7180	0.0	0.0
chr7	DMTF1	87188038	87188301	0	264	0	7275	0	7011	0.0	0.0
chr7	DMTF1	87154389	87154528	0	140	0	7275	0	7135	0.0	0.0
chr7	DMTF1	87184819	87184892	0	74	0	7275	0	7201	0.0	0.0
chr7	DMTF1	87188197	87188301	0	105	0	7275	0	7170	0.0	0.0
chr7	DMTF1	87164253	87164331	0	79	0	7275	0	7196	0.0	0.0
chr7	DMTF1	87154227	87154278	0	52	0	7275	0	7223	0.0	0.0
chr7	DMTF1	87155454	87155497	0	44	0	7275	0	7231	0.0	0.0
chr7	CROT	87357506	87357590	0	85	30	5015	30	4930	0.0	0.006085192697768763
chr7	RUNDC3B	87693907	87693958	0	52	20502	4721	20502	4669	0.0	4.391090169201114
chr7	RUNDC3B	87807372	87807519	0	148	20502	4721	20502	4573	0.0	4.483271375464684
chr7	DBF4	87897293	87897339	0	47	320	4607	320	4560	0.0	0.07017543859649122
chr7	ADAM22	87964633	87964684	0	52	0	12235	0	12183	0.0	0.0
chr7	ADAM22	88178934	88179042	0	109	0	12235	0	12126	0.0	0.0
chr7	ADAM22	88186614	88186701	0	88	0	12235	0	12147	0.0	0.0
chr7	ADAM22	88184291	88184402	0	112	0	12235	0	12123	0.0	0.0
chr7	ADAM22	88178934	88179129	0	196	0	12235	0	12039	0.0	0.0
chr7	AC003991.1	88283831	88283909	0	79	0	4852	0	4773	0.0	0.0
chr7	AC003991.1	88276955	88277169	0	215	0	4852	0	4637	0.0	0.0
chr7	AC003991.1	88282595	88282866	0	272	0	4852	0	4580	0.0	0.0
chr7	AC003991.1	88290291	88290423	0	133	0	4852	0	4719	0.0	0.0
chr7	AC002383.1	89474894	89475043	0	150	0	2016	0	1866	0.0	0.0
chr7	AC002383.1	89492392	89492488	0	97	0	2016	0	1919	0.0	0.0
chr7	AC002383.1	89490119	89490274	0	156	0	2016	0	1860	0.0	0.0
chr7	STEAP1	90162973	90163110	0	138	37	1550	37	1412	0.0	0.026203966005665724
chr7	STEAP2	90216490	90216603	0	114	765	8556	765	8442	0.0	0.0906183368869936
chr7	STEAP2	90232336	90232484	0	149	765	8556	765	8407	0.0	0.09099559890567384
chr7	STEAP2	90216494	90216603	0	110	765	8556	765	8446	0.0	0.09057542031730997
chr7	CFAP69	90261946	90262056	0	111	561	4519	561	4408	0.0	0.12726860254083486
chr7	CFAP69	90265300	90265377	0	78	561	4519	561	4441	0.0	0.12632290024769197
chr7	CFAP69	90271780	90271958	92	179	561	4519	469	4340	0.5139664804469274	0.10806451612903226
chr7	CFAP69	90273986	90274110	0	125	561	4519	561	4394	0.0	0.12767410104688212
chr7	CFAP69	90303968	90304106	0	139	561	4519	561	4380	0.0	0.12808219178082192
chr7	CFAP69	90306900	90307098	0	199	561	4519	561	4320	0.0	0.12986111111111112
chr7	CFAP69	90309262	90309367	0	106	561	4519	561	4413	0.0	0.12712440516655338
chr7	CFAP69	90276020	90276152	0	133	561	4519	561	4386	0.0	0.12790697674418605
chr7	CFAP69	90287501	90287749	0	249	561	4519	561	4270	0.0	0.13138173302107728
chr7	CFAP69	90261946	90262050	0	105	561	4519	561	4414	0.0	0.12709560489352062
chr7	GTPBP10	90355085	90355230	0	146	51	10450	51	10304	0.0	0.004949534161490683
chr7	GTPBP10	90372154	90372228	0	75	51	10450	51	10375	0.0	0.00491566265060241
chr7	GTPBP10	90354457	90354549	0	93	51	10450	51	10357	0.0	0.004924205851115188
chr7	GTPBP10	90342244	90342322	0	79	51	10450	51	10371	0.0	0.004917558576800694
chr7	CLDN12	90411962	90412061	0	100	0	6484	0	6384	0.0	0.0
chr7	CLDN12	90412006	90412061	0	56	0	6484	0	6428	0.0	0.0
chr7	CLDN12	90412006	90412049	0	44	0	6484	0	6440	0.0	0.0
chr7	CLDN12	90469890	90469953	0	64	0	6484	0	6420	0.0	0.0
chr7	CLDN12	90494366	90494430	0	65	0	6484	0	6419	0.0	0.0
chr7	CDK14	90747680	90747775	0	96	248	6964	248	6868	0.0	0.0361094933022714
chr7	CDK14	90666339	90666411	0	73	248	6964	248	6891	0.0	0.03598897112175301
chr7	CDK14	90608529	90608575	0	47	248	6964	248	6917	0.0	0.03585369379788926
chr7	CDK14	90716339	90716394	0	56	248	6964	248	6908	0.0	0.03590040532715692
chr7	CDK14	90709815	90709957	0	143	248	6964	248	6821	0.0	0.03635830523383668
chr7	AC079760.2	91320801	91320987	0	187	768	2663	768	2476	0.0	0.31017770597738287
chr7	AC079760.2	91335196	91335369	0	174	768	2663	768	2489	0.0	0.30855765367617516
chr7	AC079760.2	91493394	91493535	0	142	768	2663	768	2521	0.0	0.30464101547005157
chr7	AC079760.2	91496502	91496646	0	145	768	2663	768	2518	0.0	0.3050039714058777
chr7	AKAP9	91992157	91992211	0	55	262565	18331	262565	18276	0.0	14.36665572335303
chr7	AKAP9	92042045	92042186	0	142	262565	18331	262565	18189	0.0	14.435373027654077
chr7	AKAP9	92043281	92043377	0	97	262565	18331	262565	18234	0.0	14.399747724032029
chr7	AKAP9	92063461	92063500	0	40	262565	18331	262565	18291	0.0	14.354873981739653
chr7	ANKIB1	92392240	92392292	0	53	1275	7413	1275	7360	0.0	0.17323369565217392
chr7	ANKIB1	92325927	92326008	0	82	1275	7413	1275	7331	0.0	0.1739189742190697
chr7	ANKIB1	92347946	92348016	0	71	1275	7413	1275	7342	0.0	0.1736584037047126
chr7	GATAD1	92449091	92449213	0	123	4488	6342	4488	6219	0.0	0.7216594307766522
chr7	CDK6-AS1	92854908	92854953	0	46	0	671	0	625	0.0	0.0
chr7	CDK6-AS1	92855683	92855827	0	145	0	671	0	526	0.0	0.0
chr7	VPS50	93246101	93246129	0	29	4654	9328	4654	9299	0.0	0.5004839230024734
chr7	VPS50	93240715	93240818	0	104	4654	9328	4654	9224	0.0	0.5045533391153513
chr7	VPS50	93252652	93252775	0	124	4654	9328	4654	9204	0.0	0.5056497175141242
chr7	CASD1	94518202	94518323	0	122	0	5279	0	5157	0.0	0.0
chr7	CASD1	94517559	94517656	0	98	0	5279	0	5181	0.0	0.0
chr7	PEG10	94661037	94661097	0	61	0	3432	0	3371	0.0	0.0
chr7	PPP1R9A	95203664	95203730	0	67	153	11218	153	11151	0.0	0.013720742534301856
chr7	PPP1R9A	95288535	95288718	0	184	153	11218	153	11034	0.0	0.013866231647634585
chr7	PPP1R9A	95287109	95287133	0	25	153	11218	153	11193	0.0	0.013669257571696597
chr7	AC002451.1	95609587	95609862	0	276	102	6751	102	6475	0.0	0.015752895752895752
chr7	DYNC1I1	95828056	95828116	432	61	10847	4540	10415	4479	7.081967213114754	2.3252958249609286
chr7	DYNC1I1	95802679	95802794	0	116	10847	4540	10847	4424	0.0	2.451853526220615
chr7	SDHAF3	97136387	97136467	0	81	0	1191	0	1110	0.0	0.0
chr7	TAC1	97734247	97734292	0	46	273	1719	273	1673	0.0	0.16317991631799164
chr7	TAC1	97736298	97736352	273	55	273	1719	0	1664	4.963636363636364	0.0
chr7	TRRAP	98945746	98945800	144	55	966981	20054	966837	19999	2.618181818181818	48.344267213360666
chr7	TRRAP	98945929	98945950	48	22	966981	20054	966933	20032	2.1818181818181817	48.26941892971246
chr7	TRRAP	99030594	99030757	3332	164	966981	20054	963649	19890	20.317073170731707	48.44891905480141
chr7	TRRAP	99045541	99045792	9358	252	966981	20054	957623	19802	37.13492063492063	48.35991314008686
chr7	MYH16	99252812	99252876	51	65	2033	6350	1982	6285	0.7846153846153846	0.3153540175019889
chr7	AC004922.1	99335452	99335484	0	33	0	2725	0	2692	0.0	0.0
chr7	AC004922.1	99339857	99340009	0	153	0	2725	0	2572	0.0	0.0
chr7	ARPC1A	99363542	99363633	0	92	0	2077	0	1985	0.0	0.0
chr7	ARPC1B	99377337	99377455	0	119	0	3642	0	3523	0.0	0.0
chr7	ARPC1B	99377333	99377439	0	107	0	3642	0	3535	0.0	0.0
chr7	ARPC1B	99376443	99376574	0	132	0	3642	0	3510	0.0	0.0
chr7	ARPC1B	99384050	99384171	0	122	0	3642	0	3520	0.0	0.0
chr7	ARPC1B	99377337	99377439	0	103	0	3642	0	3539	0.0	0.0
chr7	ARPC1B	99377357	99377455	0	99	0	3642	0	3543	0.0	0.0
chr7	ARPC1B	99376432	99376574	0	143	0	3642	0	3499	0.0	0.0
chr7	ARPC1B	99377357	99377439	0	83	0	3642	0	3559	0.0	0.0
chr7	ARPC1B	99386492	99386590	0	99	0	3642	0	3543	0.0	0.0
chr7	ARPC1B	99388654	99388843	0	190	0	3642	0	3452	0.0	0.0
chr7	BUD31	99416137	99416260	0	124	204	2378	204	2254	0.0	0.09050576752440107
chr7	BUD31	99411749	99411983	51	235	204	2378	153	2143	0.2170212765957447	0.07139524031731218
chr7	CPSF4	99450275	99450371	0	97	0	3985	0	3888	0.0	0.0
chr7	CPSF4	99450701	99450795	0	95	0	3985	0	3890	0.0	0.0
chr7	CPSF4	99447772	99448040	0	269	0	3985	0	3716	0.0	0.0
chr7	CPSF4	99442996	99443175	0	180	0	3985	0	3805	0.0	0.0
chr7	ZNF789	99478273	99478356	0	84	37021	4406	37021	4322	0.0	8.565710319296622
chr7	ZNF789	99485207	99485368	347	162	37021	4406	36674	4244	2.1419753086419755	8.641376060320452
chr7	ZNF789	99476402	99476480	0	79	37021	4406	37021	4327	0.0	8.555812341113937
chr7	ZNF789	99483738	99483853	1020	116	37021	4406	36001	4290	8.793103448275861	8.391841491841491
chr7	ZKSCAN5	99520168	99520304	0	137	62745	6053	62745	5916	0.0	10.605983772819473
chr7	ZNF655	99561887	99561973	0	87	3254	7216	3254	7129	0.0	0.4564455042782999
chr7	ZNF655	99563187	99563266	0	80	3254	7216	3254	7136	0.0	0.45599775784753366
chr7	ZNF655	99571259	99571379	45	121	3254	7216	3209	7095	0.371900826446281	0.4522903453136011
chr7	ZNF655	99562348	99562494	0	147	3254	7216	3254	7069	0.0	0.4603197057575329
chr7	ZNF655	99571687	99571792	0	106	3254	7216	3254	7110	0.0	0.4576652601969058
chr7	ZNF655	99563193	99563266	0	74	3254	7216	3254	7142	0.0	0.4556146737608513
chr7	ZSCAN25	99618134	99618209	0	76	270865	5715	270865	5639	0.0	48.03422592658273
chr7	CYP3A43	99836452	99836546	0	95	427	2652	427	2557	0.0	0.16699256941728588
chr7	CYP3A43	99844142	99844242	0	101	427	2652	427	2551	0.0	0.16738533908271266
chr7	CYP3A43	99849545	99849694	0	150	427	2652	427	2502	0.0	0.1706634692246203
chr7	CYP3A43	99855590	99855718	0	129	427	2652	427	2523	0.0	0.1692429647245343
chr7	CYP3A43	99863536	99863699	0	164	427	2652	427	2488	0.0	0.17162379421221866
chr7	CYP3A43	99838676	99838798	0	123	427	2652	427	2529	0.0	0.16884143930407275
chr7	CYP3A43	99839119	99839172	0	54	427	2652	427	2598	0.0	0.16435719784449576
chr7	CYP3A43	99849978	99850099	0	122	427	2652	427	2530	0.0	0.16877470355731225
chr7	CYP3A43	99861612	99861839	0	228	427	2652	427	2424	0.0	0.17615511551155116
chr7	CYP3A43	99856832	99856899	0	68	427	2652	427	2584	0.0	0.16524767801857584
chr7	CYP3A43	99863533	99863699	0	167	427	2652	427	2485	0.0	0.17183098591549295
chr7	ZKSCAN1	100019230	100019349	0	120	181676	10327	181676	10207	0.0	17.799157440971882
chr7	ZSCAN21	100063787	100063979	0	193	97884	2045	97884	1852	0.0	52.85313174946004
chr7	ZSCAN21	100051477	100051610	0	134	97884	2045	97884	1911	0.0	51.22135007849293
chr7	COPS6	100090398	100090487	0	90	1284	2424	1284	2334	0.0	0.5501285347043702
chr7	AP4M1	100102245	100102393	0	149	0	4601	0	4452	0.0	0.0
chr7	AP4M1	100102863	100102960	0	98	0	4601	0	4503	0.0	0.0
chr7	AP4M1	100104873	100104940	0	68	0	4601	0	4533	0.0	0.0
chr7	AP4M1	100102674	100102781	0	108	0	4601	0	4493	0.0	0.0
chr7	AP4M1	100102674	100102746	0	73	0	4601	0	4528	0.0	0.0
chr7	AP4M1	100106657	100106912	0	256	0	4601	0	4345	0.0	0.0
chr7	AP4M1	100105044	100105098	0	55	0	4601	0	4546	0.0	0.0
chr7	LAMTOR4	100149498	100149579	0	82	3842	1452	3842	1370	0.0	2.8043795620437955
chr7	LAMTOR4	100149498	100149565	0	68	3842	1452	3842	1384	0.0	2.7760115606936417
chr7	LAMTOR4	100152715	100152757	0	43	3842	1452	3842	1409	0.0	2.7267565649396737
chr7	STAG3	100188811	100189016	0	206	80708	8611	80708	8405	0.0	9.602379535990481
chr7	PILRB	100353372	100354012	0	641	102	3977	102	3336	0.0	0.030575539568345324
chr7	PILRB	100353372	100353483	0	112	102	3977	102	3865	0.0	0.026390685640362226
chr7	PILRB	100353209	100353270	0	62	102	3977	102	3915	0.0	0.026053639846743294
chr7	PILRB	100353894	100354012	0	119	102	3977	102	3858	0.0	0.026438569206842923
chr7	PILRA	100397878	100397912	35	35	188	1999	153	1964	1.0	0.07790224032586558
chr7	PILRA	100389887	100390106	0	220	188	1999	188	1779	0.0	0.10567734682405847
chr7	AC069281.1	100519375	100519498	0	124	0	1003	0	879	0.0	0.0
chr7	AGFG2	100556593	100556626	0	34	0	5500	0	5466	0.0	0.0
chr7	FBXO24	100595101	100595223	0	123	0	3344	0	3221	0.0	0.0
chr7	FBXO24	100600030	100600201	0	172	0	3344	0	3172	0.0	0.0
chr7	MOSPD3	100613193	100613269	0	77	153	1702	153	1625	0.0	0.09415384615384616
chr7	GNB2	100676176	100676322	0	147	0	2613	0	2466	0.0	0.0
chr7	GNB2	100677351	100677415	0	65	0	2613	0	2548	0.0	0.0
chr7	ZAN	100793819	100794018	357	200	248129	8919	247772	8719	1.785	28.41747906870054
chr7	ZAN	100794119	100794258	0	140	248129	8919	248129	8779	0.0	28.26392527622736
chr7	SLC12A9	100859049	100859161	0	113	1283128	7409	1283128	7296	0.0	175.8673245614035
chr7	SLC12A9	100856867	100857176	3197	310	1283128	7409	1279931	7099	10.312903225806451	180.2973658261727
chr7	SLC12A9	100854155	100854378	29428	224	1283128	7409	1253700	7185	131.375	174.48851774530272
chr7	TRIP6	100867910	100867988	0	79	15456	2453	15456	2374	0.0	6.510530749789385
chr7	TRIP6	100867860	100867988	0	129	15456	2453	15456	2324	0.0	6.650602409638554
chr7	TRIP6	100871060	100871177	0	118	15456	2453	15456	2335	0.0	6.619271948608137
chr7	SRRT	100888256	100888383	137798	128	494088	4638	356290	4510	1076.546875	79.0
chr7	SRRT	100880695	100880769	7637	75	494088	4638	486451	4563	101.82666666666667	106.60771422309884
chr7	SRRT	100882764	100883090	75122	327	494088	4638	418966	4311	229.7308868501529	97.18533982834609
chr7	SRRT	100882457	100883090	82509	634	494088	4638	411579	4004	130.1403785488959	102.79195804195804
chr7	SRRT	100888277	100888383	100266	107	494088	4638	393822	4531	937.0654205607476	86.91723681306554
chr7	MUC3A	100963150	100963266	0	117	549255	11408	549255	11291	0.0	48.64538127712337
chr7	MUC3A	100966385	100966559	0	175	549255	11408	549255	11233	0.0	48.8965547939108
chr7	MUC12	101015614	101015691	0	78	2808	17146	2808	17068	0.0	0.16451839700023435
chr7	MUC17	101050483	101050635	0	153	384	14706	384	14553	0.0	0.026386312100597813
chr7	AP1S1	101157376	101157485	0	110	0	1707	0	1597	0.0	0.0
chr7	EMSLR	101309613	101309694	0	82	911	4680	911	4598	0.0	0.19812962157459765
chr7	CUX1	101916114	101916225	0	112	210834	17804	210834	17692	0.0	11.916911598462582
chr7	CUX1	102028097	102028145	0	49	210834	17804	210834	17755	0.0	11.874626865671642
chr7	CUX1	102097363	102097501	14946	139	210834	17804	195888	17665	107.5251798561151	11.089046136427966
chr7	CUX1	102198801	102198867	0	67	210834	17804	210834	17737	0.0	11.886677566668546
chr7	CUX1	102200070	102200172	2829	103	210834	17804	208005	17701	27.466019417475728	11.751031015196881
chr7	SH2B2	102300521	102301279	45731	759	57368	2394	11637	1635	60.25164690382082	7.1174311926605505
chr7	PRKRIP1	102397619	102397698	0	80	6871	3465	6871	3385	0.0	2.029837518463811
chr7	PRKRIP1	102365954	102366076	9	123	6871	3465	6862	3342	0.07317073170731707	2.0532615200478754
chr7	PRKRIP1	102365973	102366076	9	104	6871	3465	6862	3361	0.08653846153846154	2.0416542695626303
chr7	PRKRIP1	102395976	102396537	6709	562	6871	3465	162	2903	11.937722419928825	0.05580434033758181
chr7	PRKRIP1	102366017	102366076	9	60	6871	3465	6862	3405	0.15	2.015271659324523
chr7	ORAI2	102436201	102436333	878	133	22629	11112	21751	10979	6.601503759398496	1.9811458238455233
chr7	ORAI2	102438943	102439181	30	239	22629	11112	22599	10873	0.12552301255230125	2.078451209417824
chr7	ORAI2	102436229	102436333	850	105	22629	11112	21779	11007	8.095238095238095	1.978649950031798
chr7	ORAI2	102436224	102436333	855	110	22629	11112	21774	11002	7.7727272727272725	1.9790947100527176
chr7	LRWD1	102465531	102465627	0	97	4604	2902	4604	2805	0.0	1.6413547237076649
chr7	FAM185A	102751691	102751801	0	111	1970	2732	1970	2621	0.0	0.7516215185043876
chr7	LRRC17	102942289	102942342	13	54	209806	2834	209793	2780	0.24074074074074073	75.46510791366906
chr7	ARMC10	103092476	103092653	0	178	102	4585	102	4407	0.0	0.02314499659632403
chr7	ARMC10	103075776	103075881	0	106	102	4585	102	4479	0.0	0.02277294038847957
chr7	ARMC10	103097276	103097348	0	73	102	4585	102	4512	0.0	0.022606382978723406
chr7	ARMC10	103086868	103086937	0	70	102	4585	102	4515	0.0	0.022591362126245847
chr7	ARMC10	103084029	103084062	0	34	102	4585	102	4551	0.0	0.02241265655899802
chr7	PMPCB	103307595	103307708	0	114	0	5146	0	5032	0.0	0.0
chr7	PSMC2	103356169	103356209	0	41	0	7122	0	7081	0.0	0.0
chr7	AC005064.1	103504403	103504524	0	122	153	2729	153	2607	0.0	0.05868814729574223
chr7	LHFPL3	104845381	104845429	0	49	0	1860	0	1811	0.0	0.0
chr7	AC007384.1	104962284	104962357	0	74	380	2440	380	2366	0.0	0.16060862214708369
chr7	KMT2E	105110476	105110602	408	127	11085	9981	10677	9854	3.2125984251968505	1.0835193829916785
chr7	KMT2E	105038125	105038199	0	75	11085	9981	11085	9906	0.0	1.1190187764990915
chr7	KMT2E	105068474	105068545	0	72	11085	9981	11085	9909	0.0	1.118679987889797
chr7	KMT2E	105038384	105038525	0	142	11085	9981	11085	9839	0.0	1.126638886065657
chr7	KMT2E	105064027	105064116	0	90	11085	9981	11085	9891	0.0	1.1207158022444648
chr7	KMT2E	105108543	105108658	0	116	11085	9981	11085	9865	0.0	1.1236695387734414
chr7	RINT1	105535571	105535691	410	121	11000	3420	10590	3299	3.3884297520661155	3.210063655653228
chr7	CDHR3	105974843	105975046	0	204	190585	9741	190585	9537	0.0	19.983747509699068
chr7	LINC02577	106777541	106777732	0	192	8542	4128	8542	3936	0.0	2.1702235772357725
chr7	LINC02577	106775958	106776022	0	65	8542	4128	8542	4063	0.0	2.102387398474034
chr7	PIK3CG	106867549	106869556	0	2008	1126	7778	1126	5770	0.0	0.1951473136915078
chr7	HBP1	107174447	107174745	0	299	8	6030	8	5731	0.0	0.001395916942941895
chr7	HBP1	107196289	107196369	8	81	8	6030	0	5949	0.09876543209876543	0.0
chr7	DUS4L-BCAP29	107564587	107564676	1917	90	365323	7282	363406	7192	21.3	50.529199110122356
chr7	DUS4L-BCAP29	107571144	107571266	297	123	365323	7282	365026	7159	2.4146341463414633	50.988406201983516
chr7	DUS4L-BCAP29	107573703	107573821	276	119	365323	7282	365047	7163	2.319327731092437	50.96286472148541
chr7	BCAP29	107580758	107580864	12236	107	461039	5519	448803	5412	114.35514018691589	82.92738359201773
chr7	DUS4L-BCAP29	107593954	107594105	68766	152	365323	7282	296557	7130	452.4078947368421	41.59284712482469
chr7	DUS4L-BCAP29	107613653	107613732	0	80	365323	7282	365323	7202	0.0	50.725215217995
chr7	DUS4L-BCAP29	107573703	107573883	276	181	365323	7282	365047	7101	1.5248618784530388	51.407829883115056
chr7	BCAP29	107580645	107580864	50565	220	461039	5519	410474	5299	229.8409090909091	77.46254010190601
chr7	SLC26A4	107701100	107701196	0	97	102	5632	102	5535	0.0	0.01842818428184282
chr7	SLC26A4	107704330	107704385	0	56	102	5632	102	5576	0.0	0.018292682926829267
chr7	CBLL1	107752544	107752617	0	74	0	5237	0	5163	0.0	0.0
chr7	CBLL1	107755417	107755491	0	75	0	5237	0	5162	0.0	0.0
chr7	DLD	107905360	107905504	0	145	157	4987	157	4842	0.0	0.03242461792647666
chr7	DLD	107902324	107902393	0	70	157	4987	157	4917	0.0	0.031930038641448034
chr7	DLD	107901737	107901817	0	81	157	4987	157	4906	0.0	0.032001630656339174
chr7	DLD	107904662	107904746	0	85	157	4987	157	4902	0.0	0.032027743778049775
chr7	LRRN3	111097026	111097133	0	108	714	3880	714	3772	0.0	0.18928950159066807
chr7	LRRN3	111099880	111099962	0	83	714	3880	714	3797	0.0	0.18804319199367922
chr7	ZNF277	112295868	112295957	0	90	0	4755	0	4665	0.0	0.0
chr7	IFRD1	112450577	112450782	0	206	16318	6697	16318	6491	0.0	2.513942381759359
chr7	IFRD1	112462269	112462378	1245	110	16318	6697	15073	6587	11.318181818181818	2.2882951267648397
chr7	IFRD1	112450507	112450782	0	276	16318	6697	16318	6421	0.0	2.5413486995795047
chr7	IFRD1	112465638	112465838	0	201	16318	6697	16318	6496	0.0	2.5120073891625614
chr7	IFRD1	112465614	112465838	0	225	16318	6697	16318	6472	0.0	2.5213226205191597
chr7	IFRD1	112470898	112471033	0	136	16318	6697	16318	6561	0.0	2.4871208657216886
chr7	IFRD1	112475429	112475676	0	248	16318	6697	16318	6449	0.0	2.5303147774848815
chr7	LSMEM1	112483413	112483606	0	194	102	2599	102	2405	0.0	0.042411642411642414
chr7	LSMEM1	112486351	112486439	0	89	102	2599	102	2510	0.0	0.04063745019920319
chr7	AC002463.1	112618819	112619021	0	203	91636	5157	91636	4954	0.0	18.497375857892614
chr7	AC002463.1	112640161	112640218	0	58	91636	5157	91636	5099	0.0	17.971366934693076
chr7	AC002463.1	112701366	112701437	0	72	91636	5157	91636	5085	0.0	18.020845624385448
chr7	AC002463.1	112707736	112707861	0	126	91636	5157	91636	5031	0.0	18.214271516597098
chr7	AC002463.1	112757086	112757316	90263	231	91636	5157	1373	4926	390.74891774891773	0.27872513195290294
chr7	AC002463.1	112640079	112640218	0	140	91636	5157	91636	5017	0.0	18.265098664540563
chr7	AC002463.1	112626157	112626410	1326	254	91636	5157	90310	4903	5.2204724409448815	18.419335100958598
chr7	AC002463.1	112699329	112699522	0	194	91636	5157	91636	4963	0.0	18.463832359460003
chr7	AC002463.1	112648055	112648144	0	90	91636	5157	91636	5067	0.0	18.084862837971187
chr7	AC002463.1	112707741	112707861	0	121	91636	5157	91636	5036	0.0	18.196187450357428
chr7	AC002463.1	112638094	112638284	0	191	91636	5157	91636	4966	0.0	18.452678211840517
chr7	FOXP2	114538325	114538383	0	59	37127	16292	37127	16233	0.0	2.287131152590402
chr7	FOXP2	114570806	114570881	0	76	37127	16292	37127	16216	0.0	2.289528860384805
chr7	FOXP2	114629591	114629642	0	52	37127	16292	37127	16240	0.0	2.2861453201970443
chr7	FOXP2	114659355	114659432	0	78	37127	16292	37127	16214	0.0	2.289811274207475
chr7	FOXP2	114162943	114163088	0	146	37127	16292	37127	16146	0.0	2.2994549733680167
chr7	FOXP2	114463073	114463171	0	99	37127	16292	37127	16193	0.0	2.292780831223368
chr7	FOXP2	114285404	114285456	0	53	37127	16292	37127	16239	0.0	2.286286101360921
chr7	FOXP2	114366504	114366640	0	137	37127	16292	37127	16155	0.0	2.2981739399566696
chr7	FOXP2	114656439	114656594	12906	156	37127	16292	24221	16136	82.73076923076923	1.5010535448686169
chr7	FOXP2	114630610	114630613	0	4	37127	16292	37127	16288	0.0	2.27940815324165
chr7	FOXP2	114658065	114658267	13961	203	37127	16292	23166	16089	68.77339901477832	1.4398657467835168
chr7	MDFIC	115014462	115014533	0	72	0	5056	0	4984	0.0	0.0
chr7	LINC01393	115118934	115119056	0	123	0	2309	0	2186	0.0	0.0
chr7	LINC01393	115122177	115122247	0	71	0	2309	0	2238	0.0	0.0
chr7	TES	116234533	116234619	0	87	0	4275	0	4188	0.0	0.0
chr7	TES	116251759	116251975	0	217	0	4275	0	4058	0.0	0.0
chr7	CAV2	116316431	116316510	0	80	17671	6517	17671	6437	0.0	2.745222929936306
chr7	CAV2	116432958	116433119	1163	162	17671	6517	16508	6355	7.179012345679013	2.597639653815893
chr7	CAV2	116427321	116427486	102	166	17671	6517	17569	6351	0.6144578313253012	2.7663360100771532
chr7	CAV2	116500259	116500447	0	189	17671	6517	17671	6328	0.0	2.7925094816687737
chr7	CAV2	116323089	116323179	0	91	17671	6517	17671	6426	0.0	2.7499221910986615
chr7	CAV2	116500533	116500658	0	126	17671	6517	17671	6391	0.0	2.7649820059458614
chr7	CAV1	116525627	116525805	0	179	86789	3435	86789	3256	0.0	26.65509828009828
chr7	MET	116759336	116759490	0	155	23287	7248	23287	7093	0.0	3.283096010150853
chr7	MET	116771848	116771989	9281	142	23287	7248	14006	7106	65.35915492957747	1.9710104137348718
chr7	MET	116759390	116759490	0	101	23287	7248	23287	7147	0.0	3.2582901916888205
chr7	MET	116695749	116695799	0	51	23287	7248	23287	7197	0.0	3.2356537446158122
chr7	CAPZA2	116861190	116861350	0	161	612	7326	612	7165	0.0	0.08541521284019539
chr7	CAPZA2	116880066	116880147	0	82	612	7326	612	7244	0.0	0.08448371065709552
chr7	CAPZA2	116906262	116906342	0	81	612	7326	612	7245	0.0	0.084472049689441
chr7	ST7	117099761	117099844	0	84	51	6497	51	6413	0.0	0.007952596288788399
chr7	ST7	117119560	117119720	0	161	51	6497	51	6336	0.0	0.008049242424242424
chr7	ST7	117221922	117222062	0	141	51	6497	51	6356	0.0	0.008023914411579609
chr7	ST7	117134123	117134192	0	70	51	6497	51	6427	0.0	0.00793527306674965
chr7	ST7	117219083	117219176	0	94	51	6497	51	6403	0.0	0.007965016398563174
chr7	ST7	117098612	117098815	51	204	51	6497	0	6293	0.25	0.0
chr7	ST7	117090748	117090837	0	90	51	6497	51	6407	0.0	0.007960043702200718
chr7	ST7	117022902	117022999	0	98	51	6497	51	6399	0.0	0.007969995311767463
chr7	CFTR	117534275	117534365	0	91	2221	9870	2221	9779	0.0	0.22711933735555784
chr7	CFTR	117505154	117505228	0	75	2221	9870	2221	9795	0.0	0.22674834099030117
chr7	CFTR	117548640	117548823	0	184	2221	9870	2221	9686	0.0	0.22930002064835844
chr7	ANKRD7	118280192	118280289	0	98	0	2975	0	2877	0.0	0.0
chr7	ANKRD7	118227931	118227991	0	61	0	2975	0	2914	0.0	0.0
chr7	ING3	120964741	120964838	0	98	306	5212	306	5114	0.0	0.059835745013687915
chr7	PTPRZ1	122034094	122034115	0	22	108	8512	108	8490	0.0	0.012720848056537103
chr7	PTPRZ1	122038754	122038889	0	136	108	8512	108	8376	0.0	0.012893982808022923
chr7	PTPRZ1	122047673	122047790	0	118	108	8512	108	8394	0.0	0.012866333095067906
chr7	PTPRZ1	122058799	122058942	0	144	108	8512	108	8368	0.0	0.012906309751434034
chr7	PTPRZ1	122012647	122012821	0	175	108	8512	108	8337	0.0	0.012954300107952501
chr7	PTPRZ1	121893523	121893626	0	104	108	8512	108	8408	0.0	0.012844909609895337
chr7	PTPRZ1	122012647	122013889	0	1243	108	8512	108	7269	0.0	0.014857614527445316
chr7	PTPRZ1	122012077	122013889	0	1813	108	8512	108	6699	0.0	0.0161218092252575
chr7	AC015983.2	122201253	122201396	0	144	0	1896	0	1752	0.0	0.0
chr7	AC015983.2	122216347	122216462	0	116	0	1896	0	1780	0.0	0.0
chr7	AC015983.2	122145987	122146058	0	72	0	1896	0	1824	0.0	0.0
chr7	AC015983.2	122214095	122214189	0	95	0	1896	0	1801	0.0	0.0
chr7	AC004594.1	122366781	122366878	0	98	0	3479	0	3381	0.0	0.0
chr7	AC004594.1	122368069	122368204	0	136	0	3479	0	3343	0.0	0.0
chr7	AC004594.1	122357355	122357409	0	55	0	3479	0	3424	0.0	0.0
chr7	AC004594.1	122412809	122413082	0	274	0	3479	0	3205	0.0	0.0
chr7	AC004594.1	122420966	122421120	0	155	0	3479	0	3324	0.0	0.0
chr7	AC004594.1	122338949	122338996	0	48	0	3479	0	3431	0.0	0.0
chr7	AC004594.1	122331900	122332053	0	154	0	3479	0	3325	0.0	0.0
chr7	AC004594.1	122395469	122395522	0	54	0	3479	0	3425	0.0	0.0
chr7	ASB15	123612275	123612400	0	126	51	4927	51	4801	0.0	0.010622786919391794
chr7	ASB15	123608593	123608654	0	62	51	4927	51	4865	0.0	0.010483042137718397
chr7	HYAL4	123876025	123876082	0	58	0	2750	0	2692	0.0	0.0
chr7	SPAM1	123947703	123947788	0	86	6	3041	6	2955	0.0	0.0020304568527918783
chr7	AC006148.1	124334246	124334390	0	145	0	17199	0	17054	0.0	0.0
chr7	AC006148.1	124077246	124077372	0	127	0	17199	0	17072	0.0	0.0
chr7	AC006148.1	124353150	124353855	0	706	0	17199	0	16493	0.0	0.0
chr7	POT1-AS1	125116873	125117028	0	156	0	16759	0	16603	0.0	0.0
chr7	POT1-AS1	125125824	125125977	0	154	0	16759	0	16605	0.0	0.0
chr7	POT1-AS1	125403503	125403664	0	162	0	16759	0	16597	0.0	0.0
chr7	POT1-AS1	125438091	125438297	0	207	0	16759	0	16552	0.0	0.0
chr7	POT1-AS1	125138572	125138659	0	88	0	16759	0	16671	0.0	0.0
chr7	POT1-AS1	125089689	125089776	0	88	0	16759	0	16671	0.0	0.0
chr7	POT1-AS1	125000681	125001012	0	332	0	16759	0	16427	0.0	0.0
chr7	POT1-AS1	125080711	125080813	0	103	0	16759	0	16656	0.0	0.0
chr7	POT1-AS1	125347124	125347207	0	84	0	16759	0	16675	0.0	0.0
chr7	POT1-AS1	125438144	125438297	0	154	0	16759	0	16605	0.0	0.0
chr7	GRM8-AS1	127219466	127219702	720	237	422645	1921	421925	1684	3.037974683544304	250.54928741092635
chr7	SND1	127990946	127991056	0	111	9217	6520	9217	6409	0.0	1.438133874239351
chr7	SND1	128074501	128074690	0	190	9217	6520	9217	6330	0.0	1.4560821484992101
chr7	METTL2B	128477081	128477173	0	93	559539	6255	559539	6162	0.0	90.8047711781889
chr7	METTL2B	128477948	128477992	0	45	559539	6255	559539	6210	0.0	90.10289855072463
chr7	AC090114.3	128577963	128578033	0	71	29991	838	29991	767	0.0	39.101694915254235
chr7	FAM71F2	128677563	128677813	0	251	1104	3056	1104	2805	0.0	0.39358288770053473
chr7	FAM71F1	128724768	128725072	0	305	51	2436	51	2131	0.0	0.023932426091037073
chr7	CALU	128747552	128748367	0	816	26147	6140	26147	5324	0.0	4.911157024793388
chr7	CALU	128767455	128767655	26095	201	26147	6140	52	5939	129.82587064676616	0.008755682774877925
chr7	CCDC136	128792099	128792183	0	85	53458	6127	53458	6042	0.0	8.847732538894405
chr7	CCDC136	128806236	128806395	0	160	53458	6127	53458	5967	0.0	8.958940841293783
chr7	CCDC136	128817757	128817864	82	108	53458	6127	53376	6019	0.7592592592592593	8.867918258846984
chr7	FLNC	128849975	128850074	1690	100	238950	9298	237260	9198	16.9	25.794737986518808
chr7	ATP6V1F	128865119	128865203	2336	85	2336	765	0	680	27.48235294117647	0.0
chr7	IRF5	128947022	128947056	0	35	1077	4365	1077	4330	0.0	0.248729792147806
chr7	IRF5	128947229	128947535	714	307	1077	4365	363	4058	2.3257328990228014	0.08945293247905373
chr7	IRF5	128941278	128941391	0	114	1077	4365	1077	4251	0.0	0.25335215243472126
chr7	IRF5	128941278	128941424	0	147	1077	4365	1077	4218	0.0	0.2553342816500711
chr7	IRF5	128947277	128947535	413	259	1077	4365	664	4106	1.5945945945945945	0.16171456405260595
chr7	IRF5	128943058	128943134	0	77	1077	4365	1077	4288	0.0	0.2511660447761194
chr7	SMO	129209288	129209397	0	110	0	4764	0	4654	0.0	0.0
chr7	SMO	129191897	129192097	0	201	0	4764	0	4563	0.0	0.0
chr7	SMO	129211382	129211510	0	129	0	4764	0	4635	0.0	0.0
chr7	NRF1	129641724	129641822	0	99	43166	4134	43166	4035	0.0	10.697893432465923
chr7	NRF1	129744172	129744229	0	58	43166	4134	43166	4076	0.0	10.590284592737978
chr7	AC073320.1	130023012	130023070	0	59	0	1538	0	1479	0.0	0.0
chr7	KLHDC10	130096920	130097007	0	88	16515	6595	16515	6507	0.0	2.5380359612724757
chr7	KLHDC10	130094894	130094931	0	38	16515	6595	16515	6557	0.0	2.5186823242336436
chr7	CPA2	130273705	130273811	0	107	497	1805	497	1698	0.0	0.2926972909305065
chr7	CPA4	130305815	130305920	0	106	0	3971	0	3865	0.0	0.0
chr7	CPA4	130300815	130300914	0	100	0	3971	0	3871	0.0	0.0
chr7	CPA5	130345838	130345896	0	59	7470	2962	7470	2903	0.0	2.5732001377884948
chr7	CPA5	130367905	130367990	0	86	7470	2962	7470	2876	0.0	2.597357440890125
chr7	CPA5	130367371	130367571	0	201	7470	2962	7470	2761	0.0	2.7055414704817093
chr7	MEST	130500788	130500890	0	103	0	4491	0	4388	0.0	0.0
chr7	MEST	130493202	130493263	0	62	0	4491	0	4429	0.0	0.0
chr7	LINC00513	130928030	130928199	0	170	199582	2162	199582	1992	0.0	100.1917670682731
chr7	MKLN1	131478622	131478677	0	56	107	12894	107	12838	0.0	0.008334631562548683
chr7	MKLN1	131202856	131202974	0	119	107	12894	107	12775	0.0	0.00837573385518591
chr7	MKLN1	131375423	131375493	0	71	107	12894	107	12823	0.0	0.00834438119004913
chr7	BPGM	134647134	134647259	0	126	612	2545	612	2419	0.0	0.25299710624224886
chr7	BPGM	134658347	134658668	0	322	612	2545	612	2223	0.0	0.27530364372469635
chr7	CALD1	134935687	134935765	0	79	3978	9452	3978	9373	0.0	0.42441054091539526
chr7	CALD1	134844250	134844336	0	87	3978	9452	3978	9365	0.0	0.4247730912973839
chr7	CALD1	134928048	134928090	0	43	3978	9452	3978	9409	0.0	0.42278669359124244
chr7	CALD1	134962819	134962934	0	116	3978	9452	3978	9336	0.0	0.42609254498714655
chr7	AGBL3	134993492	134993678	0	187	943	7328	943	7141	0.0	0.13205433412687298
chr7	AGBL3	135051021	135051154	0	134	943	7328	943	7194	0.0	0.13108145676953017
chr7	AC009542.1	135201473	135201547	0	75	1431	2508	1431	2433	0.0	0.5881627620221949
chr7	NUP205	135613720	135613808	60183	89	234194	7667	174011	7578	676.2134831460675	22.962655054103987
chr7	STMP1	135672752	135672806	0	55	51	4939	51	4884	0.0	0.010442260442260442
chr7	AC024084.1	136027163	136027309	0	147	0	1484	0	1337	0.0	0.0
chr7	AC078845.1	136177251	136177413	0	163	0	3283	0	3120	0.0	0.0
chr7	AC078845.1	136242149	136242371	0	223	0	3283	0	3060	0.0	0.0
chr7	AC078845.1	136117070	136117188	0	119	0	3283	0	3164	0.0	0.0
chr7	AC078845.1	136405269	136405316	0	48	0	3283	0	3235	0.0	0.0
chr7	AKR1D1	138105306	138105429	0	124	153	3424	153	3300	0.0	0.046363636363636364
chr7	AKR1D1	138113689	138113772	0	84	153	3424	153	3340	0.0	0.04580838323353294
chr7	AKR1D1	138088600	138088768	153	169	153	3424	0	3255	0.9053254437869822	0.0
chr7	TMEM213	138801329	138801398	0	70	288	4817	288	4747	0.0	0.06066989677691173
chr7	TMEM213	138801326	138801398	0	73	288	4817	288	4744	0.0	0.06070826306913996
chr7	TTC26	139137846	139137939	384	94	581	5017	197	4923	4.085106382978723	0.040016250253910216
chr7	TTC26	139187405	139187539	0	135	581	5017	581	4882	0.0	0.11900860303154445
chr7	TTC26	139160947	139161022	0	76	581	5017	581	4941	0.0	0.11758753288807934
chr7	LUC7L2	139375508	139375583	0	76	57279	5494	57279	5418	0.0	10.571982281284606
chr7	LUC7L2	139374400	139374471	0	72	57279	5494	57279	5422	0.0	10.564182958317964
chr7	CLEC2L	139536273	139536348	0	76	51	2704	51	2628	0.0	0.019406392694063926
chr7	TBXAS1	139782665	139782729	0	65	3843	6297	3843	6232	0.0	0.6166559691912709
chr7	TBXAS1	139911224	139911321	0	98	3843	6297	3843	6199	0.0	0.6199386997902887
chr7	TBXAS1	140017670	140017833	0	164	3843	6297	3843	6133	0.0	0.6266101418555357
chr7	TBXAS1	139780739	139780824	0	86	3843	6297	3843	6211	0.0	0.6187409434873611
chr7	TBXAS1	139829311	139829479	561	169	3843	6297	3282	6128	3.3195266272189348	0.535574412532637
chr7	TBXAS1	139952550	139952688	0	139	3843	6297	3843	6158	0.0	0.6240662552776876
chr7	TBXAS1	139906100	139906198	0	99	3843	6297	3843	6198	0.0	0.6200387221684415
chr7	ADCK2	140689596	140689725	0	130	204	3120	204	2990	0.0	0.06822742474916388
chr7	NDUFB2	140700873	140700959	0	87	196899	4289	196899	4202	0.0	46.85840076154212
chr7	NDUFB2	140698074	140698268	0	195	196899	4289	196899	4094	0.0	48.09452857840743
chr7	NDUFB2	140700869	140700959	0	91	196899	4289	196899	4198	0.0	46.903049070986185
chr7	AGK	141555452	141555567	0	116	358	9243	358	9127	0.0	0.0392242796099485
chr7	AGK	141593145	141593185	0	41	358	9243	358	9202	0.0	0.03890458595957401
chr7	AGK	141633900	141633980	0	81	358	9243	358	9162	0.0	0.03907443789565597
chr7	AGK	141562106	141562110	0	5	358	9243	358	9238	0.0	0.03875297683481273
chr7	AGK	141641247	141641398	0	152	358	9243	358	9091	0.0	0.03937960620393796
chr7	AGK	141594674	141594928	0	255	358	9243	358	8988	0.0	0.03983088562527815
chr7	AGK	141555463	141555567	0	105	358	9243	358	9138	0.0	0.039177062814620266
chr7	AGK	141600491	141600557	0	67	358	9243	358	9176	0.0	0.03901482127288579
chr7	AGK	141624179	141624296	32	118	358	9243	326	9125	0.2711864406779661	0.035726027397260274
chr7	WEE2	141725025	141725196	0	172	0	3073	0	2901	0.0	0.0
chr7	MGAM	142004389	142004488	0	100	0	10843	0	10743	0.0	0.0
chr7	PRSS1	142751068	142751110	0	43	0	1218	0	1175	0.0	0.0
chr7	PRSS2	142772561	142772603	0	43	0	1266	0	1223	0.0	0.0
chr7	EPHB6	142863630	142863695	0	66	80	4742	80	4676	0.0	0.01710863986313088
chr7	EPHB6	142870529	142870685	0	157	80	4742	80	4585	0.0	0.017448200654307525
chr7	EPHB6	142870590	142870685	0	96	80	4742	80	4646	0.0	0.017219113215669393
chr7	GSTK1	143264547	143264676	0	130	423	3842	423	3712	0.0	0.11395474137931035
chr7	GSTK1	143268090	143268184	0	95	423	3842	423	3747	0.0	0.11289031224979984
chr7	GSTK1	143265260	143265296	0	37	423	3842	423	3805	0.0	0.11116951379763469
chr7	TMEM139	143285344	143285445	0	102	1326	2569	1326	2467	0.0	0.5374949331171464
chr7	TMEM139	143285347	143285445	0	99	1326	2569	1326	2470	0.0	0.5368421052631579
chr7	TMEM139	143285940	143286202	0	263	1326	2569	1326	2306	0.0	0.575021682567216
chr7	TMEM139	143285553	143285640	0	88	1326	2569	1326	2481	0.0	0.5344619105199516
chr7	CLCN1	143324413	143324492	2	80	803	3346	801	3266	0.025	0.24525413349663197
chr7	CLCN1	143323308	143323386	686	79	803	3346	117	3267	8.683544303797468	0.03581267217630854
chr7	CLCN1	143323572	143323627	0	56	803	3346	803	3290	0.0	0.24407294832826748
chr7	ZYX	143382592	143382685	0	94	0	3134	0	3040	0.0	0.0
chr7	ZYX	143381556	143381779	0	224	0	3134	0	2910	0.0	0.0
chr7	ZYX	143387761	143387787	0	27	0	3134	0	3107	0.0	0.0
chr7	ZYX	143384089	143384245	0	157	0	3134	0	2977	0.0	0.0
chr7	AC073264.3	143623761	143624398	0	638	0	2583	0	1945	0.0	0.0
chr7	TCAF2	143720805	143720985	0	181	0	6420	0	6239	0.0	0.0
chr7	ARHGEF35-AS1	144200170	144200277	0	108	0	7882	0	7774	0.0	0.0
chr7	ARHGEF35-AS1	144201551	144201891	0	341	0	7882	0	7541	0.0	0.0
chr7	ARHGEF35-AS1	144215858	144215912	0	55	0	7882	0	7827	0.0	0.0
chr7	OR2A9P	144298483	144298680	0	198	0	2184	0	1986	0.0	0.0
chr7	ARHGEF5	144375513	144375675	0	163	46	5833	46	5670	0.0	0.008112874779541446
chr7	CUL1	148759303	148759354	0	52	20100	4022	20100	3970	0.0	5.062972292191436
chr7	CUL1	148760332	148760496	1071	165	20100	4022	19029	3857	6.490909090909091	4.933627171376718
chr7	CUL1	148786988	148787120	51	133	20100	4022	20049	3889	0.38345864661654133	5.155309848290049
chr7	CUL1	148790309	148790441	0	133	20100	4022	20100	3889	0.0	5.168423759321162
chr7	CUL1	148797936	148798019	0	84	20100	4022	20100	3938	0.0	5.1041137633316405
chr7	ZNF212	149251279	149251327	0	49	20782	3185	20782	3136	0.0	6.626913265306122
chr7	ZNF212	149251209	149251327	259	119	20782	3185	20523	3066	2.176470588235294	6.693737769080235
chr7	AC004890.2	149291555	149291745	0	191	935	4299	935	4108	0.0	0.22760467380720545
chr7	AC004890.2	149289937	149290038	32	102	935	4299	903	4197	0.3137254901960784	0.21515368120085776
chr7	AC004890.2	149288620	149288691	0	72	935	4299	935	4227	0.0	0.22119706647740714
chr7	KRBA1	149715238	149715349	0	112	0	5309	0	5197	0.0	0.0
chr7	KRBA1	149729187	149729370	0	184	0	5309	0	5125	0.0	0.0
chr7	SSPOP	149782846	149783022	0	177	53	19328	53	19151	0.0	0.0027674795049866846
chr7	SSPOP	149811910	149812121	0	212	53	19328	53	19116	0.0	0.0027725465578572923
chr7	SSPOP	149822511	149822679	0	169	53	19328	53	19159	0.0	0.002766323920872697
chr7	SSPOP	149825799	149825938	0	140	53	19328	53	19188	0.0	0.0027621430060454453
chr7	SSPOP	149826678	149826821	0	144	53	19328	53	19184	0.0	0.002762718932443703
chr7	SSPOP	149823723	149823848	0	126	53	19328	53	19202	0.0	0.002760129153213207
chr7	SSPOP	149826074	149826277	0	204	53	19328	53	19124	0.0	0.0027713867391759048
chr7	SSPOP	149823351	149823482	0	132	53	19328	53	19196	0.0	0.002760991873306939
chr7	SSPOP	149826449	149826577	0	129	53	19328	53	19199	0.0	0.0027605604458565552
chr7	ATP6V0E2	149878677	149878790	0	114	0	6761	0	6647	0.0	0.0
chr7	ATP6V0E2	149875972	149876089	0	118	0	6761	0	6643	0.0	0.0
chr7	ATP6V0E2	149878677	149878746	0	70	0	6761	0	6691	0.0	0.0
chr7	ATP6V0E2	149879165	149879225	0	61	0	6761	0	6700	0.0	0.0
chr7	AC092666.1	150035605	150035666	0	62	7134	5281	7134	5219	0.0	1.3669285303698027
chr7	AC092666.1	150041951	150042012	0	62	7134	5281	7134	5219	0.0	1.3669285303698027
chr7	AC092666.1	150043178	150043239	0	62	7134	5281	7134	5219	0.0	1.3669285303698027
chr7	AC092666.1	150037614	150037675	0	62	7134	5281	7134	5219	0.0	1.3669285303698027
chr7	AC092666.1	150040571	150040654	0	84	7134	5281	7134	5197	0.0	1.3727150279007119
chr7	AC092666.1	150063269	150063412	0	144	7134	5281	7134	5137	0.0	1.3887482966712088
chr7	AC092666.1	150043588	150043660	510	73	7134	5281	6624	5208	6.986301369863014	1.271889400921659
chr7	AC092666.1	150062054	150062259	357	206	7134	5281	6777	5075	1.733009708737864	1.3353694581280788
chr7	AC092666.1	150043138	150043239	0	102	7134	5281	7134	5179	0.0	1.3774860011585248
chr7	AC092666.1	150041968	150042012	0	45	7134	5281	7134	5236	0.0	1.362490450725745
chr7	LRRC61	150324357	150324418	0	62	0	1972	0	1910	0.0	0.0
chr7	LRRC61	150325840	150326010	0	171	0	1972	0	1801	0.0	0.0
chr7	REPIN1	150370759	150370884	0	126	153	4590	153	4464	0.0	0.034274193548387094
chr7	REPIN1	150369670	150369868	0	199	153	4590	153	4391	0.0	0.03484399908904578
chr7	REPIN1	150369741	150369868	0	128	153	4590	153	4462	0.0	0.03428955625280143
chr7	REPIN1	150370713	150370884	0	172	153	4590	153	4418	0.0	0.03463105477591671
chr7	AC073111.3	150407583	150408488	204	906	408	4340	204	3434	0.2251655629139073	0.0594059405940594
chr7	LINC00996	150435029	150435157	0	129	0	2176	0	2047	0.0	0.0
chr7	GIMAP4	150569887	150570001	0	115	0	2102	0	1987	0.0	0.0
chr7	GIMAP4	150569887	150569959	0	73	0	2102	0	2029	0.0	0.0
chr7	TMEM176A	150804361	150804472	0	112	11121	2191	11121	2079	0.0	5.349206349206349
chr7	TMEM176A	150804361	150804485	0	125	11121	2191	11121	2066	0.0	5.382865440464666
chr7	AOC1	150853917	150854163	0	247	1864	3797	1864	3550	0.0	0.5250704225352113
chr7	NOS3	150993752	150993961	0	210	56	5947	56	5737	0.0	0.009761199233048632
chr7	ABCB8	151040267	151040301	70	35	140171	9139	140101	9104	2.0	15.388949912126538
chr7	ABCB8	151028800	151028911	0	112	140171	9139	140171	9027	0.0	15.527971640633655
chr7	ABCB8	151028779	151028852	0	74	140171	9139	140171	9065	0.0	15.462879205736348
chr7	ABCB8	151028779	151028911	0	133	140171	9139	140171	9006	0.0	15.564179435931601
chr7	ABCB8	151031240	151031291	0	52	140171	9139	140171	9087	0.0	15.4254429404644
chr7	ABCB8	151033604	151033917	0	314	140171	9139	140171	8825	0.0	15.883399433427762
chr7	ABCB8	151032843	151033061	0	219	140171	9139	140171	8920	0.0	15.714237668161434
chr7	ABCB8	151034272	151034428	0	157	140171	9139	140171	8982	0.0	15.605767089735025
chr7	ASIC3	151051171	151051319	0	149	27069	2756	27069	2607	0.0	10.383199079401612
chr7	ASIC3	151052415	151052474	0	60	27069	2756	27069	2696	0.0	10.040430267062314
chr7	AGAP3	151138142	151138313	0	172	306	10457	306	10285	0.0	0.02975206611570248
chr7	AGAP3	151119986	151120145	0	160	306	10457	306	10297	0.0	0.02971739341555793
chr7	AGAP3	151120519	151120745	0	227	306	10457	306	10230	0.0	0.029912023460410556
chr7	AGAP3	151120519	151120567	0	49	306	10457	306	10408	0.0	0.029400461183704842
chr7	AGAP3	151139978	151140116	0	139	306	10457	306	10318	0.0	0.029656910253925178
chr7	CHPF2	151234085	151234274	0	190	51	4210	51	4020	0.0	0.012686567164179104
chr7	CHPF2	151236955	151237172	0	218	51	4210	51	3992	0.0	0.01277555110220441
chr7	NUB1	151374096	151374201	0	106	562	5427	562	5321	0.0	0.10561924450291299
chr7	NUB1	151374096	151374243	0	148	562	5427	562	5279	0.0	0.10645955673422997
chr7	NUB1	151352092	151352193	0	102	562	5427	562	5325	0.0	0.10553990610328638
chr7	WDR86-AS1	151411227	151411312	0	86	48	1187	48	1101	0.0	0.043596730245231606
chr7	GALNTL5	151957782	151957886	0	105	414	3335	414	3230	0.0	0.1281733746130031
chr7	GALNT11	152100797	152100921	0	125	4941	7002	4941	6877	0.0	0.7184818961756579
chr7	GALNT11	152027596	152027718	147	123	4941	7002	4794	6879	1.1951219512195121	0.6969036197121675
chr7	GALNT11	152100824	152100921	0	98	4941	7002	4941	6904	0.0	0.7156720741599073
chr7	GALNT11	152116903	152117038	0	136	4941	7002	4941	6866	0.0	0.7196329740751529
chr7	ACTR3B	152783186	152783242	0	57	128	5081	128	5024	0.0	0.025477707006369428
chr7	PAXIP1-AS2	154928955	154929024	0	70	153	6944	153	6874	0.0	0.022257782950247308
chr7	HTR5A	155072192	155072441	0	250	306	4905	306	4655	0.0	0.0657357679914071
chr7	INSIG1	155303824	155303895	0	72	0	3328	0	3256	0.0	0.0
chr7	RBM33	155684932	155685052	0	121	51	13047	51	12926	0.0	0.003945536128732787
chr7	RBM33	155707293	155707380	0	88	51	13047	51	12959	0.0	0.00393548884944826
chr7	RNF32	156642976	156643087	255	112	3429	4235	3174	4123	2.2767857142857144	0.7698277952946884
chr7	RNF32	156646453	156646560	51	108	3429	4235	3378	4127	0.4722222222222222	0.8185122364913981
chr7	UBE3C	157164418	157164530	4495	113	186408	9218	181913	9105	39.7787610619469	19.979461834157057
chr7	DNAJB6	157369359	157369475	0	117	2601	10917	2601	10800	0.0	0.24083333333333334
chr7	DNAJB6	157337560	157337811	0	252	2601	10917	2601	10665	0.0	0.2438818565400844
chr7	PTPRN2-AS1	157855926	157856130	0	205	0	1585	0	1380	0.0	0.0
chr7	DYNC2I1	158922376	158922549	0	174	0	6714	0	6540	0.0	0.0
chr7	AC215522.2	26288	26402	51	115	153	1563	102	1448	0.4434782608695652	0.07044198895027624
chr7	AC215522.2	33680	33792	0	113	153	1563	153	1450	0.0	0.10551724137931034
chr7	AC093627.5	145293	145415	1142	123	105236	4819	104094	4696	9.284552845528456	22.166524701873936
chr7	PDGFA	500430	500499	0	70	0	4160	0	4090	0.0	0.0
chr7	PDGFA	518938	519068	0	131	0	4160	0	4029	0.0	0.0
chr7	ADAP1	900935	901031	18228	97	352582	4762	334354	4665	187.91752577319588	71.67288317256163
chr7	MICALL2	1437889	1437980	0	92	0	7681	0	7589	0.0	0.0
chr7	MICALL2	1435100	1435147	0	48	0	7681	0	7633	0.0	0.0
chr7	TMEM184A	1550122	1550198	0	77	7166	4053	7166	3976	0.0	1.8023138832997987
chr7	TMEM184A	1549546	1549604	0	59	7166	4053	7166	3994	0.0	1.7941912869303955
chr7	MAD1L1	2225409	2225550	0	142	7210	7267	7210	7125	0.0	1.0119298245614035
chr7	MAD1L1	2220883	2221022	1377	140	7210	7267	5833	7127	9.835714285714285	0.8184369299845657
chr7	MAD1L1	2230548	2230764	156	217	7210	7267	7054	7050	0.7188940092165899	1.0005673758865248
chr7	MAD1L1	2230548	2230724	156	177	7210	7267	7054	7090	0.8813559322033898	0.9949224259520452
chr7	MAD1L1	2230548	2230727	156	180	7210	7267	7054	7087	0.8666666666666667	0.9953435868491605
chr7	MRM2	2238014	2238937	612	924	2746	2892	2134	1968	0.6623376623376623	1.0843495934959348
chr7	SNX8	2337115	2337281	0	167	112203	5766	112203	5599	0.0	20.03982854081086
chr7	BRAT1	2539178	2539351	0	174	42	4242	42	4068	0.0	0.01032448377581121
chr7	BRAT1	2544908	2545056	0	149	42	4242	42	4093	0.0	0.010261421939897385
chr7	GNA12	2814311	2814389	0	79	19771	5912	19771	5833	0.0	3.3895079718841075
chr7	CARD11	2980519	2980580	0	62	351	4654	351	4592	0.0	0.07643728222996515
chr7	AC073316.1	3148980	3149068	0	89	0	1732	0	1643	0.0	0.0
chr7	MMD2	4909728	4909778	0	51	2346	2474	2346	2423	0.0	0.9682212133718531
chr7	TNRC18	5361593	5361722	0	130	36671	12605	36671	12475	0.0	2.939559118236473
chr7	TNRC18	5329936	5329969	0	34	36671	12605	36671	12571	0.0	2.917110810595816
chr7	ACTB	5529534	5529663	3688	130	29835	3559	26147	3429	28.369230769230768	7.625255176436279
chr7	ACTB	5529160	5529400	2310	241	29835	3559	27525	3318	9.5850622406639	8.295660036166366
chr7	ACTB	5529018	5529059	3460	42	29835	3559	26375	3517	82.38095238095238	7.499289166903611
chr7	ACTB	5529534	5529733	4886	200	29835	3559	24949	3359	24.43	7.427508186960405
chr7	ACTB	5540675	5540771	5535	97	29835	3559	24300	3462	57.06185567010309	7.0190641247833625
chr7	RNF216	5760390	5760511	0	122	4818	7601	4818	7479	0.0	0.6442037705575612
chr7	RNF216	5775004	5775179	0	176	4818	7601	4818	7425	0.0	0.6488888888888888
chr7	RSPH10B	5932781	5932875	0	95	30874	5015	30874	4920	0.0	6.2752032520325205
chr7	RSPH10B	5937757	5937901	0	145	30874	5015	30874	4870	0.0	6.339630390143737
chr7	RSPH10B	5945063	5945178	0	116	30874	5015	30874	4899	0.0	6.302102469891815
chr7	RSPH10B	5943910	5943990	0	81	30874	5015	30874	4934	0.0	6.257397648966356
chr7	RSPH10B	5958992	5959078	190	87	30874	5015	30684	4928	2.1839080459770117	6.226461038961039
chr7	RSPH10B	5967317	5967437	0	121	30874	5015	30874	4894	0.0	6.308541070698815
chr7	PMS2	6003689	6003792	0	104	940	5550	940	5446	0.0	0.17260374586852736
chr7	PMS2	6005891	6006031	0	141	940	5550	940	5409	0.0	0.17378443335182103
chr7	PMS2	6005891	6006026	0	136	940	5550	940	5414	0.0	0.1736239379386775
chr7	EIF2AK1	6046070	6046151	221	82	105313	4527	105092	4445	2.6951219512195124	23.642744656917884
chr7	EIF2AK1	6058147	6058242	0	96	105313	4527	105313	4431	0.0	23.767321146468067
chr7	DAGLB	6430479	6430607	0	129	26976	5365	26976	5236	0.0	5.152024446142093
chr7	DAGLB	6434761	6435020	5003	260	26976	5365	21973	5105	19.24230769230769	4.304211557296768
chr7	DAGLB	6432836	6432959	13371	124	26976	5365	13605	5241	107.83064516129032	2.595878649112765
chr7	DAGLB	6436361	6436533	92	173	26976	5365	26884	5192	0.5317919075144508	5.177966101694915
chr7	KDELR2	6466070	6466323	591	254	121023	3937	120432	3683	2.326771653543307	32.69942981265273
chr7	KDELR2	6482391	6482589	281	199	121023	3937	120742	3738	1.4120603015075377	32.30123060460139
chr7	CCZ1B	6796632	6796678	0	47	464	5850	464	5803	0.0	0.0799586420816819
chr7	CCZ1B	6812975	6813037	45	63	464	5850	419	5787	0.7142857142857143	0.07240366338344566
chr7	CCZ1B	6819765	6819941	0	177	464	5850	464	5673	0.0	0.08179093953816323
chr7	CCZ1B	6824454	6824548	204	95	464	5850	260	5755	2.1473684210526316	0.045178105994787145
chr7	COL28A1	7511651	7511844	0	194	1168	6312	1168	6118	0.0	0.19091206276560968
chr7	RPA3	7640319	7640581	357	263	1202	3101	845	2838	1.3574144486692015	0.2977448907681466
chr7	AC007161.1	7740685	7740842	0	158	0	1452	0	1294	0.0	0.0
chr7	ICA1	8227637	8227851	0	215	21696	4842	21696	4627	0.0	4.688999351631727
chr7	ICA1	8141968	8142055	0	88	21696	4842	21696	4754	0.0	4.563735801430375
chr7	ICA1	8223487	8223559	0	73	21696	4842	21696	4769	0.0	4.549381421681694
chr7	VWDE	12353814	12354487	0	674	3	6744	3	6070	0.0	0.0004942339373970346
chr7	VWDE	12345738	12345960	0	223	3	6744	3	6521	0.0	0.00046005213924244745
chr7	VWDE	12354349	12354487	0	139	3	6744	3	6605	0.0	0.0004542013626040878
chr7	VWDE	12388807	12388957	0	151	3	6744	3	6593	0.0	0.0004550280600637039
chr7	ETV1	13911238	13911307	0	70	484	9310	484	9240	0.0	0.05238095238095238
chr7	ETV1	13935707	13935896	204	190	484	9310	280	9120	1.0736842105263158	0.03070175438596491
chr7	ETV1	13977426	13977480	0	55	484	9310	484	9255	0.0	0.05229605618584549
chr7	ETV1	13989267	13989464	0	198	484	9310	484	9112	0.0	0.05311676909569798
chr7	ETV1	13990552	13990702	0	151	484	9310	484	9159	0.0	0.05284419696473414
chr7	ETV1	13907792	13907856	0	65	484	9310	484	9245	0.0	0.0523526230394808
chr7	DGKB	14753927	14753948	0	22	51	9521	51	9499	0.0	0.00536898620907464
chr7	DGKB	14841193	14841450	0	258	51	9521	51	9263	0.0	0.005505775666630681
chr7	CRPPA	16308522	16308627	150	106	3720	7208	3570	7102	1.4150943396226414	0.5026753027316249
chr7	CRPPA	16376091	16376241	0	151	3720	7208	3720	7057	0.0	0.5271361768456851
chr7	ANKMY2	16603548	16603660	0	113	827	2863	827	2750	0.0	0.30072727272727273
chr7	ANKMY2	16644625	16644812	0	188	827	2863	827	2675	0.0	0.3091588785046729
chr7	ANKMY2	16644684	16644812	0	129	827	2863	827	2734	0.0	0.3024871982443306
chr7	AGR3	16878509	16878645	0	137	0	1161	0	1024	0.0	0.0
chr7	AC073332.1	17295165	17295260	0	96	310	10260	310	10164	0.0	0.030499803227075954
chr7	AC073332.1	17291229	17291371	0	143	310	10260	310	10117	0.0	0.030641494514184048
chr7	AC073332.1	17292370	17292440	0	71	310	10260	310	10189	0.0	0.030424968102856022
chr7	AC073332.1	17287751	17287814	0	64	310	10260	310	10196	0.0	0.030404080031384857
chr7	AC073332.1	17295165	17295273	0	109	310	10260	310	10151	0.0	0.030538863166190523
chr7	AC019117.1	17459724	17459919	0	196	110	3525	110	3329	0.0	0.033042955842595374
chr7	AC019117.1	17482526	17482782	0	257	110	3525	110	3268	0.0	0.033659730722154224
chr7	AC019117.1	17482526	17482733	0	208	110	3525	110	3317	0.0	0.03316249623153452
chr7	AC019117.1	17481794	17481897	0	104	110	3525	110	3421	0.0	0.03215434083601286
chr7	SNX13	17893331	17893434	0	104	16416	16045	16416	15941	0.0	1.029797377830751
chr7	SNX13	17888559	17888722	0	164	16416	16045	16416	15881	0.0	1.0336880549083811
chr7	TMEM196	19724279	19724353	0	75	0	3555	0	3480	0.0	0.0
chr7	TMEM196	19724279	19724351	0	73	0	3555	0	3482	0.0	0.0
chr7	AC005062.1	19919865	19919977	0	113	45	3126	45	3013	0.0	0.014935280451377365
chr7	AC004130.2	20329689	20329782	0	94	0	900	0	806	0.0	0.0
chr7	SP8	20785947	20786043	0	97	0	3721	0	3624	0.0	0.0
chr7	CDCA7L	21911616	21911754	51	139	3220	3906	3169	3767	0.3669064748201439	0.8412529864613751
chr7	CDCA7L	21916753	21916894	0	142	3220	3906	3220	3764	0.0	0.8554729011689692
chr7	CDCA7L	21940261	21940315	166	55	3220	3906	3054	3851	3.018181818181818	0.7930407686315243
chr7	CDCA7L	21911616	21911751	51	136	3220	3906	3169	3770	0.375	0.8405835543766578
chr7	RAPGEF5	22191528	22191642	0	115	352	9098	352	8983	0.0	0.039185127462985636
chr7	STEAP1B	22495361	22495480	0	120	561	6324	561	6204	0.0	0.09042553191489362
chr7	STEAP1B	22655201	22655349	0	149	561	6324	561	6175	0.0	0.0908502024291498
chr7	TOMM7	22817411	22817548	0	138	0	1757	0	1619	0.0	0.0
chr7	TOMM7	22817999	22818048	0	50	0	1757	0	1707	0.0	0.0
chr7	FAM126A	22983943	22984045	4560	103	47076	7672	42516	7569	44.271844660194176	5.617122473246136
chr7	FAM126A	22991060	22991139	0	80	47076	7672	47076	7592	0.0	6.200737618545838
chr7	FAM126A	22946951	22947247	408	297	47076	7672	46668	7375	1.3737373737373737	6.327864406779661
chr7	FAM126A	22947032	22947247	192	216	47076	7672	46884	7456	0.8888888888888888	6.288090128755365
chr7	IGF2BP3	23319137	23319254	0	118	126079	8233	126079	8115	0.0	15.536537276648183
chr7	IGF2BP3	23343717	23343853	7713	137	126079	8233	118366	8096	56.2992700729927	14.620306324110672
chr7	IGF2BP3	23361689	23361741	0	53	126079	8233	126079	8180	0.0	15.413080684596578
chr7	TRA2A	23522131	23522432	2664	302	25245	3350	22581	3048	8.821192052980132	7.408464566929134
chr7	TRA2A	23531180	23531270	2022	91	25245	3350	23223	3259	22.21978021978022	7.125805461798097
chr7	TRA2A	23522353	23522432	0	80	25245	3350	25245	3270	0.0	7.720183486238532
chr7	GSDME	24749563	24749793	682	231	66838	7275	66156	7044	2.9523809523809526	9.391822827938672
chr7	OSBPL3	24806775	24806902	45	128	34494	8114	34449	7986	0.3515625	4.313673929376408
chr7	OSBPL3	24849068	24849176	0	109	34494	8114	34494	8005	0.0	4.309056839475328
chr7	OSBPL3	24863199	24863292	0	94	34494	8114	34494	8020	0.0	4.300997506234414
chr7	CYCS	25124689	25124844	1428	156	5263	5795	3835	5639	9.153846153846153	0.6800851214754389
chr7	CYCS	25124689	25124815	1428	127	5263	5795	3835	5668	11.244094488188976	0.676605504587156
chr7	C7ORF31	25179661	25179800	0	140	4131	3683	4131	3543	0.0	1.165961049957663
chr7	AC005165.1	25596313	25596364	0	52	3	5486	3	5434	0.0	0.0005520794994479205
chr7	AC005165.1	25656087	25656231	0	145	3	5486	3	5341	0.0	0.0005616925669350309
chr7	AC005165.1	25656087	25656286	0	200	3	5486	3	5286	0.0	0.0005675368898978433
chr7	AC005165.1	25656087	25656229	0	143	3	5486	3	5343	0.0	0.0005614823133071309
chr7	AC005165.1	25656087	25656261	0	175	3	5486	3	5311	0.0	0.000564865373752589
chr7	HNRNPA2B1	26193574	26193694	0	121	1337	8930	1337	8809	0.0	0.15177659212169373
chr7	HNRNPA2B1	26190992	26192338	367	1347	1337	8930	970	7583	0.27245731254639943	0.12791771066860083
chr7	HNRNPA2B1	26192494	26192577	194	84	1337	8930	1143	8846	2.3095238095238093	0.1292109427990052
chr7	HNRNPA2B1	26171679	26171847	0	169	1337	8930	1337	8761	0.0	0.15260814975459422
chr7	HNRNPA2B1	26190992	26191128	0	137	1337	8930	1337	8793	0.0	0.15205276924826566
chr7	HNRNPA2B1	26185198	26185279	0	82	1337	8930	1337	8848	0.0	0.15110759493670886
chr7	HNRNPA2B1	26197830	26197866	0	37	1337	8930	1337	8893	0.0	0.15034296637805014
chr7	HNRNPA2B1	26193250	26193373	0	124	1337	8930	1337	8806	0.0	0.1518282988871224
chr7	HNRNPA2B1	26193574	26193598	0	25	1337	8930	1337	8905	0.0	0.15014037057832677
chr7	HNRNPA2B1	26193598	26193694	0	97	1337	8930	1337	8833	0.0	0.15136420242273294
chr7	HNRNPA2B1	26192300	26192338	10	39	1337	8930	1327	8891	0.2564102564102564	0.1492520526374986
chr7	HNRNPA2B1	26191421	26191650	0	230	1337	8930	1337	8700	0.0	0.15367816091954023
chr7	HNRNPA2B1	26191421	26192338	367	918	1337	8930	970	8012	0.3997821350762527	0.12106839740389416
chr7	HOXA3	27126885	27127070	0	186	1224	4315	1224	4129	0.0	0.296439815936062
chr7	HIBADH	27649472	27649633	0	162	51	2220	51	2058	0.0	0.02478134110787172
chr7	JAZF1	28101618	28101804	0	187	74784	4271	74784	4084	0.0	18.311459353574925
chr7	JAZF1	27914729	27914808	0	80	74784	4271	74784	4191	0.0	17.843951324266285
chr7	JAZF1	27913391	27913453	0	63	74784	4271	74784	4208	0.0	17.771863117870723
chr7	CPVL	29066022	29066121	0	100	0	3356	0	3256	0.0	0.0
chr7	CPVL	29064060	29064234	0	175	0	3356	0	3181	0.0	0.0
chr7	CPVL	29184420	29184548	0	129	0	3356	0	3227	0.0	0.0
chr7	AC007255.1	29561858	29561922	0	65	0	1444	0	1379	0.0	0.0
chr7	SCRN1	29968908	29969068	0	161	2341	6059	2341	5898	0.0	0.39691420820617157
chr7	FKBP14	30022664	30022816	51	153	2028	5349	1977	5196	0.3333333333333333	0.3804849884526559
chr7	FKBP14	30020212	30020304	0	93	2028	5349	2028	5256	0.0	0.3858447488584475
chr7	NOD1	30459151	30459240	0	90	11994	6096	11994	6006	0.0	1.997002997002997
chr7	NOD1	30428503	30428609	0	107	11994	6096	11994	5989	0.0	2.002671564534981
chr7	NOD1	30463985	30464061	0	77	11994	6096	11994	6019	0.0	1.992689815583984
chr7	NOD1	30475847	30475988	74	142	11994	6096	11920	5954	0.5211267605633803	2.0020154517971114
chr7	NOD1	30463608	30463698	663	91	11994	6096	11331	6005	7.285714285714286	1.8869275603663613
chr7	GGCT	30498802	30498938	6040	137	10362	1599	4322	1462	44.08759124087591	2.9562243502051984
chr7	GGCT	30500535	30500681	14	147	10362	1599	10348	1452	0.09523809523809523	7.126721763085399
chr7	GGCT	30497740	30497896	0	157	10362	1599	10362	1442	0.0	7.185852981969487
chr7	GARS1-DT	30551317	30551395	0	79	50780	12139	50780	12060	0.0	4.2106135986733
chr7	GARS1-DT	30552099	30552179	0	81	50780	12139	50780	12058	0.0	4.211311992038481
chr7	GARS1-DT	30551317	30551479	0	163	50780	12139	50780	11976	0.0	4.240146960587842
chr7	GARS1-DT	30584710	30584808	680	99	50780	12139	50100	12040	6.8686868686868685	4.161129568106312
chr7	GARS1-DT	30576563	30576710	2082	148	50780	12139	48698	11991	14.067567567567568	4.0612125760987405
chr7	GARS1-DT	30584422	30584453	0	32	50780	12139	50780	12107	0.0	4.194267778970843
chr7	GARS1-DT	30579005	30579128	51	124	50780	12139	50729	12015	0.4112903225806452	4.22213899292551
chr7	GARS1-DT	30577648	30578091	918	444	50780	12139	49862	11695	2.0675675675675675	4.263531423685335
chr7	CRHR2	30654697	30654808	479	112	65480	3787	65001	3675	4.276785714285714	17.68734693877551
chr7	CRHR2	30686388	30686615	0	228	65480	3787	65480	3559	0.0	18.39842652430458
chr7	LSM5	32489463	32489600	0	138	0	4281	0	4143	0.0	0.0
chr7	RP9P	32928561	32928691	1638	131	11276	1440	9638	1309	12.50381679389313	7.362872421695951
chr7	RP9P	32933813	32933896	0	84	11276	1440	11276	1356	0.0	8.315634218289086
chr7	NT5C3A	33029628	33029714	1928	87	235894	3108	233966	3021	22.160919540229884	77.44654088050315
chr7	NT5C3A	33035933	33035988	28190	56	235894	3108	207704	3052	503.39285714285717	68.05504587155963
chr7	NT5C3A	33029628	33029709	1888	82	235894	3108	234006	3026	23.024390243902438	77.33179114342366
chr7	AC008080.4	33796701	33796809	0	109	0	2834	0	2725	0.0	0.0
chr7	AC008080.4	33795904	33796129	0	226	0	2834	0	2608	0.0	0.0
chr7	NPSR1-AS1	34704079	34704199	0	121	0	7122	0	7001	0.0	0.0
chr7	DPY19L1	34937993	34938119	0	127	26277	6265	26277	6138	0.0	4.2810361681329425
chr7	DPY19L1	34957983	34958070	0	88	26277	6265	26277	6177	0.0	4.254006799417192
chr7	DPY19L2P1	35102916	35103030	0	115	9964	7663	9964	7548	0.0	1.320084790673026
chr7	HERPUD2	35673200	35673278	21660	79	25345	3420	3685	3341	274.17721518987344	1.102963184675247
chr7	HERPUD2	35670214	35670328	911	115	25345	3420	24434	3305	7.921739130434783	7.393040847201211
chr7	SEPTIN7-DT	35755732	35755817	0	86	478	4118	478	4032	0.0	0.1185515873015873
chr7	SEPTIN7-DT	35763764	35763909	0	146	478	4118	478	3972	0.0	0.1203423967774421
chr7	KIAA0895	36336153	36336297	0	145	6796	4862	6796	4717	0.0	1.440746237015052
chr7	KIAA0895	36356901	36357590	0	690	6796	4862	6796	4172	0.0	1.6289549376797698
chr7	AOAH	36686698	36686794	0	97	22	3544	22	3447	0.0	0.006382361473745286
chr7	AOAH	36514471	36514590	0	120	22	3544	22	3424	0.0	0.006425233644859813
chr7	AOAH	36690096	36690180	0	85	22	3544	22	3459	0.0	0.006360219716681122
chr7	ELMO1	36887559	36887672	0	114	57	9599	57	9485	0.0	0.006009488666315234
chr7	ELMO1	37244355	37244391	0	37	57	9599	57	9562	0.0	0.005961096005019871
chr7	ELMO1	37033346	37033412	0	67	57	9599	57	9532	0.0	0.005979857322702476
chr7	ELMO1	37217711	37217756	0	46	57	9599	57	9553	0.0	0.005966712027635298
chr7	ELMO1	37393821	37393917	0	97	57	9599	57	9502	0.0	0.005998737107977268
chr7	AMPH	38417824	38417950	0	127	7067	5513	7067	5386	0.0	1.312105458596361
chr7	AMPH	38429055	38429577	6722	523	7067	5513	345	4990	12.852772466539196	0.06913827655310621
chr7	AMPH	38420911	38421016	0	106	7067	5513	7067	5407	0.0	1.3070094322174959
chr7	VPS41	38830253	38830328	94	76	55061	7789	54967	7713	1.236842105263158	7.12653960845326
chr7	VPS41	38898090	38898129	0	40	55061	7789	55061	7749	0.0	7.105562008001033
chr7	VPS41	38728340	38728434	0	95	55061	7789	55061	7694	0.0	7.156355601767611
chr7	VPS41	38796414	38796526	21187	113	55061	7789	33874	7676	187.49557522123894	4.412975508077124
chr7	GLI3	42150019	42150183	0	165	3268	13825	3268	13660	0.0	0.23923865300146413
chr7	GLI3	42145437	42145606	0	170	3268	13825	3268	13655	0.0	0.2393262541193702
chr7	GLI3	42150019	42150102	0	84	3268	13825	3268	13741	0.0	0.2378283967687941
chr7	PSMA2	42926535	42926668	1012	134	18893	8384	17881	8250	7.552238805970149	2.167393939393939
chr7	PSMA2	42927382	42927459	2510	78	18893	8384	16383	8306	32.17948717948718	1.972429568986275
chr7	AC010132.3	42911039	42911193	112	155	4840	3926	4728	3771	0.7225806451612903	1.2537788385043755
chr7	AC010132.3	42912058	42912552	153	495	4840	3926	4687	3431	0.3090909090909091	1.366074030894783
chr7	AC005537.1	43028337	43028395	0	59	308412	5165	308412	5106	0.0	60.40188014101057
chr7	AC005537.1	43044546	43044620	0	75	308412	5165	308412	5090	0.0	60.59174852652259
chr7	AC005537.1	43037484	43037598	0	115	308412	5165	308412	5050	0.0	61.07168316831683
chr7	AC005537.1	43075021	43075063	0	43	308412	5165	308412	5122	0.0	60.213197969543145
chr7	COA1	43650611	43650712	61	102	227059	11833	226998	11731	0.5980392156862745	19.350268519307818
chr7	COA1	43665657	43665722	10919	66	227059	11833	216140	11767	165.43939393939394	18.3683181779553
chr7	COA1	43650492	43650712	493	221	227059	11833	226566	11612	2.230769230769231	19.511367550809506
chr7	COA1	43711399	43711449	0	51	227059	11833	227059	11782	0.0	19.27168562213546
chr7	URGCP	43887414	43887485	0	72	477514	7095	477514	7023	0.0	67.99288053538373
chr7	URGCP	43887789	43887816	0	28	477514	7095	477514	7067	0.0	67.56954860619783
chr7	URGCP	43887789	43887811	0	23	477514	7095	477514	7072	0.0	67.52177601809954
chr7	POLR2J4	43969731	43969861	175	131	186911	7433	186736	7302	1.3358778625954197	25.573267597918377
chr7	POLR2J4	44014605	44014783	59	179	186911	7433	186852	7254	0.329608938547486	25.758478081058726
chr7	RASA4CP	44036671	44036809	2447	139	86609	4067	84162	3928	17.60431654676259	21.426171079429736
chr7	POLM	44074130	44074233	0	104	24049	4453	24049	4349	0.0	5.52977696022074
chr7	POLM	44076508	44076629	756	122	24049	4453	23293	4331	6.19672131147541	5.378203648118218
chr7	POLM	44079860	44079959	2667	100	24049	4453	21382	4353	26.67	4.91201470250402
chr7	POLM	44078321	44078438	746	118	24049	4453	23303	4335	6.322033898305085	5.375547866205306
chr7	POLM	44074130	44074220	0	91	24049	4453	24049	4362	0.0	5.513296652911508
chr7	POLM	44079570	44079741	2492	172	24049	4453	21557	4281	14.488372093023257	5.035505722961925
chr7	POLM	44080364	44080471	51	108	24049	4453	23998	4345	0.4722222222222222	5.523130034522439
chr7	POLD2	44122281	44122459	0	179	65038	3708	65038	3529	0.0	18.429583451402664
chr7	MYL7	44140711	44140787	0	77	33	1463	33	1386	0.0	0.023809523809523808
chr7	MYL7	44140711	44140856	0	146	33	1463	33	1317	0.0	0.025056947608200455
chr7	MYL7	44140711	44140827	0	117	33	1463	33	1346	0.0	0.02451708766716196
chr7	GCK	44158072	44158196	4745	125	36395	5074	31650	4949	37.96	6.395231359870681
chr7	CAMK2B	44232821	44232866	0	46	13326	7658	13326	7612	0.0	1.7506568575932737
chr7	CAMK2B	44234389	44234461	0	73	13326	7658	13326	7585	0.0	1.756888595912986
chr7	CAMK2B	44239588	44239663	0	76	13326	7658	13326	7582	0.0	1.757583750989185
chr7	CAMK2B	44240706	44240749	10599	44	13326	7658	2727	7614	240.88636363636363	0.35815602836879434
chr7	NPC1L1	44518585	44518666	0	82	1258	5287	1258	5205	0.0	0.24169068203650337
chr7	NPC1L1	44533738	44533853	0	116	1258	5287	1258	5171	0.0	0.24327982982015084
chr7	DDX56	44570757	44570877	0	121	669	3948	669	3827	0.0	0.1748105565717272
chr7	DDX56	44572889	44573050	0	162	669	3948	669	3786	0.0	0.17670364500792393
chr7	DDX56	44572889	44573046	0	158	669	3948	669	3790	0.0	0.17651715039577837
chr7	TMED4	44581092	44581239	0	148	0	3773	0	3625	0.0	0.0
chr7	H2AZ2	44840898	44841012	814736	115	835037	7009	20301	6894	7084.660869565218	2.94473455178416
chr7	H2AZ2	44843276	44843354	108	79	835037	7009	834929	6930	1.3670886075949367	120.48037518037518
chr7	H2AZ2	44835528	44835658	6490	131	835037	7009	828547	6878	49.541984732824424	120.46336144227973
chr7	MYO1G	44976862	44977071	0	210	88	8668	88	8458	0.0	0.010404350910380705
chr7	SNHG15	44984356	44984426	0	71	0	3016	0	2945	0.0	0.0
chr7	SNHG15	44986020	44986097	0	78	0	3016	0	2938	0.0	0.0
chr7	SNHG15	44985881	44986097	0	217	0	3016	0	2799	0.0	0.0
chr7	SNHG15	44984356	44986097	0	1742	0	3016	0	1274	0.0	0.0
chr7	TBRG4	45110744	45110877	1683	134	76990	5038	75307	4904	12.559701492537313	15.356239804241435
chr7	SEPTIN7P2	45746826	45746948	0	123	5722	4161	5722	4038	0.0	1.4170381376919268
chr7	SEPTIN7P2	45756908	45756992	850	85	5722	4161	4872	4076	10.0	1.1952894995093228
chr7	SEPTIN7P2	45726183	45726236	16	54	5722	4161	5706	4107	0.2962962962962963	1.389335281227173
chr7	SEPTIN7P2	45728831	45729026	102	196	5722	4161	5620	3965	0.5204081632653061	1.4174022698612863
chr7	SEPTIN7P2	45765705	45765812	4548	108	5722	4161	1174	4053	42.111111111111114	0.28966197878114974
chr7	TNS3	47405497	47405559	0	63	8485	11804	8485	11741	0.0	0.722681202623286
chr7	HUS1	47971259	47971516	0	258	0	2928	0	2670	0.0	0.0
chr7	HUS1	47976214	47976421	0	208	0	2928	0	2720	0.0	0.0
chr7	SUN3	47991009	47991045	0	37	11847	1742	11847	1705	0.0	6.948387096774193
chr7	SUN3	48018498	48018596	568	99	11847	1742	11279	1643	5.737373737373737	6.86488131466829
chr7	FIGNL1	50449555	50449723	0	169	0	1093	0	924	0.0	0.0
chr7	FIGNL1	50448180	50448289	0	110	0	1093	0	983	0.0	0.0
chr7	FIGNL1	50449562	50449723	0	162	0	1093	0	931	0.0	0.0
chr7	FIGNL1	50449117	50449723	0	607	0	1093	0	486	0.0	0.0
chr7	FIGNL1	50447967	50448055	0	89	0	1093	0	1004	0.0	0.0
chr7	FIGNL1	50449544	50449723	0	180	0	1093	0	913	0.0	0.0
chr7	FIGNL1	50449499	50449723	0	225	0	1093	0	868	0.0	0.0
chr7	DDC	50499147	50499242	102	96	377	3104	275	3008	1.0625	0.09142287234042554
chr7	DDC	50528136	50528280	0	145	377	3104	377	2959	0.0	0.12740790807705304
chr7	DDC	50539914	50540028	0	115	377	3104	377	2989	0.0	0.12612914018066243
chr7	DDC	50529207	50529342	0	136	377	3104	377	2968	0.0	0.12702156334231807
chr7	DDC	50537859	50537979	224	121	377	3104	153	2983	1.8512396694214877	0.05129064699966477
chr7	GRB10	50616209	50616347	0	139	266	9680	266	9541	0.0	0.027879677182685254
chr7	GRB10	50703820	50703908	0	89	266	9680	266	9591	0.0	0.027734334271713065
chr7	GRB10	50755886	50756056	0	171	266	9680	266	9509	0.0	0.027973498790619413
chr7	GRB10	50732271	50732368	0	98	266	9680	266	9582	0.0	0.02776038405343352
chr7	GRB10	50780626	50780736	0	111	266	9680	266	9569	0.0	0.027798098024871983
chr7	GRB10	50710874	50710990	0	117	266	9680	266	9563	0.0	0.027815539056781344
chr7	GRB10	50705139	50705323	0	185	266	9680	266	9495	0.0	0.02801474460242233
chr7	COBL	51083057	51083228	0	172	255	14368	255	14196	0.0	0.017962806424344887
chr7	COBL	51172455	51172530	0	76	255	14368	255	14292	0.0	0.017842149454240133
chr7	COBL	51187913	51187958	0	46	255	14368	255	14322	0.0	0.017804775869291998
chr7	LINC01446	53691926	53692089	0	164	0	7300	0	7136	0.0	0.0
chr7	LINC01446	53776487	53776628	0	142	0	7300	0	7158	0.0	0.0
chr7	LINC01446	53771433	53771607	0	175	0	7300	0	7125	0.0	0.0
chr7	LINC01446	53811507	53811574	0	68	0	7300	0	7232	0.0	0.0
chr7	LINC01446	53811507	53811571	0	65	0	7300	0	7235	0.0	0.0
chr7	LINC01446	53710831	53710894	0	64	0	7300	0	7236	0.0	0.0
chr7	LINC01446	53780156	53780230	0	75	0	7300	0	7225	0.0	0.0
chr7	LINC01446	53692330	53692473	0	144	0	7300	0	7156	0.0	0.0
chr7	LINC01446	53780777	53780868	0	92	0	7300	0	7208	0.0	0.0
chr7	LINC01446	53769915	53770065	0	151	0	7300	0	7149	0.0	0.0
chr7	LINC02854	53934921	53935007	0	87	2148	775	2148	688	0.0	3.122093023255814
chr7	SEC61G	54757494	54757594	0	101	0	1847	0	1746	0.0	0.0
chr7	VOPP1	55497612	55497690	0	79	71485	5361	71485	5282	0.0	13.53369935630443
chr7	VOPP1	55561979	55562051	96	73	71485	5361	71389	5288	1.3150684931506849	13.50018910741301
chr7	VOPP1	55530828	55530911	388	84	71485	5361	71097	5277	4.619047619047619	13.472996020466175
chr7	PSPH	56033380	56033494	0	115	160693	2748	160693	2633	0.0	61.030383592859856
chr7	PSPH	56043147	56043261	0	115	160693	2748	160693	2633	0.0	61.030383592859856
chr7	PHKG1	56084148	56084244	0	97	84762	2773	84762	2676	0.0	31.67488789237668
chr7	PHKG1	56086969	56087024	1104	56	84762	2773	83658	2717	19.714285714285715	30.790577843209423
chr7	PHKG1	56087597	56087776	214	180	84762	2773	84548	2593	1.1888888888888889	32.606247589664484
chr7	AC092447.7	56428384	56428441	0	58	161	1842	161	1784	0.0	0.09024663677130045
chr7	AC092634.4	63891751	63891805	2	55	155	1871	153	1816	0.03636363636363636	0.0842511013215859
chr7	AC092634.4	63891073	63891220	0	148	155	1871	155	1723	0.0	0.08995937318630295
chr7	ZNF680	64544305	64544432	51	128	53716	5567	53665	5439	0.3984375	9.86670343813201
chr7	GUSB	65970281	65970366	47	86	1598	3830	1551	3744	0.5465116279069767	0.41426282051282054
chr7	GUSB	65974918	65975071	0	154	1598	3830	1598	3676	0.0	0.43471164309031557
chr7	GUSB	65979726	65979911	0	186	1598	3830	1598	3644	0.0	0.43852908891328213
chr7	GUSB	65979398	65979541	123	144	1598	3830	1475	3686	0.8541666666666666	0.4001627780792187
chr7	GUSB	65980223	65980409	1203	187	1598	3830	395	3643	6.433155080213904	0.10842712050507823
chr7	GUSB	65979833	65979911	0	79	1598	3830	1598	3751	0.0	0.426019728072514
chr7	GUSB	65979385	65979541	175	157	1598	3830	1423	3673	1.1146496815286624	0.3874217261094473
chr7	LINC00174	66395878	66395956	0	79	187780	11077	187780	10998	0.0	17.07401345699218
chr7	LINC00174	66429678	66429757	0	80	187780	11077	187780	10997	0.0	17.075566063471857
chr7	LINC00174	66439134	66439304	0	171	187780	11077	187780	10906	0.0	17.218045112781954
chr7	LINC00174	66480393	66480448	41	56	187780	11077	187739	11021	0.7321428571428571	17.034661101533437
chr7	LINC00174	66487948	66488038	0	91	187780	11077	187780	10986	0.0	17.092663389768795
chr7	LINC00174	66401194	66401394	0	201	187780	11077	187780	10876	0.0	17.26553880102979
chr7	LINC00174	66455658	66455853	0	196	187780	11077	187780	10881	0.0	17.257604999540483
chr7	LINC00174	66432739	66432851	0	113	187780	11077	187780	10964	0.0	17.126960963152133
chr7	LINC00174	66492273	66492339	70	67	187780	11077	187710	11010	1.044776119402985	17.049046321525886
chr7	AC006001.3	66560578	66560675	0	98	13688	5901	13688	5803	0.0	2.3587799414096158
chr7	AC006001.3	66576754	66576932	0	179	13688	5901	13688	5722	0.0	2.3921705697308635
chr7	PMS2P4	67296936	67297049	0	114	51	851	51	737	0.0	0.06919945725915876
chr7	CALN1	72403250	72403442	0	193	820	10007	820	9814	0.0	0.08355410637864276
chr7	CALN1	72412057	72412275	45	219	820	10007	775	9788	0.2054794520547945	0.0791785860237025
chr7	TYW1B	72810470	72810665	0	196	7693	3277	7693	3081	0.0	2.4969165855241804
chr7	TYW1B	72807065	72807356	0	292	7693	3277	7693	2985	0.0	2.577219430485762
chr7	NSUN5P2	72949312	72949491	0	180	13027	1874	13027	1694	0.0	7.690082644628099
chr7	NSUN5P2	72952151	72952295	6513	145	13027	1874	6514	1729	44.91724137931035	3.767495662232504
chr7	STAG3L3	73000357	73000481	0	125	429	3267	429	3142	0.0	0.13653723742838955
chr7	STAG3L3	72999054	72999162	0	109	429	3267	429	3158	0.0	0.1358454718176061
chr7	BCL7B	73537933	73538013	0	81	50528	3073	50528	2992	0.0	16.887700534759357
chr7	BCL7B	73539881	73540052	0	172	50528	3073	50528	2901	0.0	17.41744226128921
chr7	BCL7B	73543547	73543644	0	98	50528	3073	50528	2975	0.0	16.984201680672268
chr7	BCL7B	73552166	73552242	0	77	50528	3073	50528	2996	0.0	16.865153538050734
chr7	BCL7B	73542829	73542907	0	79	50528	3073	50528	2994	0.0	16.876419505678022
chr7	BCL7B	73553547	73553669	0	123	50528	3073	50528	2950	0.0	17.12813559322034
chr7	TBL2	73574382	73574513	0	132	148	4171	148	4039	0.0	0.03664273334983907
chr7	TBL2	73574382	73574571	0	190	148	4171	148	3981	0.0	0.037176588796784725
chr7	TBL2	73576540	73576701	0	162	148	4171	148	4009	0.0	0.03691693689199302
chr7	TBL2	73574382	73574804	0	423	148	4171	148	3748	0.0	0.03948772678762007
chr7	TBL2	73577972	73578267	0	296	148	4171	148	3875	0.0	0.03819354838709677
chr7	MLXIPL	73596638	73596789	1632	152	67917	4671	66285	4519	10.736842105263158	14.66806815667183
chr7	MLXIPL	73596638	73596786	1576	149	67917	4671	66341	4522	10.577181208053691	14.670720919946927
chr7	ABHD11	73737220	73737391	0	172	286	2293	286	2121	0.0	0.13484205563413484
chr7	ABHD11	73736928	73737220	0	293	286	2293	286	2000	0.0	0.143
chr7	ABHD11	73736928	73737110	0	183	286	2293	286	2110	0.0	0.13554502369668248
chr7	ABHD11	73737220	73737360	0	141	286	2293	286	2152	0.0	0.13289962825278812
chr7	ABHD11	73737875	73738072	102	198	286	2293	184	2095	0.5151515151515151	0.08782816229116945
chr7	METTL27	73840413	73840549	0	137	0	1456	0	1319	0.0	0.0
chr7	RFC2	74249011	74249118	48	108	6726	2224	6678	2116	0.4444444444444444	3.155954631379962
chr7	RFC2	74252428	74252498	34	71	6726	2224	6692	2153	0.4788732394366197	3.10822108685555
chr7	RFC2	74246661	74246763	574	103	6726	2224	6152	2121	5.572815533980583	2.9005186232909006
chr7	RFC2	74233774	74233894	682	121	6726	2224	6044	2103	5.636363636363637	2.8739895387541607
chr7	RFC2	74249011	74249220	48	210	6726	2224	6678	2014	0.22857142857142856	3.3157894736842106
chr7	RFC2	74253598	74253717	102	120	6726	2224	6624	2104	0.85	3.1482889733840302
chr7	AC211433.1	74722734	74722788	0	55	2565	2928	2565	2873	0.0	0.8927949878176122
chr7	GTF2IRD2	74849111	74850290	102	1180	7780	7923	7678	6743	0.08644067796610169	1.1386623164763459
chr7	STAG3L2	74882851	74883041	0	191	648	2335	648	2144	0.0	0.30223880597014924
chr7	STAG3L2	74883727	74883835	0	109	648	2335	648	2226	0.0	0.29110512129380056
chr7	STAG3L2	74885022	74885146	51	125	648	2335	597	2210	0.408	0.2701357466063348
chr7	STAG3L2	74888561	74888700	0	140	648	2335	648	2195	0.0	0.29521640091116175
chr7	POM121C	75426361	75426453	0	93	430	8814	430	8721	0.0	0.049306272216488936
chr7	POM121C	75484197	75484256	0	60	430	8814	430	8754	0.0	0.04912040210189628
chr7	PMS2P3	75512308	75512421	1934	114	5260	1455	3326	1341	16.964912280701753	2.4802386278896345
chr7	TMEM120A	75987537	75987602	301	66	85419	1694	85118	1628	4.5606060606060606	52.28378378378378
chr7	TMEM120A	75987922	75987984	0	63	85419	1694	85419	1631	0.0	52.37216431637032
chr7	TMEM120A	75989164	75989224	0	61	85419	1694	85419	1633	0.0	52.30802204531537
chr7	STYXL1	76000889	76001002	0	114	5727	1888	5727	1774	0.0	3.2282976324689967
chr7	STYXL1	76013741	76013887	799	147	5727	1888	4928	1741	5.4353741496598635	2.8305571510626075
chr7	STYXL1	76021850	76021992	357	143	5727	1888	5370	1745	2.4965034965034967	3.0773638968481376
chr7	POMZP3	76618496	76618615	0	120	6357	1868	6357	1748	0.0	3.6367276887871856
chr7	FAM185BP	77109544	77109662	0	119	0	1292	0	1173	0.0	0.0
chr7	GSAP	77321332	77321403	203	72	59178	8592	58975	8520	2.8194444444444446	6.921948356807512
chr7	GSAP	77323646	77323742	0	97	59178	8592	59178	8495	0.0	6.966215420835786
chr7	APTR	77661197	77661333	0	137	153	5920	153	5783	0.0	0.02645685630295694
chr7	APTR	77685201	77685328	0	128	153	5920	153	5792	0.0	0.02641574585635359
chr7	APTR	77684089	77684251	0	163	153	5920	153	5757	0.0	0.026576341844710787
chr7	MAGI2	78135020	78135206	0	187	284	25254	284	25067	0.0	0.011329636573981729
chr7	MAGI2	78185628	78185670	0	43	284	25254	284	25211	0.0	0.011264924041093173
chr7	MAGI2	78065573	78065662	0	90	284	25254	284	25164	0.0	0.011285964075663646
chr7	MAGI2	78026067	78026104	0	38	284	25254	284	25216	0.0	0.01126269035532995
chr7	MAGI2	78583420	78583494	80	75	284	25254	204	25179	1.0666666666666667	0.0081019897533659
chr7	MAGI2	78554566	78554671	0	106	284	25254	284	25148	0.0	0.01129314458406235
chr7	MAGI2	78345443	78345572	0	130	284	25254	284	25124	0.0	0.011303932494825664
chr7	AC004862.1	80362114	80362224	0	111	129213	3489	129213	3378	0.0	38.251332149200714
chr7	AC004862.1	80360523	80360645	0	123	129213	3489	129213	3366	0.0	38.38770053475936
chr7	AC004862.1	80374340	80374460	41930	121	129213	3489	87283	3368	346.5289256198347	25.915380047505938
chr7	AC004862.1	80381850	80382060	769	211	129213	3489	128444	3278	3.6445497630331753	39.183648566198904
chr7	AC004862.1	80384848	80384979	1615	132	129213	3489	127598	3357	12.234848484848484	38.00953232052428
chr7	AC004862.1	80389914	80390011	0	98	129213	3489	129213	3391	0.0	38.104688882335594
chr7	SEMA3C	80905828	80905916	0	89	0	6126	0	6037	0.0	0.0
chr7	AC008163.1	81528428	81528576	0	149	22673	5496	22673	5347	0.0	4.240321675706003
chr7	AC008163.1	81567908	81568065	0	158	22673	5496	22673	5338	0.0	4.247470962907456
chr7	AC008163.1	81586879	81586983	225	105	22673	5496	22448	5391	2.142857142857143	4.16397699870154
chr7	AC008163.1	81586946	81586983	0	38	22673	5496	22673	5458	0.0	4.154085745694394
chr7	AC008163.1	81583119	81583270	45	152	22673	5496	22628	5344	0.29605263157894735	4.234281437125748
chr7	AC008163.1	81624372	81624443	0	72	22673	5496	22673	5424	0.0	4.180125368731564
chr7	AC008163.1	81625151	81625226	0	76	22673	5496	22673	5420	0.0	4.183210332103321
chr7	CACNA2D1	81983313	81983334	0	22	867	9032	867	9010	0.0	0.09622641509433963
chr7	CACNA2D1	82001658	82001715	0	58	867	9032	867	8974	0.0	0.09661243592600847
chr7	PCLO	82835666	82835693	0	28	654	21068	654	21040	0.0	0.031083650190114068
chr7	PCLO	82821111	82821294	0	184	654	21068	654	20884	0.0	0.03131583987741812
chr7	PCLO	82848867	82848921	0	55	654	21068	654	21013	0.0	0.031123590158473324
chr7	PCLO	82868106	82868195	0	90	654	21068	654	20978	0.0	0.031175517208504148
chr7	SEMA3E	83616611	83616712	0	102	475	8472	475	8370	0.0	0.05675029868578255
chr7	SEMA3A	84489095	84489182	0	88	0	9086	0	8998	0.0	0.0
chr7	ELAPOR2	86947726	86947922	0	197	0	7850	0	7653	0.0	0.0
chr7	ELAPOR2	86964903	86965024	0	122	0	7850	0	7728	0.0	0.0
chr7	ELAPOR2	86941351	86941385	0	35	0	7850	0	7815	0.0	0.0
chr7	ELAPOR2	86911621	86911695	0	75	0	7850	0	7775	0.0	0.0
chr7	TP53TG1	87345042	87345233	0	192	0	5876	0	5684	0.0	0.0
chr7	TP53TG1	87329934	87330094	0	161	0	5876	0	5715	0.0	0.0
chr7	ABCB4	87411892	87412033	0	142	27069	7393	27069	7251	0.0	3.7331402565163425
chr7	ABCB4	87448633	87448706	51	74	27069	7393	27018	7319	0.6891891891891891	3.691487908184178
chr7	ABCB1	87566784	87566976	0	193	19041	6455	19041	6262	0.0	3.0407218141168957
chr7	SLC25A40	87836729	87836810	2930	82	567384	4907	564454	4825	35.73170731707317	116.98528497409326
chr7	SLC25A40	87843753	87843863	144	111	567384	4907	567240	4796	1.2972972972972974	118.27356130108424
chr7	SLC25A40	87841931	87842041	703	111	567384	4907	566681	4796	6.333333333333333	118.1570058381985
chr7	SLC25A40	87860071	87860169	0	99	567384	4907	567384	4808	0.0	118.00831946755407
chr7	SRI	88218858	88218942	0	85	0	3757	0	3672	0.0	0.0
chr7	SRI	88214794	88214936	0	143	0	3757	0	3614	0.0	0.0
chr7	STEAP4	88282640	88283168	0	529	0	11254	0	10725	0.0	0.0
chr7	STEAP4	88290915	88291014	0	100	0	11254	0	11154	0.0	0.0
chr7	MTERF1	91880054	91880113	0	60	51422	4878	51422	4818	0.0	10.672893316728933
chr7	MTERF1	91876877	91876978	1326	102	51422	4878	50096	4776	13.0	10.489112227805695
chr7	MTERF1	91876877	91876926	1222	50	51422	4878	50200	4828	24.44	10.3976801988401
chr7	KRIT1	92225719	92225827	51	109	208648	5947	208597	5838	0.46788990825688076	35.73090099349092
chr7	KRIT1	92234448	92234592	25420	145	208648	5947	183228	5802	175.31034482758622	31.580144777662873
chr7	KRIT1	92244001	92244149	8885	149	208648	5947	199763	5798	59.630872483221474	34.453777164539495
chr7	LRRD1	92159004	92159203	0	200	121453	4457	121453	4257	0.0	28.530185576697203
chr7	LRRD1	92163285	92165276	119650	1992	121453	4457	1803	2465	60.06526104417671	0.7314401622718053
chr7	KRIT1	92245426	92245595	0	170	208648	5947	208648	5777	0.0	36.11701575212048
chr7	TMBIM7P	92428012	92428066	0	55	121	2049	121	1994	0.0	0.06068204613841525
chr7	TMBIM7P	92429369	92429448	0	80	121	2049	121	1969	0.0	0.061452513966480445
chr7	PEX1	92504731	92504902	0	172	1034	7210	1034	7038	0.0	0.14691673770957658
chr7	PEX1	92509328	92509411	84	84	1034	7210	950	7126	1.0	0.13331462250912152
chr7	FAM133B	92566013	92566061	0	49	89	4492	89	4443	0.0	0.02003151024082827
chr7	FAM133B	92585297	92585396	0	100	89	4492	89	4392	0.0	0.020264116575591986
chr7	FAM133B	92566009	92566061	0	53	89	4492	89	4439	0.0	0.020049560711872045
chr7	SAMD9	93114794	93114895	0	102	102	6858	102	6756	0.0	0.015097690941385435
chr7	SAMD9L	93146882	93147146	0	265	0	2461	0	2196	0.0	0.0
chr7	SAMD9L	93147087	93147146	0	60	0	2461	0	2401	0.0	0.0
chr7	SAMD9L	93145908	93146040	0	133	0	2461	0	2328	0.0	0.0
chr7	HEPACAM2	93197372	93197397	0	26	261	2492	261	2466	0.0	0.10583941605839416
chr7	HEPACAM2	93225882	93225951	90	70	261	2492	171	2422	1.2857142857142858	0.07060280759702725
chr7	CALCR	93462062	93462110	0	49	1136	4055	1136	4006	0.0	0.2835746380429356
chr7	CALCR	93495903	93495974	0	72	1136	4055	1136	3983	0.0	0.2852121516444891
chr7	CALCR	93441499	93441549	0	51	1136	4055	1136	4004	0.0	0.2837162837162837
chr7	BET1	93994351	93994385	0	35	0	5238	0	5203	0.0	0.0
chr7	SGCE	94618757	94618956	644	200	695	11980	51	11780	3.22	0.00432937181663837
chr7	SGCE	94587777	94587812	0	36	695	11980	695	11944	0.0	0.05818821165438714
chr7	SGCE	94598774	94598963	0	190	695	11980	695	11790	0.0	0.058948261238337574
chr7	SGCE	94599696	94599723	0	28	695	11980	695	11952	0.0	0.05814926372155288
chr7	SGCE	94600645	94600857	0	213	695	11980	695	11767	0.0	0.059063482620888924
chr7	SGCE	94622545	94622626	0	82	695	11980	695	11898	0.0	0.05841317868549336
chr7	SGCE	94628201	94628359	0	159	695	11980	695	11821	0.0	0.05879367227814906
chr7	SGCE	94629718	94629841	0	124	695	11980	695	11856	0.0	0.05862010796221322
chr7	SGCE	94588688	94588732	0	45	695	11980	695	11935	0.0	0.05823209049015501
chr7	SGCE	94587777	94587884	0	108	695	11980	695	11872	0.0	0.0585411051212938
chr7	SGCE	94639340	94639448	0	109	695	11980	695	11871	0.0	0.05854603655968326
chr7	SGCE	94597929	94598004	0	76	695	11980	695	11904	0.0	0.05838373655913978
chr7	SGCE	94587777	94588732	0	956	695	11980	695	11024	0.0	0.06304426705370102
chr7	SGCE	94644605	94644667	0	63	695	11980	695	11917	0.0	0.05832004699169254
chr7	SGCE	94640896	94640964	0	69	695	11980	695	11911	0.0	0.05834942490135169
chr7	SGCE	94587777	94587849	0	73	695	11980	695	11907	0.0	0.058369026622994875
chr7	SGCE	94597748	94598004	0	257	695	11980	695	11723	0.0	0.05928516591316216
chr7	SGCE	94618757	94618932	644	176	695	11980	51	11804	3.659090909090909	0.0043205692985428664
chr7	SGCE	94597748	94597839	0	92	695	11980	695	11888	0.0	0.058462314939434726
chr7	SGCE	94594431	94594546	0	116	695	11980	695	11864	0.0	0.058580579905596765
chr7	SGCE	94621848	94621995	0	148	695	11980	695	11832	0.0	0.05873901284651792
chr7	SGCE	94622515	94622626	0	112	695	11980	695	11868	0.0	0.0585608358611392
chr7	SGCE	94587777	94587809	0	33	695	11980	695	11947	0.0	0.05817360006696242
chr7	SGCE	94599326	94599400	0	75	695	11980	695	11905	0.0	0.05837883242335153
chr7	SGCE	94597923	94598004	0	82	695	11980	695	11898	0.0	0.05841317868549336
chr7	SGCE	94618757	94618935	644	179	695	11980	51	11801	3.5977653631284916	0.00432166765528345
chr7	SGCE	94629718	94629821	0	104	695	11980	695	11876	0.0	0.05852138767261704
chr7	PON3	95367361	95367488	0	128	0	4129	0	4001	0.0	0.0
chr7	PON3	95390153	95390209	0	57	0	4129	0	4072	0.0	0.0
chr7	PON2	95424514	95424585	0	72	153	3559	153	3487	0.0	0.043877258388299395
chr7	PON2	95434258	95434333	0	76	153	3559	153	3483	0.0	0.04392764857881137
chr7	PON2	95415147	95415272	0	126	153	3559	153	3433	0.0	0.04456743373143024
chr7	SLC25A13	96234801	96234917	0	117	771	3638	771	3521	0.0	0.21897188298778755
chr7	SEM1	96484824	96484854	0	31	102	11514	102	11483	0.0	0.008882696159540189
chr7	SEM1	96496283	96496341	0	59	102	11514	102	11455	0.0	0.008904408555216063
chr7	SEM1	96656456	96656585	0	130	102	11514	102	11384	0.0	0.008959943780744906
chr7	SEM1	96558116	96558256	0	141	102	11514	102	11373	0.0	0.008968609865470852
chr7	SEM1	96637239	96637306	0	68	102	11514	102	11446	0.0	0.008911410099598113
chr7	SEM1	96694797	96694891	0	95	102	11514	102	11419	0.0	0.008932480952797969
chr7	DLX6-AS1	96978346	96979591	0	1246	459	16178	459	14932	0.0	0.03073935172783284
chr7	DLX6-AS1	97011824	97012303	0	480	459	16178	459	15698	0.0	0.029239393553318893
chr7	DLX6-AS1	96979489	96979587	0	99	459	16178	459	16079	0.0	0.028546551402450403
chr7	DLX6-AS1	96979083	96979587	0	505	459	16178	459	15673	0.0	0.029286033305684935
chr7	DLX6-AS1	97012180	97012303	0	124	459	16178	459	16054	0.0	0.028591005356920395
chr7	DLX6-AS1	96979083	96979591	0	509	459	16178	459	15669	0.0	0.02929350947731189
chr7	AC079781.5	97908794	97909011	0	218	48076	5190	48076	4972	0.0	9.66934835076428
chr7	AC079781.5	97945507	97945615	48	109	48076	5190	48028	5081	0.44036697247706424	9.452469986223184
chr7	ASNS	97871718	97871996	0	279	18578	4867	18578	4588	0.0	4.04925893635571
chr7	ASNS	97868907	97869105	51	199	18578	4867	18527	4668	0.2562814070351759	3.9689374464438734
chr7	ASNS	97869777	97869813	32	37	18578	4867	18546	4830	0.8648648648648649	3.839751552795031
chr7	TECPR1	98245921	98246165	0	245	0	8184	0	7939	0.0	0.0
chr7	TMEM130	98863094	98863400	408	307	3696	4279	3288	3972	1.3289902280130292	0.8277945619335347
chr7	TMEM130	98860178	98860338	1530	161	3696	4279	2166	4118	9.503105590062113	0.5259834871296746
chr7	SMURF1	99050914	99050992	1994	79	159845	6304	157851	6225	25.240506329113924	25.357590361445784
chr7	AC004834.1	99299463	99299666	0	204	537	4618	537	4414	0.0	0.12165835976438605
chr7	AC004834.1	99305588	99305769	0	182	537	4618	537	4436	0.0	0.12105500450856628
chr7	ATP5MF-PTCD1	99441389	99441487	0	99	0	2870	0	2771	0.0	0.0
chr7	ATP5MF	99459146	99459263	0	118	0	2117	0	1999	0.0	0.0
chr7	ATP5MF	99460085	99460193	0	109	0	2117	0	2008	0.0	0.0
chr7	ZNF394	99498715	99498842	3014	128	22831	7765	19817	7637	23.546875	2.5948670944087993
chr7	CYP3A5	99672783	99672915	13210	133	358841	8312	345631	8179	99.32330827067669	42.25834454089742
chr7	CYP3A5	99671770	99671878	0	109	358841	8312	358841	8203	0.0	43.74509325856394
chr7	CYP3A5	99676316	99676576	3657	261	358841	8312	355184	8051	14.011494252873563	44.11675568252391
chr7	CYP3A4	99761775	99761868	36	94	25610	3400	25574	3306	0.3829787234042553	7.735632183908046
chr7	TRIM4	99916701	99916779	5715	79	26339	4841	20624	4762	72.34177215189874	4.330953380932382
chr7	ZNF3	100077302	100077433	0	132	194299	5432	194299	5300	0.0	36.66018867924528
chr7	ZNF3	100079535	100079656	585	122	194299	5432	193714	5310	4.795081967213115	36.48097928436911
chr7	ZNF3	100077228	100077433	0	206	194299	5432	194299	5226	0.0	37.17929582854956
chr7	ZNF3	100079535	100079572	0	38	194299	5432	194299	5394	0.0	36.02131998516871
chr7	TAF6	100113348	100113405	0	58	120	3852	120	3794	0.0	0.0316288877174486
chr7	TAF6	100118517	100118649	0	133	120	3852	120	3719	0.0	0.032266738370529714
chr7	TAF6	100116513	100116633	0	121	120	3852	120	3731	0.0	0.032162958992227285
chr7	TAF6	100116513	100116612	0	100	120	3852	120	3752	0.0	0.031982942430703626
chr7	MAP11	100156385	100156549	357	165	8804	2975	8447	2810	2.1636363636363636	3.006049822064057
chr7	MAP11	100157632	100157762	765	131	8804	2975	8039	2844	5.8396946564885495	2.826652601969058
chr7	GAL3ST4	100166501	100166805	324	305	17397	2633	17073	2328	1.062295081967213	7.333762886597938
chr7	GPC2	100175571	100175894	23483	324	70016	3469	46533	3145	72.47839506172839	14.795866454689984
chr7	CASTOR3	100213046	100213133	0	88	43848	4870	43848	4782	0.0	9.169385194479297
chr7	CASTOR3	100223569	100223698	1002	130	43848	4870	42846	4740	7.707692307692308	9.039240506329113
chr7	CASTOR3	100222596	100222720	0	125	43848	4870	43848	4745	0.0	9.240885142255005
chr7	PMS2P1	100332441	100332581	0	141	0	5373	0	5232	0.0	0.0
chr7	PMS2P1	100325690	100325868	0	179	0	5373	0	5194	0.0	0.0
chr7	PMS2P1	100330181	100330284	0	104	0	5373	0	5269	0.0	0.0
chr7	PMS2P1	100330908	100331040	0	133	0	5373	0	5240	0.0	0.0
chr7	PMS2P1	100325690	100325779	0	90	0	5373	0	5283	0.0	0.0
chr7	PMS2P1	100330908	100331043	0	136	0	5373	0	5237	0.0	0.0
chr7	PMS2P1	100332441	100332576	0	136	0	5373	0	5237	0.0	0.0
chr7	PMS2P1	100328835	100329019	0	185	0	5373	0	5188	0.0	0.0
chr7	PMS2P1	100330908	100330961	0	54	0	5373	0	5319	0.0	0.0
chr7	PMS2P1	100335205	100335428	0	224	0	5373	0	5149	0.0	0.0
chr7	PMS2P1	100330908	100331204	0	297	0	5373	0	5076	0.0	0.0
chr7	PMS2P1	100334971	100335428	204	458	0	5373	-204	4915	0.44541484716157204	-0.04150559511698881
chr7	ZCWPW1	100401888	100402041	70	154	267160	3336	267090	3182	0.45454545454545453	83.9377749842866
chr7	ZCWPW1	100405012	100405093	67715	82	267160	3336	199445	3254	825.7926829268292	61.29225568531039
chr7	ZCWPW1	100402515	100402576	1218	62	267160	3336	265942	3274	19.64516129032258	81.22846670739158
chr7	PPP1R35	100435630	100435767	42	138	2335	1121	2293	983	0.30434782608695654	2.3326551373346898
chr7	LRCH4	100577085	100577154	0	70	0	5999	0	5929	0.0	0.0
chr7	TFR2	100629252	100629372	0	121	30	4851	30	4730	0.0	0.006342494714587738
chr7	TFR2	100631498	100631596	0	99	30	4851	30	4752	0.0	0.006313131313131313
chr7	ACTL6B	100655802	100655879	0	78	357	2389	357	2311	0.0	0.15447858070099524
chr7	GIGYF1	100689301	100689555	0	255	102	6865	102	6610	0.0	0.015431164901664145
chr7	EPHB4	100805165	100805321	1616	157	973180	6454	971564	6297	10.292993630573248	154.28997935524853
chr7	ACHE	100892333	100892554	0	222	31893	3736	31893	3514	0.0	9.075981787137165
chr7	ACHE	100892333	100892818	408	486	31893	3736	31485	3250	0.8395061728395061	9.687692307692307
chr7	ACHE	100892707	100892818	172	112	31893	3736	31721	3624	1.5357142857142858	8.7530353200883
chr7	ACHE	100891168	100891338	90	171	31893	3736	31803	3565	0.5263157894736842	8.920897615708276
chr7	ACHE	100892333	100892643	115	311	31893	3736	31778	3425	0.36977491961414793	9.278248175182481
chr7	ACHE	100892686	100892818	193	133	31893	3736	31700	3603	1.4511278195488722	8.798223702470164
chr7	ACHE	100896139	100896281	0	143	31893	3736	31893	3593	0.0	8.876426384636794
chr7	NAT16	101179096	101179136	0	41	51	3890	51	3849	0.0	0.013250194855806703
chr7	MOGAT3	101196186	101196389	0	204	0	2258	0	2054	0.0	0.0
chr7	PLOD3	101207577	101207724	0	148	51	5401	51	5253	0.0	0.009708737864077669
chr7	PLOD3	101212529	101212655	0	127	51	5401	51	5274	0.0	0.009670079635949944
chr7	PLOD3	101217165	101217418	0	254	51	5401	51	5147	0.0	0.00990868467068195
chr7	CLDN15	101234277	101234442	0	166	51	2635	51	2469	0.0	0.020656136087484813
chr7	CLDN15	101236746	101236886	0	141	51	2635	51	2494	0.0	0.02044907778668805
chr7	CLDN15	101233872	101234116	0	245	51	2635	51	2390	0.0	0.021338912133891212
chr7	CLDN15	101234277	101234373	0	97	51	2635	51	2538	0.0	0.02009456264775414
chr7	FIS1	101240141	101240247	0	107	0	1800	0	1693	0.0	0.0
chr7	FIS1	101244006	101244139	0	134	0	1800	0	1666	0.0	0.0
chr7	IFT22	101318123	101318213	0	91	153	3810	153	3719	0.0	0.04114009142242538
chr7	IFT22	101318955	101319032	0	78	153	3810	153	3732	0.0	0.0409967845659164
chr7	IFT22	101321426	101321499	0	74	153	3810	153	3736	0.0	0.04095289079229122
chr7	IFT22	101318955	101319063	0	109	153	3810	153	3701	0.0	0.041340178330181034
chr7	MYL10	101623919	101624021	0	103	204	1059	204	956	0.0	0.21338912133891214
chr7	RASA4B	102483824	102483889	0	66	284	7327	284	7261	0.0	0.03911306982509296
chr7	RASA4B	102490985	102491123	0	139	284	7327	284	7188	0.0	0.03951029493600445
chr7	POLR2J3	102569834	102569924	51	91	51	3918	0	3827	0.5604395604395604	0.0
chr7	POLR2J3	102568009	102568184	0	176	51	3918	51	3742	0.0	0.013629075360769643
chr7	POLR2J3	102566581	102566736	0	156	51	3918	51	3762	0.0	0.013556618819776715
chr7	RASA4	102583003	102583068	0	66	0	8099	0	8033	0.0	0.0
chr7	RASA4	102590158	102590296	0	139	0	8099	0	7960	0.0	0.0
chr7	RASA4	102602323	102602405	0	83	0	8099	0	8016	0.0	0.0
chr7	RASA4	102605857	102605987	0	131	0	8099	0	7968	0.0	0.0
chr7	RASA4	102611085	102611142	0	58	0	8099	0	8041	0.0	0.0
chr7	FBXL13	102931880	102931933	0	54	13904	4038	13904	3984	0.0	3.4899598393574296
chr7	FBXL13	103028599	103028748	0	150	13904	4038	13904	3888	0.0	3.5761316872427984
chr7	FBXL13	102822382	102822440	30	59	13904	4038	13874	3979	0.5084745762711864	3.4868057300829354
chr7	FBXL13	103055087	103055178	0	92	13904	4038	13904	3946	0.0	3.523568170299037
chr7	FBXL13	102832839	102832974	0	136	13904	4038	13904	3902	0.0	3.5633008713480265
chr7	FBXL13	102854776	102854860	1071	85	13904	4038	12833	3953	12.6	3.246395142929421
chr7	FBXL13	103046808	103047020	0	213	13904	4038	13904	3825	0.0	3.635032679738562
chr7	DPY19L2P2	103184001	103184127	0	127	51	5606	51	5479	0.0	0.0093082679321044
chr7	DPY19L2P2	103238802	103238871	0	70	51	5606	51	5536	0.0	0.00921242774566474
chr7	DPY19L2P2	103226213	103226379	0	167	51	5606	51	5439	0.0	0.009376723662437948
chr7	DPY19L2P2	103258443	103258592	0	150	51	5606	51	5456	0.0	0.0093475073313783
chr7	DPY19L2P2	103278244	103278346	0	103	51	5606	51	5503	0.0	0.009267672178811557
chr7	DPY19L2P2	103279832	103279894	51	63	51	5606	0	5543	0.8095238095238095	0.0
chr7	DNAJC2	103324481	103324562	0	82	88	5991	88	5909	0.0	0.014892536808258588
chr7	DNAJC2	103327331	103327378	0	48	88	5991	88	5943	0.0	0.01480733636210668
chr7	SLC26A5	103378445	103378553	0	109	27	3428	27	3319	0.0	0.008134980415787888
chr7	SLC26A5	103380479	103380549	0	71	27	3428	27	3357	0.0	0.00804289544235925
chr7	SLC26A5	103389328	103389424	0	97	27	3428	27	3331	0.0	0.008105673971780246
chr7	SLC26A5	103392918	103393066	0	149	27	3428	27	3279	0.0	0.008234217749313814
chr7	SLC26A5	103413001	103413112	0	112	27	3428	27	3316	0.0	0.008142340168878166
chr7	SLC26A5	103390428	103390506	0	79	27	3428	27	3349	0.0	0.008062108091967751
chr7	RELN	103478388	103478394	0	7	207	12852	207	12845	0.0	0.016115219929933828
chr7	RELN	103478388	103478524	0	137	207	12852	207	12715	0.0	0.0162799842705466
chr7	ORC5	104202410	104202544	0	135	106	3741	106	3606	0.0	0.029395452024403773
chr7	ORC5	104202376	104202544	0	169	106	3741	106	3572	0.0	0.02967525195968645
chr7	LHFPL3-AS1	104798336	104798407	0	72	17779	3053	17779	2981	0.0	5.9641060046964105
chr7	SRPK2	105125781	105125874	0	94	36413	5398	36413	5304	0.0	6.865196078431373
chr7	SRPK2	105126247	105126340	14	94	36413	5398	36399	5304	0.14893617021276595	6.862556561085973
chr7	SRPK2	105268805	105268869	0	65	36413	5398	36413	5333	0.0	6.827864241515095
chr7	PUS7	105462213	105462427	0	215	135	4451	135	4236	0.0	0.03186968838526912
chr7	PUS7	105505954	105506056	84	103	135	4451	51	4348	0.8155339805825242	0.011729530818767249
chr7	EFCAB10	105567466	105567490	0	25	2040	2585	2040	2560	0.0	0.796875
chr7	EFCAB10	105569406	105569571	0	166	2040	2585	2040	2419	0.0	0.8433236874741629
chr7	ATXN7L1	105624074	105624267	0	194	1790	8314	1790	8120	0.0	0.2204433497536946
chr7	ATXN7L1	105639486	105639569	0	84	1790	8314	1790	8230	0.0	0.2174969623329283
chr7	ATXN7L1	105875811	105875880	0	70	1790	8314	1790	8244	0.0	0.2171276079573023
chr7	ATXN7L1	105617791	105618097	0	307	1790	8314	1790	8007	0.0	0.22355438990882978
chr7	ATXN7L1	105649406	105649560	260	155	1790	8314	1530	8159	1.6774193548387097	0.18752298075744578
chr7	SYPL1	106092547	106092669	0	123	0	2483	0	2360	0.0	0.0
chr7	SYPL1	106092563	106092669	0	107	0	2483	0	2376	0.0	0.0
chr7	SYPL1	106096292	106096302	0	11	0	2483	0	2472	0.0	0.0
chr7	AC004917.1	106520728	106520819	0	92	25	2096	25	2004	0.0	0.0124750499001996
chr7	AC004917.1	106591549	106591682	0	134	25	2096	25	1962	0.0	0.0127420998980632
chr7	COG5	107256731	107256794	4090	64	30553	8422	26463	8358	63.90625	3.1661880832735103
chr7	SLC26A4-AS1	107654610	107654816	0	207	204	8534	204	8327	0.0	0.024498618950402305
chr7	SLC26A4-AS1	107654643	107654816	0	174	204	8534	204	8360	0.0	0.024401913875598084
chr7	SLC26A3	107773919	107774153	0	235	0	3403	0	3168	0.0	0.0
chr7	LAMB1	107929411	107929619	0	209	51	15924	51	15715	0.0	0.0032453070314985683
chr7	LAMB1	107936278	107936373	0	96	51	15924	51	15828	0.0	0.0032221379833206974
chr7	LAMB1	107939988	107940358	0	371	51	15924	51	15553	0.0	0.0032791101395229214
chr7	LAMB1	107959248	107959480	0	233	51	15924	51	15691	0.0	0.0032502708559046588
chr7	LAMB1	107998356	107998492	0	137	51	15924	51	15787	0.0	0.003230506112624311
chr7	LAMB1	108002126	108002384	0	259	51	15924	51	15665	0.0	0.003255665496329397
chr7	LAMB4	108030805	108030979	0	175	2106	7058	2106	6883	0.0	0.30597123347377597
chr7	NRCAM	108175321	108175357	0	37	6762	8273	6762	8236	0.0	0.8210296260320544
chr7	NRCAM	108191253	108191283	0	31	6762	8273	6762	8242	0.0	0.8204319339966027
chr7	NRCAM	108225644	108225701	0	58	6762	8273	6762	8215	0.0	0.8231284236153378
chr7	NRCAM	108237751	108237769	0	19	6762	8273	6762	8254	0.0	0.8192391567724739
chr7	NRCAM	108166920	108167073	0	154	6762	8273	6762	8119	0.0	0.8328611898016998
chr7	NRCAM	108168276	108168402	0	127	6762	8273	6762	8146	0.0	0.8301006629020378
chr7	PNPLA8	108521475	108521521	0	47	0	5688	0	5641	0.0	0.0
chr7	PNPLA8	108514435	108515574	0	1140	0	5688	0	4548	0.0	0.0
chr7	PNPLA8	108518189	108518301	0	113	0	5688	0	5575	0.0	0.0
chr7	PNPLA8	108514435	108515447	0	1013	0	5688	0	4675	0.0	0.0
chr7	PNPLA8	108514143	108514293	0	151	0	5688	0	5537	0.0	0.0
chr7	THAP5	108565829	108566022	0	194	0	5062	0	4868	0.0	0.0
chr7	THAP5	108565951	108566022	0	72	0	5062	0	4990	0.0	0.0
chr7	AC073114.1	110432810	110432906	0	97	0	3082	0	2985	0.0	0.0
chr7	IMMP2L	110886592	110886695	0	104	0	3465	0	3361	0.0	0.0
chr7	IMMP2L	111532517	111532585	0	69	0	3465	0	3396	0.0	0.0
chr7	DOCK4	111732225	111732287	0	63	2808	11836	2808	11773	0.0	0.23851184914635182
chr7	DOCK4	111742012	111742132	0	121	2808	11836	2808	11715	0.0	0.23969270166453266
chr7	DOCK4	111782863	111782924	0	62	2808	11836	2808	11774	0.0	0.23849159164260234
chr7	DOCK4	111784096	111784123	0	28	2808	11836	2808	11808	0.0	0.23780487804878048
chr7	DOCK4	111735053	111735167	0	115	2808	11836	2808	11721	0.0	0.23957000255950858
chr7	DOCK4	111840762	111840870	0	109	2808	11836	2808	11727	0.0	0.23944742900997698
chr7	TMEM168	112783697	112784953	0	1257	0	7838	0	6581	0.0	0.0
chr7	TMEM168	112788453	112788544	0	92	0	7838	0	7746	0.0	0.0
chr7	TMEM168	112783697	112783783	0	87	0	7838	0	7751	0.0	0.0
chr7	BMT2	112935186	112935264	0	79	0	4104	0	4025	0.0	0.0
chr7	HRAT17	112986535	112986664	0	130	51	3836	51	3706	0.0	0.013761467889908258
chr7	HRAT17	112977143	112977199	0	57	51	3836	51	3779	0.0	0.01349563376554644
chr7	HRAT17	112980045	112980164	0	120	51	3836	51	3716	0.0	0.01372443487621098
chr7	HRAT17	112973604	112973672	0	69	51	3836	51	3767	0.0	0.013538624900451287
chr7	HRAT17	112982986	112983141	0	156	51	3836	51	3680	0.0	0.013858695652173913
chr7	HRAT17	112980903	112981161	0	259	51	3836	51	3577	0.0	0.01425775789767962
chr7	GPR85	113085991	113086109	0	119	0	7246	0	7127	0.0	0.0
chr7	GPR85	113085991	113086106	0	116	0	7246	0	7130	0.0	0.0
chr7	TFEC	115974169	115974256	0	88	0	3858	0	3770	0.0	0.0
chr7	AC073130.1	116284367	116284406	0	40	0	2565	0	2525	0.0	0.0
chr7	COMETT	116600790	116600934	0	145	0	1698	0	1553	0.0	0.0
chr7	WNT2	117315070	117315348	0	279	0	4366	0	4087	0.0	0.0
chr7	WNT2	117300844	117301156	0	313	0	4366	0	4053	0.0	0.0
chr7	WNT2	117315070	117315284	0	215	0	4366	0	4151	0.0	0.0
chr7	ASZ1	117385697	117385809	0	113	0	3062	0	2949	0.0	0.0
chr7	ASZ1	117422236	117422359	0	124	0	3062	0	2938	0.0	0.0
chr7	CTTNBP2	117725051	117725257	0	207	51	6668	51	6461	0.0	0.007893514935768457
chr7	CTTNBP2	117746012	117746099	0	88	51	6668	51	6580	0.0	0.007750759878419453
chr7	CTTNBP2	117786385	117786425	0	41	51	6668	51	6627	0.0	0.007695789950203712
chr7	TSPAN12	120814004	120814247	0	244	0	3274	0	3030	0.0	0.0
chr7	FAM3C	121380208	121380264	0	57	206	3406	206	3349	0.0	0.061510898775753955
chr7	AASS	122081499	122081595	0	97	0	6223	0	6126	0.0	0.0
chr7	AASS	122098744	122098866	0	123	0	6223	0	6100	0.0	0.0
chr7	AASS	122082787	122082891	0	105	0	6223	0	6118	0.0	0.0
chr7	AASS	122098748	122098866	0	119	0	6223	0	6104	0.0	0.0
chr7	AASS	122079148	122079327	0	180	0	6223	0	6043	0.0	0.0
chr7	CADPS2	122393195	122393315	0	121	204	6398	204	6277	0.0	0.03249960172056715
chr7	CADPS2	122414067	122414076	0	10	204	6398	204	6388	0.0	0.031934877896055106
chr7	CADPS2	122480851	122480860	0	10	204	6398	204	6388	0.0	0.031934877896055106
chr7	CADPS2	122436359	122436380	0	22	204	6398	204	6376	0.0	0.031994981179422836
chr7	CADPS2	122386294	122386309	0	16	204	6398	204	6382	0.0	0.03196490128486368
chr7	SLC13A1	123186695	123186749	2733	55	22765	4420	20032	4365	49.69090909090909	4.589232531500572
chr7	SLC13A1	123190457	123190613	11246	157	22765	4420	11519	4263	71.63057324840764	2.702087731644382
chr7	IQUB	123479794	123479970	0	177	0	4300	0	4123	0.0	0.0
chr7	NDUFA5	123550469	123550586	0	118	408	7705	408	7587	0.0	0.053776196124950576
chr7	NDUFA5	123557403	123557448	0	46	408	7705	408	7659	0.0	0.053270661966314144
chr7	NDUFA5	123550469	123550584	0	116	408	7705	408	7589	0.0	0.05376202398207933
chr7	NDUFA5	123551367	123551576	0	210	408	7705	408	7495	0.0	0.054436290860573715
chr7	NDUFA5	123557403	123557507	0	105	408	7705	408	7600	0.0	0.05368421052631579
chr7	NDUFA5	123553669	123553756	0	88	408	7705	408	7617	0.0	0.05356439543127216
chr7	NDUFA5	123546657	123546817	0	161	408	7705	408	7544	0.0	0.05408271474019088
chr7	NDUFA5	123546582	123546817	0	236	408	7705	408	7469	0.0	0.054625786584549474
chr7	NDUFA5	123544734	123544761	0	28	408	7705	408	7677	0.0	0.05314576006252442
chr7	NDUFA5	123544729	123544761	0	33	408	7705	408	7672	0.0	0.053180396246089674
chr7	ASB15-AS1	123622973	123623160	0	188	0	1738	0	1550	0.0	0.0
chr7	POT1	124829253	124829342	0	90	0	8237	0	8147	0.0	0.0
chr7	POT1	124870910	124871041	0	132	0	8237	0	8105	0.0	0.0
chr7	POT1	124915573	124915646	0	74	0	8237	0	8163	0.0	0.0
chr7	POT1	124835278	124835414	0	137	0	8237	0	8100	0.0	0.0
chr7	POT1	124848539	124848659	0	121	0	8237	0	8116	0.0	0.0
chr7	POT1	124865128	124865299	0	172	0	8237	0	8065	0.0	0.0
chr7	POT1	124882442	124882466	0	25	0	8237	0	8212	0.0	0.0
chr7	POT1	124897459	124897595	0	137	0	8237	0	8100	0.0	0.0
chr7	GRM8	126701756	126701827	0	72	306	6186	306	6114	0.0	0.050049067713444556
chr7	GRM8	126445235	126445453	0	219	306	6186	306	5967	0.0	0.05128205128205128
chr7	RBM28	128325817	128325891	85	75	611879	15885	611794	15810	1.1333333333333333	38.6966476913346
chr7	RBM28	128338249	128338342	0	94	611879	15885	611879	15791	0.0	38.74859096953961
chr7	RBM28	128341117	128341219	338	103	611879	15885	611541	15782	3.2815533980582523	38.74927132175897
chr7	PRRT4	128361305	128361422	700	118	2536	3551	1836	3433	5.932203389830509	0.5348092047771629
chr7	IMPDH1	128393721	128393738	0	18	1343013	3677	1343013	3659	0.0	367.04372779447937
chr7	IMPDH1	128405766	128405865	822	100	1343013	3677	1342191	3577	8.22	375.2281241263629
chr7	IMPDH1	128400816	128400891	0	76	1343013	3677	1343013	3601	0.0	372.9555678978062
chr7	IMPDH1	128409440	128409484	49630	45	1343013	3677	1293383	3632	1102.888888888889	356.107654185022
chr7	IMPDH1	128409288	128409366	101241	79	1343013	3677	1241772	3598	1281.5316455696202	345.1284046692607
chr7	IMPDH1	128400831	128400891	0	61	1343013	3677	1343013	3616	0.0	371.40846238938053
chr7	IMPDH1	128409288	128409352	82353	65	1343013	3677	1260660	3612	1266.9692307692308	349.01993355481727
chr7	KCP	128864901	128865010	765	110	7674	12575	6909	12465	6.954545454545454	0.5542719614921781
chr7	KCP	128879717	128879829	0	113	7674	12575	7674	12462	0.0	0.6157920077034184
chr7	TNPO3	128986728	128986920	0	193	3989	4700	3989	4507	0.0	0.8850676725094297
chr7	TNPO3	129041556	129041717	0	162	3989	4700	3989	4538	0.0	0.8790215954164831
chr7	UBE2H	129865014	129865065	0	52	69967	6527	69967	6475	0.0	10.805714285714286
chr7	UBE2H	129948958	129949102	0	145	69967	6527	69967	6382	0.0	10.963177687245377
chr7	ZC3HC1	130023510	130023723	0	214	26856	3026	26856	2812	0.0	9.55049786628734
chr7	ZC3HC1	130050442	130050488	0	47	26856	3026	26856	2979	0.0	9.01510574018127
chr7	ZC3HC1	130036649	130036966	23042	318	26856	3026	3814	2708	72.45911949685535	1.4084194977843427
chr7	TMEM209	130178401	130178527	0	127	0	4570	0	4443	0.0	0.0
chr7	CEP41	130400038	130400254	0	217	2981	12794	2981	12577	0.0	0.23701995706448278
chr7	CEP41	130416918	130416966	264	49	2981	12794	2717	12745	5.387755102040816	0.21318163985876815
chr7	CEP41	130427954	130428018	0	65	2981	12794	2981	12729	0.0	0.23418964569094194
chr7	CEP41	130426645	130426759	0	115	2981	12794	2981	12679	0.0	0.2351131792728133
chr7	CEP41	130426628	130426759	0	132	2981	12794	2981	12662	0.0	0.23542884220502291
chr7	CEP41	130427395	130427482	0	88	2981	12794	2981	12706	0.0	0.23461356839288525
chr7	CEP41	130413455	130413569	0	115	2981	12794	2981	12679	0.0	0.2351131792728133
chr7	CEP41	130433868	130434041	0	174	2981	12794	2981	12620	0.0	0.23621236133122028
chr7	CEP41	130403030	130403091	0	62	2981	12794	2981	12732	0.0	0.2341344643418159
chr7	TSGA13	130686261	130686308	0	48	428	2204	428	2156	0.0	0.19851576994434136
chr7	TSGA13	130686261	130686373	0	113	428	2204	428	2091	0.0	0.20468675274988044
chr7	LINC-PINT	131052424	131052555	0	132	2795	8484	2795	8352	0.0	0.33465038314176243
chr7	AC016831.6	130872459	130872639	51	181	2081	10992	2030	10811	0.281767955801105	0.18777171399500509
chr7	AC016831.6	130912109	130912152	0	44	2081	10992	2081	10948	0.0	0.1900803799780782
chr7	LINC-PINT	130978507	130978528	0	22	2795	8484	2795	8462	0.0	0.33030016544552115
chr7	LINC-PINT	131002196	131002320	1020	125	2795	8484	1775	8359	8.16	0.21234597439885153
chr7	LINC-PINT	130959868	130959970	0	103	2795	8484	2795	8381	0.0	0.33349242333850376
chr7	LINC-PINT	131009708	131009778	0	71	2795	8484	2795	8413	0.0	0.33222393914180437
chr7	LINC-PINT	131106544	131106617	0	74	2795	8484	2795	8410	0.0	0.3323424494649227
chr7	LINC-PINT	131076524	131076587	0	64	2795	8484	2795	8420	0.0	0.3319477434679335
chr7	LINC-PINT	130993981	130994093	0	113	2795	8484	2795	8371	0.0	0.3338908135228766
chr7	LINC-PINT	130967388	130967517	0	130	2795	8484	2795	8354	0.0	0.33457026574096244
chr7	MKLN1-AS	131321878	131321931	0	54	0	7684	0	7630	0.0	0.0
chr7	MKLN1-AS	131311129	131311223	0	95	0	7684	0	7589	0.0	0.0
chr7	PODXL	131510235	131510331	0	97	0	6903	0	6806	0.0	0.0
chr7	CHCHD3	132886973	132886988	0	16	48253	3443	48253	3427	0.0	14.080245112343157
chr7	CHCHD3	133022405	133022495	0	91	48253	3443	48253	3352	0.0	14.395286396181385
chr7	SLC35B4	134304804	134304854	0	51	10	1724	10	1673	0.0	0.005977286312014346
chr7	AC009275.1	134373061	134373140	0	80	51	5023	51	4943	0.0	0.010317620878009305
chr7	AC009275.1	134371344	134371520	0	177	51	5023	51	4846	0.0	0.010524143623607098
chr7	AC009275.1	134416320	134416412	0	93	51	5023	51	4930	0.0	0.010344827586206896
chr7	AC009275.1	134417710	134417836	0	127	51	5023	51	4896	0.0	0.010416666666666666
chr7	AC009275.1	134418626	134418974	0	349	51	5023	51	4674	0.0	0.010911424903722721
chr7	AC009275.1	134430274	134430392	0	119	51	5023	51	4904	0.0	0.010399673735725938
chr7	CNOT4	135363853	135364066	255	214	12728	5584	12473	5370	1.191588785046729	2.3227188081936685
chr7	SLC13A4	135684123	135684261	0	139	0	4236	0	4097	0.0	0.0
chr7	AC009264.1	137032793	137032913	0	121	0	6929	0	6808	0.0	0.0
chr7	AC009264.1	137031904	137031963	0	60	0	6929	0	6869	0.0	0.0
chr7	PTN	137236143	137236242	306	100	306	1628	0	1528	3.06	0.0
chr7	DGKI	137485373	137485418	0	46	891	15589	891	15543	0.0	0.05732484076433121
chr7	DGKI	137493782	137493836	0	55	891	15589	891	15534	0.0	0.05735805330243337
chr7	DGKI	137463488	137463611	0	124	891	15589	891	15465	0.0	0.05761396702230844
chr7	DGKI	137545899	137545962	0	64	891	15589	891	15525	0.0	0.057391304347826085
chr7	CREB3L2	137922589	137922767	0	179	51	4960	51	4781	0.0	0.010667224430035557
chr7	SVOPL	138621045	138621135	0	91	12971	3244	12971	3153	0.0	4.113859816048208
chr7	SVOPL	138659863	138659988	1020	126	12971	3244	11951	3118	8.095238095238095	3.8329057087876843
chr7	ATP6V0A4	138715763	138715881	2617	119	114561	4149	111944	4030	21.991596638655462	27.777667493796525
chr7	ATP6V0A4	138786157	138786260	109	104	114561	4149	114452	4045	1.0480769230769231	28.2946847960445
chr7	ATP6V0A4	138780033	138780122	543	90	114561	4149	114018	4059	6.033333333333333	28.090169992609017
chr7	ATP6V0A4	138709623	138709795	32928	173	114561	4149	81633	3976	190.33526011560693	20.531438631790746
chr7	PARP12	140027275	140027406	0	132	251553	5260	251553	5128	0.0	49.05479719188767
chr7	PARP12	140037714	140037856	294	143	251553	5260	251259	5117	2.055944055944056	49.10279460621458
chr7	KDM7A	140095617	140095711	136	95	1887	9399	1751	9304	1.431578947368421	0.18819862424763542
chr7	SLC37A3	140345215	140345263	930	49	402216	8904	401286	8855	18.979591836734695	45.31744776962168
chr7	SLC37A3	140351272	140351451	192	180	402216	8904	402024	8724	1.0666666666666667	46.082530949105916
chr7	SLC37A3	140358639	140358785	578	147	402216	8904	401638	8757	3.931972789115646	45.86479387918237
chr7	SLC37A3	140364407	140364491	0	85	402216	8904	402216	8819	0.0	45.607892051252975
chr7	SLC37A3	140380281	140380390	51	110	402216	8904	402165	8794	0.4636363636363636	45.73174891971799
chr7	SLC37A3	140348625	140348767	51	143	402216	8904	402165	8761	0.35664335664335667	45.90400639196439
chr7	SLC37A3	140352061	140352146	540	86	402216	8904	401676	8818	6.27906976744186	45.55182581084146
chr7	SLC37A3	140337283	140337349	973	67	402216	8904	401243	8837	14.522388059701493	45.40488853683377
chr7	SLC37A3	140343411	140343563	711	153	402216	8904	401505	8751	4.647058823529412	45.88104216660953
chr7	SLC37A3	140355667	140355764	0	98	402216	8904	402216	8806	0.0	45.67522143992732
chr7	SLC37A3	140345868	140345970	1118	103	402216	8904	401098	8801	10.854368932038835	45.57413930235201
chr7	SLC37A3	140352061	140352181	653	121	402216	8904	401563	8783	5.396694214876033	45.72048275076853
chr7	SLC37A3	140379213	140379307	0	95	402216	8904	402216	8809	0.0	45.6596662504257
chr7	MKRN1	140473774	140473827	18	54	9992	5678	9974	5624	0.3333333333333333	1.773470839260313
chr7	MKRN1	140474380	140474489	0	110	9992	5678	9992	5568	0.0	1.7945402298850575
chr7	MKRN1	140475217	140475335	0	119	9992	5678	9992	5559	0.0	1.7974455837380825
chr7	MKRN1	140473243	140473332	0	90	9992	5678	9992	5588	0.0	1.788117394416607
chr7	MKRN1	140472202	140472405	0	204	9992	5678	9992	5474	0.0	1.825356229448301
chr7	DENND2A	140601402	140602542	0	1141	1672	5198	1672	4057	0.0	0.4121271875770274
chr7	DENND2A	140605704	140605806	0	103	1672	5198	1672	5095	0.0	0.3281648675171737
chr7	BRAF	140734616	140734770	0	155	1100	20294	1100	20139	0.0	0.054620388301305924
chr7	BRAF	140785688	140785808	0	121	1100	20294	1100	20173	0.0	0.05452832994596738
chr7	BRAF	140808236	140808316	0	81	1100	20294	1100	20213	0.0	0.054420422500371046
chr7	BRAF	140747365	140747447	0	83	1100	20294	1100	20211	0.0	0.0544258077284647
chr7	BRAF	140748931	140749052	0	122	1100	20294	1100	20172	0.0	0.0545310331152092
chr7	MRPS33	141010418	141010660	0	243	51	4992	51	4749	0.0	0.010739102969046115
chr7	AC073878.1	141547331	141547400	0	70	0	2122	0	2052	0.0	0.0
chr7	WEE2-AS1	141727496	141727642	0	147	0	5092	0	4945	0.0	0.0
chr7	WEE2-AS1	141714188	141714374	0	187	0	5092	0	4905	0.0	0.0
chr7	WEE2-AS1	141727203	141727378	0	176	0	5092	0	4916	0.0	0.0
chr7	WEE2-AS1	141737382	141737567	0	186	0	5092	0	4906	0.0	0.0
chr7	WEE2-AS1	141727991	141728145	0	155	0	5092	0	4937	0.0	0.0
chr7	WEE2-AS1	141727553	141727642	0	90	0	5092	0	5002	0.0	0.0
chr7	WEE2-AS1	141727203	141727642	0	440	0	5092	0	4652	0.0	0.0
chr7	WEE2-AS1	141711757	141711800	0	44	0	5092	0	5048	0.0	0.0
chr7	WEE2-AS1	141724999	141725256	0	258	0	5092	0	4834	0.0	0.0
chr7	PRSS37	141837560	141837650	0	91	0	2228	0	2137	0.0	0.0
chr7	CLEC5A	141943895	141943964	0	70	0	4136	0	4066	0.0	0.0
chr7	CLEC5A	141946213	141946312	0	100	0	4136	0	4036	0.0	0.0
chr7	CLEC5A	141935813	141935950	0	138	0	4136	0	3998	0.0	0.0
chr7	CLEC5A	141945340	141945400	0	61	0	4136	0	4075	0.0	0.0
chr7	TRPV5	142928087	142928234	0	148	0	3639	0	3491	0.0	0.0
chr7	FAM131B	143359325	143359419	0	95	0	6306	0	6211	0.0	0.0
chr7	FAM131B	143359731	143359767	0	37	0	6306	0	6269	0.0	0.0
chr7	FAM131B	143359549	143359629	0	81	0	6306	0	6225	0.0	0.0
chr7	FAM131B	143359325	143359518	0	194	0	6306	0	6112	0.0	0.0
chr7	EPHA1	143394807	143395014	0	208	102	4564	102	4356	0.0	0.023415977961432508
chr7	AC099548.2	143833246	143833883	0	638	0	3634	0	2996	0.0	0.0
chr7	AC099548.2	143836156	143836269	0	114	0	3634	0	3520	0.0	0.0
chr7	AC099548.2	143833728	143833883	0	156	0	3634	0	3478	0.0	0.0
chr7	TCAF1	143881922	143882099	0	178	51	6256	51	6078	0.0	0.00839091806515301
chr7	AC074386.1	144253532	144253588	0	57	0	2197	0	2140	0.0	0.0
chr7	AC074386.1	144311883	144311936	0	54	0	2197	0	2143	0.0	0.0
chr7	OR2A1-AS1	144350717	144350824	0	108	0	2545	0	2437	0.0	0.0
chr7	AC074386.1	144311883	144311939	0	57	0	2197	0	2140	0.0	0.0
chr7	OR2A1-AS1	144335078	144335132	0	55	0	2545	0	2490	0.0	0.0
chr7	OR2A1-AS1	144349103	144349443	0	341	0	2545	0	2204	0.0	0.0
chr7	NOBOX	144401045	144401597	0	553	51	2124	51	1571	0.0	0.032463399108847865
chr7	TPK1	144531063	144531169	0	107	153	8466	153	8359	0.0	0.01830362483550664
chr7	TPK1	144606928	144607050	0	123	153	8466	153	8343	0.0	0.018338727076591153
chr7	TPK1	144681806	144681864	0	59	153	8466	153	8407	0.0	0.018199119781134768
chr7	TPK1	144591422	144591569	0	148	153	8466	153	8318	0.0	0.018393844674200528
chr7	TPK1	144667725	144667846	0	122	153	8466	153	8344	0.0	0.01833652924256951
chr7	AC006007.1	145677865	145677980	0	116	0	993	0	877	0.0	0.0
chr7	EZH2	148814913	148815039	0	127	18876	4102	18876	3975	0.0	4.748679245283019
chr7	EZH2	148818977	148819059	40	83	18876	4102	18836	4019	0.4819277108433735	4.686737994526002
chr7	EZH2	148832633	148832750	918	118	18876	4102	17958	3984	7.779661016949152	4.507530120481928
chr7	EZH2	148836821	148837000	0	180	18876	4102	18876	3922	0.0	4.812850586435492
chr7	PDIA4	149027848	149027992	0	145	16983	3309	16983	3164	0.0	5.367572692793932
chr7	ZNF786	149080590	149080717	0	128	0	3277	0	3149	0.0	0.0
chr7	ZNF767P	149558607	149558839	10162	233	68206	4017	58044	3784	43.6137339055794	15.339323467230445
chr7	ZNF767P	149621045	149621172	0	128	68206	4017	68206	3889	0.0	17.538184623296477
chr7	ZNF767P	149563519	149563603	3200	85	68206	4017	65006	3932	37.64705882352941	16.532553407934895
chr7	ATP6V0E2-AS1	149870241	149870351	0	111	0	3296	0	3185	0.0	0.0
chr7	RARRES2	150338614	150338741	0	128	0	736	0	608	0.0	0.0
chr7	TMEM176B	150793960	150794071	51	112	23409	1981	23358	1869	0.45535714285714285	12.497592295345104
chr7	TMEM176B	150800021	150800167	842	147	23409	1981	22567	1834	5.727891156462585	12.304798255179934
chr7	ATG9B	151018619	151019374	0	756	74	5653	74	4897	0.0	0.015111292628139678
chr7	ATG9B	151015359	151015713	0	355	74	5653	74	5298	0.0	0.013967534918837296
chr7	CDK5	151055752	151055848	0	97	57659	2201	57659	2104	0.0	27.404467680608366
chr7	FASTK	151079499	151079922	79	424	252	3292	173	2868	0.18632075471698112	0.0603207810320781
chr7	ASB10	151176562	151176676	0	115	2397	2381	2397	2266	0.0	1.057811120917917
chr7	IQCA1L	151195849	151195975	153	127	17329	2846	17176	2719	1.204724409448819	6.317028319235013
chr7	SMARCD3	151245459	151245671	0	213	13016	4505	13016	4292	0.0	3.032618825722274
chr7	WDR86	151385087	151385223	0	137	0	3982	0	3845	0.0	0.0
chr7	WDR86	151385087	151385287	0	201	0	3982	0	3781	0.0	0.0
chr7	CRYGN	151436179	151436325	0	147	255	3188	255	3041	0.0	0.08385399539625123
chr7	CRYGN	151432167	151432285	0	119	255	3188	255	3069	0.0	0.08308895405669599
chr7	RHEB	151498088	151498180	0	93	51	3438	51	3345	0.0	0.015246636771300448
chr7	PRKAG2	151568715	151568842	0	128	26240	14143	26240	14015	0.0	1.8722797003210845
chr7	PRKAG2	151574890	151574949	0	60	26240	14143	26240	14083	0.0	1.8632393666122276
chr7	PRKAG2	151632068	151632138	10	71	26240	14143	26230	14072	0.14084507042253522	1.8639852188743604
chr7	PRKAG2	151606093	151606183	0	91	26240	14143	26240	14052	0.0	1.8673498434386564
chr7	PRKAG2	151790880	151791000	693	121	26240	14143	25547	14022	5.7272727272727275	1.8219226929111396
chr7	PRKAG2	151566613	151566699	0	87	26240	14143	26240	14056	0.0	1.86681844052362
chr7	PRKAG2	151566572	151566613	0	42	26240	14143	26240	14101	0.0	1.860860931848805
chr7	PRKAG2	151631637	151631768	0	132	26240	14143	26240	14011	0.0	1.8728142174006137
chr7	KMT2C	152157760	152157925	255	166	42832	18723	42577	18557	1.536144578313253	2.2943902570458587
chr7	KMT2C	152158862	152159072	46	211	42832	18723	42786	18512	0.21800947867298578	2.311257562662057
chr7	KMT2C	152238706	152238826	0	121	42832	18723	42832	18602	0.0	2.3025481131061176
chr7	LINC01287	153405491	153405598	0	108	0	9603	0	9495	0.0	0.0
chr7	LINC01287	153400178	153400546	0	369	0	9603	0	9234	0.0	0.0
chr7	LINC01287	153404056	153404233	0	178	0	9603	0	9425	0.0	0.0
chr7	LINC01287	153406955	153407084	0	130	0	9603	0	9473	0.0	0.0
chr7	LINC01287	153412090	153413482	0	1393	0	9603	0	8210	0.0	0.0
chr7	LINC01287	153412090	153413220	0	1131	0	9603	0	8472	0.0	0.0
chr7	LINC01287	153401340	153401691	0	352	0	9603	0	9251	0.0	0.0
chr7	LINC01287	153412090	153412731	0	642	0	9603	0	8961	0.0	0.0
chr7	LINC01287	153403362	153403492	0	131	0	9603	0	9472	0.0	0.0
chr7	LINC01287	153404056	153404326	0	271	0	9603	0	9332	0.0	0.0
chr7	LINC01287	153411581	153411724	0	144	0	9603	0	9459	0.0	0.0
chr7	LINC01287	153411585	153411724	0	140	0	9603	0	9463	0.0	0.0
chr7	LINC01287	153404056	153404602	0	547	0	9603	0	9056	0.0	0.0
chr7	PAXIP1	154986016	154986179	0	164	204	9703	204	9539	0.0	0.02138588950623755
chr7	HTR5A-AS1	155070275	155070453	0	179	51	3810	51	3631	0.0	0.01404571743321399
chr7	SHH	155800457	155800667	0	211	51	4970	51	4759	0.0	0.01071653708762345
chr7	SHH	155800457	155800597	0	141	51	4970	51	4829	0.0	0.010561192793539035
chr7	LINC01006	156471154	156472711	21240	1558	146491	11122	125251	9564	13.632862644415917	13.096089502300293
chr7	LINC01006	156605187	156605380	0	194	146491	11122	146491	10928	0.0	13.405106149341142
chr7	LINC01006	156605657	156605764	0	108	146491	11122	146491	11014	0.0	13.300435808970402
chr7	LINC01006	156584200	156584520	0	321	146491	11122	146491	10801	0.0	13.562725673548746
chr7	LINC01006	156480664	156481620	86598	957	146491	11122	59893	10165	90.48902821316615	5.892080668962125
chr7	LINC01006	156481376	156481617	51	242	146491	11122	146440	10880	0.21074380165289255	13.459558823529411
chr7	LINC01006	156603784	156603911	102	128	146491	11122	146389	10994	0.796875	13.31535382936147
chr7	LMBR1	156688029	156688191	67	163	26429	8530	26362	8367	0.4110429447852761	3.150711127046731
chr7	LMBR1	156836812	156836885	0	74	26429	8530	26429	8456	0.0	3.125473036896878
chr7	LMBR1	156779654	156779732	0	79	26429	8530	26429	8451	0.0	3.1273222103893032
chr7	LMBR1	156736492	156736615	0	124	26429	8530	26429	8406	0.0	3.144063763978111
chr7	LMBR1	156834477	156834595	0	119	26429	8530	26429	8411	0.0	3.142194744976816
chr7	LMBR1	156833752	156833792	360	41	26429	8530	26069	8489	8.78048780487805	3.070915302155731
chr7	LMBR1	156836808	156836885	0	78	26429	8530	26429	8452	0.0	3.126952200662565
chr7	LMBR1	156834477	156834575	0	99	26429	8530	26429	8431	0.0	3.134740837385838
chr7	MNX1	157006478	157006639	682	162	26154	2760	25472	2598	4.209876543209877	9.804464973056197
chr7	PTPRN2	158316818	158316932	0	115	1989	3610	1989	3495	0.0	0.5690987124463519
chr7	PTPRN2	158489734	158489785	0	52	1989	3610	1989	3558	0.0	0.5590219224283305
chr7	PTPRN2	158110828	158110915	0	88	1989	3610	1989	3522	0.0	0.5647359454855196
chr7	NCAPG2	158650831	158650972	0	142	10204	7141	10204	6999	0.0	1.4579225603657666
chr7	NCAPG2	158662193	158662367	176	175	10204	7141	10028	6966	1.0057142857142858	1.4395635946023544
chr7	NCAPG2	158668395	158668492	0	98	10204	7141	10204	7043	0.0	1.4488144256708788
chr7	NCAPG2	158702247	158702348	700	102	10204	7141	9504	7039	6.862745098039215	1.3501917886063362
chr7	NCAPG2	158703649	158703702	514	54	10204	7141	9690	7087	9.518518518518519	1.3672922252010724
chr7	ESYT2	158752780	158752843	0	64	24719	7041	24719	6977	0.0	3.542926759352157
chr8	AC019257.1	1972914	1973036	0	123	0	2174	0	2051	0.0	0.0
chr8	AC246817.2	2705214	2705286	0	73	102	10364	102	10291	0.0	0.00991157321931785
chr8	AC246817.2	2671716	2671853	0	138	102	10364	102	10226	0.0	0.00997457461372971
chr8	AC246817.2	2721489	2721592	0	104	102	10364	102	10260	0.0	0.009941520467836258
chr8	AC246817.2	2678856	2678939	0	84	102	10364	102	10280	0.0	0.009922178988326848
chr8	CSMD1	3018476	3018650	0	175	236	18788	236	18613	0.0	0.012679310159565894
chr8	CSMD1	2954223	2954268	0	46	236	18788	236	18742	0.0	0.01259203927008857
chr8	CSMD1	3096848	3097037	0	190	236	18788	236	18598	0.0	0.012689536509302076
chr8	CSMD1	3613275	3613278	0	4	236	18788	236	18784	0.0	0.01256388415672913
chr8	CSMD1	3598303	3598306	0	4	236	18788	236	18784	0.0	0.01256388415672913
chr8	ANGPT2	6532331	6532487	242	157	58666	6803	58424	6646	1.5414012738853504	8.790851640084261
chr8	MCPH1-AS1	6621344	6621635	0	292	52401	9929	52401	9637	0.0	5.437480543737678
chr8	MCPH1-AS1	6634594	6635419	0	826	52401	9929	52401	9103	0.0	5.756453916291332
chr8	MCPH1-AS1	6620991	6621635	0	645	52401	9929	52401	9284	0.0	5.644226626454115
chr8	MCPH1-AS1	6621422	6621635	0	214	52401	9929	52401	9715	0.0	5.3938239835306225
chr8	MCPH1-AS1	6669988	6670240	0	253	52401	9929	52401	9676	0.0	5.415564282761472
chr8	XKR5	6829168	6829306	0	139	0	4919	0	4780	0.0	0.0
chr8	FAM66B	7323768	7323833	0	66	0	6754	0	6688	0.0	0.0
chr8	SPAG11B	7449132	7449236	0	105	0	1983	0	1878	0.0	0.0
chr8	SPAG11B	7450822	7450900	0	79	0	1983	0	1904	0.0	0.0
chr8	SPAG11B	7451123	7451199	0	77	0	1983	0	1906	0.0	0.0
chr8	ALG1L13P	8243992	8244040	0	49	2281	1403	2281	1354	0.0	1.6846381093057607
chr8	AC103957.1	8422396	8423013	0	618	0	1679	0	1061	0.0	0.0
chr8	AC021242.2	9374352	9374405	0	54	0	2683	0	2629	0.0	0.0
chr8	AC104964.1	10478487	10478555	0	69	51	1531	51	1462	0.0	0.03488372093023256
chr8	PINX1	10820192	10820269	43	78	102	2814	59	2736	0.5512820512820513	0.021564327485380116
chr8	PINX1	10787623	10787825	0	203	102	2814	102	2611	0.0	0.03906549214860207
chr8	PINX1	10820192	10820310	51	119	102	2814	51	2695	0.42857142857142855	0.018923933209647494
chr8	CTSB	11847678	11847822	0	145	0	8249	0	8104	0.0	0.0
chr8	CTSB	11849997	11850047	0	51	0	8249	0	8198	0.0	0.0
chr8	CTSB	11848411	11848507	0	97	0	8249	0	8152	0.0	0.0
chr8	CTSB	11849045	11849164	0	120	0	8249	0	8129	0.0	0.0
chr8	CTSB	11845081	11845222	0	142	0	8249	0	8107	0.0	0.0
chr8	CTSB	11861299	11861479	0	181	0	8249	0	8068	0.0	0.0
chr8	CTSB	11864375	11864463	0	89	0	8249	0	8160	0.0	0.0
chr8	CTSB	11865463	11865584	0	122	0	8249	0	8127	0.0	0.0
chr8	CTSB	11867253	11867526	0	274	0	8249	0	7975	0.0	0.0
chr8	CTSB	11849045	11849215	0	171	0	8249	0	8078	0.0	0.0
chr8	CTSB	11865463	11865560	0	98	0	8249	0	8151	0.0	0.0
chr8	CTSB	11867253	11867391	0	139	0	8249	0	8110	0.0	0.0
chr8	CTSB	11861405	11861479	0	75	0	8249	0	8174	0.0	0.0
chr8	CTSB	11864375	11864483	0	109	0	8249	0	8140	0.0	0.0
chr8	CTSB	11857857	11857940	0	84	0	8249	0	8165	0.0	0.0
chr8	CTSB	11862344	11862478	0	135	0	8249	0	8114	0.0	0.0
chr8	CTSB	11866156	11866201	0	46	0	8249	0	8203	0.0	0.0
chr8	CTSB	11854679	11854914	0	236	0	8249	0	8013	0.0	0.0
chr8	CTSB	11850865	11850980	0	116	0	8249	0	8133	0.0	0.0
chr8	CTSB	11856395	11856585	0	191	0	8249	0	8058	0.0	0.0
chr8	CTSB	11847678	11847815	0	138	0	8249	0	8111	0.0	0.0
chr8	CTSB	11849045	11849228	0	184	0	8249	0	8065	0.0	0.0
chr8	CTSB	11861360	11861479	0	120	0	8249	0	8129	0.0	0.0
chr8	CTSB	11846561	11846616	0	56	0	8249	0	8193	0.0	0.0
chr8	CTSB	11864696	11864903	0	208	0	8249	0	8041	0.0	0.0
chr8	FAM86B1	12188310	12188424	0	115	0	4142	0	4027	0.0	0.0
chr8	FAM86B1	12186699	12186833	0	135	0	4142	0	4007	0.0	0.0
chr8	FAM86B1	12189807	12189888	0	82	0	4142	0	4060	0.0	0.0
chr8	FAM86B1	12186351	12186617	0	267	0	4142	0	3875	0.0	0.0
chr8	FAM86B1	12188071	12188173	0	103	0	4142	0	4039	0.0	0.0
chr8	FAM86B1	12193610	12193684	0	75	0	4142	0	4067	0.0	0.0
chr8	FAM86B1	12191778	12191841	0	64	0	4142	0	4078	0.0	0.0
chr8	FAM86B2	12428632	12428898	0	267	51	1374	51	1107	0.0	0.04607046070460705
chr8	FAM86B2	12430349	12430451	0	103	51	1374	51	1271	0.0	0.04012588512981904
chr8	AC068587.4	12596017	12596214	0	198	9309	16955	9309	16757	0.0	0.5555290326430745
chr8	LONRF1	12737271	12737360	0	90	0	5725	0	5635	0.0	0.0
chr8	AC123777.1	12767729	12767914	0	186	0	1264	0	1078	0.0	0.0
chr8	DLC1	13102789	13102853	0	65	83	12281	83	12216	0.0	0.0067943680419122465
chr8	SGCZ	14324102	14324204	0	103	88	7353	88	7250	0.0	0.012137931034482758
chr8	MSR1	16120417	16120606	0	190	102	7839	102	7649	0.0	0.013335076480585698
chr8	FGF20	16995654	16995758	0	105	612	1843	612	1738	0.0	0.3521288837744534
chr8	CNOT7	17232426	17232537	0	112	1785	10657	1785	10545	0.0	0.16927453769559034
chr8	CNOT7	17243441	17243545	0	105	1785	10657	1785	10552	0.0	0.1691622441243366
chr8	CNOT7	17245856	17245931	0	76	1785	10657	1785	10581	0.0	0.1686986107173235
chr8	CNOT7	17243441	17243622	0	182	1785	10657	1785	10475	0.0	0.17040572792362768
chr8	MTMR7	17309276	17309326	0	51	51	6948	51	6897	0.0	0.007394519356241845
chr8	MTMR7	17361116	17361274	0	159	51	6948	51	6789	0.0	0.007512152010605391
chr8	MTUS1	17724101	17724162	0	62	197	12042	197	11980	0.0	0.0164440734557596
chr8	MTUS1	17723671	17723833	0	163	197	12042	197	11879	0.0	0.016583887532620592
chr8	FGL1	17891680	17891807	0	128	18007	3313	18007	3185	0.0	5.653689167974882
chr8	ASAH1	18059340	18059464	0	125	6243	9281	6243	9156	0.0	0.6818479685452162
chr8	ASAH1	18064456	18064531	0	76	6243	9281	6243	9205	0.0	0.6782183595871809
chr8	ASAH1	18069791	18069878	116	88	6243	9281	6127	9193	1.3181818181818181	0.6664853693027304
chr8	ASAH1	18071299	18071390	0	92	6243	9281	6243	9189	0.0	0.6793992817499184
chr8	ASAH1	18063184	18063230	0	47	6243	9281	6243	9234	0.0	0.6760883690708253
chr8	ASAH1	18064456	18064468	0	13	6243	9281	6243	9268	0.0	0.6736081139404402
chr8	ASAH1	18064456	18064474	0	19	6243	9281	6243	9262	0.0	0.6740444828330814
chr8	ASAH1	18071299	18071411	0	113	6243	9281	6243	9168	0.0	0.680955497382199
chr8	ASAH1	18064456	18064471	0	16	6243	9281	6243	9265	0.0	0.673826227738802
chr8	ASAH1	18071330	18071390	0	61	6243	9281	6243	9220	0.0	0.677114967462039
chr8	ASAH1	18069791	18069872	116	82	6243	9281	6127	9199	1.4146341463414633	0.6660506576801827
chr8	ASAH1	18064122	18064278	0	157	6243	9281	6243	9124	0.0	0.6842393686979396
chr8	ASAH1	18073255	18073276	0	22	6243	9281	6243	9259	0.0	0.6742628793606221
chr8	ASAH1	18083980	18084286	0	307	6243	9281	6243	8974	0.0	0.6956763984845108
chr8	ASAH1	18076176	18076413	252	238	6243	9281	5991	9043	1.0588235294117647	0.6625013822846401
chr8	PSD3	18774826	18774938	0	113	624	15239	624	15126	0.0	0.041253470844902815
chr8	PSD3	18802330	18802352	0	23	624	15239	624	15216	0.0	0.04100946372239748
chr8	PSD3	18803161	18803279	0	119	624	15239	624	15120	0.0	0.04126984126984127
chr8	CSGALNACT1	19591159	19591278	0	120	10068	6602	10068	6482	0.0	1.5532243134834927
chr8	CSGALNACT1	19585165	19585317	0	153	10068	6602	10068	6449	0.0	1.5611722747712824
chr8	CSGALNACT1	19457529	19457816	0	288	10068	6602	10068	6314	0.0	1.594551789673741
chr8	CSGALNACT1	19601770	19601865	0	96	10068	6602	10068	6506	0.0	1.5474946203504458
chr8	SLC18A1	20147257	20147391	0	135	130	3929	130	3794	0.0	0.03426462836056932
chr8	SLC18A1	20174360	20174444	0	85	130	3929	130	3844	0.0	0.033818938605619145
chr8	SLC18A1	20181748	20181952	0	205	130	3929	130	3724	0.0	0.03490870032223416
chr8	SLC18A1	20164868	20164964	0	97	130	3929	130	3832	0.0	0.03392484342379958
chr8	SLC18A1	20148414	20148516	0	103	130	3929	130	3826	0.0	0.03397804495556717
chr8	AC021613.1	20954654	20954744	0	91	0	13152	0	13061	0.0	0.0
chr8	GFRA2	21782584	21782899	0	316	748	5482	748	5166	0.0	0.14479287650019357
chr8	GFRA2	21782584	21783142	0	559	748	5482	748	4923	0.0	0.1519398740605322
chr8	GFRA2	21774971	21775055	0	85	748	5482	748	5397	0.0	0.13859551602742265
chr8	DOK2	21911900	21911988	51	89	1197	1090	1146	1001	0.5730337078651685	1.144855144855145
chr8	DOK2	21912228	21912510	118	283	1197	1090	1079	807	0.4169611307420495	1.3370508054522925
chr8	HR	22116874	22117039	5920	166	55124	7984	49204	7818	35.66265060240964	6.293681248401126
chr8	HR	22122492	22122608	510	117	55124	7984	54614	7867	4.358974358974359	6.942163467649676
chr8	REEP4	22138638	22138793	204	156	204	2273	0	2117	1.3076923076923077	0.0
chr8	REEP4	22138925	22139061	0	137	204	2273	204	2136	0.0	0.09550561797752809
chr8	LGI3	22154141	22154213	0	73	289	3412	289	3339	0.0	0.0865528601377658
chr8	PHYHIP	22228787	22228909	153	123	984	3938	831	3815	1.2439024390243902	0.217824377457405
chr8	BIN3	22636524	22636586	0	63	0	4410	0	4347	0.0	0.0
chr8	BIN3	22644754	22644803	0	50	0	4410	0	4360	0.0	0.0
chr8	BIN3	22636921	22636962	0	42	0	4410	0	4368	0.0	0.0
chr8	BIN3	22634412	22634525	0	114	0	4410	0	4296	0.0	0.0
chr8	EGR3	22692301	22692354	0	54	0	5038	0	4984	0.0	0.0
chr8	TNFRSF10B	23043137	23043243	0	107	12852	4954	12852	4847	0.0	2.6515370332164223
chr8	LOXL2	23333400	23333623	0	224	342471	5755	342471	5531	0.0	61.91845959139396
chr8	LOXL2	23403953	23404073	48	121	342471	5755	342423	5634	0.39669421487603307	60.777955271565496
chr8	LOXL2	23382390	23382513	0	124	342471	5755	342471	5631	0.0	60.81885988279169
chr8	LOXL2	23370642	23370762	0	121	342471	5755	342471	5634	0.0	60.78647497337593
chr8	ENTPD4	23449892	23449997	0	106	5545694	7070	5545694	6964	0.0	796.3374497415278
chr8	AC041005.1	25180816	25180985	0	170	11884	3575	11884	3405	0.0	3.4901615271659323
chr8	KCTD9	25444291	25444335	0	45	0	4398	0	4353	0.0	0.0
chr8	KCTD9	25446079	25446250	0	172	0	4398	0	4226	0.0	0.0
chr8	KCTD9	25446128	25446250	0	123	0	4398	0	4275	0.0	0.0
chr8	EBF2	25858058	25858154	0	97	109	7116	109	7019	0.0	0.015529277674882462
chr8	STMN4	27241676	27241757	0	82	0	3302	0	3220	0.0	0.0
chr8	STMN4	27243710	27243801	0	92	0	3302	0	3210	0.0	0.0
chr8	STMN4	27239225	27239279	0	55	0	3302	0	3247	0.0	0.0
chr8	TRIM35	27290155	27290178	0	24	7723	3266	7723	3242	0.0	2.382171499074645
chr8	TRIM35	27298463	27298559	89	97	7723	3266	7634	3169	0.9175257731958762	2.4089618176080783
chr8	CHRNA2	27462978	27463993	396323	1016	400214	5067	3891	4051	390.08169291338584	0.9605035793631203
chr8	CHRNA2	27462978	27463860	1836	883	400214	5067	398378	4184	2.0792751981879953	95.21462715105163
chr8	CHRNA2	27477167	27477228	0	62	400214	5067	400214	5005	0.0	79.96283716283716
chr8	CHRNA2	27475212	27475272	168	61	400214	5067	400046	5006	2.7540983606557377	79.91330403515781
chr8	CLU	27614172	27614370	12735	199	25263	5788	12528	5589	63.994974874371856	2.241545893719807
chr8	CLU	27613577	27613683	0	107	25263	5788	25263	5681	0.0	4.446928357683507
chr8	CCDC25	27740471	27740517	0	47	0	4420	0	4373	0.0	0.0
chr8	CCDC25	27748494	27748598	0	105	0	4420	0	4315	0.0	0.0
chr8	CCDC25	27756718	27756770	0	53	0	4420	0	4367	0.0	0.0
chr8	CCDC25	27765203	27765251	0	49	0	4420	0	4371	0.0	0.0
chr8	CCDC25	27748076	27748279	0	204	0	4420	0	4216	0.0	0.0
chr8	CCDC25	27764285	27764533	0	249	0	4420	0	4171	0.0	0.0
chr8	SCARA5	27921570	27922245	0	676	51	4389	51	3713	0.0	0.013735523835173714
chr8	SCARA5	27966413	27966542	51	130	51	4389	0	4259	0.3923076923076923	0.0
chr8	FBXO16	28456765	28456930	21	166	5987	3825	5966	3659	0.12650602409638553	1.6305001366493577
chr8	FBXO16	28473771	28473807	0	37	5987	3825	5987	3788	0.0	1.58051742344245
chr8	FBXO16	28483347	28483483	0	137	5987	3825	5987	3688	0.0	1.6233731019522777
chr8	ZNF395	28375261	28375382	0	122	16455	5747	16455	5625	0.0	2.925333333333333
chr8	ZNF395	28368448	28368565	0	118	16455	5747	16455	5629	0.0	2.9232545745247824
chr8	FBXO16	28429377	28429403	0	27	5987	3825	5987	3798	0.0	1.5763559768299105
chr8	FBXO16	28483347	28483462	0	116	5987	3825	5987	3709	0.0	1.6141817201401996
chr8	FBXO16	28447170	28447273	0	104	5987	3825	5987	3721	0.0	1.6089760816984682
chr8	INTS9	28812326	28812461	0	136	5830	4789	5830	4653	0.0	1.2529550827423168
chr8	INTS9	28813491	28813612	0	122	5830	4789	5830	4667	0.0	1.2491964859652882
chr8	INTS9	28835291	28835378	0	88	5830	4789	5830	4701	0.0	1.2401616677302703
chr8	INTS9	28846746	28846809	0	64	5830	4789	5830	4725	0.0	1.2338624338624338
chr8	INTS9	28859435	28859563	0	129	5830	4789	5830	4660	0.0	1.2510729613733906
chr8	INTS9	28850212	28850273	0	62	5830	4789	5830	4727	0.0	1.2333403850222129
chr8	INTS9	28862039	28862212	0	174	5830	4789	5830	4615	0.0	1.2632719393282774
chr8	KIF13B	29075280	29075343	0	64	258449	11154	258449	11090	0.0	23.304688908926963
chr8	KIF13B	29196186	29196199	196	14	258449	11154	258253	11140	14.0	23.182495511669657
chr8	KIF13B	29249984	29250084	0	101	258449	11154	258449	11053	0.0	23.38270152899665
chr8	SARAF	30073876	30074055	0	180	0	1698	0	1518	0.0	0.0
chr8	SARAF	30073876	30074051	0	176	0	1698	0	1522	0.0	0.0
chr8	SARAF	30073876	30074028	0	153	0	1698	0	1545	0.0	0.0
chr8	RBPMS-AS1	30383127	30383362	0	236	0	1527	0	1291	0.0	0.0
chr8	RBPMS-AS1	30383543	30383697	0	155	0	1527	0	1372	0.0	0.0
chr8	GSR	30689160	30689319	0	160	51	3619	51	3459	0.0	0.014744145706851692
chr8	GSR	30692968	30693055	0	88	51	3619	51	3531	0.0	0.014443500424808835
chr8	GSR	30704646	30704864	0	219	51	3619	51	3400	0.0	0.015
chr8	TTI2	33507228	33507321	0	94	473	3568	473	3474	0.0	0.13615428900402993
chr8	TTI2	33512959	33513004	0	46	473	3568	473	3522	0.0	0.13429869392390686
chr8	AF279873.4	34005239	34005336	0	98	0	515	0	417	0.0	0.0
chr8	AC124290.2	36034866	36034948	0	83	0	446	0	363	0.0	0.0
chr8	LINC01605	37531311	37531398	0	88	24	1532	24	1444	0.0	0.01662049861495845
chr8	BRF2	37845685	37845774	0	90	51	2723	51	2633	0.0	0.019369540448157994
chr8	BRF2	37847302	37847341	0	40	51	2723	51	2683	0.0	0.01900857249347745
chr8	BRF2	37847273	37847341	0	69	51	2723	51	2654	0.0	0.01921627731725697
chr8	RAB11FIP1	37871277	37873179	102	1903	255	8656	153	6753	0.053599579611140306	0.02265659706796979
chr8	STAR	38145221	38145315	51	95	14036	3614	13985	3519	0.5368421052631579	3.974140380789997
chr8	LSM1	38169801	38169917	0	117	9117	1222	9117	1105	0.0	8.250678733031675
chr8	LSM1	38170942	38171012	0	71	9117	1222	9117	1151	0.0	7.920938314509122
chr8	PLPP5	38268370	38268461	1194	92	118166	3045	116972	2953	12.978260869565217	39.61124280392821
chr8	PLPP5	38268370	38268407	205	38	118166	3045	117961	3007	5.394736842105263	39.22879946790822
chr8	NSD3	38299443	38299590	2344	148	1646248	15273	1643904	15125	15.837837837837839	108.68786776859504
chr8	NSD3	38363872	38363900	0	29	1646248	15273	1646248	15244	0.0	107.99317764366307
chr8	FGFR1	38421796	38421941	0	146	510	11651	510	11505	0.0	0.04432855280312908
chr8	FGFR1	38426121	38426245	0	125	510	11651	510	11526	0.0	0.04424778761061947
chr8	FGFR1	38429681	38429948	0	268	510	11651	510	11383	0.0	0.04480365457260828
chr8	FGFR1	38458846	38458894	0	49	510	11651	510	11602	0.0	0.043957938286502324
chr8	FGFR1	38461095	38461255	0	161	510	11651	510	11490	0.0	0.044386422976501305
chr8	FGFR1	38423024	38423175	0	152	510	11651	510	11499	0.0	0.04435168275502217
chr8	FGFR1	38443396	38443492	0	97	510	11651	510	11554	0.0	0.0441405573827246
chr8	FGFR1	38440305	38440373	0	69	510	11651	510	11582	0.0	0.0440338456225177
chr8	FGFR1	38429246	38429390	0	145	510	11651	510	11506	0.0	0.04432470015644012
chr8	FGFR1	38457355	38457534	0	180	510	11651	510	11471	0.0	0.04445994246360387
chr8	FGFR1	38458846	38458969	0	124	510	11651	510	11527	0.0	0.0442439489893294
chr8	FGFR1	38458846	38458984	0	139	510	11651	510	11512	0.0	0.04430159833217512
chr8	AC069120.1	38544083	38544179	0	97	0	2688	0	2591	0.0	0.0
chr8	AC069120.1	38552958	38553091	0	134	0	2688	0	2554	0.0	0.0
chr8	ADAM3A	39477695	39477846	0	152	0	3023	0	2871	0.0	0.0
chr8	ADAM3A	39512577	39512656	0	80	0	3023	0	2943	0.0	0.0
chr8	ADAM3A	39490262	39490357	0	96	0	3023	0	2927	0.0	0.0
chr8	ADAM3A	39477695	39477943	0	249	0	3023	0	2774	0.0	0.0
chr8	ADAM3A	39522259	39522342	0	84	0	3023	0	2939	0.0	0.0
chr8	ADAM2	39809409	39809466	0	58	0	2928	0	2870	0.0	0.0
chr8	ZMAT4	40674703	40674931	0	229	0	3453	0	3224	0.0	0.0
chr8	ZMAT4	40786688	40786782	0	95	0	3453	0	3358	0.0	0.0
chr8	ZMAT4	40808508	40808571	0	64	0	3453	0	3389	0.0	0.0
chr8	ANK1	41661800	41661941	0	142	68560	10404	68560	10262	0.0	6.68095887741181
chr8	ANK1	41661429	41661564	0	136	68560	10404	68560	10268	0.0	6.6770549279314375
chr8	ANK1	41661875	41661941	0	67	68560	10404	68560	10337	0.0	6.632485247170359
chr8	ANK1	41700430	41700454	0	25	68560	10404	68560	10379	0.0	6.605646015993834
chr8	ANK1	41672515	41672912	0	398	68560	10404	68560	10006	0.0	6.851888866679992
chr8	KAT6A	42049619	42049707	0	89	643	16866	643	16777	0.0	0.03832628002622638
chr8	KAT6A	42049575	42049707	0	133	643	16866	643	16733	0.0	0.03842706030000598
chr8	KAT6A	41957048	41957180	0	133	643	16866	643	16733	0.0	0.03842706030000598
chr8	PLAT	42185080	42185172	212	93	365345	6705	365133	6612	2.2795698924731185	55.222776769509984
chr8	PLAT	42188933	42189071	69873	139	365345	6705	295472	6566	502.68345323741005	45.000304599451724
chr8	PLAT	42206646	42206698	0	53	365345	6705	365345	6652	0.0	54.922579675285625
chr8	PLAT	42187397	42187572	18695	176	365345	6705	346650	6529	106.2215909090909	53.093888803798436
chr8	PLAT	42177374	42177437	8129	64	365345	6705	357216	6641	127.015625	53.78948953470863
chr8	PLAT	42185080	42185158	207	79	365345	6705	365138	6626	2.6202531645569622	55.10685179595533
chr8	PLAT	42187905	42188016	5140	112	365345	6705	360205	6593	45.892857142857146	54.63446079174882
chr8	AC083973.1	42265614	42266396	0	783	139966	2277	139966	1494	0.0	93.68540829986613
chr8	SLC20A2	42471066	42471201	0	136	1838	6168	1838	6032	0.0	0.3047082228116711
chr8	CHRNA6	42759068	42759113	0	46	12620	2604	12620	2558	0.0	4.933541829554339
chr8	THAP1	42839185	42839381	0	197	153	995	153	798	0.0	0.19172932330827067
chr8	RNF170	42865415	42865489	4523	75	25060	5835	20537	5760	60.306666666666665	3.565451388888889
chr8	RNF170	42889302	42889414	0	113	25060	5835	25060	5722	0.0	4.379587556798322
chr8	ASNSP1	46590069	46590151	0	83	0	2850	0	2767	0.0	0.0
chr8	ASNSP1	46592102	46592267	0	166	0	2850	0	2684	0.0	0.0
chr8	ASNSP1	46595686	46595780	0	95	0	2850	0	2755	0.0	0.0
chr8	ASNSP1	46600435	46600674	0	240	0	2850	0	2610	0.0	0.0
chr8	ASNSP1	46593463	46593631	0	169	0	2850	0	2681	0.0	0.0
chr8	PRKDC	47776843	47776983	0	141	412	15496	412	15355	0.0	0.02683165092803647
chr8	PRKDC	47782161	47782254	0	94	412	15496	412	15402	0.0	0.026749772756784834
chr8	EFCAB1	48731347	48731503	0	157	128587	4814	128587	4657	0.0	27.61155250161048
chr8	PXDNL	51374596	51374731	0	136	51	5262	51	5126	0.0	0.009949278189621538
chr8	PCMTD1	51870247	51870390	0	144	0	6122	0	5978	0.0	0.0
chr8	PCMTD1	51860844	51861246	0	403	0	6122	0	5719	0.0	0.0
chr8	ST18	52210029	52210117	0	89	295	12096	295	12007	0.0	0.02456900141584076
chr8	ST18	52171568	52171623	0	56	295	12096	295	12040	0.0	0.024501661129568107
chr8	ST18	52217741	52217901	0	161	295	12096	295	11935	0.0	0.024717218265605363
chr8	ST18	52217812	52217901	0	90	295	12096	295	12006	0.0	0.02457104780942862
chr8	ST18	52217745	52217901	0	157	295	12096	295	11939	0.0	0.02470893709690929
chr8	ST18	52246585	52246664	0	80	295	12096	295	12016	0.0	0.024550599201065247
chr8	ALKAL1	52538430	52538507	0	78	0	1145	0	1067	0.0	0.0
chr8	RB1CC1	52660595	52660657	0	63	2851	6657	2851	6594	0.0	0.432362754018805
chr8	RB1CC1	52685398	52685520	0	123	2851	6657	2851	6534	0.0	0.43633302724211814
chr8	RB1CC1	52686852	52686967	276	116	2851	6657	2575	6541	2.3793103448275863	0.39367069255465525
chr8	RB1CC1	52685936	52686156	0	221	2851	6657	2851	6436	0.0	0.4429770043505283
chr8	OPRK1	53242738	53242912	0	175	51	5676	51	5501	0.0	0.009271041628794765
chr8	AC022034.3	53408698	53408788	0	91	0	3228	0	3137	0.0	0.0
chr8	AC022034.3	53401479	53401569	0	91	0	3228	0	3137	0.0	0.0
chr8	AC022034.3	53422696	53422835	0	140	0	3228	0	3088	0.0	0.0
chr8	AC022034.3	53399569	53399837	0	269	0	3228	0	2959	0.0	0.0
chr8	AC022034.3	53422222	53422294	0	73	0	3228	0	3155	0.0	0.0
chr8	AC022034.3	53430310	53430462	0	153	0	3228	0	3075	0.0	0.0
chr8	AC022034.1	53521018	53521379	0	362	0	7532	0	7170	0.0	0.0
chr8	ATP6V1H	53756554	53756656	0	103	0	3871	0	3768	0.0	0.0
chr8	ATP6V1H	53811163	53811217	0	55	0	3871	0	3816	0.0	0.0
chr8	ATP6V1H	53806741	53806858	0	118	0	3871	0	3753	0.0	0.0
chr8	TCEA1	54010429	54010492	0	64	0	4334	0	4270	0.0	0.0
chr8	TCEA1	54002891	54002940	0	50	0	4334	0	4284	0.0	0.0
chr8	TCEA1	54002891	54003086	0	196	0	4334	0	4138	0.0	0.0
chr8	LYPLA1	54052654	54052756	0	103	0	4705	0	4602	0.0	0.0
chr8	LYPLA1	54062253	54062324	0	72	0	4705	0	4633	0.0	0.0
chr8	LYPLA1	54063327	54063375	0	49	0	4705	0	4656	0.0	0.0
chr8	LYPLA1	54065747	54065813	0	67	0	4705	0	4638	0.0	0.0
chr8	LYPLA1	54100907	54100939	0	33	0	4705	0	4672	0.0	0.0
chr8	TMEM68	55743480	55743620	0	141	0	6607	0	6466	0.0	0.0
chr8	TMEM68	55745060	55745121	0	62	0	6607	0	6545	0.0	0.0
chr8	TMEM68	55756243	55756411	0	169	0	6607	0	6438	0.0	0.0
chr8	TMEM68	55762634	55763028	0	395	0	6607	0	6212	0.0	0.0
chr8	TMEM68	55763935	55763980	0	46	0	6607	0	6561	0.0	0.0
chr8	TMEM68	55751420	55751546	0	127	0	6607	0	6480	0.0	0.0
chr8	TMEM68	55763636	55763701	0	66	0	6607	0	6541	0.0	0.0
chr8	TMEM68	55763421	55763701	0	281	0	6607	0	6326	0.0	0.0
chr8	RPS20	56073694	56073768	0	75	0	6105	0	6030	0.0	0.0
chr8	RPS20	56074059	56074159	0	101	0	6105	0	6004	0.0	0.0
chr8	PLAG1	56168027	56168386	0	360	0	7834	0	7474	0.0	0.0
chr8	PLAG1	56179408	56179513	0	106	0	7834	0	7728	0.0	0.0
chr8	SDR16C5	56312156	56312288	0	133	0	3287	0	3154	0.0	0.0
chr8	SDR16C5	56303937	56304084	0	148	0	3287	0	3139	0.0	0.0
chr8	SDR16C6P	56382522	56382622	0	101	102	1094	102	993	0.0	0.1027190332326284
chr8	LINC00968	56534945	56535009	0	65	0	3316	0	3251	0.0	0.0
chr8	LINC00968	56544078	56544178	0	101	0	3316	0	3215	0.0	0.0
chr8	LINC00968	56538588	56538894	0	307	0	3316	0	3009	0.0	0.0
chr8	AC009597.1	56645631	56645847	0	217	4816	2974	4816	2757	0.0	1.7468262604280014
chr8	AC009597.1	56654907	56655009	0	103	4816	2974	4816	2871	0.0	1.6774642981539534
chr8	BPNT2	56967109	56967218	0	110	220396	7626	220396	7516	0.0	29.323576370409793
chr8	AC092819.1	58260524	58260753	0	230	0	2277	0	2047	0.0	0.0
chr8	AC092819.1	58271280	58271547	0	268	0	2277	0	2009	0.0	0.0
chr8	AC092819.1	58271280	58271596	0	317	0	2277	0	1960	0.0	0.0
chr8	NSMAF	58637233	58637389	0	157	0	6094	0	5937	0.0	0.0
chr8	NSMAF	58639967	58640102	0	136	0	6094	0	5958	0.0	0.0
chr8	LINC01301	60408354	60408497	0	144	153	9536	153	9392	0.0	0.01629045996592845
chr8	LINC01301	60468071	60468192	0	122	153	9536	153	9414	0.0	0.016252390057361378
chr8	ASPH	61618977	61619019	0	43	15615	19640	15615	19597	0.0	0.796805633515334
chr8	ASPH	61638321	61638363	0	43	15615	19640	15615	19597	0.0	0.796805633515334
chr8	ASPH	61643944	61644001	224	58	15615	19640	15391	19582	3.8620689655172415	0.785976917577367
chr8	ASPH	61646749	61646878	0	130	15615	19640	15615	19510	0.0	0.800358790363916
chr8	ASPH	61633682	61633727	0	46	15615	19640	15615	19594	0.0	0.7969276309074207
chr8	ASPH	61638321	61638360	0	40	15615	19640	15615	19600	0.0	0.7966836734693877
chr8	ASPH	61682438	61682483	0	46	15615	19640	15615	19594	0.0	0.7969276309074207
chr8	GGH	63023906	63023997	0	92	0	6476	0	6384	0.0	0.0
chr8	GGH	63023906	63023939	0	34	0	6476	0	6442	0.0	0.0
chr8	GGH	63017065	63017183	0	119	0	6476	0	6357	0.0	0.0
chr8	AC011124.1	63413383	63413717	0	335	0	3217	0	2882	0.0	0.0
chr8	LINC01414	64151092	64151164	0	73	0	4070	0	3997	0.0	0.0
chr8	LINC01414	64230555	64230619	0	65	0	4070	0	4005	0.0	0.0
chr8	LINC01414	63895497	63895549	0	53	0	4070	0	4017	0.0	0.0
chr8	LINC01414	64166974	64167027	0	54	0	4070	0	4016	0.0	0.0
chr8	AC104232.1	64804172	64804278	0	107	0	882	0	775	0.0	0.0
chr8	ARMC1	65613243	65613433	0	191	0	3427	0	3236	0.0	0.0
chr8	ARMC1	65622262	65622354	0	93	0	3427	0	3334	0.0	0.0
chr8	ARMC1	65632897	65632997	0	101	0	3427	0	3326	0.0	0.0
chr8	MYBL1	66566063	66566243	0	181	13839	6691	13839	6510	0.0	2.1258064516129034
chr8	SNHG6	66922323	66922392	0	70	0	1198	0	1128	0.0	0.0
chr8	SNHG6	66922613	66922725	0	113	0	1198	0	1085	0.0	0.0
chr8	PPP1R42	66971093	66971140	0	48	237	2092	237	2044	0.0	0.1159491193737769
chr8	PPP1R42	66988399	66988517	0	119	237	2092	237	1973	0.0	0.12012164216928535
chr8	PPP1R42	66982048	66982180	36	133	237	2092	201	1959	0.2706766917293233	0.10260336906584992
chr8	PPP1R42	67014425	67014592	0	168	237	2092	237	1924	0.0	0.12318087318087319
chr8	PPP1R42	67021244	67021344	0	101	237	2092	237	1991	0.0	0.11903566047212456
chr8	COPS5	67047767	67047859	0	93	969	6172	969	6079	0.0	0.15940121730547788
chr8	COPS5	67060496	67060545	0	50	969	6172	969	6122	0.0	0.15828160731786997
chr8	COPS5	67061291	67061422	0	132	969	6172	969	6040	0.0	0.16043046357615895
chr8	COPS5	67060320	67060545	0	226	969	6172	969	5946	0.0	0.16296670030272453
chr8	COPS5	67080881	67081096	0	216	969	6172	969	5956	0.0	0.1626930826057757
chr8	CPA6	67517922	67518047	0	126	63442	2900	63442	2774	0.0	22.87022350396539
chr8	C8ORF34-AS1	68312143	68312217	0	75	0	4657	0	4582	0.0	0.0
chr8	C8ORF34-AS1	68308859	68308963	0	105	0	4657	0	4552	0.0	0.0
chr8	C8ORF34-AS1	68312143	68312281	0	139	0	4657	0	4518	0.0	0.0
chr8	C8ORF34-AS1	68312143	68312252	0	110	0	4657	0	4547	0.0	0.0
chr8	C8ORF34-AS1	68316714	68317012	0	299	0	4657	0	4358	0.0	0.0
chr8	C8ORF34-AS1	68312143	68312220	0	78	0	4657	0	4579	0.0	0.0
chr8	LINC01592	68998303	68998342	0	40	0	3717	0	3677	0.0	0.0
chr8	LINC01592	68954057	68954162	0	106	0	3717	0	3611	0.0	0.0
chr8	LINC01592	68954057	68954113	0	57	0	3717	0	3660	0.0	0.0
chr8	LINC01592	69000058	69000122	0	65	0	3717	0	3652	0.0	0.0
chr8	LINC01592	68948494	68948589	0	96	0	3717	0	3621	0.0	0.0
chr8	LINC01603	69447586	69447731	0	146	0	1560	0	1414	0.0	0.0
chr8	LINC01603	69447586	69447698	0	113	0	1560	0	1447	0.0	0.0
chr8	SLCO5A1	69676608	69676673	0	66	153	9921	153	9855	0.0	0.015525114155251141
chr8	SLCO5A1	69738039	69738204	0	166	153	9921	153	9755	0.0	0.015684264479753973
chr8	NCOA2	70144641	70144848	0	208	22	9572	22	9364	0.0	0.002349423323366083
chr8	TRAM1	70598133	70598255	0	123	0	4144	0	4021	0.0	0.0
chr8	LACTB2	70640901	70641050	0	150	0	1940	0	1790	0.0	0.0
chr8	EYA1	71244602	71244692	0	91	32139	8802	32139	8711	0.0	3.6894730800137756
chr8	EYA1	71354781	71354909	0	129	32139	8802	32139	8673	0.0	3.7056381874783813
chr8	EYA1	71323955	71323986	0	32	32139	8802	32139	8770	0.0	3.6646522234891674
chr8	EYA1	71470857	71470931	0	75	32139	8802	32139	8727	0.0	3.682708834651083
chr8	EYA1	71225151	71225305	0	155	32139	8802	32139	8647	0.0	3.716780386261131
chr8	C8ORF89	73250267	73250323	0	57	0	662	0	605	0.0	0.0
chr8	RDH10-AS1	73321739	73322087	0	349	0	3809	0	3460	0.0	0.0
chr8	STAU2	73673106	73673242	0	137	0	8989	0	8852	0.0	0.0
chr8	STAU2	73688653	73688813	0	161	0	8989	0	8828	0.0	0.0
chr8	STAU2	73709031	73709162	0	132	0	8989	0	8857	0.0	0.0
chr8	STAU2	73739755	73739868	0	114	0	8989	0	8875	0.0	0.0
chr8	STAU2	73527690	73527804	0	115	0	8989	0	8874	0.0	0.0
chr8	STAU2	73738283	73738349	0	67	0	8989	0	8922	0.0	0.0
chr8	STAU2	73561410	73561539	0	130	0	8989	0	8859	0.0	0.0
chr8	STAU2	73668980	73669110	0	131	0	8989	0	8858	0.0	0.0
chr8	STAU2	73697307	73697442	0	136	0	8989	0	8853	0.0	0.0
chr8	STAU2	73742223	73742363	0	141	0	8989	0	8848	0.0	0.0
chr8	UBE2W	73825146	73825249	0	104	1224	9101	1224	8997	0.0	0.13604534844948316
chr8	UBE2W	73870268	73870301	0	34	1224	9101	1224	9067	0.0	0.13499503694717105
chr8	UBE2W	73796606	73796690	0	85	1224	9101	1224	9016	0.0	0.13575865128660158
chr8	UBE2W	73795790	73795914	0	125	1224	9101	1224	8976	0.0	0.13636363636363635
chr8	ELOC	73959764	73959818	2026	55	38657	4943	36631	4888	36.836363636363636	7.494067103109656
chr8	ELOC	73969559	73969673	364	115	38657	4943	38293	4828	3.1652173913043478	7.931441590720795
chr8	ELOC	73964486	73964625	1632	140	38657	4943	37025	4803	11.657142857142857	7.708723714345201
chr8	CASC9	75276986	75277090	7693	105	24791	3373	17098	3268	73.26666666666667	5.231946144430845
chr8	CASC9	75271313	75271433	0	121	24791	3373	24791	3252	0.0	7.623308733087331
chr8	CASC9	75324220	75324333	0	114	24791	3373	24791	3259	0.0	7.606934642528383
chr8	CASC9	75278356	75278481	2059	126	24791	3373	22732	3247	16.341269841269842	7.000923929781337
chr8	ZFHX4-AS1	76672826	76673033	0	208	0	5260	0	5052	0.0	0.0
chr8	ZFHX4-AS1	76615152	76615319	0	168	0	5260	0	5092	0.0	0.0
chr8	ZFHX4-AS1	76614792	76615319	0	528	0	5260	0	4732	0.0	0.0
chr8	PEX2	76988306	76988338	0	33	0	4975	0	4942	0.0	0.0
chr8	PEX2	76986186	76986296	0	111	0	4975	0	4864	0.0	0.0
chr8	PKIA-AS1	78535849	78535973	0	125	51	7213	51	7088	0.0	0.007195259593679458
chr8	IL7	78738503	78738635	0	133	0	3129	0	2996	0.0	0.0
chr8	IL7	78736473	78736527	0	55	0	3129	0	3074	0.0	0.0
chr8	IL7	78746893	78747096	0	204	0	3129	0	2925	0.0	0.0
chr8	HEY1	79766650	79766732	0	83	1020	4811	1020	4728	0.0	0.21573604060913706
chr8	MRPS28	80002998	80003180	0	183	0	1805	0	1622	0.0	0.0
chr8	MRPS28	79958256	79958435	0	180	0	1805	0	1625	0.0	0.0
chr8	TPD52	80064477	80064593	0	117	51	7967	51	7850	0.0	0.006496815286624204
chr8	TPD52	80044166	80044208	0	43	51	7967	51	7924	0.0	0.006436143361938415
chr8	TPD52	80050444	80050471	0	28	51	7967	51	7939	0.0	0.006423982869379015
chr8	TPD52	80052605	80052675	0	71	51	7967	51	7896	0.0	0.006458966565349544
chr8	TPD52	80119814	80119884	0	71	51	7967	51	7896	0.0	0.006458966565349544
chr8	PMP2	81444816	81444989	0	174	5808	3528	5808	3354	0.0	1.7316636851520573
chr8	IMPA1	81670938	81671047	0	110	0	4417	0	4307	0.0	0.0
chr8	IMPA1	81676233	81676279	0	47	0	4417	0	4370	0.0	0.0
chr8	IMPA1	81679125	81679230	0	106	0	4417	0	4311	0.0	0.0
chr8	IMPA1	81685762	81685963	0	202	0	4417	0	4215	0.0	0.0
chr8	IMPA1	81676233	81676265	0	33	0	4417	0	4384	0.0	0.0
chr8	IMPA1	81678582	81678689	0	108	0	4417	0	4309	0.0	0.0
chr8	IMPA1	81674671	81674831	0	161	0	4417	0	4256	0.0	0.0
chr8	ZFAND1	81717248	81717288	0	41	970	2569	970	2528	0.0	0.3837025316455696
chr8	ZFAND1	81708787	81708829	0	43	970	2569	970	2526	0.0	0.384006334125099
chr8	SNX16	81829429	81829516	0	88	0	4619	0	4531	0.0	0.0
chr8	SNX16	81840197	81840443	0	247	0	4619	0	4372	0.0	0.0
chr8	AC060765.1	82536235	82536405	0	171	637	1669	637	1498	0.0	0.4252336448598131
chr8	RBIS	85214920	85215037	0	118	0	2119	0	2001	0.0	0.0
chr8	RBIS	85219235	85219363	0	129	0	2119	0	1990	0.0	0.0
chr8	RBIS	85219322	85219363	0	42	0	2119	0	2077	0.0	0.0
chr8	RBIS	85219235	85219360	0	126	0	2119	0	1993	0.0	0.0
chr8	CA1	85332489	85332552	8	64	460	3056	452	2992	0.125	0.15106951871657753
chr8	CA1	85338251	85338449	0	199	460	3056	460	2857	0.0	0.16100805040252011
chr8	CA1	85351730	85351784	0	55	460	3056	460	3001	0.0	0.15328223925358214
chr8	CA1	85336944	85337063	0	120	460	3056	460	2936	0.0	0.1566757493188011
chr8	CA1	85341598	85341659	0	62	460	3056	460	2994	0.0	0.15364061456245826
chr8	CA1	85342748	85342825	0	78	460	3056	460	2978	0.0	0.1544660846205507
chr8	CA1	85338088	85338139	0	52	460	3056	460	3004	0.0	0.15312916111850866
chr8	CA1	85349810	85349885	0	76	460	3056	460	2980	0.0	0.15436241610738255
chr8	CA1	85341753	85341834	0	82	460	3056	460	2974	0.0	0.1546738399462004
chr8	CA1	85341753	85341808	0	56	460	3056	460	3000	0.0	0.15333333333333332
chr8	CA3-AS1	85444006	85444120	0	115	0	3418	0	3303	0.0	0.0
chr8	SLC7A13	86215560	86215688	0	129	0	2215	0	2086	0.0	0.0
chr8	RMDN1	86484871	86484961	0	91	153	5558	153	5467	0.0	0.02798609840863362
chr8	RMDN1	86474819	86474953	0	135	153	5558	153	5423	0.0	0.02821316614420063
chr8	RMDN1	86474819	86474914	0	96	153	5558	153	5462	0.0	0.028011717319663128
chr8	RMDN1	86505299	86505379	0	81	153	5558	153	5477	0.0	0.027935000912908528
chr8	RMDN1	86494828	86494966	0	139	153	5558	153	5419	0.0	0.028233991511348956
chr8	AF121898.1	87636600	87636650	0	51	111011	2929	111011	2878	0.0	38.5722724113968
chr8	AF121898.1	87646916	87647029	0	114	111011	2929	111011	2815	0.0	39.435523978685616
chr8	AF117829.1	89725517	89725641	0	125	3411	13611	3411	13486	0.0	0.2529289633694201
chr8	NBN	89946139	89946295	0	157	0	6181	0	6024	0.0	0.0
chr8	NBN	89981952	89982002	0	51	0	6181	0	6130	0.0	0.0
chr8	CALB1	90093397	90093484	0	88	51	7066	51	6978	0.0	0.007308684436801376
chr8	CALB1	90093397	90093675	0	279	51	7066	51	6787	0.0	0.007514365699130691
chr8	AC004083.1	90562228	90562340	0	113	821	4799	821	4686	0.0	0.17520273154075972
chr8	TMEM64	90631551	90631707	0	157	12357	5879	12357	5722	0.0	2.159559594547361
chr8	TMEM64	90727498	90727579	0	82	12357	5879	12357	5797	0.0	2.1316198033465588
chr8	PIP4P2	91008742	91008795	0	54	32400	2876	32400	2822	0.0	11.481218993621544
chr8	PIP4P2	91024288	91024366	26	79	32400	2876	32374	2797	0.3291139240506329	11.574544154451198
chr8	RUNX1T1	92062545	92062709	0	165	118127	12864	118127	12699	0.0	9.302071029214899
chr8	RUNX1T1	92095027	92095171	3468	145	118127	12864	114659	12719	23.917241379310344	9.014781036244988
chr8	RUNX1T1	92081233	92081293	7303	61	118127	12864	110824	12803	119.72131147540983	8.656096227446692
chr8	RUNX1T1	92075964	92076137	4880	174	118127	12864	113247	12690	28.04597701149425	8.924113475177306
chr8	RUNX1T1	92062545	92062627	0	83	118127	12864	118127	12781	0.0	9.242391049213676
chr8	RUNX1T1	91979776	91979931	0	156	118127	12864	118127	12708	0.0	9.295483160214038
chr8	RUNX1T1	91994486	91994623	0	138	118127	12864	118127	12726	0.0	9.282335376394782
chr8	RUNX1T1	92003301	92003380	990	80	118127	12864	117137	12784	12.375	9.162781602002504
chr8	RUNX1T1	92075964	92076132	4785	169	118127	12864	113342	12695	28.31360946745562	8.928081922016542
chr8	RUNX1T1	92062545	92062622	0	78	118127	12864	118127	12786	0.0	9.238776787110902
chr8	TRIQK	92916928	92917010	0	83	710	4946	710	4863	0.0	0.14600041126876415
chr8	TRIQK	92954405	92954564	0	160	710	4946	710	4786	0.0	0.14834935227747598
chr8	TRIQK	92916928	92917007	0	80	710	4946	710	4866	0.0	0.14591039868475134
chr8	TRIQK	92921502	92921660	149	159	710	4946	561	4787	0.9371069182389937	0.11719239607269688
chr8	TRIQK	92960500	92960719	0	220	710	4946	710	4726	0.0	0.15023275497249258
chr8	RBM12B	93737306	93737355	0	50	0	5969	0	5919	0.0	0.0
chr8	RBM12B	93740628	93740696	0	69	0	5969	0	5900	0.0	0.0
chr8	CDH17	94130625	94130739	0	115	0	3898	0	3783	0.0	0.0
chr8	CDH17	94151867	94152112	0	246	0	3898	0	3652	0.0	0.0
chr8	CDH17	94197229	94197331	0	103	0	3898	0	3795	0.0	0.0
chr8	RAD54B	94458267	94458436	0	170	102	5337	102	5167	0.0	0.019740661892781113
chr8	RAD54B	94432610	94432656	0	47	102	5337	102	5290	0.0	0.019281663516068054
chr8	VIRMA	94491577	94491909	0	333	153	9910	153	9577	0.0	0.01597577529497755
chr8	VIRMA	94494859	94494956	0	98	153	9910	153	9812	0.0	0.015593151243375458
chr8	VIRMA	94499373	94499506	0	134	153	9910	153	9776	0.0	0.015650572831423896
chr8	VIRMA	94510416	94510652	0	237	153	9910	153	9673	0.0	0.015817223198594025
chr8	VIRMA	94534838	94535007	0	170	153	9910	153	9740	0.0	0.01570841889117043
chr8	CCNE2	94892817	94892969	0	153	0	4412	0	4259	0.0	0.0
chr8	TP53INP1	94932069	94932107	793	39	142119	5648	141326	5609	20.333333333333332	25.196291674095203
chr8	UQCRB	96234422	96234536	0	115	1377	9892	1377	9777	0.0	0.140840748695919
chr8	UQCRB	96231225	96231515	0	291	1377	9892	1377	9601	0.0	0.14342256014998436
chr8	UQCRB	96231531	96231621	0	91	1377	9892	1377	9801	0.0	0.14049586776859505
chr8	UQCRB	96231378	96231515	0	138	1377	9892	1377	9754	0.0	0.1411728521632151
chr8	MTERF3	96239793	96239855	0	63	8180	1811	8180	1748	0.0	4.679633867276888
chr8	MTERF3	96243918	96244080	0	163	8180	1811	8180	1648	0.0	4.963592233009709
chr8	MTERF3	96260136	96260247	0	112	8180	1811	8180	1699	0.0	4.8145968216598
chr8	RPL30	98044942	98045088	0	147	456	3856	456	3709	0.0	0.12294418980857375
chr8	RPL30	98044826	98045088	0	263	456	3856	456	3593	0.0	0.12691344280545505
chr8	RIDA	98108645	98108751	0	107	0	1504	0	1397	0.0	0.0
chr8	RIDA	98108645	98108713	0	69	0	1504	0	1435	0.0	0.0
chr8	RIDA	98108645	98108768	0	124	0	1504	0	1380	0.0	0.0
chr8	NIPAL2	98193384	98193412	0	29	4437	5352	4437	5323	0.0	0.8335525079842194
chr8	STK3	98749275	98749390	0	116	873	7884	873	7768	0.0	0.11238414006179197
chr8	STK3	98889774	98889902	0	129	873	7884	873	7755	0.0	0.11257253384912959
chr8	STK3	98638459	98638560	63	102	873	7884	810	7782	0.6176470588235294	0.1040863531225906
chr8	VPS13B-DT	98961946	98962041	0	96	2745	3622	2745	3526	0.0	0.7785025524673851
chr8	RGS22	100080133	100080355	306	223	9270	6401	8964	6178	1.3721973094170403	1.4509550016186468
chr8	RGS22	100091877	100091987	0	111	9270	6401	9270	6290	0.0	1.4737678855325913
chr8	RGS22	100054333	100054423	0	91	9270	6401	9270	6310	0.0	1.4690966719492868
chr8	RNF19A	100261541	100261755	0	215	0	5281	0	5066	0.0	0.0
chr8	RNF19A	100264033	100264195	0	163	0	5281	0	5118	0.0	0.0
chr8	RNF19A	100300527	100300651	0	125	0	5281	0	5156	0.0	0.0
chr8	RNF19A	100312343	100312410	0	68	0	5281	0	5213	0.0	0.0
chr8	AP003472.1	100410734	100410771	0	38	0	1822	0	1784	0.0	0.0
chr8	AP003472.1	100395380	100395457	0	78	0	1822	0	1744	0.0	0.0
chr8	ANKRD46	100527844	100528003	0	160	51	5482	51	5322	0.0	0.009582863585118376
chr8	ANKRD46	100533208	100533311	0	104	51	5482	51	5378	0.0	0.009483079211602826
chr8	ANKRD46	100532355	100532460	0	106	51	5482	51	5376	0.0	0.009486607142857142
chr8	ANKRD46	100554578	100554717	0	140	51	5482	51	5342	0.0	0.009546986147510296
chr8	SNX31	100577018	100577075	0	58	0	3160	0	3102	0.0	0.0
chr8	SNX31	100657723	100657867	0	145	0	3160	0	3015	0.0	0.0
chr8	SNX31	100649273	100649348	0	76	0	3160	0	3084	0.0	0.0
chr8	PABPC1	100706886	100706997	0	112	51	8827	51	8715	0.0	0.00585197934595525
chr8	PABPC1	100712361	100712457	0	97	51	8827	51	8730	0.0	0.00584192439862543
chr8	PABPC1	100712651	100712789	0	139	51	8827	51	8688	0.0	0.005870165745856353
chr8	PABPC1	100721390	100721619	0	230	51	8827	51	8597	0.0	0.005932301965802024
chr8	PABPC1	100706650	100706805	0	156	51	8827	51	8671	0.0	0.0058816745473417135
chr8	PABPC1	100721390	100721452	0	63	51	8827	51	8764	0.0	0.00581926061159288
chr8	YWHAZ	100948595	100948900	0	306	102	5869	102	5563	0.0	0.018335430523099047
chr8	YWHAZ	100951928	100952125	0	198	102	5869	102	5671	0.0	0.017986245812026097
chr8	YWHAZ	100951928	100952308	0	381	102	5869	102	5488	0.0	0.01858600583090379
chr8	ZNF706	101199194	101199239	0	46	13259	4818	13259	4772	0.0	2.7784995808885165
chr8	ZNF706	101199989	101200097	0	109	13259	4818	13259	4709	0.0	2.81567211722234
chr8	ZNF706	101199989	101200123	0	135	13259	4818	13259	4683	0.0	2.831304719197096
chr8	ZNF706	101202332	101202447	0	116	13259	4818	13259	4702	0.0	2.8198638877073585
chr8	ZNF706	101204649	101204693	405	45	13259	4818	12854	4773	9.0	2.693065158181437
chr8	ZNF706	101200767	101201004	0	238	13259	4818	13259	4580	0.0	2.8949781659388645
chr8	ZNF706	101202332	101202452	0	121	13259	4818	13259	4697	0.0	2.822865658931233
chr8	NCALD	101887140	101887227	0	88	26091	5763	26091	5675	0.0	4.597533039647577
chr8	NCALD	102029009	102029096	0	88	26091	5763	26091	5675	0.0	4.597533039647577
chr8	NCALD	101950257	101950360	0	104	26091	5763	26091	5659	0.0	4.610531896094717
chr8	NCALD	101750597	101750687	0	91	26091	5763	26091	5672	0.0	4.599964739069112
chr8	NCALD	101852571	101852670	0	100	26091	5763	26091	5663	0.0	4.607275295779622
chr8	NCALD	101779923	101779979	0	57	26091	5763	26091	5706	0.0	4.572555205047319
chr8	NCALD	101721212	101721351	2733	140	26091	5763	23358	5623	19.521428571428572	4.154010314778588
chr8	NCALD	101750042	101750162	0	121	26091	5763	26091	5642	0.0	4.624423963133641
chr8	NCALD	101745830	101745993	0	164	26091	5763	26091	5599	0.0	4.659939274870513
chr8	RRM2B	102232148	102232304	0	157	10507	4052	10507	3895	0.0	2.6975609756097563
chr8	RRM2B	102234724	102234845	0	122	10507	4052	10507	3930	0.0	2.6735368956743004
chr8	AZIN1	102839649	102839823	0	175	459	5939	459	5764	0.0	0.0796321998612075
chr8	AZIN1	102849998	102850144	0	147	459	5939	459	5792	0.0	0.07924723756906077
chr8	AZIN1	102859069	102859188	0	120	459	5939	459	5819	0.0	0.07887953256573295
chr8	BAALC-AS1	103277977	103278021	340	45	163374	14006	163034	13961	7.555555555555555	11.67781677530263
chr8	BAALC-AS1	103268390	103268472	111	83	163374	14006	163263	13923	1.3373493975903614	11.726136608489549
chr8	BAALC-AS1	103268691	103268843	937	153	163374	14006	162437	13853	6.124183006535947	11.725763372554681
chr8	SLC25A32	103404775	103404861	141	87	6005	3661	5864	3574	1.6206896551724137	1.6407386681589256
chr8	SLC25A32	103403163	103403324	612	162	6005	3661	5393	3499	3.7777777777777777	1.5412975135753073
chr8	DPYS	104381183	104381314	0	132	20869	3828	20869	3696	0.0	5.646374458874459
chr8	DPYS	104451245	104451404	0	160	20869	3828	20869	3668	0.0	5.689476553980371
chr8	DPYS	104392783	104392991	153	209	20869	3828	20716	3619	0.7320574162679426	5.724233213594916
chr8	LRP12	104531906	104531963	0	58	50027	9784	50027	9726	0.0	5.143635615874974
chr8	ZFPM2-AS1	105787066	105787221	0	156	0	2451	0	2295	0.0	0.0
chr8	ZFPM2-AS1	106060134	106060234	0	101	0	2451	0	2350	0.0	0.0
chr8	ANGPT1	107284681	107284848	12327	168	43212	7136	30885	6968	73.375	4.432405281285878
chr8	ANGPT1	107303239	107303367	0	129	43212	7136	43212	7007	0.0	6.166975881261595
chr8	RSPO2	107989055	107989244	0	190	0	4366	0	4176	0.0	0.0
chr8	RSPO2	108060042	108060238	0	197	0	4366	0	4169	0.0	0.0
chr8	EIF3E	108239957	108240075	0	119	51	27596	51	27477	0.0	0.00185609782727372
chr8	EIF3E	108241798	108241913	0	116	51	27596	51	27480	0.0	0.0018558951965065502
chr8	EIF3E	108239957	108240098	0	142	51	27596	51	27454	0.0	0.0018576528010490275
chr8	EIF3E	108243292	108243463	0	172	51	27596	51	27424	0.0	0.0018596849474912486
chr8	EIF3E	108219749	108219830	0	82	51	27596	51	27514	0.0	0.001853601802718616
chr8	EIF3E	108242111	108242346	0	236	51	27596	51	27360	0.0	0.0018640350877192982
chr8	EIF3E	108268245	108268422	0	178	51	27596	51	27418	0.0	0.0018600919104238092
chr8	EIF3E	108434372	108434493	0	122	51	27596	51	27474	0.0	0.001856300502293077
chr8	EIF3E	108434372	108434487	0	116	51	27596	51	27480	0.0	0.0018558951965065502
chr8	EIF3E	108241885	108241913	0	29	51	27596	51	27567	0.0	0.0018500380890194798
chr8	EIF3E	108242111	108242256	0	146	51	27596	51	27450	0.0	0.0018579234972677596
chr8	AC104248.1	108916046	108916091	0	46	0	1972	0	1926	0.0	0.0
chr8	NUDCD1	109322308	109322463	51	156	308969	9547	308918	9391	0.3269230769230769	32.895112341603664
chr8	NUDCD1	109313796	109313888	0	93	308969	9547	308969	9454	0.0	32.6812989210916
chr8	SYBU	109586059	109586162	0	104	52	6757	52	6653	0.0	0.007816022846836013
chr8	SYBU	109642727	109642932	0	206	52	6757	52	6551	0.0	0.007937719432147763
chr8	SYBU	109642727	109642929	0	203	52	6757	52	6554	0.0	0.007934086054317974
chr8	SYBU	109645883	109646004	0	122	52	6757	52	6635	0.0	0.007837226827430294
chr8	SYBU	109642727	109642947	0	221	52	6757	52	6536	0.0	0.00795593635250918
chr8	SYBU	109644635	109644716	0	82	52	6757	52	6675	0.0	0.007790262172284644
chr8	LINC01608	111014903	111015032	0	130	0	12963	0	12833	0.0	0.0
chr8	LINC01608	111005529	111005649	0	121	0	12963	0	12842	0.0	0.0
chr8	LINC01608	111004660	111004769	0	110	0	12963	0	12853	0.0	0.0
chr8	LINC01608	110931442	110933251	0	1810	0	12963	0	11153	0.0	0.0
chr8	LINC01608	110947259	110947418	0	160	0	12963	0	12803	0.0	0.0
chr8	LINC01609	111113431	111113520	0	90	0	3404	0	3314	0.0	0.0
chr8	LINC01609	111121265	111121332	0	68	0	3404	0	3336	0.0	0.0
chr8	LINC01609	111116534	111116600	0	67	0	3404	0	3337	0.0	0.0
chr8	LINC01609	111184572	111184668	0	97	0	3404	0	3307	0.0	0.0
chr8	LINC01609	111228414	111228572	0	159	0	3404	0	3245	0.0	0.0
chr8	LINC01609	111186393	111186479	0	87	0	3404	0	3317	0.0	0.0
chr8	CSMD3	112304720	112304915	0	196	102	20481	102	20285	0.0	0.00502834606852354
chr8	CSMD3	112975836	112976148	0	313	102	20481	102	20168	0.0	0.005057516858389528
chr8	TRPS1	115623600	115623758	0	159	102	11061	102	10902	0.0	0.009356081452944413
chr8	LINC00536	116261411	116261641	0	231	0	3491	0	3260	0.0	0.0
chr8	EIF3H	116726015	116726172	0	158	896	6450	896	6292	0.0	0.1424030514939606
chr8	EIF3H	116697052	116697237	0	186	896	6450	896	6264	0.0	0.14303959131545338
chr8	EIF3H	116734276	116734324	0	49	896	6450	896	6401	0.0	0.1399781284174348
chr8	EIF3H	116737236	116737287	0	52	896	6450	896	6398	0.0	0.1400437636761488
chr8	EIF3H	116689068	116689140	0	73	896	6450	896	6377	0.0	0.14050493962678376
chr8	EIF3H	116734276	116734354	0	79	896	6450	896	6371	0.0	0.14063726259613876
chr8	EXT1	117831598	117831653	0	56	6038	7752	6038	7696	0.0	0.7845634095634095
chr8	SAMD12	118439861	118439961	0	101	426	15396	426	15295	0.0	0.02785223929388689
chr8	SAMD12	118439831	118439961	0	131	426	15396	426	15265	0.0	0.027906976744186046
chr8	TNFRSF11B	118930487	118930768	102	282	5979	2518	5877	2236	0.3617021276595745	2.6283542039355994
chr8	MAL2-AS1	119244809	119244842	0	34	0	2009	0	1975	0.0	0.0
chr8	MAL2-AS1	119224249	119224312	0	64	0	2009	0	1945	0.0	0.0
chr8	MAL2-AS1	119244809	119244975	0	167	0	2009	0	1842	0.0	0.0
chr8	ENPP2	119595846	119596002	0	157	1440	6760	1440	6603	0.0	0.21808268968650613
chr8	ENPP2	119572175	119572250	0	76	1440	6760	1440	6684	0.0	0.21543985637342908
chr8	ENPP2	119618149	119618323	0	175	1440	6760	1440	6585	0.0	0.21867881548974943
chr8	TAF2	119796989	119797103	0	115	51	6411	51	6296	0.0	0.008100381194409149
chr8	TAF2	119819345	119819506	0	162	51	6411	51	6249	0.0	0.00816130580892943
chr8	TAF2	119744880	119745036	0	157	51	6411	51	6254	0.0	0.008154780940198274
chr8	TAF2	119761607	119761772	0	166	51	6411	51	6245	0.0	0.008166533226581264
chr8	MRPL13	120432029	120432123	70	95	121	4217	51	4122	0.7368421052631579	0.012372634643377001
chr8	SNTB1	120551130	120551251	0	122	6851	6806	6851	6684	0.0	1.024985038898863
chr8	LINC01151	122693372	122693481	0	110	3919	10472	3919	10362	0.0	0.3782088399922795
chr8	LINC01151	122693372	122693436	0	65	3919	10472	3919	10407	0.0	0.3765734601710387
chr8	FAM83A-AS1	123201643	123201982	0	340	0	2531	0	2191	0.0	0.0
chr8	ZHX1	123253321	123256171	0	2851	0	6740	0	3889	0.0	0.0
chr8	ATAD2	123328189	123328579	0	391	0	7131	0	6740	0.0	0.0
chr8	ATAD2	123380528	123380677	0	150	0	7131	0	6981	0.0	0.0
chr8	ANXA13	123735754	123735877	0	124	0	3815	0	3691	0.0	0.0
chr8	TATDN1	124522150	124522200	870	51	286290	4793	285420	4742	17.058823529411764	60.18979333614509
chr8	TATDN1	124522936	124523002	903	67	286290	4793	285387	4726	13.477611940298507	60.386584849767246
chr8	TATDN1	124503839	124503951	0	113	286290	4793	286290	4680	0.0	61.17307692307692
chr8	TATDN1	124518817	124518881	335	65	286290	4793	285955	4728	5.153846153846154	60.48117597292724
chr8	TATDN1	124518741	124518881	71681	141	286290	4793	214609	4652	508.3758865248227	46.13263112639725
chr8	TATDN1	124526664	124526824	1070	161	286290	4793	285220	4632	6.645962732919255	61.575993091537136
chr8	MTSS1	124557680	124557875	0	196	351180	7472	351180	7276	0.0	48.26553051126993
chr8	MTSS1	124558712	124558832	0	121	351180	7472	351180	7351	0.0	47.77309209631343
chr8	MTSS1	124580550	124580562	0	13	351180	7472	351180	7459	0.0	47.08137820083121
chr8	WASHC5	125083712	125084022	0	311	4	4792	4	4481	0.0	0.0008926578888640928
chr8	WASHC5	125083112	125083258	0	147	4	4792	4	4645	0.0	0.000861141011840689
chr8	WASHC5	125083712	125083776	0	65	4	4792	4	4727	0.0	0.0008462026655383964
chr8	WASHC5	125083834	125084022	0	189	4	4792	4	4603	0.0	0.0008689984792526613
chr8	LINC00861	125945932	125946182	0	251	102	8777	102	8526	0.0	0.011963406052076003
chr8	CASC19	127188044	127188115	0	72	51	18096	51	18024	0.0	0.002829560585885486
chr8	CASC19	127189909	127189982	0	74	51	18096	51	18022	0.0	0.0028298745977139053
chr8	CASC19	127197474	127197564	0	91	51	18096	51	18005	0.0	0.0028325465148569843
chr8	CASC19	127202041	127202152	0	112	51	18096	51	17984	0.0	0.0028358540925266904
chr8	CASC19	127168897	127169117	0	221	51	18096	51	17875	0.0	0.002853146853146853
chr8	CASC19	127164437	127164526	0	90	51	18096	51	18006	0.0	0.0028323892035988004
chr8	CASC19	127203162	127203220	0	59	51	18096	51	18037	0.0	0.002827521206409048
chr8	CASC19	127201017	127201123	0	107	51	18096	51	17989	0.0	0.0028350658735894155
chr8	CASC19	127205346	127205612	0	267	51	18096	51	17829	0.0	0.0028605081608615176
chr8	CASC19	127174189	127174364	0	176	51	18096	51	17920	0.0	0.0028459821428571427
chr8	CASC19	127184826	127185770	0	945	51	18096	51	17151	0.0	0.00297358754591569
chr8	CASC19	127191665	127191847	0	183	51	18096	51	17913	0.0	0.0028470942890638086
chr8	CASC19	127201017	127201173	0	157	51	18096	51	17939	0.0	0.0028429678354423326
chr8	CASC19	127205346	127205445	0	100	51	18096	51	17996	0.0	0.002833963102911758
chr8	CASC19	127191661	127191847	0	187	51	18096	51	17909	0.0	0.0028477301915238147
chr8	CASC8	127323014	127323154	0	141	11	2350	11	2209	0.0	0.004979628791308284
chr8	LINC00824	128422912	128423026	0	115	0	4572	0	4457	0.0	0.0
chr8	CCDC26	129480642	129480690	0	49	37930	49644	37930	49595	0.0	0.7647948381893336
chr8	CCDC26	129370306	129370377	0	72	37930	49644	37930	49572	0.0	0.7651496812716856
chr8	CCDC26	129399530	129399684	0	155	37930	49644	37930	49489	0.0	0.7664329446947806
chr8	CCDC26	129223220	129223369	0	150	37930	49644	37930	49494	0.0	0.7663555178405463
chr8	CCDC26	129352803	129352980	0	178	37930	49644	37930	49466	0.0	0.7667893098289734
chr8	CCDC26	129388044	129388118	0	75	37930	49644	37930	49569	0.0	0.7651959894288769
chr8	CCDC26	129399513	129399684	0	172	37930	49644	37930	49472	0.0	0.7666963130659767
chr8	CCDC26	129254421	129254495	0	75	37930	49644	37930	49569	0.0	0.7651959894288769
chr8	CCDC26	129266059	129266266	0	208	37930	49644	37930	49436	0.0	0.7672546322518004
chr8	CCDC26	129344628	129344774	0	147	37930	49644	37930	49497	0.0	0.7663090692365194
chr8	CCDC26	129267779	129267863	0	85	37930	49644	37930	49559	0.0	0.7653503904437136
chr8	CCDC26	129230768	129230861	0	94	37930	49644	37930	49550	0.0	0.765489404641776
chr8	CCDC26	129270161	129270300	0	140	37930	49644	37930	49504	0.0	0.7662007110536523
chr8	CCDC26	129303204	129303301	0	98	37930	49644	37930	49546	0.0	0.765551204940863
chr8	CCDC26	129276784	129276919	0	136	37930	49644	37930	49508	0.0	0.7661388058495596
chr8	CCDC26	129554803	129554941	0	139	37930	49644	37930	49505	0.0	0.7661852338147662
chr8	CCDC26	129284657	129284772	0	116	37930	49644	37930	49528	0.0	0.765829429817477
chr8	CCDC26	129402215	129402251	0	37	37930	49644	37930	49607	0.0	0.7646098332896567
chr8	CCDC26	129443601	129443752	0	152	37930	49644	37930	49492	0.0	0.766386486704922
chr8	CCDC26	129550814	129550926	0	113	37930	49644	37930	49531	0.0	0.7657830449617411
chr8	CCDC26	129360662	129360832	51	171	37930	49644	37879	49473	0.2982456140350877	0.7656499504780385
chr8	CCDC26	129402166	129402251	0	86	37930	49644	37930	49558	0.0	0.7653658339723153
chr8	CCDC26	129554909	129554941	0	33	37930	49644	37930	49611	0.0	0.7645481848783536
chr8	CCDC26	129571402	129571433	0	32	37930	49644	37930	49612	0.0	0.7645327743287914
chr8	CCDC26	129360173	129360832	51	660	37930	49644	37879	48984	0.07727272727272727	0.7732933202678426
chr8	CCDC26	129494543	129494766	0	224	37930	49644	37930	49420	0.0	0.7675030352084177
chr8	CCDC26	129491672	129491748	0	77	37930	49644	37930	49567	0.0	0.7652268646478504
chr8	CCDC26	129552681	129552810	0	130	37930	49644	37930	49514	0.0	0.7660459667972694
chr8	CCDC26	129509649	129509721	0	73	37930	49644	37930	49571	0.0	0.7651651167012972
chr8	CCDC26	129441180	129441310	0	131	37930	49644	37930	49513	0.0	0.7660614384101145
chr8	CCDC26	129554667	129554941	0	275	37930	49644	37930	49369	0.0	0.7682958941846098
chr8	CCDC26	129509649	129510198	0	550	37930	49644	37930	49094	0.0	0.772599502994256
chr8	CCDC26	129573117	129573214	0	98	37930	49644	37930	49546	0.0	0.765551204940863
chr8	CCDC26	129389855	129389927	0	73	37930	49644	37930	49571	0.0	0.7651651167012972
chr8	CYRIB	129862228	129862334	0	107	82	7461	82	7354	0.0	0.011150394343214578
chr8	CYRIB	129879388	129879471	0	84	82	7461	82	7377	0.0	0.011115629659753287
chr8	CYRIB	129880375	129880458	0	84	82	7461	82	7377	0.0	0.011115629659753287
chr8	CYRIB	129896671	129896854	0	184	82	7461	82	7277	0.0	0.011268379826851724
chr8	CYRIB	129904498	129904585	31	88	82	7461	51	7373	0.3522727272727273	0.0069171300691713
chr8	CYRIB	129970942	129970995	0	54	82	7461	82	7407	0.0	0.011070608883488592
chr8	CYRIB	129896748	129896854	0	107	82	7461	82	7354	0.0	0.011150394343214578
chr8	CYRIB	129912469	129912515	0	47	82	7461	82	7414	0.0	0.011060156460749933
chr8	CYRIB	129871374	129871496	0	123	82	7461	82	7338	0.0	0.011174707004633416
chr8	CYRIB	129879596	129879789	0	194	82	7461	82	7267	0.0	0.011283886060272464
chr8	CYRIB	129912359	129912417	0	59	82	7461	82	7402	0.0	0.011078087003512564
chr8	CYRIB	129894486	129894564	0	79	82	7461	82	7382	0.0	0.011108100785694934
chr8	ASAP1	130091972	130092143	0	172	0	8333	0	8161	0.0	0.0
chr8	ASAP1	130160784	130160793	0	10	0	8333	0	8323	0.0	0.0
chr8	ASAP1	130361669	130361771	0	103	0	8333	0	8230	0.0	0.0
chr8	KCNQ3	132184240	132184367	0	128	0	11790	0	11662	0.0	0.0
chr8	LRRC6	132615037	132615097	0	61	102	4306	102	4245	0.0	0.02402826855123675
chr8	LRRC6	132632739	132632963	0	225	102	4306	102	4081	0.0	0.024993874050477823
chr8	LRRC6	132578407	132578516	0	110	102	4306	102	4196	0.0	0.02430886558627264
chr8	TMEM71	132713994	132714052	0	59	203	3352	203	3293	0.0	0.06164591557849985
chr8	TMEM71	132727797	132727986	0	190	203	3352	203	3162	0.0	0.0641998734977862
chr8	TMEM71	132757233	132757294	51	62	203	3352	152	3290	0.8225806451612904	0.046200607902735565
chr8	TMEM71	132758839	132758915	0	77	203	3352	203	3275	0.0	0.06198473282442748
chr8	TMEM71	132759297	132759447	0	151	203	3352	203	3201	0.0	0.06341768197438301
chr8	TMEM71	132760291	132760369	0	79	203	3352	203	3273	0.0	0.06202260922700886
chr8	SLA	133044983	133045115	0	133	0	7510	0	7377	0.0	0.0
chr8	SLA	133060099	133060200	0	102	0	7510	0	7408	0.0	0.0
chr8	SLA	133074852	133075130	0	279	0	7510	0	7231	0.0	0.0
chr8	SLA	133087717	133087840	0	124	0	7510	0	7386	0.0	0.0
chr8	SLA	133059061	133059192	0	132	0	7510	0	7378	0.0	0.0
chr8	SLA	133064110	133064179	0	70	0	7510	0	7440	0.0	0.0
chr8	SLA	133076655	133076755	0	101	0	7510	0	7409	0.0	0.0
chr8	SLA	133063579	133063728	0	150	0	7510	0	7360	0.0	0.0
chr8	NDRG1	133247874	133247926	0	53	137	10313	137	10260	0.0	0.013352826510721248
chr8	NDRG1	133250439	133250543	0	105	137	10313	137	10208	0.0	0.013420846394984327
chr8	NDRG1	133256776	133256863	0	88	137	10313	137	10225	0.0	0.013398533007334963
chr8	NDRG1	133258365	133258426	0	62	137	10313	137	10251	0.0	0.01336454980001951
chr8	NDRG1	133264546	133264652	0	107	137	10313	137	10206	0.0	0.01342347638643935
chr8	NDRG1	133280231	133280267	0	37	137	10313	137	10276	0.0	0.013332035811599844
chr8	NDRG1	133284248	133284329	0	82	137	10313	137	10231	0.0	0.013390675398299287
chr8	NDRG1	133246978	133247120	0	143	137	10313	137	10170	0.0	0.013470993117010817
chr8	NDRG1	133255269	133255400	0	132	137	10313	137	10181	0.0	0.013456438463805127
chr8	NDRG1	133250439	133250676	0	238	137	10313	137	10075	0.0	0.01359801488833747
chr8	NDRG1	133288259	133288431	0	173	137	10313	137	10140	0.0	0.013510848126232742
chr8	NDRG1	133280960	133281055	0	96	137	10313	137	10217	0.0	0.013409024175393951
chr8	NDRG1	133267077	133267122	0	46	137	10313	137	10267	0.0	0.013343722606408882
chr8	NDRG1	133284756	133284896	0	141	137	10313	137	10172	0.0	0.013468344475029493
chr8	ST3GAL1	133499134	133499189	0	56	0	8868	0	8812	0.0	0.0
chr8	ST3GAL1	133475718	133476600	0	883	0	8868	0	7985	0.0	0.0
chr8	ST3GAL1	133507198	133507321	0	124	0	8868	0	8744	0.0	0.0
chr8	ST3GAL1	133539636	133539729	0	94	0	8868	0	8774	0.0	0.0
chr8	ZFAT	134608728	134608879	0	152	11812	6733	11812	6581	0.0	1.7948640024312414
chr8	ZFAT	134610469	134610655	0	187	11812	6733	11812	6546	0.0	1.8044607393828291
chr8	ZFAT	134674729	134674888	0	160	11812	6733	11812	6573	0.0	1.797048531872813
chr8	ZFAT	134564986	134565152	0	167	11812	6733	11812	6566	0.0	1.7989643618641487
chr8	ZFAT	134599729	134599862	0	134	11812	6733	11812	6599	0.0	1.7899681769965146
chr8	FAM135B	138367332	138367410	0	79	140	14093	140	14014	0.0	0.00999000999000999
chr8	COL22A1	138679616	138679676	0	61	0	7936	0	7875	0.0	0.0
chr8	COL22A1	138883081	138883244	0	164	0	7936	0	7772	0.0	0.0
chr8	KCNK9	139611336	139612674	0	1339	0	6793	0	5454	0.0	0.0
chr8	KCNK9	139638022	139638053	0	32	0	6793	0	6761	0.0	0.0
chr8	TRAPPC9	140426614	140426641	0	28	62	9689	62	9661	0.0	0.006417555118517752
chr8	AGO2	140535467	140535569	0	103	0	15869	0	15766	0.0	0.0
chr8	AGO2	140585118	140585311	0	194	0	15869	0	15675	0.0	0.0
chr8	PTK2	140686631	140686694	0	64	8105	12062	8105	11998	0.0	0.6755292548758126
chr8	PTK2	140702569	140702707	0	139	8105	12062	8105	11923	0.0	0.6797785792166401
chr8	PTK2	140746759	140746860	0	102	8105	12062	8105	11960	0.0	0.677675585284281
chr8	PTK2	140752231	140752316	0	86	8105	12062	8105	11976	0.0	0.6767702070808284
chr8	PTK2	140846259	140846322	0	64	8105	12062	8105	11998	0.0	0.6755292548758126
chr8	PTK2	140879470	140879637	0	168	8105	12062	8105	11894	0.0	0.681436018160417
chr8	PTK2	140925660	140925749	0	90	8105	12062	8105	11972	0.0	0.6769963247577682
chr8	PTK2	140984077	140984155	0	79	8105	12062	8105	11983	0.0	0.6763748643912209
chr8	PTK2	140762367	140762388	0	22	8105	12062	8105	12040	0.0	0.6731727574750831
chr8	PTK2	140669726	140669735	0	10	8105	12062	8105	12052	0.0	0.6725024892134086
chr8	PTK2	140769574	140769592	0	19	8105	12062	8105	12043	0.0	0.6730050651830939
chr8	PTK2	140864311	140864399	0	89	8105	12062	8105	11973	0.0	0.6769397811743089
chr8	PTK2	140751902	140751987	0	86	8105	12062	8105	11976	0.0	0.6767702070808284
chr8	PTK2	140770715	140770799	0	85	8105	12062	8105	11977	0.0	0.6767137012607498
chr8	PTK2	140660600	140660648	0	49	8105	12062	8105	12013	0.0	0.6746857570964788
chr8	PTK2	140718008	140718211	0	204	8105	12062	8105	11858	0.0	0.6835048068814302
chr8	PTK2	140948665	140948723	0	59	8105	12062	8105	12003	0.0	0.6752478547029909
chr8	PTK2	140927345	140927414	0	70	8105	12062	8105	11992	0.0	0.6758672448298866
chr8	SLC45A4	141253988	141254629	204	642	4488	8610	4284	7968	0.3177570093457944	0.5376506024096386
chr8	MROH5	141434823	141434926	0	104	2018	4795	2018	4691	0.0	0.43018546152206355
chr8	MROH5	141436685	141436862	843	178	2018	4795	1175	4617	4.735955056179775	0.25449426034221356
chr8	MROH5	141489696	141489837	0	142	2018	4795	2018	4653	0.0	0.433698689017838
chr8	MROH5	141475924	141476147	0	224	2018	4795	2018	4571	0.0	0.44147888864581053
chr8	MROH5	141496319	141496501	0	183	2018	4795	2018	4612	0.0	0.4375542064180399
chr8	TSNARE1	142279859	142280324	99	466	758	4358	659	3892	0.21244635193133046	0.16932168550873586
chr8	TSNARE1	142365910	142366017	0	108	758	4358	758	4250	0.0	0.17835294117647058
chr8	LNCOC1	142723633	142723722	0	90	51	6398	51	6308	0.0	0.008084971464806594
chr8	LNCOC1	142724657	142724738	0	82	51	6398	51	6316	0.0	0.008074730842305257
chr8	LYNX1	142775340	142775363	0	24	0	5029	0	5005	0.0	0.0
chr8	LYNX1	142775905	142776121	0	217	0	5029	0	4812	0.0	0.0
chr8	CYP11B1	142874956	142875154	0	199	0	4216	0	4017	0.0	0.0
chr8	CYP11B1	142877756	142877834	0	79	0	4216	0	4137	0.0	0.0
chr8	CYP11B1	142879345	142879480	0	136	0	4216	0	4080	0.0	0.0
chr8	LY6E-DT	143009048	143009207	0	160	51	3859	51	3699	0.0	0.013787510137875101
chr8	LY6E-DT	143012484	143012572	0	89	51	3859	51	3770	0.0	0.013527851458885942
chr8	TOP1MT	143359263	143359404	631	142	7540	6431	6909	6289	4.443661971830986	1.098584830656702
chr8	TOP1MT	143334107	143334285	0	179	7540	6431	7540	6252	0.0	1.2060140754958413
chr8	TOP1MT	143332486	143332601	0	116	7540	6431	7540	6315	0.0	1.1939825811559779
chr8	TOP1MT	143327302	143327790	0	489	7540	6431	7540	5942	0.0	1.2689330191854595
chr8	TOP1MT	143328192	143328315	0	124	7540	6431	7540	6307	0.0	1.1954970667512288
chr8	TOP1MT	143343219	143343286	0	68	7540	6431	7540	6363	0.0	1.184975640421185
chr8	TOP1MT	143332486	143332657	0	172	7540	6431	7540	6259	0.0	1.2046652819939287
chr8	TOP1MT	143344915	143344981	0	67	7540	6431	7540	6364	0.0	1.184789440603394
chr8	TOP1MT	143333795	143333927	0	133	7540	6431	7540	6298	0.0	1.197205462051445
chr8	MROH6	143567610	143567676	0	67	0	3546	0	3479	0.0	0.0
chr8	MROH6	143568141	143568261	0	121	0	3546	0	3425	0.0	0.0
chr8	NAPRT	143577061	143577177	0	117	0	2597	0	2480	0.0	0.0
chr8	EEF1D	143586218	143586290	0	73	0	8812	0	8739	0.0	0.0
chr8	EEF1D	143593892	143594071	0	180	0	8812	0	8632	0.0	0.0
chr8	EEF1D	143588990	143590092	0	1103	0	8812	0	7709	0.0	0.0
chr8	EEF1D	143590607	143590738	0	132	0	8812	0	8680	0.0	0.0
chr8	EEF1D	143592714	143592893	0	180	0	8812	0	8632	0.0	0.0
chr8	EEF1D	143588990	143590081	0	1092	0	8812	0	7720	0.0	0.0
chr8	EEF1D	143592646	143592660	0	15	0	8812	0	8797	0.0	0.0
chr8	EEF1D	143593874	143594071	0	198	0	8812	0	8614	0.0	0.0
chr8	EEF1D	143592646	143592797	0	152	0	8812	0	8660	0.0	0.0
chr8	EEF1D	143592714	143592942	0	229	0	8812	0	8583	0.0	0.0
chr8	EEF1D	143594415	143594518	0	104	0	8812	0	8708	0.0	0.0
chr8	EEF1D	143590607	143590729	0	123	0	8812	0	8689	0.0	0.0
chr8	EEF1D	143590644	143590738	0	95	0	8812	0	8717	0.0	0.0
chr8	EEF1D	143590607	143590735	0	129	0	8812	0	8683	0.0	0.0
chr8	EEF1D	143592646	143592942	0	297	0	8812	0	8515	0.0	0.0
chr8	EEF1D	143592646	143592893	0	248	0	8812	0	8564	0.0	0.0
chr8	EEF1D	143590644	143590735	0	92	0	8812	0	8720	0.0	0.0
chr8	PYCR3	143608763	143608876	0	114	0	3955	0	3841	0.0	0.0
chr8	SCRIB	143791875	143791913	0	39	163329	6452	163329	6413	0.0	25.468423514735694
chr8	SCRIB	143807551	143807614	0	64	163329	6452	163329	6388	0.0	25.568096430807763
chr8	SCRIB	143793256	143793340	1122	85	163329	6452	162207	6367	13.2	25.476205434270458
chr8	SCRIB	143791665	143791740	0	76	163329	6452	163329	6376	0.0	25.61621706398996
chr8	PUF60	143820665	143820716	0	52	391666	4846	391666	4794	0.0	81.69920734251147
chr8	PUF60	143824312	143824399	0	88	391666	4846	391666	4758	0.0	82.31736023539302
chr8	PUF60	143824312	143824396	0	85	391666	4846	391666	4761	0.0	82.2654904431842
chr8	PUF60	143827384	143827536	0	153	391666	4846	391666	4693	0.0	83.4574898785425
chr8	NRBP2	143835819	143835875	0	57	2244	4948	2244	4891	0.0	0.4588018810059293
chr8	PLEC	143922503	143925884	0	3382	153	17036	153	13654	0.0	0.011205507543576973
chr8	PLEC	143937748	143937784	0	37	153	17036	153	16999	0.0	0.009000529442908406
chr8	PLEC	143938400	143938415	0	16	153	17036	153	17020	0.0	0.008989424206815512
chr8	PARP10	143985720	143985975	0	256	0	5815	0	5559	0.0	0.0
chr8	PARP10	143986054	143986233	0	180	0	5815	0	5635	0.0	0.0
chr8	SHARPIN	144099080	144099205	0	126	666188	2512	666188	2386	0.0	279.2070410729254
chr8	BOP1	144289094	144289304	0	211	0	3779	0	3568	0.0	0.0
chr8	DGAT1	144319027	144319068	0	42	102	3847	102	3805	0.0	0.026806833114323258
chr8	TMEM249	144354236	144354331	218	96	27870	1229	27652	1133	2.2708333333333335	24.406001765225067
chr8	FBXL6	144355967	144356214	3476	248	235802	3250	232326	3002	14.016129032258064	77.39040639573618
chr8	SLC39A4	144413236	144413389	24	154	10283	2852	10259	2698	0.15584415584415584	3.802446256486286
chr8	SLC39A4	144415809	144416091	969	283	10283	2852	9314	2569	3.4240282685512367	3.6255352277150643
chr8	CYHR1	144464459	144464612	546	154	105660	9265	105114	9111	3.5454545454545454	11.537043134672373
chr8	RECQL4	144512391	144512561	0	171	153	4192	153	4021	0.0	0.0380502362596369
chr8	ARHGAP39	144537720	144537813	88	94	50511	4900	50423	4806	0.9361702127659575	10.491677070328755
chr8	ZNF251	144754695	144754803	0	109	71040	4075	71040	3966	0.0	17.912254160363087
chr8	ZNF34	144777457	144777577	9451	121	49890	3115	40439	2994	78.10743801652893	13.506680026720106
chr8	RPL8	144790677	144790763	0	87	408	1672	408	1585	0.0	0.25741324921135644
chr8	ZNF250	144886839	144886902	21393	64	79516	3889	58123	3825	334.265625	15.195555555555556
chr8	ZNF250	144895142	144895232	12343	91	79516	3889	67173	3798	135.63736263736263	17.68641390205371
chr8	ZNF16	144947939	144948025	0	87	924	5242	924	5155	0.0	0.17924345295829291
chr8	ZNF252P	144996506	144996607	69738	102	1581530	7532	1511792	7430	683.7058823529412	203.47133243606999
chr8	ZNF252P	144994478	144994592	65684	115	1581530	7532	1515846	7417	571.1652173913044	204.37454496427128
chr8	ZNF252P	145000351	145000538	976	188	1581530	7532	1580554	7344	5.191489361702128	215.21704793028323
chr8	ZNF596	240301	240496	0	196	1690	4549	1690	4353	0.0	0.38823799678382725
chr8	FBXO25	432885	432935	0	51	50717	10390	50717	10339	0.0	4.905406712448013
chr8	FBXO25	467719	467746	0	28	50717	10390	50717	10362	0.0	4.894518432734993
chr8	DLGAP2	1669742	1669784	0	43	34103	15158	34103	15115	0.0	2.256235527621568
chr8	CLN8	1765067	1765223	0	157	12320	8418	12320	8261	0.0	1.4913448735019974
chr8	CLN8	1772923	1772985	408	63	12320	8418	11912	8355	6.476190476190476	1.4257330939557151
chr8	ARHGEF10	1843352	1843436	0	85	91537	10602	91537	10517	0.0	8.703717790244367
chr8	ARHGEF10	1880047	1880164	0	118	91537	10602	91537	10484	0.0	8.731114078595956
chr8	ARHGEF10	1926376	1926463	0	88	91537	10602	91537	10514	0.0	8.7062012554689
chr8	MYOM2	2141140	2141177	0	38	346	7102	346	7064	0.0	0.04898074745186863
chr8	MYOM2	2142374	2142397	0	24	346	7102	346	7078	0.0	0.04888386549872845
chr8	AC246817.1	2808366	2808434	0	69	0	6094	0	6025	0.0	0.0
chr8	MCPH1	6438952	6439096	0	145	6732	9791	6732	9646	0.0	0.6979058677171884
chr8	AGPAT5	6724869	6724939	0	71	0	6247	0	6176	0.0	0.0
chr8	AGPAT5	6755050	6755174	0	125	0	6247	0	6122	0.0	0.0
chr8	AF228730.5	7154741	7154790	0	50	0	2047	0	1997	0.0	0.0
chr8	SPAG11A	7860346	7860422	0	77	1	1983	1	1906	0.0	0.0005246589716684155
chr8	SPAG11A	7860645	7860723	0	79	1	1983	1	1904	0.0	0.0005252100840336134
chr8	SPAG11A	7862308	7862412	0	105	1	1983	1	1878	0.0	0.0005324813631522897
chr8	FAM66E	7960492	7960986	0	495	354	2852	354	2357	0.0	0.1501909206618583
chr8	FAM86B3P	8234482	8234584	4661	103	6501	3972	1840	3869	45.25242718446602	0.4755750840010339
chr8	FAM86B3P	8236031	8236299	51	269	6501	3972	6450	3703	0.1895910780669145	1.7418309478800973
chr8	FAM86B3P	8241540	8241680	27	141	6501	3972	6474	3831	0.19148936170212766	1.6898981989036805
chr8	ERI1	9004073	9004296	357	224	5222	6398	4865	6174	1.59375	0.7879818594104309
chr8	ERI1	9009031	9009138	0	108	5222	6398	5222	6290	0.0	0.8302066772655008
chr8	ERI1	9096742	9096860	0	119	5222	6398	5222	6279	0.0	0.8316610925306578
chr8	AC022784.5	9142282	9142373	0	92	0	722	0	630	0.0	0.0
chr8	AC022784.1	9154205	9154343	0	139	17392	16960	17392	16821	0.0	1.0339456631591464
chr8	AC022784.1	9168110	9169177	0	1068	17392	16960	17392	15892	0.0	1.0943871130128366
chr8	AC022784.1	9193409	9194032	0	624	17392	16960	17392	16336	0.0	1.0646425073457395
chr8	AC022784.1	9189347	9189597	0	251	17392	16960	17392	16709	0.0	1.0408761745167274
chr8	AC022784.1	9198923	9198991	0	69	17392	16960	17392	16891	0.0	1.0296607660884494
chr8	AC022784.1	9154965	9155149	0	185	17392	16960	17392	16775	0.0	1.0367809239940387
chr8	AC022784.1	9154965	9155076	0	112	17392	16960	17392	16848	0.0	1.0322886989553657
chr8	AC022784.1	9189347	9189586	0	240	17392	16960	17392	16720	0.0	1.0401913875598086
chr8	AC022784.1	9193059	9193089	0	31	17392	16960	17392	16929	0.0	1.0273495185775887
chr8	AC022784.1	9193957	9194032	0	76	17392	16960	17392	16884	0.0	1.0300876569533286
chr8	AC022784.1	9319873	9320071	0	199	17392	16960	17392	16761	0.0	1.0376469184416204
chr8	AC022784.1	9332838	9332995	0	158	17392	16960	17392	16802	0.0	1.035114867277705
chr8	AC022784.1	9332922	9332995	0	74	17392	16960	17392	16886	0.0	1.0299656520194245
chr8	AC022784.1	9332403	9332513	0	111	17392	16960	17392	16849	0.0	1.032227431895068
chr8	AC022784.1	9363261	9363382	0	122	17392	16960	17392	16838	0.0	1.0329017698063903
chr8	AC022784.1	9391505	9391565	0	61	17392	16960	17392	16899	0.0	1.0291733238653176
chr8	AC022784.1	9407605	9407867	0	263	17392	16960	17392	16697	0.0	1.0416242438761454
chr8	AC022784.1	9389704	9389827	0	124	17392	16960	17392	16836	0.0	1.0330244713708718
chr8	TNKS	9743463	9743572	0	110	612	14227	612	14117	0.0	0.043351986966069275
chr8	TNKS	9772368	9772423	0	56	612	14227	612	14171	0.0	0.04318678992308235
chr8	MSRA	10245103	10245223	0	121	255	4152	255	4031	0.0	0.06325973703795584
chr8	MSRA	10096243	10096318	0	76	255	4152	255	4076	0.0	0.06256133464180569
chr8	C8ORF74	10687079	10687271	0	193	58262	5362	58262	5169	0.0	11.271425807699748
chr8	MTMR9	11297899	11297951	0	53	0	8416	0	8363	0.0	0.0
chr8	TDH	11361385	11361535	0	151	0	2248	0	2097	0.0	0.0
chr8	TDH	11362907	11362973	0	67	0	2248	0	2181	0.0	0.0
chr8	TDH	11362882	11362973	0	92	0	2248	0	2156	0.0	0.0
chr8	FAM167A-AS1	11404540	11404702	0	163	0	2238	0	2075	0.0	0.0
chr8	BLK	11543223	11543347	0	125	0	4919	0	4794	0.0	0.0
chr8	LINC00208	11582503	11582580	0	78	0	2834	0	2756	0.0	0.0
chr8	GATA4	11707855	11708928	1620366	1074	1950373	3555	330007	2481	1508.7206703910615	133.0137041515518
chr8	GATA4	11705913	11706033	1873	121	1950373	3555	1948500	3434	15.479338842975206	567.4140943506115
chr8	NEIL2	11771445	11771585	0	141	294	3371	294	3230	0.0	0.09102167182662539
chr8	NEIL2	11779597	11779950	192	354	294	3371	102	3017	0.5423728813559322	0.03380841895923102
chr8	NEIL2	11770173	11770335	51	163	294	3371	243	3208	0.3128834355828221	0.07574812967581047
chr8	FDFT1	11821749	11821878	0	130	290	4998	290	4868	0.0	0.05957271980279376
chr8	FDFT1	11802758	11802931	0	174	290	4998	290	4824	0.0	0.06011608623548922
chr8	FDFT1	11808793	11808891	0	99	290	4998	290	4899	0.0	0.05919575423555828
chr8	FDFT1	11802257	11802455	0	199	290	4998	290	4799	0.0	0.0604292560950198
chr8	FDFT1	11803321	11803518	0	198	290	4998	290	4800	0.0	0.06041666666666667
chr8	FDFT1	11803090	11803225	0	136	290	4998	290	4862	0.0	0.059646236116824354
chr8	FAM66D	12121986	12122050	0	65	0	7125	0	7060	0.0	0.0
chr8	FAM66D	12145931	12146015	0	85	0	7125	0	7040	0.0	0.0
chr8	FAM66D	12121644	12121740	0	97	0	7125	0	7028	0.0	0.0
chr8	FAM66D	12145947	12146015	0	69	0	7125	0	7056	0.0	0.0
chr8	FAM66D	12145422	12145546	0	125	0	7125	0	7000	0.0	0.0
chr8	FAM66D	12121986	12122160	0	175	0	7125	0	6950	0.0	0.0
chr8	TUSC3	15650696	15650814	0	119	340	5206	340	5087	0.0	0.06683703558089248
chr8	TUSC3	15730665	15730729	0	65	340	5206	340	5141	0.0	0.066134993191986
chr8	TUSC3	15748374	15748465	0	92	340	5206	340	5114	0.0	0.06648416112631991
chr8	TUSC3	15757790	15757855	0	66	340	5206	340	5140	0.0	0.06614785992217899
chr8	MICU3	17069687	17069719	0	33	221677	4620	221677	4587	0.0	48.327229125790275
chr8	MICU3	17090545	17090584	0	40	221677	4620	221677	4580	0.0	48.40109170305677
chr8	VPS37A	17265770	17265815	0	46	51	5710	51	5664	0.0	0.009004237288135594
chr8	VPS37A	17265906	17265981	0	76	51	5710	51	5634	0.0	0.009052183173588925
chr8	VPS37A	17248309	17248417	0	109	51	5710	51	5601	0.0	0.009105516871987145
chr8	SLC7A2	17502256	17502302	0	47	82	7920	82	7873	0.0	0.010415343579321732
chr8	SLC7A2	17538776	17538922	0	147	82	7920	82	7773	0.0	0.010549337450147947
chr8	PCM1	17924712	17924780	95638	69	248465	12520	152827	12451	1386.0579710144928	12.274275158621798
chr8	PCM1	17963100	17963291	0	192	248465	12520	248465	12328	0.0	20.154526281635302
chr8	PCM1	17980590	17980755	0	166	248465	12520	248465	12354	0.0	20.112109438238626
chr8	PCM1	18014583	18014840	0	258	248465	12520	248465	12262	0.0	20.263007665959876
chr8	PCM1	17940041	17940158	132	118	248465	12520	248333	12402	1.11864406779661	20.023625221738428
chr8	PCM1	17983232	17983289	0	58	248465	12520	248465	12462	0.0	19.937810945273633
chr8	AC124242.1	18085241	18085485	0	245	0	3569	0	3324	0.0	0.0
chr8	AC124242.1	18087024	18087137	0	114	0	3569	0	3455	0.0	0.0
chr8	NAT1	18212390	18212774	0	385	0	2896	0	2511	0.0	0.0
chr8	NAT1	18216876	18216994	0	119	0	2896	0	2777	0.0	0.0
chr8	AC100849.2	19136677	19136846	0	170	0	2568	0	2398	0.0	0.0
chr8	SH2D4A	19319343	19319728	0	386	0	3405	0	3019	0.0	0.0
chr8	SH2D4A	19357202	19357283	0	82	0	3405	0	3323	0.0	0.0
chr8	INTS10	19819572	19819676	0	105	0	6356	0	6251	0.0	0.0
chr8	INTS10	19820378	19820518	0	141	0	6356	0	6215	0.0	0.0
chr8	INTS10	19824802	19824972	0	171	0	6356	0	6185	0.0	0.0
chr8	INTS10	19826425	19826559	0	135	0	6356	0	6221	0.0	0.0
chr8	INTS10	19841826	19841955	0	130	0	6356	0	6226	0.0	0.0
chr8	INTS10	19849161	19849239	0	79	0	6356	0	6277	0.0	0.0
chr8	LPL	19959259	19959380	0	122	102	4144	102	4022	0.0	0.02536051715564396
chr8	LPL	19946541	19946698	0	158	102	4144	102	3986	0.0	0.025589563472152535
chr8	ATP6V1B2	20203958	20204083	0	126	0	4458	0	4332	0.0	0.0
chr8	AC023403.1	20358257	20358435	0	179	0	989	0	810	0.0	0.0
chr8	AC023403.1	20363603	20363830	0	228	0	989	0	761	0.0	0.0
chr8	NPM2	22024723	22024830	0	108	16819	1896	16819	1788	0.0	9.406599552572708
chr8	NPM2	22025215	22025306	0	92	16819	1896	16819	1804	0.0	9.323170731707316
chr8	NPM2	22034108	22034275	11942	168	16819	1896	4877	1728	71.08333333333333	2.822337962962963
chr8	FGF17	22046526	22046633	224	108	1552	3292	1328	3184	2.074074074074074	0.41708542713567837
chr8	DMTN	22069015	22069060	0	46	120500	4133	120500	4087	0.0	29.483728896501102
chr8	DMTN	22067084	22067159	12257	76	120500	4133	108243	4057	161.27631578947367	26.680552132117327
chr8	DMTN	22080804	22080870	0	67	120500	4133	120500	4066	0.0	29.636005902606986
chr8	DMTN	22059372	22059496	6319	125	120500	4133	114181	4008	50.552	28.48827345309381
chr8	FAM160B2	22089760	22089854	0	95	76704	6498	76704	6403	0.0	11.979384663439014
chr8	SFTPC	22162573	22162732	0	160	0	2654	0	2494	0.0	0.0
chr8	SFTPC	22163882	22164059	0	178	0	2654	0	2476	0.0	0.0
chr8	SFTPC	22163882	22164051	0	170	0	2654	0	2484	0.0	0.0
chr8	BMP1	22177566	22177732	0	167	891	6861	891	6694	0.0	0.13310427248282045
chr8	BMP1	22206853	22206981	0	129	891	6861	891	6732	0.0	0.1323529411764706
chr8	BMP1	22199263	22199387	0	125	891	6861	891	6736	0.0	0.13227434679334918
chr8	POLR3D	22248153	22248278	590	126	14274	5592	13684	5466	4.682539682539683	2.5034760336626416
chr8	POLR3D	22249043	22249309	27	267	14274	5592	14247	5325	0.10112359550561797	2.6754929577464788
chr8	PIWIL2	22354270	22354378	1224	109	275187	5761	273963	5652	11.229357798165138	48.47186836518047
chr8	SLC39A14	22379426	22379514	43	89	45476	6745	45433	6656	0.48314606741573035	6.825871394230769
chr8	PPP3CC	22498000	22498112	0	113	76950	2915	76950	2802	0.0	27.46252676659529
chr8	PPP3CC	22539468	22539498	0	31	76950	2915	76950	2884	0.0	26.681692094313455
chr8	PPP3CC	22531301	22531328	0	28	76950	2915	76950	2887	0.0	26.65396605472809
chr8	SORBS3	22565825	22565872	0	48	266	5808	266	5760	0.0	0.04618055555555556
chr8	SORBS3	22566344	22566484	0	141	266	5808	266	5667	0.0	0.04693841538733016
chr8	PDLIM2	22589297	22589374	21	78	102	7319	81	7241	0.2692307692307692	0.011186300234774203
chr8	PDLIM2	22591550	22591668	0	119	102	7319	102	7200	0.0	0.014166666666666666
chr8	PDLIM2	22580961	22581078	0	118	102	7319	102	7201	0.0	0.014164699347312874
chr8	PDLIM2	22593732	22593832	0	101	102	7319	102	7218	0.0	0.014131338320864505
chr8	C8ORF58	22602536	22602643	0	108	0	3102	0	2994	0.0	0.0
chr8	C8ORF58	22602560	22602643	0	84	0	3102	0	3018	0.0	0.0
chr8	CCAR2	22605735	22605831	0	97	0	6444	0	6347	0.0	0.0
chr8	AC037441.1	22879290	22879407	42579	118	469879	4016	427300	3898	360.83898305084745	109.62031811185223
chr8	TNFRSF10C	23111719	23111825	2918	107	20934	1550	18016	1443	27.27102803738318	12.485100485100485
chr8	CHMP7	23249209	23249381	306	173	261325	3469	261019	3296	1.76878612716763	79.1926577669903
chr8	CHMP7	23259065	23259126	488	62	261325	3469	260837	3407	7.870967741935484	76.55914294100381
chr8	CHMP7	23252367	23252461	449	95	261325	3469	260876	3374	4.726315789473684	77.3195020746888
chr8	CHMP7	23247986	23248197	1342	212	261325	3469	259983	3257	6.330188679245283	79.82284310715383
chr8	ADAM28	24308640	24308768	0	129	24	9346	24	9217	0.0	0.0026038841271563413
chr8	ADAM28	24353769	24353832	0	64	24	9346	24	9282	0.0	0.002585649644473174
chr8	ADAM28	24349863	24349972	0	110	24	9346	24	9236	0.0	0.00259852750108272
chr8	ADAMDEC1	24392261	24392380	0	120	0	2453	0	2333	0.0	0.0
chr8	ADAMDEC1	24390128	24390218	0	91	0	2453	0	2362	0.0	0.0
chr8	ADAM7	24506090	24506156	0	67	0	4508	0	4441	0.0	0.0
chr8	DOCK5	25300575	25300657	3075	83	159276	16044	156201	15961	37.04819277108434	9.786416891172232
chr8	DOCK5	25388808	25388941	0	134	159276	16044	159276	15910	0.0	10.011062225015714
chr8	CDCA2	25460239	25460300	0	62	45	3713	45	3651	0.0	0.012325390304026294
chr8	AC009623.1	25671295	25671686	0	392	0	3660	0	3268	0.0	0.0
chr8	PPP2R2A	26363720	26363890	16961	171	216728	7726	199767	7555	99.18713450292398	26.441694242223694
chr8	PPP2R2A	26333485	26333570	0	86	216728	7726	216728	7640	0.0	28.367539267015708
chr8	PPP2R2A	26358906	26359032	0	127	216728	7726	216728	7599	0.0	28.520594815107252
chr8	PPP2R2A	26339902	26339973	0	72	216728	7726	216728	7654	0.0	28.31565194669454
chr8	PPP2R2A	26358911	26359032	0	122	216728	7726	216728	7604	0.0	28.50184113624408
chr8	PTK2B	27323266	27323426	0	161	11526	7538	11526	7377	0.0	1.5624237494916633
chr8	PTK2B	27445793	27445919	0	127	11526	7538	11526	7411	0.0	1.5552557009850223
chr8	EPHX2	27500925	27501010	0	86	46549	4206	46549	4120	0.0	11.298300970873786
chr8	EPHX2	27506871	27506994	0	124	46549	4206	46549	4082	0.0	11.403478686918177
chr8	EPHX2	27515717	27515813	0	97	46549	4206	46549	4109	0.0	11.328547091749817
chr8	EPHX2	27500963	27501010	0	48	46549	4206	46549	4158	0.0	11.195045695045694
chr8	EPHX2	27500927	27501010	0	84	46549	4206	46549	4122	0.0	11.292819019893257
chr8	ESCO2	27792667	27792811	0	145	1428	7821	1428	7676	0.0	0.18603439291297552
chr8	ELP3	28099827	28099966	0	140	51	5184	51	5044	0.0	0.010111022997620936
chr8	ELP3	28107912	28107976	0	65	51	5184	51	5119	0.0	0.009962883375659308
chr8	ELP3	28097218	28097318	0	101	51	5184	51	5083	0.0	0.010033444816053512
chr8	ELP3	28183193	28183264	0	72	51	5184	51	5112	0.0	0.009976525821596244
chr8	FZD3	28499932	28499978	0	47	130576	12856	130576	12809	0.0	10.194082285892732
chr8	EXTL3	28743085	28743214	0	130	35537	7671	35537	7541	0.0	4.712504972815276
chr8	HMBOX1	28924639	28924755	0	117	3875	6053	3875	5936	0.0	0.6527964959568733
chr8	HMBOX1	29047357	29047453	0	97	3875	6053	3875	5956	0.0	0.650604432505037
chr8	HMBOX1	28891759	28891790	0	32	3875	6053	3875	6021	0.0	0.6435808005314732
chr8	HMBOX1	29042638	29042718	0	81	3875	6053	3875	5972	0.0	0.648861352980576
chr8	HMBOX1	29049289	29049361	0	73	3875	6053	3875	5980	0.0	0.6479933110367893
chr8	LEPROTL1	30101897	30101973	0	77	8935	5423	8935	5346	0.0	1.6713430602319492
chr8	LEPROTL1	30104733	30104991	255	259	8935	5423	8680	5164	0.9845559845559846	1.680867544539117
chr8	LEPROTL1	30132374	30132489	0	116	8935	5423	8935	5307	0.0	1.6836254004145468
chr8	DCTN6	30175084	30175190	0	107	51	1969	51	1862	0.0	0.027389903329752954
chr8	DCTN6	30177125	30177214	0	90	51	1969	51	1879	0.0	0.027142096860031932
chr8	DCTN6	30165715	30165901	0	187	51	1969	51	1782	0.0	0.02861952861952862
chr8	RBPMS	30561943	30562149	2595	207	84569	8416	81974	8209	12.53623188405797	9.985869167986356
chr8	RBPMS	30549499	30549585	0	87	84569	8416	84569	8329	0.0	10.153559851122584
chr8	RBPMS	30537577	30537723	285	147	84569	8416	84284	8269	1.9387755102040816	10.192768170274519
chr8	RBPMS	30545163	30545220	0	58	84569	8416	84569	8358	0.0	10.118329743957885
chr8	UBXN8	30754664	30754787	0	124	0	4037	0	3913	0.0	0.0
chr8	UBXN8	30754664	30754749	0	86	0	4037	0	3951	0.0	0.0
chr8	WRN	31083698	31083779	46	82	1350	8258	1304	8176	0.5609756097560976	0.15949119373776907
chr8	WRN	31090464	31090532	0	69	1350	8258	1350	8189	0.0	0.16485529368665283
chr8	WRN	31064288	31064434	0	147	1350	8258	1350	8111	0.0	0.16644063617309826
chr8	NRG1	32749560	32749584	0	25	19289	19683	19289	19658	0.0	0.9812290161766202
chr8	NRG1	32756402	32756529	0	128	19289	19683	19289	19555	0.0	0.9863973408335464
chr8	NRG1	32614513	32614564	0	52	19289	19683	19289	19631	0.0	0.9825785747032755
chr8	NRG1	32616834	32616885	19034	52	19289	19683	255	19631	366.03846153846155	0.012989659212470073
chr8	NRG1	32742674	32742733	0	60	19289	19683	19289	19623	0.0	0.9829791571115528
chr8	NRG1	32554943	32555057	0	115	19289	19683	19289	19568	0.0	0.9857420278004906
chr8	NRG1	32742007	32742075	0	69	19289	19683	19289	19614	0.0	0.9834302029162842
chr8	NRG1	32763217	32763359	0	143	19289	19683	19289	19540	0.0	0.9871545547594678
chr8	NRG1	32727948	32728078	0	131	19289	19683	19289	19552	0.0	0.9865486906710311
chr8	AC090204.1	33041634	33041771	0	138	0	1787	0	1649	0.0	0.0
chr8	AC090204.1	32996200	32996316	0	117	0	1787	0	1670	0.0	0.0
chr8	AC090204.1	33041634	33041743	0	110	0	1787	0	1677	0.0	0.0
chr8	AC090204.1	32996200	32996355	0	156	0	1787	0	1631	0.0	0.0
chr8	AC090204.1	32951027	32951119	0	93	0	1787	0	1694	0.0	0.0
chr8	MAK16	33490284	33490339	0	56	51	4321	51	4265	0.0	0.011957796014067995
chr8	AF279873.3	34034885	34034924	0	40	0	2728	0	2688	0.0	0.0
chr8	UNC5D	35684581	35684749	0	169	153	10818	153	10649	0.0	0.014367546248474035
chr8	UNC5D	35705928	35705961	0	34	153	10818	153	10784	0.0	0.014187685459940653
chr8	UNC5D	35721454	35721469	0	16	153	10818	153	10802	0.0	0.014164043695611923
chr8	AC124290.1	36146651	36146686	0	36	255	10323	255	10287	0.0	0.02478856809565471
chr8	AC124290.1	36186152	36186203	0	52	255	10323	255	10271	0.0	0.02482718333171064
chr8	KCNU1	36804026	36804088	0	63	0	3995	0	3932	0.0	0.0
chr8	KCNU1	36922982	36923044	0	63	0	3995	0	3932	0.0	0.0
chr8	AC124067.3	37562362	37562868	51	507	153	3546	102	3039	0.10059171597633136	0.03356367226061204
chr8	AC124067.3	37564680	37564772	0	93	153	3546	153	3453	0.0	0.044309296264118156
chr8	AC124067.3	37561838	37561938	0	101	153	3546	153	3445	0.0	0.0444121915820029
chr8	ERLIN2	37737907	37738029	21	123	10706	8103	10685	7980	0.17073170731707318	1.3389724310776943
chr8	ERLIN2	37741771	37741818	275	48	10706	8103	10431	8055	5.729166666666667	1.294972067039106
chr8	ERLIN2	37740364	37740446	0	83	10706	8103	10706	8020	0.0	1.3349127182044889
chr8	ASH2L	38135667	38135766	71	100	187790	5501	187719	5401	0.71	34.75634141825588
chr8	ASH2L	38107020	38107166	311	147	187790	5501	187479	5354	2.1156462585034013	35.01662308554352
chr8	ASH2L	38106377	38106444	74	68	187790	5501	187716	5433	1.088235294117647	34.55107675317504
chr8	BAG4	38192687	38192795	0	109	4522	4814	4522	4705	0.0	0.961105207226355
chr8	DDHD2	38234393	38234584	0	192	361665	7507	361665	7315	0.0	49.44155844155844
chr8	DDHD2	38238088	38238209	0	122	361665	7507	361665	7385	0.0	48.97291807718348
chr8	DDHD2	38240274	38240364	853	91	361665	7507	360812	7416	9.373626373626374	48.65318230852211
chr8	DDHD2	38234393	38234510	0	118	361665	7507	361665	7389	0.0	48.94640682095006
chr8	DDHD2	38234399	38234584	0	186	361665	7507	361665	7321	0.0	49.401038109547876
chr8	LETM2	38406945	38407038	0	94	104	5024	104	4930	0.0	0.021095334685598377
chr8	LETM2	38394097	38394241	0	145	104	5024	104	4879	0.0	0.021315843410534947
chr8	LETM2	38394182	38394241	0	60	104	5024	104	4964	0.0	0.020950846091861403
chr8	TACC1	38825310	38825368	0	59	902221	12557	902221	12498	0.0	72.1892302768443
chr8	TACC1	38825307	38825368	0	62	902221	12557	902221	12495	0.0	72.20656262505003
chr8	TACC1	38742350	38742451	0	102	902221	12557	902221	12455	0.0	72.43845845042152
chr8	TACC1	38744894	38745493	0	600	902221	12557	902221	11957	0.0	75.45546541774692
chr8	TACC1	38823989	38824025	0	37	902221	12557	902221	12520	0.0	72.0623801916933
chr8	TACC1	38787556	38787743	128	188	902221	12557	902093	12369	0.6808510638297872	72.93176489611125
chr8	PLEKHA2	38917906	38918070	1326	165	8441	5592	7115	5427	8.036363636363637	1.3110374055647687
chr8	PLEKHA2	38901797	38901892	320	96	8441	5592	8121	5496	3.3333333333333335	1.4776200873362446
chr8	ADAM9	39011657	39011716	0	60	23735	17281	23735	17221	0.0	1.37825910225887
chr8	ADAM9	39041945	39042117	0	173	23735	17281	23735	17108	0.0	1.3873626373626373
chr8	ADAM9	39076146	39076275	0	130	23735	17281	23735	17151	0.0	1.3838843216139
chr8	ADAM9	39082967	39083073	0	107	23735	17281	23735	17174	0.0	1.382030977058344
chr8	ADAM9	39090046	39090188	0	143	23735	17281	23735	17138	0.0	1.3849340646516513
chr8	ADAM9	39071297	39071403	176	107	23735	17281	23559	17174	1.644859813084112	1.3717829276813789
chr8	ADAM9	39082640	39082721	0	82	23735	17281	23735	17199	0.0	1.3800220943078085
chr8	ADAM9	39046001	39046058	0	58	23735	17281	23735	17223	0.0	1.3780990535911282
chr8	ADAM9	39091671	39091764	676	94	23735	17281	23059	17187	7.191489361702128	1.3416535753767382
chr8	ADAM9	39046953	39047046	0	94	23735	17281	23735	17187	0.0	1.3809856286728341
chr8	ADAM9	39071297	39071413	176	117	23735	17281	23559	17164	1.5042735042735043	1.3725821486832905
chr8	ADAM32	39118085	39118165	0	81	51	10077	51	9996	0.0	0.00510204081632653
chr8	ADAM32	39160896	39160965	0	70	51	10077	51	10007	0.0	0.005096432497251923
chr8	ADAM32	39281135	39281174	0	40	51	10077	51	10037	0.0	0.005081199561621999
chr8	ADAM5	39319451	39319505	0	55	0	2870	0	2815	0.0	0.0
chr8	ADAM5	39325212	39325278	0	67	0	2870	0	2803	0.0	0.0
chr8	ADAM5	39345860	39346044	0	185	0	2870	0	2685	0.0	0.0
chr8	ADAM5	39392573	39392660	0	88	0	2870	0	2782	0.0	0.0
chr8	ADAM5	39315454	39315534	0	81	0	2870	0	2789	0.0	0.0
chr8	ADAM5	39344063	39344186	0	124	0	2870	0	2746	0.0	0.0
chr8	AC123767.1	39536513	39536680	0	168	0	2038	0	1870	0.0	0.0
chr8	AC123767.1	39578413	39578471	0	59	0	2038	0	1979	0.0	0.0
chr8	ADAM18	39605727	39605761	0	35	51	3849	51	3814	0.0	0.013371788148925014
chr8	ADAM18	39610528	39610706	0	179	51	3849	51	3670	0.0	0.013896457765667575
chr8	ADAM18	39637263	39637335	0	73	51	3849	51	3776	0.0	0.01350635593220339
chr8	ADAM18	39648343	39648527	0	185	51	3849	51	3664	0.0	0.013919213973799126
chr8	IDO1	39908988	39909030	0	43	0	3502	0	3459	0.0	0.0
chr8	IDO2	40005326	40005378	0	53	0	3899	0	3846	0.0	0.0
chr8	AC105999.1	40370755	40370920	0	166	0	1467	0	1301	0.0	0.0
chr8	GPAT4	41610598	41610621	0	24	10546	7612	10546	7588	0.0	1.389826041117554
chr8	AP3M2	42154477	42154536	281	60	32266	4420	31985	4360	4.683333333333334	7.3360091743119265
chr8	AP3M2	42162280	42162418	179	139	32266	4420	32087	4281	1.2877697841726619	7.495211399205793
chr8	AP3M2	42167163	42167371	408	209	32266	4420	31858	4211	1.9521531100478469	7.565423889812396
chr8	AP3M2	42154565	42154960	6990	396	32266	4420	25276	4024	17.651515151515152	6.28131212723658
chr8	AP3M2	42155978	42156039	1258	62	32266	4420	31008	4358	20.29032258064516	7.115190454336852
chr8	AP3M2	42154615	42154960	6903	346	32266	4420	25363	4074	19.95086705202312	6.225576828669612
chr8	AP3M2	42168196	42168249	1073	54	32266	4420	31193	4366	19.87037037037037	7.144525881814017
chr8	IKBKB	42272082	42272205	0	124	64940	8552	64940	8428	0.0	7.705268153773138
chr8	IKBKB	42288633	42288728	315	96	64940	8552	64625	8456	3.28125	7.642502365184485
chr8	IKBKB	42308900	42309025	456	126	64940	8552	64484	8426	3.619047619047619	7.65297887491099
chr8	IKBKB	42319584	42319646	0	63	64940	8552	64940	8489	0.0	7.649899870420544
chr8	IKBKB	42329123	42329214	0	92	64940	8552	64940	8460	0.0	7.67612293144208
chr8	POLB	42354416	42354521	283	106	14013	3749	13730	3643	2.669811320754717	3.768871808948669
chr8	POLB	42339011	42339069	21	59	14013	3749	13992	3690	0.3559322033898305	3.791869918699187
chr8	POLB	42344952	42345019	0	68	14013	3749	14013	3681	0.0	3.806845965770171
chr8	POLB	42362611	42362698	0	88	14013	3749	14013	3661	0.0	3.827642720568151
chr8	POLB	42361095	42361202	586	108	14013	3749	13427	3641	5.425925925925926	3.6877231529799506
chr8	POLB	42370113	42370181	0	69	14013	3749	14013	3680	0.0	3.8078804347826085
chr8	VDAC3	42393844	42393884	110	41	128923	2913	128813	2872	2.682926829268293	44.851323119777156
chr8	VDAC3	42399650	42399703	231	54	128923	2913	128692	2859	4.277777777777778	45.01294158796782
chr8	VDAC3	42395083	42395133	1496	51	128923	2913	127427	2862	29.333333333333332	44.523759608665266
chr8	VDAC3	42393810	42393884	127	75	128923	2913	128796	2838	1.6933333333333334	45.38266384778013
chr8	VDAC3	42396677	42396680	0	4	128923	2913	128923	2909	0.0	44.31866620831901
chr8	VDAC3	42396655	42396680	14	26	128923	2913	128909	2887	0.5384615384615384	44.65154139244891
chr8	SMIM19	42546468	42546606	0	139	0	3977	0	3838	0.0	0.0
chr8	CHRNB3	42704348	42704481	34	134	19472	2605	19438	2471	0.2537313432835821	7.866450829623634
chr8	HOOK3	42994433	42994492	493	60	171905	6313	171412	6253	8.216666666666667	27.412761874300337
chr8	HOOK3	43000270	43000276	56	7	171905	6313	171849	6306	8.0	27.251665080875355
chr8	FNTA	43072180	43072307	0	128	300022	8702	300022	8574	0.0	34.99206904595288
chr8	FNTA	43064100	43064215	0	116	300022	8702	300022	8586	0.0	34.94316328907524
chr8	FNTA	43059091	43059177	0	87	300022	8702	300022	8615	0.0	34.82553685432385
chr8	POMK	43097523	43097615	0	93	26862	8233	26862	8140	0.0	3.3
chr8	POMK	43102504	43102600	0	97	26862	8233	26862	8136	0.0	3.301622418879056
chr8	POMK	43102221	43102451	0	231	26862	8233	26862	8002	0.0	3.3569107723069234
chr8	POMK	43117432	43117513	0	82	26862	8233	26862	8151	0.0	3.2955465587044532
chr8	POMK	43109563	43109849	0	287	26862	8233	26862	7946	0.0	3.3805688396677573
chr8	POMK	43120230	43120498	0	269	26862	8233	26862	7964	0.0	3.3729281767955803
chr8	HGSNAT	43158574	43158711	0	138	117	8341	117	8203	0.0	0.014263074484944533
chr8	HGSNAT	43167943	43168061	0	119	117	8341	117	8222	0.0	0.014230114327414254
chr8	HGSNAT	43182348	43182415	0	68	117	8341	117	8273	0.0	0.014142390910189774
chr8	HGSNAT	43196429	43196540	0	112	117	8341	117	8229	0.0	0.014218009478672985
chr8	POTEA	43301972	43302110	0	139	0	2282	0	2143	0.0	0.0
chr8	LINC00293	46842276	46842352	0	77	102	8452	102	8375	0.0	0.012179104477611941
chr8	LINC00293	46846028	46846081	0	54	102	8452	102	8398	0.0	0.012145748987854251
chr8	LINC00293	46849448	46849530	0	83	102	8452	102	8369	0.0	0.012187836061656111
chr8	LINC00293	46836741	46836798	0	58	102	8452	102	8394	0.0	0.012151536812008578
chr8	LINC00293	46843349	46843426	0	78	102	8452	102	8374	0.0	0.012180558872701218
chr8	LINC00293	46849733	46850560	0	828	102	8452	102	7624	0.0	0.013378803777544596
chr8	LINC00293	46836741	46836819	0	79	102	8452	102	8373	0.0	0.012182013615191688
chr8	LINC00293	46848783	46848901	0	119	102	8452	102	8333	0.0	0.012240489619584783
chr8	LINC00293	46848783	46848968	0	186	102	8452	102	8266	0.0	0.012339704814904429
chr8	LINC00293	46842967	46843128	0	162	102	8452	102	8290	0.0	0.012303980699638117
chr8	LINC00293	46844188	46844296	0	109	102	8452	102	8343	0.0	0.01222581805106077
chr8	LINC00293	46848783	46849530	0	748	102	8452	102	7704	0.0	0.0132398753894081
chr8	LINC00293	46849360	46849530	0	171	102	8452	102	8281	0.0	0.012317352976693636
chr8	LINC00293	46847975	46848100	0	126	102	8452	102	8326	0.0	0.012250780687004564
chr8	LINC00293	46846403	46846679	0	277	102	8452	102	8175	0.0	0.012477064220183486
chr8	LINC00293	46853008	46853104	0	97	102	8452	102	8355	0.0	0.012208258527827648
chr8	LINC00293	46842081	46842134	0	54	102	8452	102	8398	0.0	0.012145748987854251
chr8	LINC00293	46849375	46849530	0	156	102	8452	102	8296	0.0	0.012295081967213115
chr8	LINC00293	46842992	46843128	0	137	102	8452	102	8315	0.0	0.01226698737221888
chr8	LINC00293	46853008	46853161	0	154	102	8452	102	8298	0.0	0.012292118582791034
chr8	SPIDR	47279861	47280017	0	157	51	7208	51	7051	0.0	0.007233016593391008
chr8	SPIDR	47293866	47294030	0	165	51	7208	51	7043	0.0	0.007241232429362488
chr8	SPIDR	47396375	47396626	0	252	51	7208	51	6956	0.0	0.007331799884991374
chr8	SPIDR	47407860	47407961	0	102	51	7208	51	7106	0.0	0.007177033492822967
chr8	SPIDR	47598945	47599196	0	252	51	7208	51	6956	0.0	0.007331799884991374
chr8	SPIDR	47284027	47284094	0	68	51	7208	51	7140	0.0	0.007142857142857143
chr8	SPIDR	47728932	47729102	0	171	51	7208	51	7037	0.0	0.007247406565297712
chr8	SPIDR	47732128	47732193	0	66	51	7208	51	7142	0.0	0.007140856902828339
chr8	MCM4	47961130	47961214	0	85	0	6523	0	6438	0.0	0.0
chr8	MCM4	47966186	47966407	0	222	0	6523	0	6301	0.0	0.0
chr8	MCM4	47969278	47969401	0	124	0	6523	0	6399	0.0	0.0
chr8	MCM4	47961130	47961426	0	297	0	6523	0	6226	0.0	0.0
chr8	MCM4	47966186	47966275	0	90	0	6523	0	6433	0.0	0.0
chr8	MCM4	47971040	47971189	0	150	0	6523	0	6373	0.0	0.0
chr8	UBE2V2	48034865	48035061	0	197	327	6598	327	6401	0.0	0.05108576784877363
chr8	UBE2V2	48043032	48043181	0	150	327	6598	327	6448	0.0	0.050713399503722084
chr8	UBE2V2	48050259	48050508	56	250	327	6598	271	6348	0.224	0.04269061121613107
chr8	UBE2V2	48043498	48043626	0	129	327	6598	327	6469	0.0	0.05054877106198794
chr8	AC022915.2	48695985	48696209	153	225	84759	2762	84606	2537	0.68	33.348837209302324
chr8	AC044893.1	49228139	49228220	0	82	89	2165	89	2083	0.0	0.04272683629380701
chr8	AC044893.1	49214708	49214874	0	167	89	2165	89	1998	0.0	0.04454454454454455
chr8	AC044893.1	49193106	49193195	0	90	89	2165	89	2075	0.0	0.042891566265060244
chr8	SNTG1	50402209	50402344	0	136	37	9266	37	9130	0.0	0.0040525739320920046
chr8	SNTG1	50438542	50438599	0	58	37	9266	37	9208	0.0	0.004018245004344049
chr8	SNTG1	50530176	50530259	0	84	37	9266	37	9182	0.0	0.0040296231757786976
chr8	SNTG1	50553049	50553179	0	131	37	9266	37	9135	0.0	0.0040503557744937056
chr8	SNTG1	50752000	50752111	0	112	37	9266	37	9154	0.0	0.004041948874808827
chr8	SNTG1	50172560	50172635	0	76	37	9266	37	9190	0.0	0.004026115342763874
chr8	SNTG1	50568881	50569019	0	139	37	9266	37	9127	0.0	0.004053905993206968
chr8	SNTG1	50402209	50402324	0	116	37	9266	37	9150	0.0	0.004043715846994536
chr8	SNTG1	50575667	50575724	0	58	37	9266	37	9208	0.0	0.004018245004344049
chr8	SNTG1	50747773	50747835	0	63	37	9266	37	9203	0.0	0.004020428121264805
chr8	SNTG1	50011775	50011857	0	83	37	9266	37	9183	0.0	0.004029184362408799
chr8	AC064807.1	51913056	51913180	0	125	255	4817	255	4692	0.0	0.05434782608695652
chr8	AC103831.1	52294817	52294921	0	105	2550	3042	2550	2937	0.0	0.8682328907048008
chr8	RGS20	53879257	53879602	0	346	0	3215	0	2869	0.0	0.0
chr8	RGS20	53939575	53939724	0	150	0	3215	0	3065	0.0	0.0
chr8	RGS20	53946664	53946748	0	85	0	3215	0	3130	0.0	0.0
chr8	TGS1	55782747	55782812	0	66	0	4575	0	4509	0.0	0.0
chr8	CHCHD7	56212761	56212909	0	149	204	3872	204	3723	0.0	0.0547945205479452
chr8	CHCHD7	56216679	56216754	0	76	204	3872	204	3796	0.0	0.05374077976817703
chr8	CHCHD7	56212761	56212889	0	129	204	3872	204	3743	0.0	0.05450173657493989
chr8	AC012349.1	56526980	56527134	0	155	153	7735	153	7580	0.0	0.020184696569920845
chr8	AC012349.1	56493000	56493098	0	99	153	7735	153	7636	0.0	0.02003666841278156
chr8	AC012349.1	56524623	56524749	0	127	153	7735	153	7608	0.0	0.020110410094637224
chr8	LINC01606	57154692	57155645	0	954	39	8839	39	7885	0.0	0.0049461001902346225
chr8	LINC01606	57226490	57226625	39	136	39	8839	0	8703	0.2867647058823529	0.0
chr8	LINC01606	57149100	57149199	0	100	39	8839	39	8739	0.0	0.004462753175420529
chr8	LINC01606	57226490	57226607	0	118	39	8839	39	8721	0.0	0.004471964224286206
chr8	LINC01606	57219055	57219138	0	84	39	8839	39	8755	0.0	0.004454597372929754
chr8	AC068075.1	57344930	57345140	35	211	35	3224	0	3013	0.16587677725118483	0.0
chr8	AC068075.1	57346693	57347063	0	371	35	3224	35	2853	0.0	0.012267788293024886
chr8	AC068075.1	57348368	57348586	0	219	35	3224	35	3005	0.0	0.011647254575707155
chr8	AC068075.1	57351042	57351158	0	117	35	3224	35	3107	0.0	0.01126488574187319
chr8	AC068075.1	57344963	57345140	35	178	35	3224	0	3046	0.19662921348314608	0.0
chr8	AC068075.1	57348415	57348586	0	172	35	3224	35	3052	0.0	0.011467889908256881
chr8	FAM110B	58043183	58043299	0	117	43732	4933	43732	4816	0.0	9.080564784053156
chr8	FAM110B	58189317	58189416	0	100	43732	4933	43732	4833	0.0	9.048624043037451
chr8	UBXN2B	58430518	58430669	0	152	357	5305	357	5153	0.0	0.06928003104987386
chr8	UBXN2B	58434857	58434948	0	92	357	5305	357	5213	0.0	0.06848263955495876
chr8	SDCBP	58565018	58565084	0	67	51	4744	51	4677	0.0	0.010904425914047467
chr8	SDCBP	58575902	58576061	0	160	51	4744	51	4584	0.0	0.01112565445026178
chr8	SDCBP	58565021	58565084	0	64	51	4744	51	4680	0.0	0.010897435897435897
chr8	SDCBP	58575899	58576061	0	163	51	4744	51	4581	0.0	0.011132940406024885
chr8	SDCBP	58565018	58565066	0	49	51	4744	51	4695	0.0	0.010862619808306708
chr8	SDCBP	58560283	58561795	0	1513	51	4744	51	3231	0.0	0.015784586815227482
chr8	AC087664.2	59612818	59612889	0	72	0	1743	0	1671	0.0	0.0
chr8	AC087664.2	59619603	59619738	0	136	0	1743	0	1607	0.0	0.0
chr8	AC087664.2	59619603	59619829	0	227	0	1743	0	1516	0.0	0.0
chr8	AC087664.2	59613261	59613607	0	347	0	1743	0	1396	0.0	0.0
chr8	AC087664.2	59613380	59613607	0	228	0	1743	0	1515	0.0	0.0
chr8	AC021393.1	60058250	60058528	0	279	0	3900	0	3621	0.0	0.0
chr8	AC021393.1	60059604	60059705	0	102	0	3900	0	3798	0.0	0.0
chr8	RAB2A	60591857	60591969	0	113	102	5435	102	5322	0.0	0.019165727170236752
chr8	RAB2A	60558851	60558923	0	73	102	5435	102	5362	0.0	0.019022752704214847
chr8	RAB2A	60576233	60576297	0	65	102	5435	102	5370	0.0	0.01899441340782123
chr8	RAB2A	60569954	60570057	0	104	102	5435	102	5331	0.0	0.019133370849746763
chr8	CLVS1	61292317	61292454	0	138	17223	7405	17223	7267	0.0	2.3700288977569834
chr8	CLVS1	61299676	61300282	0	607	17223	7405	17223	6798	0.0	2.5335392762577227
chr8	CLVS1	61299676	61300278	0	603	17223	7405	17223	6802	0.0	2.532049397236107
chr8	CLVS1	61391127	61391229	0	103	17223	7405	17223	7302	0.0	2.358668857847165
chr8	LINC02842	61827818	61827977	0	160	0	3164	0	3004	0.0	0.0
chr8	NKAIN3	62589713	62589794	0	82	236	28741	236	28659	0.0	0.008234760459192575
chr8	NKAIN3	62750339	62750849	0	511	236	28741	236	28230	0.0	0.008359900814736096
chr8	NKAIN3	62918452	62918513	0	62	236	28741	236	28679	0.0	0.00822901774817811
chr8	NKAIN3	62953901	62953972	0	72	236	28741	236	28669	0.0	0.008231888102131222
chr8	NKAIN3	62990167	62991069	0	903	236	28741	236	27838	0.0	0.008477620518715425
chr8	YTHDF3	63173650	63173681	0	32	467	6172	467	6140	0.0	0.0760586319218241
chr8	YTHDF3	63186146	63187745	161	1600	467	6172	306	4572	0.100625	0.06692913385826772
chr8	YTHDF3	63175330	63175416	0	87	467	6172	467	6085	0.0	0.07674609695973705
chr8	YTHDF3	63175336	63175416	0	81	467	6172	467	6091	0.0	0.07667049745526186
chr8	YTHDF3	63172652	63172798	0	147	467	6172	467	6025	0.0	0.0775103734439834
chr8	LINC01289	63778448	63780922	357	2475	38382	4462	38025	1987	0.14424242424242426	19.136889783593357
chr8	MIR124-2HG	64380020	64380187	0	168	0	3786	0	3618	0.0	0.0
chr8	MTFR1	65689565	65689599	0	35	0	4610	0	4575	0.0	0.0
chr8	MTFR1	65682352	65682451	0	100	0	4610	0	4510	0.0	0.0
chr8	MTFR1	65719379	65719481	0	103	0	4610	0	4507	0.0	0.0
chr8	DNAJC5B	66051530	66051666	0	137	0	3670	0	3533	0.0	0.0
chr8	TRIM55	66155622	66155710	0	89	0	3090	0	3001	0.0	0.0
chr8	TRIM55	66154046	66154334	0	289	0	3090	0	2801	0.0	0.0
chr8	ADHFE1	66444366	66444420	0	55	51	3221	51	3166	0.0	0.016108654453569172
chr8	ADHFE1	66445217	66445414	0	198	51	3221	51	3023	0.0	0.016870658286470393
chr8	ADHFE1	66453709	66453840	0	132	51	3221	51	3089	0.0	0.016510197474910976
chr8	AC009879.3	66474792	66474952	0	161	294758	5020	294758	4859	0.0	60.66227618851615
chr8	VXN	66510095	66510157	2957	63	317973	4772	315016	4709	46.93650793650794	66.89658101507752
chr8	VXN	66513539	66513637	474	99	317973	4772	317499	4673	4.787878787878788	67.94329124759255
chr8	ADHFE1	66439235	66439305	0	71	51	3221	51	3150	0.0	0.01619047619047619
chr8	ADHFE1	66442797	66442844	0	48	51	3221	51	3173	0.0	0.016073116924046643
chr8	ADHFE1	66440161	66440199	0	39	51	3221	51	3182	0.0	0.016027655562539284
chr8	ADHFE1	66447263	66447341	0	79	51	3221	51	3142	0.0	0.016231699554423933
chr8	VXN	66498824	66498918	0	95	317973	4772	317973	4677	0.0	67.98652982681206
chr8	C8ORF44-SGK3	66690704	66690760	29	57	73	2989	44	2932	0.5087719298245614	0.015006821282401092
chr8	SGK3	66813852	66813928	0	77	1676	5510	1676	5433	0.0	0.30848518314006995
chr8	SGK3	66843451	66843547	0	97	1676	5510	1676	5413	0.0	0.30962497690744506
chr8	C8ORF44	66677641	66677954	51	314	91	2145	40	1831	0.1624203821656051	0.02184598580010923
chr8	C8ORF44	66676744	66676902	0	159	91	2145	91	1986	0.0	0.04582074521651561
chr8	C8ORF44	66680392	66680458	40	67	91	2145	51	2078	0.5970149253731343	0.024542829643888354
chr8	SGK3	66793615	66793832	0	218	1676	5510	1676	5292	0.0	0.3167044595616024
chr8	SGK3	66777956	66778089	0	134	1676	5510	1676	5376	0.0	0.3117559523809524
chr8	MCMDC2	66877348	66877544	0	197	0	6364	0	6167	0.0	0.0
chr8	CSPP1	67076481	67076581	0	101	2130	22998	2130	22897	0.0	0.09302528715552255
chr8	CSPP1	67091802	67091883	0	82	2130	22998	2130	22916	0.0	0.0929481584918834
chr8	CSPP1	67103036	67103135	0	100	2130	22998	2130	22898	0.0	0.09302122456109704
chr8	CSPP1	67137455	67137603	0	149	2130	22998	2130	22849	0.0	0.093220709877894
chr8	CSPP1	67149782	67149935	0	154	2130	22998	2130	22844	0.0	0.0932411136403432
chr8	CSPP1	67193463	67193602	0	140	2130	22998	2130	22858	0.0	0.09318400559979001
chr8	CSPP1	67093542	67093641	90	100	2130	22998	2040	22898	0.9	0.08909075028386759
chr8	CSPP1	67154023	67154136	0	114	2130	22998	2130	22884	0.0	0.09307813319349764
chr8	CSPP1	67079350	67079462	0	113	2130	22998	2130	22885	0.0	0.09307406598208433
chr8	CSPP1	67114328	67114370	0	43	2130	22998	2130	22955	0.0	0.09279024177739055
chr8	CSPP1	67076487	67076581	0	95	2130	22998	2130	22903	0.0	0.09300091691044841
chr8	CSPP1	67078366	67078487	0	122	2130	22998	2130	22876	0.0	0.09311068368595908
chr8	CSPP1	67069679	67069802	0	124	2130	22998	2130	22874	0.0	0.09311882486666084
chr8	CSPP1	67086822	67086846	0	25	2130	22998	2130	22973	0.0	0.09271753797936708
chr8	CSPP1	67074242	67074351	0	110	2130	22998	2130	22888	0.0	0.09306186648025166
chr8	CSPP1	67074805	67074923	0	119	2130	22998	2130	22879	0.0	0.09309847458367936
chr8	CSPP1	67123087	67123159	0	73	2130	22998	2130	22925	0.0	0.09291166848418757
chr8	CSPP1	67105568	67105661	0	94	2130	22998	2130	22904	0.0	0.0929968564442892
chr8	CSPP1	67152612	67152712	0	101	2130	22998	2130	22897	0.0	0.09302528715552255
chr8	CSPP1	67093547	67093641	75	95	2130	22998	2055	22903	0.7894736842105263	0.0897262367375453
chr8	CSPP1	67115196	67115264	0	69	2130	22998	2130	22929	0.0	0.09289545989794583
chr8	CSPP1	67120878	67121130	816	253	2130	22998	1314	22745	3.225296442687747	0.057770938667839083
chr8	CSPP1	67134023	67134165	0	143	2130	22998	2130	22855	0.0	0.09319623714723255
chr8	CSPP1	67172768	67172973	0	206	2130	22998	2130	22792	0.0	0.09345384345384346
chr8	CSPP1	67172777	67172973	0	197	2130	22998	2130	22801	0.0	0.09341695539669313
chr8	CSPP1	67192097	67192217	0	121	2130	22998	2130	22877	0.0	0.09310661362940945
chr8	CSPP1	67192688	67192803	0	116	2130	22998	2130	22882	0.0	0.09308626868280745
chr8	CSPP1	67189839	67190014	0	176	2130	22998	2130	22822	0.0	0.09333099640697573
chr8	CSPP1	67162637	67162762	0	126	2130	22998	2130	22872	0.0	0.09312696747114375
chr8	CSPP1	67194626	67194718	0	93	2130	22998	2130	22905	0.0	0.09299279633267846
chr8	C8ORF34	68468691	68468820	0	130	44	10285	44	10155	0.0	0.004332840965041851
chr8	C8ORF34	68640375	68640511	0	137	44	10285	44	10148	0.0	0.0043358297201418995
chr8	C8ORF34	68776398	68776449	0	52	44	10285	44	10233	0.0	0.004299814326199551
chr8	C8ORF34	68530592	68530679	0	88	44	10285	44	10197	0.0	0.004314994606256742
chr8	SULF1	69495764	69495926	0	163	255	9293	255	9130	0.0	0.02792990142387733
chr8	SULF1	69638501	69638644	0	144	255	9293	255	9149	0.0	0.027871898568149523
chr8	SULF1	69640807	69640841	0	35	255	9293	255	9258	0.0	0.027543745949449125
chr8	XKR9	70683512	70683630	0	119	465	3941	465	3822	0.0	0.12166405023547881
chr8	XKR9	70678029	70678139	0	111	465	3941	465	3830	0.0	0.12140992167101827
chr8	AC009446.1	71695940	71696033	0	94	0	904	0	810	0.0	0.0
chr8	MSC-AS1	71844228	71844422	0	195	0	7084	0	6889	0.0	0.0
chr8	MSC-AS1	71965408	71965534	0	127	0	7084	0	6957	0.0	0.0
chr8	MSC-AS1	72025361	72025434	0	74	0	7084	0	7010	0.0	0.0
chr8	MSC-AS1	71973537	71973659	0	123	0	7084	0	6961	0.0	0.0
chr8	MSC-AS1	71954137	71954383	0	247	0	7084	0	6837	0.0	0.0
chr8	TERF1	73013894	73013990	0	97	0	11467	0	11370	0.0	0.0
chr8	TERF1	73024821	73024971	0	151	0	11467	0	11316	0.0	0.0
chr8	TERF1	73030335	73030395	0	61	0	11467	0	11406	0.0	0.0
chr8	TERF1	73039544	73039619	0	76	0	11467	0	11391	0.0	0.0
chr8	TERF1	73038705	73038795	0	91	0	11467	0	11376	0.0	0.0
chr8	TERF1	73012855	73012931	0	77	0	11467	0	11390	0.0	0.0
chr8	TERF1	73039115	73039219	0	105	0	11467	0	11362	0.0	0.0
chr8	TERF1	73030794	73030955	0	162	0	11467	0	11305	0.0	0.0
chr8	AC111149.2	73359105	73359227	0	123	0	2366	0	2243	0.0	0.0
chr8	TMEM70	73979078	73979171	12528	94	43748	2988	31220	2894	133.27659574468086	10.787836903939185
chr8	LY96	74004795	74004885	280	91	688	564	408	473	3.076923076923077	0.8625792811839323
chr8	GDAP1	74360136	74360310	0	175	21694	20769	21694	20594	0.0	1.0534136156161988
chr8	GDAP1	74351273	74351466	0	194	21694	20769	21694	20575	0.0	1.0543863912515188
chr8	GDAP1	74351273	74351321	0	49	21694	20769	21694	20720	0.0	1.047007722007722
chr8	GDAP1	74351273	74351418	0	146	21694	20769	21694	20623	0.0	1.0519323085874994
chr8	GDAP1	74363383	74363449	0	67	21694	20769	21694	20702	0.0	1.0479180755482562
chr8	GDAP1	74360140	74360310	0	171	21694	20769	21694	20598	0.0	1.0532090494222741
chr8	GDAP1	74351453	74351466	0	14	21694	20769	21694	20755	0.0	1.045242110334859
chr8	GDAP1	74361883	74361978	0	96	21694	20769	21694	20673	0.0	1.0493880907463842
chr8	GDAP1	74362263	74362351	0	89	21694	20769	21694	20680	0.0	1.0490328820116055
chr8	GDAP1	74360136	74360149	0	14	21694	20769	21694	20755	0.0	1.045242110334859
chr8	GDAP1	74362938	74363053	0	116	21694	20769	21694	20653	0.0	1.050404299617489
chr8	GDAP1	74363371	74363449	0	79	21694	20769	21694	20690	0.0	1.0485258579023682
chr8	GDAP1	74363984	74364163	0	180	21694	20769	21694	20589	0.0	1.0536694351352665
chr8	GDAP1	74351251	74351466	0	216	21694	20769	21694	20553	0.0	1.055515009974213
chr8	CRISPLD1	75013986	75014102	0	117	0	4446	0	4329	0.0	0.0
chr8	HNF4G	75543810	75543979	0	170	0	4813	0	4643	0.0	0.0
chr8	ZFHX4	76842654	76842771	0	118	51	15869	51	15751	0.0	0.003237889657799505
chr8	ZFHX4	76703597	76703618	0	22	51	15869	51	15847	0.0	0.003218274752319051
chr8	ZFHX4	76834120	76834434	0	315	51	15869	51	15554	0.0	0.003278899318503279
chr8	ZFHX4	76782142	76782218	0	77	51	15869	51	15792	0.0	0.003229483282674772
chr8	PKIA	78572810	78572939	0	130	51	4020	51	3890	0.0	0.013110539845758355
chr8	ZC2HC1A	78675786	78675863	0	78	0	4148	0	4070	0.0	0.0
chr8	ZC2HC1A	78711989	78712106	0	118	0	4148	0	4030	0.0	0.0
chr8	AC138646.1	79307229	79307281	0	53	0	2051	0	1998	0.0	0.0
chr8	AC138646.1	79307226	79307281	0	56	0	2051	0	1995	0.0	0.0
chr8	STMN2	79663579	79663661	0	83	1144	2049	1144	1966	0.0	0.5818921668362157
chr8	AC036214.4	79926333	79926448	0	116	51	2698	51	2582	0.0	0.019752130131680867
chr8	AC034114.2	80285682	80285804	0	123	314619	4283	314619	4160	0.0	75.62956730769231
chr8	AC034114.2	80327144	80327207	0	64	314619	4283	314619	4219	0.0	74.57193647783835
chr8	AC034114.2	80448696	80448980	0	285	314619	4283	314619	3998	0.0	78.69409704852426
chr8	AC034114.2	80274104	80274243	0	140	314619	4283	314619	4143	0.0	75.93989862418537
chr8	AC034114.2	80334799	80335052	0	254	314619	4283	314619	4029	0.0	78.0886075949367
chr8	AC034114.2	80285686	80285804	0	119	314619	4283	314619	4164	0.0	75.55691642651297
chr8	AC034114.2	80303423	80303526	0	104	314619	4283	314619	4179	0.0	75.28571428571429
chr8	AC079209.1	81157613	81157803	0	191	5	2771	5	2580	0.0	0.001937984496124031
chr8	AC079209.1	81162624	81162666	0	43	5	2771	5	2728	0.0	0.0018328445747800588
chr8	AC079209.1	81162592	81162666	0	75	5	2771	5	2696	0.0	0.00185459940652819
chr8	LINC02235	81848990	81849107	0	118	10036	4148	10036	4030	0.0	2.490322580645161
chr8	LINC02235	81874266	81874376	0	111	10036	4148	10036	4037	0.0	2.4860044587565024
chr8	AC060765.2	82435224	82435430	0	207	0	4917	0	4710	0.0	0.0
chr8	RALYL	84346118	84346150	0	33	0	4551	0	4518	0.0	0.0
chr8	RALYL	84804769	84804802	0	34	0	4551	0	4517	0.0	0.0
chr8	RALYL	84849979	84850027	0	49	0	4551	0	4502	0.0	0.0
chr8	RALYL	84887603	84887776	0	174	0	4551	0	4377	0.0	0.0
chr8	LRRCC1	85123412	85123606	0	195	0	5020	0	4825	0.0	0.0
chr8	LRRCC1	85129174	85129379	0	206	0	5020	0	4814	0.0	0.0
chr8	LRRCC1	85109594	85109800	0	207	0	5020	0	4813	0.0	0.0
chr8	CA13	85237718	85237870	0	153	0	5610	0	5457	0.0	0.0
chr8	CA13	85224954	85225295	0	342	0	5610	0	5268	0.0	0.0
chr8	CA2	85473692	85473811	0	120	307	2015	307	1895	0.0	0.16200527704485487
chr8	CA2	85473388	85473468	0	81	307	2015	307	1934	0.0	0.15873836608066183
chr8	WWP1	86402018	86402203	0	186	102	6466	102	6280	0.0	0.01624203821656051
chr8	WWP1	86440625	86440733	0	109	102	6466	102	6357	0.0	0.01604530438886267
chr8	CPNE3	86515461	86515499	0	39	3	6676	3	6637	0.0	0.00045201145095675755
chr8	CPNE3	86537562	86537646	0	85	3	6676	3	6591	0.0	0.0004551661356395084
chr8	CPNE3	86524876	86524997	0	122	3	6676	3	6554	0.0	0.00045773573390296
chr8	CPNE3	86524708	86524814	0	107	3	6676	3	6569	0.0	0.00045669051606028315
chr8	CPNE3	86521603	86521714	0	112	3	6676	3	6564	0.0	0.0004570383912248629
chr8	AC090578.1	88693626	88693665	0	40	0	9713	0	9673	0.0	0.0
chr8	AC090578.1	88799848	88799879	0	32	0	9713	0	9681	0.0	0.0
chr8	RIPK2	89762828	89762982	0	155	0	3072	0	2917	0.0	0.0
chr8	RIPK2	89759321	89759446	0	126	0	3072	0	2946	0.0	0.0
chr8	DECR1	90017202	90017326	0	125	0	4418	0	4293	0.0	0.0
chr8	DECR1	90036840	90036940	0	101	0	4418	0	4317	0.0	0.0
chr8	DECR1	90017301	90017326	0	26	0	4418	0	4392	0.0	0.0
chr8	DECR1	90005291	90005369	0	79	0	4418	0	4339	0.0	0.0
chr8	DECR1	90017123	90017326	0	204	0	4418	0	4214	0.0	0.0
chr8	DECR1	90015540	90015666	0	127	0	4418	0	4291	0.0	0.0
chr8	DECR1	90005447	90005731	0	285	0	4418	0	4133	0.0	0.0
chr8	LINC00534	90454408	90454523	0	116	3162	14863	3162	14747	0.0	0.21441649148979453
chr8	LINC00534	90566488	90566549	0	62	3162	14863	3162	14801	0.0	0.2136342139044659
chr8	LINC00534	90351540	90351666	0	127	3162	14863	3162	14736	0.0	0.21457654723127037
chr8	LINC00534	90236024	90236219	0	196	3162	14863	3162	14667	0.0	0.21558600940887707
chr8	LINC00534	90387566	90387684	0	119	3162	14863	3162	14744	0.0	0.21446011937059142
chr8	OTUD6B	91076591	91076731	0	141	172	3985	172	3844	0.0	0.044745057232049947
chr8	LRRC69	91206692	91206831	0	140	153	3030	153	2890	0.0	0.052941176470588235
chr8	SLC26A7	91338149	91338232	0	84	0	6281	0	6197	0.0	0.0
chr8	AC104211.1	92678808	92679110	0	303	0	2798	0	2495	0.0	0.0
chr8	AC104211.1	92677588	92677775	0	188	0	2798	0	2610	0.0	0.0
chr8	AC104211.1	92677627	92677775	0	149	0	2798	0	2649	0.0	0.0
chr8	AC117834.1	92886893	92886943	0	51	0	955	0	904	0.0	0.0
chr8	AC117834.1	92926289	92926370	0	82	0	955	0	873	0.0	0.0
chr8	CIBAR1	93718674	93718788	0	115	0	6800	0	6685	0.0	0.0
chr8	CIBAR1	93727130	93727244	0	115	0	6800	0	6685	0.0	0.0
chr8	CIBAR1	93702519	93702543	0	25	0	6800	0	6775	0.0	0.0
chr8	CIBAR1	93702164	93702383	0	220	0	6800	0	6580	0.0	0.0
chr8	CIBAR1	93724509	93724595	0	87	0	6800	0	6713	0.0	0.0
chr8	TMEM67	93755777	93755866	0	90	357	7387	357	7297	0.0	0.04892421543099904
chr8	TMEM67	93765405	93765475	0	71	357	7387	357	7316	0.0	0.04879715691634773
chr8	TMEM67	93755777	93755908	0	132	357	7387	357	7255	0.0	0.049207443142660234
chr8	TMEM67	93761984	93762023	0	40	357	7387	357	7347	0.0	0.048591261739485504
chr8	TMEM67	93759859	93759993	0	135	357	7387	357	7252	0.0	0.04922779922779923
chr8	TMEM67	93762949	93763065	0	117	357	7387	357	7270	0.0	0.049105914718019256
chr8	TMEM67	93791881	93792004	0	124	357	7387	357	7263	0.0	0.049153242461792646
chr8	PDP1	93917910	93917945	0	36	1530	5612	1530	5576	0.0	0.27439024390243905
chr8	ESRP1	94692676	94692827	0	152	0	4621	0	4469	0.0	0.0
chr8	ESRP1	94696851	94696961	0	111	0	4621	0	4510	0.0	0.0
chr8	DPY19L4	94738368	94738459	1319	92	100434	7156	99115	7064	14.33695652173913	14.031002265005663
chr8	DPY19L4	94734629	94734754	14	126	100434	7156	100420	7030	0.1111111111111111	14.284495021337127
chr8	DPY19L4	94765182	94765314	0	133	100434	7156	100434	7023	0.0	14.30072618539086
chr8	DPY19L4	94781083	94781166	69	84	100434	7156	100365	7072	0.8214285714285714	14.191883484162895
chr8	INTS8	94827262	94827403	3286	142	8392	7694	5106	7552	23.140845070422536	0.6761122881355932
chr8	INTS8	94824892	94825067	0	176	8392	7694	8392	7518	0.0	1.1162543229582336
chr8	INTS8	94874551	94874602	30	52	8392	7694	8362	7642	0.5769230769230769	1.0942161737764984
chr8	INTS8	94866311	94866353	0	43	8392	7694	8392	7651	0.0	1.0968500849562148
chr8	INTS8	94868691	94868813	0	123	8392	7694	8392	7571	0.0	1.1084401003830406
chr8	INTS8	94866311	94866351	0	41	8392	7694	8392	7653	0.0	1.09656343917418
chr8	NDUFAF6	94980854	94980973	0	120	1292	6433	1292	6313	0.0	0.20465705686678282
chr8	NDUFAF6	94945482	94945619	0	138	1292	6433	1292	6295	0.0	0.20524225575853852
chr8	NDUFAF6	95023169	95023319	0	151	1292	6433	1292	6282	0.0	0.20566698503661254
chr8	NDUFAF6	95034007	95034122	280	116	1292	6433	1012	6317	2.413793103448276	0.160202627829666
chr8	NDUFAF6	94980858	94980973	0	116	1292	6433	1292	6317	0.0	0.20452746556909926
chr8	NDUFAF6	95031994	95032094	0	101	1292	6433	1292	6332	0.0	0.2040429564118762
chr8	NDUFAF6	95040705	95040927	0	223	1292	6433	1292	6210	0.0	0.20805152979066022
chr8	NDUFAF6	95031994	95032098	0	105	1292	6433	1292	6328	0.0	0.20417193426042984
chr8	NDUFAF6	95036301	95036494	0	194	1292	6433	1292	6239	0.0	0.20708446866485014
chr8	NDUFAF6	95036370	95036494	0	125	1292	6433	1292	6308	0.0	0.20481927710843373
chr8	NDUFAF6	95044476	95044595	0	120	1292	6433	1292	6313	0.0	0.20465705686678282
chr8	NDUFAF6	95052173	95052230	0	58	1292	6433	1292	6375	0.0	0.20266666666666666
chr8	C8ORF37-AS1	95486409	95486494	0	86	101716	4839	101716	4753	0.0	21.400378708184306
chr8	C8ORF37-AS1	95301121	95301192	0	72	101716	4839	101716	4767	0.0	21.337528844136774
chr8	CPQ	96680442	96680547	0	106	0	3459	0	3353	0.0	0.0
chr8	CPQ	96659283	96659323	0	41	0	3459	0	3418	0.0	0.0
chr8	MTDH	97689037	97689103	0	67	0	7888	0	7821	0.0	0.0
chr8	MTDH	97699753	97699852	0	100	0	7888	0	7788	0.0	0.0
chr8	MTDH	97719048	97719189	0	142	0	7888	0	7746	0.0	0.0
chr8	MTDH	97706625	97706750	0	126	0	7888	0	7762	0.0	0.0
chr8	MATN2	97941776	97941899	0	124	1142	6549	1142	6425	0.0	0.1777431906614786
chr8	MATN2	97961407	97961530	0	124	1142	6549	1142	6425	0.0	0.1777431906614786
chr8	MATN2	97994479	97994602	0	124	1142	6549	1142	6425	0.0	0.1777431906614786
chr8	MATN2	98021204	98021327	0	124	1142	6549	1142	6425	0.0	0.1777431906614786
chr8	MATN2	98027415	98027829	0	415	1142	6549	1142	6134	0.0	0.18617541571568308
chr8	ERICH5	98089075	98090029	0	955	0	1553	0	598	0.0	0.0
chr8	OSR2	98948172	98948421	0	250	561	2479	561	2229	0.0	0.25168236877523553
chr8	VPS13B	99507136	99507203	0	68	55582	16783	55582	16715	0.0	3.3252766975770265
chr8	VPS13B	99507769	99507911	153	143	55582	16783	55429	16640	1.06993006993007	3.3310697115384613
chr8	VPS13B	99556449	99556653	0	205	55582	16783	55582	16578	0.0	3.3527566654602485
chr8	VPS13B	99776774	99776956	0	183	55582	16783	55582	16600	0.0	3.3483132530120483
chr8	FLJ42969	101054497	101054579	0	83	0	3136	0	3053	0.0	0.0
chr8	FLJ42969	101072334	101072435	0	102	0	3136	0	3034	0.0	0.0
chr8	FLJ42969	101064909	101065134	0	226	0	3136	0	2910	0.0	0.0
chr8	FLJ42969	101071293	101071481	0	189	0	3136	0	2947	0.0	0.0
chr8	GRHL2	101649413	101649499	0	87	2016	6069	2016	5982	0.0	0.3370110330992979
chr8	MAILR	102995624	102995682	0	59	368	7456	368	7397	0.0	0.0497498986075436
chr8	MAILR	102864910	102864994	0	85	368	7456	368	7371	0.0	0.049925383258716594
chr8	MAILR	102992249	102992407	0	159	368	7456	368	7297	0.0	0.050431684253802934
chr8	ATP6V1C1	103040797	103040968	0	172	0	5864	0	5692	0.0	0.0
chr8	BAALC	103212918	103213085	0	168	4417	4005	4417	3837	0.0	1.1511597602293457
chr8	BAALC	103200657	103200762	0	106	4417	4005	4417	3899	0.0	1.132854578096948
chr8	FZD6	103328267	103328416	0	150	7042	4072	7042	3922	0.0	1.7955124936257012
chr8	FZD6	103307750	103307880	739	131	7042	4072	6303	3941	5.641221374045801	1.599340268967267
chr8	DCAF13	103420974	103421082	0	109	24786	7371	24786	7262	0.0	3.413109336271
chr8	DCAF13	103420263	103420463	1836	201	24786	7371	22950	7170	9.134328358208956	3.200836820083682
chr8	RIMS2	103998184	103998250	0	67	21164	14005	21164	13938	0.0	1.5184388004017793
chr8	RIMS2	104013441	104013621	260	181	21164	14005	20904	13824	1.4364640883977902	1.5121527777777777
chr8	RIMS2	103809279	103809321	0	43	21164	14005	21164	13962	0.0	1.515828677839851
chr8	RIMS2	103927841	103927889	0	49	21164	14005	21164	13956	0.0	1.5164803668672973
chr8	RIMS2	103716308	103716320	0	13	21164	14005	21164	13992	0.0	1.5125786163522013
chr8	RIMS2	104094477	104094729	0	253	21164	14005	21164	13752	0.0	1.538976148923793
chr8	DCSTAMP	104354876	104355185	0	310	102	2784	102	2474	0.0	0.041228779304769606
chr8	OXR1	106739457	106739583	0	127	102	6705	102	6578	0.0	0.015506232897537246
chr8	OXR1	106737519	106737600	0	82	102	6705	102	6623	0.0	0.015400875736071266
chr8	EMC2	108446161	108446301	0	141	204	6073	204	5932	0.0	0.03438975050573163
chr8	ENY2	109336127	109336204	0	78	0	6789	0	6711	0.0	0.0
chr8	ENY2	109342689	109342809	0	121	0	6789	0	6668	0.0	0.0
chr8	EBAG9	109550809	109550907	0	99	0	3692	0	3593	0.0	0.0
chr8	EBAG9	109557730	109557919	0	190	0	3692	0	3502	0.0	0.0
chr8	LINC02237	111756305	111756400	0	96	51	3366	51	3270	0.0	0.015596330275229359
chr8	LINC02237	111754396	111754545	0	150	51	3366	51	3216	0.0	0.01585820895522388
chr8	AC024996.1	112452007	112452095	0	89	0	1458	0	1369	0.0	0.0
chr8	UTP23	116786502	116786649	0	148	204	5250	204	5102	0.0	0.039984319874559
chr8	UTP23	116770191	116770366	43	176	204	5250	161	5074	0.24431818181818182	0.03173039022467481
chr8	UTP23	116779482	116779586	0	105	204	5250	204	5145	0.0	0.03965014577259475
chr8	SLC30A8	117146818	117146848	0	31	123	6294	123	6263	0.0	0.01963915056682101
chr8	MED30	117530722	117530827	0	106	0	1444	0	1338	0.0	0.0
chr8	AC023590.1	118284513	118284586	0	74	0	2885	0	2811	0.0	0.0
chr8	SAMD12-AS1	118673421	118673549	0	129	276	3793	276	3664	0.0	0.07532751091703056
chr8	SAMD12-AS1	118744226	118744331	0	106	276	3793	276	3687	0.0	0.07485760781122865
chr8	COL14A1	120213934	120214061	0	128	14	10245	14	10117	0.0	0.0013838094296728279
chr8	HAS2-AS1	121643372	121643517	0	146	102	5667	102	5521	0.0	0.01847491396486144
chr8	HAS2-AS1	121879629	121879765	0	137	102	5667	102	5530	0.0	0.01844484629294756
chr8	HAS2-AS1	121888824	121888977	0	154	102	5667	102	5513	0.0	0.018501723199709778
chr8	HAS2-AS1	121903438	121903540	0	103	102	5667	102	5564	0.0	0.01833213515456506
chr8	HAS2-AS1	121913758	121913893	0	136	102	5667	102	5531	0.0	0.018441511480744893
chr8	HAS2-AS1	121891725	121891754	0	30	102	5667	102	5637	0.0	0.018094731240021287
chr8	HAS2-AS1	121862925	121863009	0	85	102	5667	102	5582	0.0	0.01827302042278753
chr8	HAS2-AS1	121884777	121884884	0	108	102	5667	102	5559	0.0	0.01834862385321101
chr8	HAS2-AS1	121907643	121907710	0	68	102	5667	102	5599	0.0	0.01821753884622254
chr8	AC016405.1	122810452	122810573	0	122	0	1025	0	903	0.0	0.0
chr8	TBC1D31	123082701	123082817	0	117	51	7097	51	6980	0.0	0.007306590257879656
chr8	TBC1D31	123120054	123120188	0	135	51	7097	51	6962	0.0	0.00732548118356794
chr8	TBC1D31	123134113	123134206	0	94	51	7097	51	7003	0.0	0.007282593174353849
chr8	TBC1D31	123142261	123142456	0	196	51	7097	51	6901	0.0	0.007390233299521809
chr8	TBC1D31	123128280	123128513	0	234	51	7097	51	6863	0.0	0.007431152557190733
chr8	FAM83A	123179763	123179871	0	109	0	5483	0	5374	0.0	0.0
chr8	FAM83A	123191802	123191970	0	169	0	5483	0	5314	0.0	0.0
chr8	FAM83A	123179653	123179871	0	219	0	5483	0	5264	0.0	0.0
chr8	NTAQ1	123436452	123436601	0	150	51	4939	51	4789	0.0	0.010649404886197537
chr8	NTAQ1	123435441	123435542	0	102	51	4939	51	4837	0.0	0.01054372544965888
chr8	NTAQ1	123448046	123448224	0	179	51	4939	51	4760	0.0	0.010714285714285714
chr8	NTAQ1	123438133	123438238	0	106	51	4939	51	4833	0.0	0.010552451893234015
chr8	FAM91A1	123786003	123786151	0	149	0	7289	0	7140	0.0	0.0
chr8	FAM91A1	123812055	123812177	0	123	0	7289	0	7166	0.0	0.0
chr8	AC090192.2	124275730	124275834	0	105	1615	2469	1615	2364	0.0	0.6831641285956007
chr8	NDUFB9	124549760	124550501	2754	742	998395	14277	995641	13535	3.711590296495957	73.5604728481714
chr8	NDUFB9	124549760	124549833	389	74	998395	14277	998006	14203	5.256756756756757	70.26726747870168
chr8	NDUFB9	124567646	124568914	0	1269	998395	14277	998395	13008	0.0	76.75238314883148
chr8	LINC00964	124945637	124945746	0	110	348	10517	348	10407	0.0	0.03343903142115884
chr8	LINC00964	124946054	124946159	0	106	348	10517	348	10411	0.0	0.033426183844011144
chr8	LINC00964	124944486	124944797	33	312	348	10517	315	10205	0.10576923076923077	0.030867221950024497
chr8	LINC00964	124947542	124947792	0	251	348	10517	348	10266	0.0	0.03389830508474576
chr8	LINC00964	124944486	124945051	33	566	348	10517	315	9951	0.05830388692579505	0.03165511003919204
chr8	LINC00964	124945634	124945746	0	113	348	10517	348	10404	0.0	0.03344867358708189
chr8	LINC00964	124943269	124943501	0	233	348	10517	348	10284	0.0	0.0338389731621937
chr8	LINC00964	124943269	124943383	0	115	348	10517	348	10402	0.0	0.03345510478754086
chr8	LINC00964	124943269	124945051	102	1783	348	10517	246	8734	0.05720695457094784	0.028165788871078543
chr8	LINC00964	124944566	124945051	0	486	348	10517	348	10031	0.0	0.03469245339447712
chr8	LINC00964	124945952	124946159	0	208	348	10517	348	10309	0.0	0.03375691143660879
chr8	LINC00964	124943269	124945746	102	2478	348	10517	246	8039	0.04116222760290557	0.030600820997636523
chr8	LINC00964	124943188	124943269	0	82	348	10517	348	10435	0.0	0.03334930522280786
chr8	LINC00964	124944566	124944797	0	232	348	10517	348	10285	0.0	0.033835683033544
chr8	LINC00964	124944486	124945281	33	796	348	10517	315	9721	0.0414572864321608	0.03240407365497377
chr8	LINC00964	124944566	124945281	0	716	348	10517	348	9801	0.0	0.03550658096112642
chr8	NSMCE2	125102050	125102146	0	97	33	3005	33	2908	0.0	0.011348005502063274
chr8	NSMCE2	125102013	125102146	0	134	33	3005	33	2871	0.0	0.011494252873563218
chr8	NSMCE2	125094467	125094533	0	67	33	3005	33	2938	0.0	0.01123213070115725
chr8	NSMCE2	125130212	125130354	0	143	33	3005	33	2862	0.0	0.011530398322851153
chr8	NSMCE2	125155999	125156098	0	100	33	3005	33	2905	0.0	0.011359724612736662
chr8	AC084116.1	126499014	126499137	0	124	0	1516	0	1392	0.0	0.0
chr8	PCAT1	127013302	127013774	0	473	153	16754	153	16281	0.0	0.009397457158651189
chr8	PCAT1	126848519	126848662	0	144	153	16754	153	16610	0.0	0.009211318482841662
chr8	PCAT1	126878374	126878480	0	107	153	16754	153	16647	0.0	0.009190845197332853
chr8	PCAT1	126926317	126926399	0	83	153	16754	153	16671	0.0	0.009177613820406695
chr8	PCAT1	126938255	126938310	0	56	153	16754	153	16698	0.0	0.009162773984908373
chr8	PVT1	127890588	127890998	0	411	30944	23370	30944	22959	0.0	1.3477938934622589
chr8	PVT1	127939507	127939676	0	170	30944	23370	30944	23200	0.0	1.333793103448276
chr8	PVT1	128070159	128070272	0	114	30944	23370	30944	23256	0.0	1.3305813553491572
chr8	PVT1	127795893	127796071	51	179	30944	23370	30893	23191	0.2849162011173184	1.3321115950153077
chr8	PVT1	128010317	128010444	0	128	30944	23370	30944	23242	0.0	1.3313828414077962
chr8	PVT1	127855154	127855319	0	166	30944	23370	30944	23204	0.0	1.3335631787622824
chr8	PVT1	127932052	127932198	0	147	30944	23370	30944	23223	0.0	1.332472118158722
chr8	PVT1	127969415	127969537	0	123	30944	23370	30944	23247	0.0	1.3310964855680303
chr8	PVT1	128070159	128070361	0	203	30944	23370	30944	23167	0.0	1.3356930116113437
chr8	PVT1	127989161	127989291	0	131	30944	23370	30944	23239	0.0	1.3315547140582642
chr8	PVT1	128070161	128070272	0	112	30944	23370	30944	23258	0.0	1.330466936108006
chr8	PVT1	127795893	127796008	49	116	30944	23370	30895	23254	0.4224137931034483	1.3285886299131333
chr8	PVT1	127816827	127816884	0	58	30944	23370	30944	23312	0.0	1.327385037748799
chr8	PVT1	128091246	128091353	0	108	30944	23370	30944	23262	0.0	1.330238156650331
chr8	PVT1	127994882	127995093	0	212	30944	23370	30944	23158	0.0	1.3362121081267813
chr8	PVT1	127902455	127902539	0	85	30944	23370	30944	23285	0.0	1.3289242001288384
chr8	PVT1	128099369	128099573	6048	205	30944	23370	24896	23165	29.502439024390245	1.0747248003453487
chr8	PVT1	127983903	127984204	0	302	30944	23370	30944	23068	0.0	1.3414253511357725
chr8	PVT1	127851933	127852347	0	415	30944	23370	30944	22955	0.0	1.3480287519059029
chr8	PVT1	128038916	128038980	0	65	30944	23370	30944	23305	0.0	1.3277837373954087
chr8	PVT1	127932464	127932474	0	11	30944	23370	30944	23359	0.0	1.324714242904234
chr8	PVT1	128082752	128082848	0	97	30944	23370	30944	23273	0.0	1.3296094186396252
chr8	PVT1	128009589	128009718	0	130	30944	23370	30944	23240	0.0	1.3314974182444062
chr8	PVT1	127881800	127881884	0	85	30944	23370	30944	23285	0.0	1.3289242001288384
chr8	PVT1	127803149	127803559	0	411	30944	23370	30944	22959	0.0	1.3477938934622589
chr8	PVT1	128095691	128095817	0	127	30944	23370	30944	23243	0.0	1.3313255603837715
chr8	PVT1	127882061	127882185	0	125	30944	23370	30944	23245	0.0	1.3312110131211012
chr8	PVT1	127855162	127855319	0	158	30944	23370	30944	23212	0.0	1.333103567120455
chr8	PVT1	127932027	127932198	0	172	30944	23370	30944	23198	0.0	1.3339080955254763
chr8	PVT1	128048447	128048609	0	163	30944	23370	30944	23207	0.0	1.333390787262464
chr8	PVT1	127982359	127982479	0	121	30944	23370	30944	23249	0.0	1.3309819777194718
chr8	PVT1	128074072	128074291	408	220	30944	23370	30536	23150	1.8545454545454545	1.3190496760259178
chr8	PVT1	128080302	128080430	0	129	30944	23370	30944	23241	0.0	1.331440127361129
chr8	PVT1	128031958	128032272	0	315	30944	23370	30944	23055	0.0	1.3421817393190196
chr8	PVT1	128074069	128074291	408	223	30944	23370	30536	23147	1.8295964125560538	1.3192206333434138
chr8	PVT1	128049584	128049748	0	165	30944	23370	30944	23205	0.0	1.3335057099762981
chr8	PVT1	128069068	128069147	0	80	30944	23370	30944	23290	0.0	1.3286389008158008
chr8	PVT1	128049587	128049748	0	162	30944	23370	30944	23208	0.0	1.3333333333333333
chr8	PVT1	128084542	128084621	0	80	30944	23370	30944	23290	0.0	1.3286389008158008
chr8	AC022973.3	129946387	129946602	0	216	0	2443	0	2227	0.0	0.0
chr8	PHF20L1	132816887	132817076	0	190	416	12899	416	12709	0.0	0.03273270910378472
chr8	PHF20L1	132799094	132799172	0	79	416	12899	416	12820	0.0	0.032449297971918874
chr8	PHF20L1	132799082	132799172	0	91	416	12899	416	12808	0.0	0.03247970018738289
chr8	PHF20L1	132788803	132788999	78	197	416	12899	338	12702	0.39593908629441626	0.02660998267989293
chr8	PHF20L1	132807722	132807783	0	62	416	12899	416	12837	0.0	0.03240632546545143
chr8	PHF20L1	132825034	132825157	0	124	416	12899	416	12775	0.0	0.03256360078277887
chr8	TG	132941350	132941542	0	193	4998	11185	4998	10992	0.0	0.4546943231441048
chr8	TG	132966559	132966697	0	139	4998	11185	4998	11046	0.0	0.4524714828897338
chr8	TG	132983349	132983412	0	64	4998	11185	4998	11121	0.0	0.4494200161855948
chr8	TG	133131811	133131946	0	136	4998	11185	4998	11049	0.0	0.4523486288351887
chr8	TG	132994715	132994804	0	90	4998	11185	4998	11095	0.0	0.4504731861198738
chr8	CCN4	133225389	133225583	0	195	51	5195	51	5000	0.0	0.0102
chr8	CCN4	133220580	133220841	0	262	51	5195	51	4933	0.0	0.010338536387593756
chr8	CCN4	133212863	133213143	0	281	51	5195	51	4914	0.0	0.010378510378510378
chr8	LINC01591	135288095	135288112	0	18	0	1348	0	1330	0.0	0.0
chr8	LINC01591	135293757	135293870	0	114	0	1348	0	1234	0.0	0.0
chr8	LINC01591	135293793	135293870	0	78	0	1348	0	1270	0.0	0.0
chr8	KHDRBS3	135606954	135607037	0	84	0	8661	0	8577	0.0	0.0
chr8	KHDRBS3	135645058	135645117	0	60	0	8661	0	8601	0.0	0.0
chr8	LINC02055	136089035	136089206	0	172	153	24423	153	24251	0.0	0.006309018184817121
chr8	LINC02055	136153759	136153826	0	68	153	24423	153	24355	0.0	0.006282077602135085
chr8	LINC02055	136519147	136519239	0	93	153	24423	153	24330	0.0	0.006288532675709001
chr8	LINC02055	136529794	136529941	0	148	153	24423	153	24275	0.0	0.006302780638516993
chr8	LINC02055	136563076	136563240	0	165	153	24423	153	24258	0.0	0.0063071976255256
chr8	LINC02055	136790460	136790494	0	35	153	24423	153	24388	0.0	0.006273577169099557
chr8	LINC02055	136645939	136646047	0	109	153	24423	153	24314	0.0	0.006292670889199638
chr8	LINC02055	136888279	136888350	0	72	153	24423	153	24351	0.0	0.0062831095232228655
chr8	CHRAC1	140514368	140514495	0	128	0	3308	0	3180	0.0	0.0
chr8	DENND3	141160631	141160787	0	157	7245	13106	7245	12949	0.0	0.5595026642984015
chr8	DENND3	141163332	141163429	0	98	7245	13106	7245	13008	0.0	0.5569649446494465
chr8	DENND3	141150285	141150348	0	64	7245	13106	7245	13042	0.0	0.5555129581352554
chr8	PTP4A3	141427749	141427824	0	76	0	2881	0	2805	0.0	0.0
chr8	ADGRB1	142524237	142524304	0	68	121	7183	121	7115	0.0	0.017006324666198173
chr8	ADGRB1	142526541	142526627	0	87	121	7183	121	7096	0.0	0.01705186020293123
chr8	LY6E	143020261	143020377	0	117	0	2646	0	2529	0.0	0.0
chr8	LY6E	143018832	143019119	0	288	0	2646	0	2358	0.0	0.0
chr8	C8ORF31	143047678	143047814	0	137	145	4098	145	3961	0.0	0.03660691744508962
chr8	C8ORF31	143042957	143043087	0	131	145	4098	145	3967	0.0	0.036551550289891606
chr8	C8ORF31	143044173	143044234	0	62	145	4098	145	4036	0.0	0.035926660059464814
chr8	GLI4	143269359	143269520	0	162	0	2527	0	2365	0.0	0.0
chr8	ZNF696	143292142	143292284	0	143	0	5403	0	5260	0.0	0.0
chr8	ZNF696	143295378	143295470	0	93	0	5403	0	5310	0.0	0.0
chr8	GSDMD	143558681	143558914	0	234	84	3503	84	3269	0.0	0.02569593147751606
chr8	ZNF707	143690056	143690123	0	68	2091	6052	2091	5984	0.0	0.3494318181818182
chr8	ZNF707	143692244	143692330	0	87	2091	6052	2091	5965	0.0	0.35054484492875104
chr8	ZNF707	143684623	143684755	0	133	2091	6052	2091	5919	0.0	0.35326913329954385
chr8	ZNF707	143689203	143689301	0	99	2091	6052	2091	5953	0.0	0.3512514698471359
chr8	ZNF707	143687380	143687478	0	99	2091	6052	2091	5953	0.0	0.3512514698471359
chr8	ZNF707	143687993	143688067	0	75	2091	6052	2091	5977	0.0	0.34984105738664883
chr8	ZNF707	143684755	143685067	0	313	2091	6052	2091	5739	0.0	0.3643491897543126
chr8	ZNF707	143692000	143692107	0	108	2091	6052	2091	5944	0.0	0.3517833109017497
chr8	ZNF707	143686916	143687014	0	99	2091	6052	2091	5953	0.0	0.3512514698471359
chr8	MAPK15	143717693	143717792	25	100	25	2567	0	2467	0.25	0.0
chr8	MAPK15	143720999	143721105	0	107	25	2567	25	2460	0.0	0.01016260162601626
chr8	GRINA	143991877	143992078	0	202	0	2462	0	2260	0.0	0.0
chr8	GRINA	143991877	143991949	0	73	0	2462	0	2389	0.0	0.0
chr8	SPATC1	144041231	144041371	0	141	0	2175	0	2034	0.0	0.0
chr8	GPAA1	144083123	144083303	0	181	1150	2761	1150	2580	0.0	0.44573643410852715
chr8	WDR97	144112223	144112349	0	127	6545	7698	6545	7571	0.0	0.8644828952582222
chr8	WDR97	144113439	144113517	152	79	6545	7698	6393	7619	1.9240506329113924	0.8390864942905893
chr8	HGH1	144138506	144138607	520	102	9803	2449	9283	2347	5.098039215686274	3.955262036642522
chr8	MROH1	144247566	144247679	0	114	0	10950	0	10836	0.0	0.0
chr8	MROH1	144242601	144242628	0	28	0	10950	0	10922	0.0	0.0
chr8	HSF1	144311173	144311249	0	77	0	5162	0	5085	0.0	0.0
chr8	HSF1	144312627	144312711	0	85	0	5162	0	5077	0.0	0.0
chr8	HSF1	144313845	144313911	0	67	0	5162	0	5095	0.0	0.0
chr8	SLC52A2	144359622	144359747	0	126	156854	3711	156854	3585	0.0	43.75285913528592
chr8	SLC52A2	144359622	144359726	0	105	156854	3711	156854	3606	0.0	43.49805879090405
chr8	ADCK5	144377392	144377490	714	99	126504	2760	125790	2661	7.212121212121212	47.271702367531006
chr8	ADCK5	144389262	144389336	0	75	126504	2760	126504	2685	0.0	47.11508379888268
chr8	PPP1R16A	144478585	144478682	0	98	4384	5425	4384	5327	0.0	0.8229772855265628
chr8	MFSD3	144510359	144510507	0	149	51	1627	51	1478	0.0	0.03450608930987822
chr8	LRRC14	144518748	144518815	0	68	54445	4663	54445	4595	0.0	11.848748639825898
chr8	LRRC14	144523635	144524105	0	471	54445	4663	54445	4192	0.0	12.98783396946565
chr8	AF186192.2	144705952	144706042	0	91	571	1686	571	1595	0.0	0.3579937304075235
chr8	ZNF517	144803640	144803767	9048	128	252999	4098	243951	3970	70.6875	61.44861460957179
chr8	ZNF7	144829477	144829604	0	128	14689	10298	14689	10170	0.0	1.444346116027532
chr8	ZNF7	144829444	144829604	0	161	14689	10298	14689	10137	0.0	1.4490480418269704
chr8	ZNF7	144829522	144829604	0	83	14689	10298	14689	10215	0.0	1.4379833578071464
chr8	ZNF7	144830930	144831029	0	100	14689	10298	14689	10198	0.0	1.4403804667581879
chr8	ZNF7	144828007	144828053	765	47	14689	10298	13924	10251	16.27659574468085	1.3583065066822748
chr8	C8ORF33	145053061	145053146	169	86	1674059	3783	1673890	3697	1.9651162790697674	452.7698133621856
chr8	C8ORF33	145061257	145061311	54	55	1674059	3783	1674005	3728	0.9818181818181818	449.03567596566523
chr8	C8ORF33	145061227	145061311	54	85	1674059	3783	1674005	3698	0.6352941176470588	452.67847485127095
chr9	PGM5P3-AS1	74148	74205	0	58	102	3123	102	3065	0.0	0.033278955954323
chr9	PGM5P3-AS1	80650	80807	0	158	102	3123	102	2965	0.0	0.034401349072512646
chr9	DOCK8	220747	220863	0	117	408	12921	408	12804	0.0	0.031865042174320526
chr9	DOCK8	371427	371566	0	140	408	12921	408	12781	0.0	0.03192238478992254
chr9	DOCK8	386330	386426	0	97	408	12921	408	12824	0.0	0.031815346225826574
chr9	DOCK8	280790	280905	0	116	408	12921	408	12805	0.0	0.03186255368996486
chr9	DOCK8	365590	366552	0	963	408	12921	408	11958	0.0	0.03411941796287005
chr9	DOCK8	369221	369447	0	227	408	12921	408	12694	0.0	0.032141169056247046
chr9	KANK1	549106	549721	0	616	525867	9291	525867	8675	0.0	60.618674351585014
chr9	KANK1	735711	735780	144	70	525867	9291	525723	9221	2.057142857142857	57.013664461555145
chr9	DMRT2	1055721	1055799	0	79	0	3147	0	3068	0.0	0.0
chr9	DMRT2	1050619	1050775	0	157	0	3147	0	2990	0.0	0.0
chr9	SMARCA2	2028986	2029247	9547	262	536632	15566	527085	15304	36.43893129770992	34.440995818086776
chr9	SMARCA2	2086828	2087071	24085	244	536632	15566	512547	15322	98.70901639344262	33.451703432972195
chr9	SMARCA2	2115821	2116049	12688	229	536632	15566	523944	15337	55.4061135371179	34.162091673730195
chr9	SMARCA2	2086828	2086897	3665	70	536632	15566	532967	15496	52.357142857142854	34.39384357253485
chr9	SMARCA2	2170418	2170472	90	55	536632	15566	536542	15511	1.6363636363636365	34.591064405905485
chr9	SMARCA2	2181570	2181676	18740	107	536632	15566	517892	15459	175.14018691588785	33.50100265217672
chr9	SMARCA2	2072031	2072067	0	37	536632	15566	536632	15529	0.0	34.556764762702045
chr9	SMARCA2	2159813	2159909	1467	97	536632	15566	535165	15469	15.123711340206185	34.59596612579999
chr9	SMARCA2	2161000	2161035	0	36	536632	15566	536632	15530	0.0	34.5545396007727
chr9	SMARCA2	2159428	2159466	0	39	536632	15566	536632	15527	0.0	34.56121594641592
chr9	SMARCA2	2160975	2161035	0	61	536632	15566	536632	15505	0.0	34.61025475653015
chr9	VLDLR	2641376	2641499	11621	124	271160	9408	259539	9284	93.71774193548387	27.955514864282637
chr9	VLDLR	2651414	2651498	1536	85	271160	9408	269624	9323	18.070588235294117	28.920304622975436
chr9	LINC01231	3186917	3187035	0	119	0	5272	0	5153	0.0	0.0
chr9	SLC1A1	4583037	4583172	98	136	4943	3987	4845	3851	0.7205882352941176	1.2581147753830173
chr9	RCL1	4826857	4827033	35283	177	290388	4153	255105	3976	199.33898305084745	64.16121730382294
chr9	CD274	5457078	5457420	13985	343	99950	4115	85965	3772	40.77259475218659	22.79029692470838
chr9	RIC1	5753535	5753646	1371	112	283174	8618	281803	8506	12.241071428571429	33.129908300023516
chr9	MLANA	5891054	5891199	0	146	3314	2885	3314	2739	0.0	1.2099306316173786
chr9	IL33	6251139	6251265	0	127	0	3262	0	3135	0.0	0.0
chr9	IL33	6252865	6252991	0	127	0	3262	0	3135	0.0	0.0
chr9	UHRF2	6433913	6434173	42684	261	1005741	9898	963057	9637	163.54022988505747	99.93327799107607
chr9	UHRF2	6492302	6492401	1699	100	1005741	9898	1004042	9798	16.99	102.47417840375587
chr9	AL354707.1	6721096	6721174	0	79	3240	3185	3240	3106	0.0	1.0431423052157116
chr9	KDM4C	6981841	6982765	5916	925	297105	10355	291189	9430	6.395675675675676	30.879003181336163
chr9	KDM4C	7105401	7105500	1319	100	297105	10355	295786	10255	13.19	28.843100926377378
chr9	TYRP1	12698450	12698655	0	206	3366	3746	3366	3540	0.0	0.9508474576271186
chr9	TYRP1	12707996	12708143	0	148	3366	3746	3366	3598	0.0	0.9355197331851028
chr9	SNAPC3	15447094	15447244	12019	151	308827	4975	296808	4824	79.59602649006622	61.527363184079604
chr9	ADAMTSL1	18675856	18675907	929	52	675360	11952	674431	11900	17.865384615384617	56.67487394957983
chr9	ADAMTSL1	18892388	18892596	13938	209	675360	11952	661422	11743	66.68899521531101	56.32478923614068
chr9	ADAMTSL1	18889567	18889748	7755	182	675360	11952	667605	11770	42.60989010989011	56.72090059473237
chr9	DENND4C	19324361	19324507	1330	147	214181	8778	212851	8631	9.047619047619047	24.661221179469354
chr9	DENND4C	19331977	19332184	7231	208	214181	8778	206950	8570	34.76442307692308	24.14819136522754
chr9	DENND4C	19336685	19336832	1275	148	214181	8778	212906	8630	8.614864864864865	24.67045191193511
chr9	DENND4C	19371755	19371820	438	66	214181	8778	213743	8712	6.636363636363637	24.534320477502295
chr9	DENND4C	19337600	19337672	716	73	214181	8778	213465	8705	9.808219178082192	24.522113727742678
chr9	FOCAD	20819795	20819900	492	106	131614	9254	131122	9148	4.6415094339622645	14.333406209007434
chr9	FOCAD	20863420	20863550	0	131	131614	9254	131614	9123	0.0	14.426614052395045
chr9	FOCAD	20929357	20929596	5993	240	131614	9254	125621	9014	24.970833333333335	13.936210339471932
chr9	MTAP	21859302	21859425	52873	124	1046096	13923	993223	13799	426.39516129032256	71.97789694905428
chr9	CDKN2B-AS1	22061952	22062026	0	75	343239	18594	343239	18519	0.0	18.534424104973272
chr9	CDKN2B-AS1	22066234	22066353	0	120	343239	18594	343239	18474	0.0	18.57957128937967
chr9	CDKN2B-AS1	22032673	22032986	4304	314	343239	18594	338935	18280	13.707006369426752	18.541301969365428
chr9	CDKN2B-AS1	22058358	22059054	204	697	343239	18594	343035	17897	0.2926829268292683	19.16717885679164
chr9	CDKN2B-AS1	22065661	22065757	0	97	343239	18594	343239	18497	0.0	18.55646861653241
chr9	CDKN2B-AS1	22097257	22097364	162	108	343239	18594	343077	18486	1.5	18.558747160012985
chr9	CDKN2B-AS1	22113665	22113799	730	135	343239	18594	342509	18459	5.407407407407407	18.555122162630695
chr9	CDKN2B-AS1	22118643	22118767	2907	125	343239	18594	340332	18469	23.256	18.42720233905463
chr9	CDKN2B-AS1	22046316	22046449	867	134	343239	18594	342372	18460	6.470149253731344	18.546695557963165
chr9	CDKN2B-AS1	22092307	22092469	51	163	343239	18594	343188	18431	0.3128834355828221	18.620150832835982
chr9	CDKN2B-AS1	22056251	22056387	3786	137	343239	18594	339453	18457	27.635036496350367	18.391558758194723
chr9	CDKN2B-AS1	22063943	22064018	0	76	343239	18594	343239	18518	0.0	18.535424991899774
chr9	CDKN2B-AS1	22120199	22120410	3214	212	343239	18594	340025	18382	15.160377358490566	18.497715156130997
chr9	CDKN2B-AS1	22029432	22029594	3763	163	343239	18594	339476	18431	23.085889570552148	18.418751017307798
chr9	CDKN2B-AS1	22023943	22024011	78	69	343239	18594	343161	18525	1.1304347826086956	18.52421052631579
chr9	CDKN2B-AS1	22112319	22112395	133	77	343239	18594	343106	18517	1.7272727272727273	18.529243397958634
chr9	LINC01241	25802428	25802519	0	92	0	3087	0	2995	0.0	0.0
chr9	IFT74	26992382	26992677	2	296	203356	6878	203354	6582	0.006756756756756757	30.89547250075965
chr9	IFT74	26982285	26982399	0	115	203356	6878	203356	6763	0.0	30.068904332396865
chr9	TEK	27157830	27158142	0	313	5049	4828	5049	4515	0.0	1.1182724252491694
chr9	TEK	27191928	27191965	0	38	5049	4828	5049	4790	0.0	1.054070981210856
chr9	TEK	27180239	27180368	0	130	5049	4828	5049	4698	0.0	1.0747126436781609
chr9	ACO1	32386370	32386442	721	73	689337	7577	688616	7504	9.876712328767123	91.76652452025586
chr9	ACO1	32386370	32386438	721	69	689337	7577	688616	7508	10.44927536231884	91.71763452317528
chr9	SMIM27	32565396	32565628	5932	233	54515	3621	48583	3388	25.459227467811157	14.339728453364817
chr9	B4GALT1-AS1	33178895	33178957	204	63	30048	3840	29844	3777	3.238095238095238	7.901509134233518
chr9	CHMP5	33278112	33278225	97367	114	879724	2399	782357	2285	854.0964912280701	342.3881838074398
chr9	AL356218.2	33409881	33409962	0	82	0	1471	0	1389	0.0	0.0
chr9	AL356218.2	33402421	33402577	0	157	0	1471	0	1314	0.0	0.0
chr9	ANKRD18B	33528999	33529173	5485	175	36076	4805	30591	4630	31.34285714285714	6.607127429805615
chr9	CYP4F26P	33602811	33602919	633	109	2147	3903	1514	3794	5.807339449541284	0.39905113336847653
chr9	CYP4F26P	33604479	33604570	0	92	2147	3903	2147	3811	0.0	0.5633691944371556
chr9	CYP4F26P	33604296	33604403	0	108	2147	3903	2147	3795	0.0	0.5657444005270093
chr9	PRSS3	33794745	33794873	0	129	921	1434	921	1305	0.0	0.7057471264367816
chr9	PRSS3	33796642	33796802	0	161	921	1434	921	1273	0.0	0.7234878240377062
chr9	UBAP1	34249778	34249961	65464	184	614613	2780	549149	2596	355.7826086956522	211.53659476117105
chr9	UBAP1	34220907	34220948	2853	42	614613	2780	611760	2738	67.92857142857143	223.43316289262236
chr9	UBAP1	34234215	34234340	17880	126	614613	2780	596733	2654	141.9047619047619	224.84287867370008
chr9	NUDT2	34338712	34338847	53549	136	377761	1078	324212	942	393.74264705882354	344.1740976645435
chr9	NUDT2	34336299	34336341	3734	43	377761	1078	374027	1035	86.83720930232558	361.37874396135265
chr9	NUDT2	34336228	34336341	12266	114	377761	1078	365495	964	107.59649122807018	379.1441908713693
chr9	DNAI1	34483447	34483480	0	34	8096	3636	8096	3602	0.0	2.2476401998889504
chr9	DNAI1	34514393	34514542	30	150	8096	3636	8066	3486	0.2	2.3138267355134823
chr9	DNAI1	34517284	34517467	51	184	8096	3636	8045	3452	0.27717391304347827	2.3305330243337194
chr9	CNTFR-AS1	34580099	34580201	81	103	131	2607	50	2504	0.7864077669902912	0.019968051118210862
chr9	CNTFR-AS1	34569511	34569616	50	106	131	2607	81	2501	0.4716981132075472	0.032387045181927226
chr9	GALT	34647831	34647961	21769	131	319782	4322	298013	4191	166.17557251908397	71.10785015509425
chr9	IL11RA	34655604	34655665	5595	62	208711	4224	203116	4162	90.24193548387096	48.80249879865449
chr9	IL11RA	34656738	34656908	16107	171	208711	4224	192604	4053	94.19298245614036	47.52134221564273
chr9	DNAJB5	34990667	34990812	0	146	82612	3656	82612	3510	0.0	23.536182336182335
chr9	DNAJB5	34990347	34990611	144	265	82612	3656	82468	3391	0.5433962264150943	24.319669713948688
chr9	DNAJB5	34990498	34990611	80	114	82612	3656	82532	3542	0.7017543859649122	23.30095990965556
chr9	C9ORF131	35042410	35042485	454	76	21650	3828	21196	3752	5.973684210526316	5.649253731343284
chr9	UNC13B	35371933	35371939	0	7	525408	17963	525408	17956	0.0	29.260859879705947
chr9	UNC13B	35397166	35397310	14490	145	525408	17963	510918	17818	99.93103448275862	28.674261982265126
chr9	UNC13B	35401950	35402007	0	58	525408	17963	525408	17905	0.0	29.344205529181792
chr9	UNC13B	35291068	35291104	0	37	525408	17963	525408	17926	0.0	29.30982929822604
chr9	UNC13B	35300165	35308412	204	8248	525408	17963	525204	9715	0.024733268671193017	54.061142563046836
chr9	UNC13B	35364544	35364567	418	24	525408	17963	524990	17939	17.416666666666668	29.26528792017392
chr9	ATP8B5P	35480459	35480598	0	140	41844	6309	41844	6169	0.0	6.782946993029665
chr9	TESK1	35607326	35607409	6931	84	223624	3305	216693	3221	82.51190476190476	67.27506985408259
chr9	CA9	35676296	35676389	1911	94	13330	1619	11419	1525	20.329787234042552	7.487868852459016
chr9	AL133410.1	35787864	35788036	744	173	14228	3404	13484	3231	4.300578034682081	4.173320953265243
chr9	NPR2	35808508	35808683	48988	176	652456	4126	603468	3950	278.34090909090907	152.7767088607595
chr9	TMEM8B	35841525	35841794	16200	270	221485	16232	205285	15962	60.0	12.860857035459215
chr9	GLIPR2	36150871	36150949	300	79	22509	3062	22209	2983	3.7974683544303796	7.445189406637613
chr9	GLIPR2	36148546	36148650	1374	105	22509	3062	21135	2957	13.085714285714285	7.147446736557321
chr9	CLTA	36198978	36199096	519018	119	2753488	2526	2234470	2407	4361.495798319328	928.321562110511
chr9	CLTA	36209266	36209320	2451	55	2753488	2526	2751037	2471	44.56363636363636	1113.3294212869284
chr9	CLTA	36210624	36210660	312	37	2753488	2526	2753176	2489	8.432432432432432	1106.1374045801526
chr9	CLTA	36197550	36197588	92932	39	2753488	2526	2660556	2487	2382.871794871795	1069.7852834740652
chr9	MELK	36657240	36657363	71501	124	1414354	3106	1342853	2982	576.6209677419355	450.3195841716969
chr9	MELK	36583626	36583712	46837	87	1414354	3106	1367517	3019	538.3563218390805	452.9701888042398
chr9	MELK	36597221	36597290	31067	70	1414354	3106	1383287	3036	443.8142857142857	455.62812911725956
chr9	MELK	36594627	36594771	69821	145	1414354	3106	1344533	2961	481.5241379310345	454.080715974333
chr9	MELK	36581643	36581739	33535	97	1414354	3106	1380819	3009	345.7216494845361	458.8963110667996
chr9	MELK	36589535	36589652	43558	118	1414354	3106	1370796	2988	369.135593220339	458.7670682730924
chr9	MELK	36606805	36606923	0	119	1414354	3106	1414354	2987	0.0	473.50318044861064
chr9	MELK	36606829	36606923	0	95	1414354	3106	1414354	3011	0.0	469.72899368980404
chr9	EBLN3P	37084198	37084292	4380	95	1040114	7939	1035734	7844	46.10526315789474	132.04156042835288
chr9	EBLN3P	37080341	37080536	43355	196	1040114	7939	996759	7743	221.19897959183675	128.73033707865167
chr9	POLR1E	37492281	37492375	1299	95	1960657	2512	1959358	2417	13.673684210526316	810.6570128258171
chr9	TRMT10B	37762576	37762685	21932	110	276821	2875	254889	2765	199.38181818181818	92.18408679927667
chr9	TRMT10B	37768075	37768228	22419	154	276821	2875	254402	2721	145.57792207792207	93.49577361264241
chr9	TRMT10B	37762542	37762685	22985	144	276821	2875	253836	2731	159.61805555555554	92.94617356279751
chr9	TRMT10B	37763628	37763865	15042	238	276821	2875	261779	2637	63.20168067226891	99.27152066742511
chr9	TRMT10B	37763628	37763753	10933	126	276821	2875	265888	2749	86.76984126984127	96.72171698799563
chr9	DCAF10	37842088	37842286	42902	199	1023010	8300	980108	8101	215.58793969849245	120.98605110480187
chr9	DCAF10	37857240	37857351	28127	112	1023010	8300	994883	8188	251.13392857142858	121.50500732779678
chr9	ALDH1B1	38394476	38394565	0	90	708075	3120	708075	3030	0.0	233.6881188118812
chr9	ANKRD20A2P	40226906	40227021	0	116	0	4425	0	4309	0.0	0.0
chr9	BX664727.3	40281393	40281675	0	283	51	5288	51	5005	0.0	0.01018981018981019
chr9	BX664727.3	40266950	40267100	0	151	51	5288	51	5137	0.0	0.009927973525403932
chr9	BX664727.3	40291748	40291919	0	172	51	5288	51	5116	0.0	0.0099687255668491
chr9	BX664727.3	40271886	40271999	0	114	51	5288	51	5174	0.0	0.009856977193660611
chr9	FAM95B1	40326283	40326445	357	163	1333	2302	976	2139	2.1901840490797544	0.4562879850397382
chr9	FAM95B1	40324888	40325092	0	205	1333	2302	1333	2097	0.0	0.6356700047687173
chr9	FAM95B1	40324984	40325092	0	109	1333	2302	1333	2193	0.0	0.6078431372549019
chr9	FAM95B1	40326317	40326445	357	129	1333	2302	976	2173	2.7674418604651163	0.4491486424298205
chr9	FAM95B1	40327942	40328105	0	164	1333	2302	1333	2138	0.0	0.6234798877455566
chr9	AMYH02020865.1	40507903	40508011	0	109	1309	3624	1309	3515	0.0	0.3724039829302987
chr9	AL353626.1	40799010	40799083	0	74	96	512	96	438	0.0	0.2191780821917808
chr9	FRG1HP	40993252	40993434	0	183	0	1712	0	1529	0.0	0.0
chr9	FRG1HP	41009793	41009843	0	51	0	1712	0	1661	0.0	0.0
chr9	ANKRD20A7P	42838214	42838275	0	62	0	7916	0	7854	0.0	0.0
chr9	ANKRD20A7P	42856951	42857107	0	157	0	7916	0	7759	0.0	0.0
chr9	ANKRD20A7P	42910731	42911013	0	283	0	7916	0	7633	0.0	0.0
chr9	ANKRD20A7P	42901237	42901355	0	119	0	7916	0	7797	0.0	0.0
chr9	FAM74A6	60935238	60935322	0	85	0	1817	0	1732	0.0	0.0
chr9	FAM74A4	61210861	61210945	0	85	0	1959	0	1874	0.0	0.0
chr9	FAM27C	61920892	61921356	0	465	0	12969	0	12504	0.0	0.0
chr9	FAM27C	62003322	62003478	0	157	0	12969	0	12812	0.0	0.0
chr9	FAM27C	62072999	62073117	0	119	0	12969	0	12850	0.0	0.0
chr9	FAM27C	61920281	61920435	0	155	0	12969	0	12814	0.0	0.0
chr9	FAM27C	61972189	61972670	0	482	0	12969	0	12487	0.0	0.0
chr9	FAM27C	61920302	61920435	0	134	0	12969	0	12835	0.0	0.0
chr9	FAM27C	62072996	62073117	0	122	0	12969	0	12847	0.0	0.0
chr9	FAM27C	61975790	61975912	0	123	0	12969	0	12846	0.0	0.0
chr9	FAM27C	61952972	61954499	0	1528	0	12969	0	11441	0.0	0.0
chr9	FAM27C	62072999	62073110	0	112	0	12969	0	12857	0.0	0.0
chr9	LINC01410	62811938	62812075	0	138	0	4130	0	3992	0.0	0.0
chr9	ANKRD20A4P	64373186	64373301	0	116	0	4526	0	4410	0.0	0.0
chr9	CBWD5	65690966	65691026	0	61	612	10606	612	10545	0.0	0.058036984352773824
chr9	CBWD5	65700250	65700337	0	88	612	10606	612	10518	0.0	0.05818596691386195
chr9	CBWD5	65702969	65703014	0	46	612	10606	612	10560	0.0	0.05795454545454545
chr9	CBWD5	65708901	65708958	0	58	612	10606	612	10548	0.0	0.05802047781569966
chr9	CBWD5	65731629	65731698	0	70	612	10606	612	10536	0.0	0.05808656036446469
chr9	CBWD5	65693385	65693473	0	89	612	10606	612	10517	0.0	0.05819149947703718
chr9	CBWD5	65677127	65677225	0	99	612	10606	612	10507	0.0	0.05824688303036071
chr9	CBWD5	65707012	65707152	0	141	612	10606	612	10465	0.0	0.05848064978499761
chr9	CBWD5	65694904	65695049	0	146	612	10606	612	10460	0.0	0.058508604206500954
chr9	CBWD5	65694904	65695044	0	141	612	10606	612	10465	0.0	0.05848064978499761
chr9	CBWD5	65704330	65704547	0	218	612	10606	612	10388	0.0	0.058914131690412014
chr9	CBWD5	65704330	65704414	0	85	612	10606	612	10521	0.0	0.058169375534645
chr9	ZNF658	66902908	66903057	0	150	0	4852	0	4702	0.0	0.0
chr9	ANKRD20A1	67862940	67863055	0	116	422	6539	422	6423	0.0	0.06570138564533708
chr9	ANKRD20A1	67860470	67860696	0	227	422	6539	422	6312	0.0	0.06685678073510773
chr9	CBWD3	68256920	68256980	30	61	9568	10070	9538	10009	0.4918032786885246	0.952942351883305
chr9	CBWD3	68259346	68259434	0	89	9568	10070	9568	9981	0.0	0.958621380623184
chr9	CBWD3	68266219	68266306	0	88	9568	10070	9568	9982	0.0	0.9585253456221198
chr9	CBWD3	68243182	68243280	0	99	9568	10070	9568	9971	0.0	0.9595827900912647
chr9	CBWD3	68274881	68274938	0	58	9568	10070	9568	10012	0.0	0.9556532161406313
chr9	CBWD3	68260856	68261001	0	146	9568	10070	9568	9924	0.0	0.9641273679967755
chr9	CBWD3	68260856	68260996	0	141	9568	10070	9568	9929	0.0	0.9636418571860208
chr9	CBWD3	68269599	68269722	0	124	9568	10070	9568	9946	0.0	0.9619947717675448
chr9	CBWD3	68270301	68270518	0	218	9568	10070	9568	9852	0.0	0.9711733658140479
chr9	AL353608.3	68328888	68328957	0	70	51	5290	51	5220	0.0	0.009770114942528735
chr9	PGM5	68384397	68384544	0	148	2680	5335	2680	5187	0.0	0.5166763061499904
chr9	PIP5K1B	68742500	68742657	964	158	6660	5121	5696	4963	6.10126582278481	1.147692927664719
chr9	PIP5K1B	68991139	68991257	50	119	6660	5121	6610	5002	0.42016806722689076	1.3214714114354258
chr9	PIP5K1B	68824095	68824215	0	121	6660	5121	6660	5000	0.0	1.332
chr9	AL358113.1	69046384	69046482	232	99	7777	8743	7545	8644	2.3434343434343434	0.8728597871355854
chr9	AL358113.1	69053139	69053260	514	122	7777	8743	7263	8621	4.213114754098361	0.842477670803851
chr9	AL358113.1	69064937	69065035	51	99	7777	8743	7726	8644	0.5151515151515151	0.8937991670522906
chr9	TJP2	69248011	69248224	0	214	28876	10925	28876	10711	0.0	2.6959200821585285
chr9	TJP2	69251034	69251364	0	331	28876	10925	28876	10594	0.0	2.7256937889371344
chr9	TJP2	69249374	69249485	0	112	28876	10925	28876	10813	0.0	2.6704892259317488
chr9	TJP2	69185086	69185204	0	119	28876	10925	28876	10806	0.0	2.6722191375161946
chr9	FAM189A2	69388157	69388450	0	294	0	5150	0	4856	0.0	0.0
chr9	C9ORF135	69844516	69844625	0	110	16	1258	16	1148	0.0	0.013937282229965157
chr9	C9ORF135	69886837	69886895	0	59	16	1258	16	1199	0.0	0.013344453711426188
chr9	C9ORF135	69902254	69902388	0	135	16	1258	16	1123	0.0	0.014247551202137132
chr9	C9ORF85	71947005	71947112	0	108	0	4980	0	4872	0.0	0.0
chr9	C9ORF85	71941804	71941934	0	131	0	4980	0	4849	0.0	0.0
chr9	C9ORF85	71918424	71918555	0	132	0	4980	0	4848	0.0	0.0
chr9	GDA	72223119	72223227	0	109	51	5582	51	5473	0.0	0.009318472501370363
chr9	GDA	72214758	72214876	0	119	51	5582	51	5463	0.0	0.009335529928610654
chr9	LINC01504	72336765	72336864	0	100	7363	4345	7363	4245	0.0	1.7345111896348646
chr9	LINC01504	72328663	72328721	800	59	7363	4345	6563	4286	13.559322033898304	1.531264582361176
chr9	TMC1	72577901	72578023	33	123	84	8743	51	8620	0.2682926829268293	0.0059164733178654295
chr9	TMC1	72648596	72648664	0	69	84	8743	84	8674	0.0	0.009684113442471755
chr9	TMC1	72700517	72700643	0	127	84	8743	84	8616	0.0	0.009749303621169917
chr9	TMC1	72830630	72830682	0	53	84	8743	84	8690	0.0	0.009666283084004603
chr9	TMC1	72627920	72628063	0	144	84	8743	84	8599	0.0	0.00976857774159786
chr9	TMC1	72817084	72817288	51	205	84	8743	33	8538	0.24878048780487805	0.003865073787772312
chr9	TMC1	72818678	72818748	0	71	84	8743	84	8672	0.0	0.009686346863468635
chr9	ANXA1	73154197	73154342	0	146	0	4467	0	4321	0.0	0.0
chr9	ANXA1	73154197	73154340	0	144	0	4467	0	4323	0.0	0.0
chr9	PCSK5	76302136	76302217	0	82	0	11876	0	11794	0.0	0.0
chr9	GCNT1	76460059	76460177	0	119	0	9269	0	9150	0.0	0.0
chr9	PCA3	76703918	76703958	0	41	510	12897	510	12856	0.0	0.03967019290603609
chr9	PCA3	76733589	76733729	0	141	510	12897	510	12756	0.0	0.03998118532455315
chr9	PCA3	76737715	76737786	0	72	510	12897	510	12825	0.0	0.03976608187134503
chr9	PCA3	76783704	76783887	0	184	510	12897	510	12713	0.0	0.0401164162668135
chr9	PCA3	76856436	76856581	0	146	510	12897	510	12751	0.0	0.03999686299113795
chr9	PCA3	76738658	76738796	0	139	510	12897	510	12758	0.0	0.039974917698698854
chr9	PCA3	76782667	76782832	0	166	510	12897	510	12731	0.0	0.040059696803079095
chr9	VPS13A	77283354	77283471	0	118	51	20179	51	20061	0.0	0.0025422461492448033
chr9	VPS13A	77305556	77305637	0	82	51	20179	51	20097	0.0	0.0025376921928646065
chr9	CEP78	78240291	78240364	0	74	0	12902	0	12828	0.0	0.0
chr9	CEP78	78246668	78246782	0	115	0	12902	0	12787	0.0	0.0
chr9	CEP78	78262906	78262984	0	79	0	12902	0	12823	0.0	0.0
chr9	CEP78	78265858	78265906	0	49	0	12902	0	12853	0.0	0.0
chr9	CEP78	78250245	78250263	0	19	0	12902	0	12883	0.0	0.0
chr9	PSAT1	78328050	78328188	0	139	13	2215	13	2076	0.0	0.006262042389210019
chr9	TLE4	79576132	79576177	0	46	51	8082	51	8036	0.0	0.006346441015430563
chr9	TLE4	79627373	79627448	0	76	51	8082	51	8006	0.0	0.006370222333250062
chr9	TLE4	79706746	79706899	0	154	51	8082	51	7928	0.0	0.0064328960645812314
chr9	TLE4	79601414	79601509	0	96	51	8082	51	7986	0.0	0.006386175807663411
chr9	TLE4	79649819	79649858	0	40	51	8082	51	8042	0.0	0.0063417060432728175
chr9	TLE4	79707122	79707218	0	97	51	8082	51	7985	0.0	0.006386975579211021
chr9	TLE4	79671208	79671338	0	131	51	8082	51	7951	0.0	0.006414287511004905
chr9	TLE4	79705888	79705942	0	55	51	8082	51	8027	0.0	0.0063535567459823096
chr9	TLE4	79717996	79718071	0	76	51	8082	51	8006	0.0	0.006370222333250062
chr9	AL162726.3	82349803	82349848	0	46	2550	4452	2550	4406	0.0	0.5787562414888788
chr9	AL162726.3	82426291	82426376	0	86	2550	4452	2550	4366	0.0	0.5840586349060926
chr9	AL162726.3	82396707	82396800	0	94	2550	4452	2550	4358	0.0	0.5851307939421753
chr9	AL162726.3	82297381	82297540	0	160	2550	4452	2550	4292	0.0	0.5941286113699907
chr9	AL162726.3	82453344	82453458	0	115	2550	4452	2550	4337	0.0	0.5879640304357852
chr9	AL162726.3	82426981	82427026	0	46	2550	4452	2550	4406	0.0	0.5787562414888788
chr9	AL162726.3	82451602	82451729	0	128	2550	4452	2550	4324	0.0	0.589731729879741
chr9	IDNK	83628006	83628211	0	206	153	1820	153	1614	0.0	0.09479553903345725
chr9	IDNK	83641547	83641591	0	45	153	1820	153	1775	0.0	0.08619718309859155
chr9	IDNK	83628180	83628211	0	32	153	1820	153	1788	0.0	0.08557046979865772
chr9	AL354733.1	83835550	83835705	0	156	102	2486	102	2330	0.0	0.04377682403433476
chr9	AL354733.1	83830867	83830939	0	73	102	2486	102	2413	0.0	0.042271031910484876
chr9	AL354733.2	83858863	83859160	0	298	0	3124	0	2826	0.0	0.0
chr9	AL354733.2	83859576	83859674	0	99	0	3124	0	3025	0.0	0.0
chr9	AL354733.2	83855055	83855177	0	123	0	3124	0	3001	0.0	0.0
chr9	AL354733.2	83863660	83863822	0	163	0	3124	0	2961	0.0	0.0
chr9	AL390838.1	84077905	84078087	0	183	0	2979	0	2796	0.0	0.0
chr9	NTRK2	84669301	84669423	0	123	1746	20370	1746	20247	0.0	0.08623499777744852
chr9	NTRK2	84669679	84669888	0	210	1746	20370	1746	20160	0.0	0.08660714285714285
chr9	NTRK2	84861039	84861087	0	49	1746	20370	1746	20321	0.0	0.08592096845627675
chr9	AL158828.1	86417085	86417235	0	151	2971	1170	2971	1019	0.0	2.915603532875368
chr9	AL159996.1	86754969	86755144	0	176	0	2722	0	2546	0.0	0.0
chr9	DAPK1	87637942	87638081	0	140	0	8937	0	8797	0.0	0.0
chr9	DAPK1	87639649	87639698	0	50	0	8937	0	8887	0.0	0.0
chr9	DAPK1	87697006	87697204	0	199	0	8937	0	8738	0.0	0.0
chr9	CTSL	87728584	87728809	0	226	0	5954	0	5728	0.0	0.0
chr9	CTSL	87730380	87730498	0	119	0	5954	0	5835	0.0	0.0
chr9	CTSL	87727593	87727729	0	137	0	5954	0	5817	0.0	0.0
chr9	CTSL	87727360	87727468	0	109	0	5954	0	5845	0.0	0.0
chr9	CTSL	87727360	87727395	0	36	0	5954	0	5918	0.0	0.0
chr9	CTSL	87728249	87728396	0	148	0	5954	0	5806	0.0	0.0
chr9	CTSL	87728584	87729085	0	502	0	5954	0	5452	0.0	0.0
chr9	SPIN1	88462495	88462749	0	255	3162	4913	3162	4658	0.0	0.6788321167883211
chr9	SPIN1	88426381	88426591	0	211	3162	4913	3162	4702	0.0	0.672479795831561
chr9	UNQ6494	89700273	89700357	0	85	0	3355	0	3270	0.0	0.0
chr9	AL161629.1	90004948	90005141	0	194	102	3536	102	3342	0.0	0.03052064631956912
chr9	AL161629.1	89979488	89979531	0	44	102	3536	102	3492	0.0	0.029209621993127148
chr9	AL161629.1	90000640	90001218	0	579	102	3536	102	2957	0.0	0.034494420020290836
chr9	AL161629.1	89978275	89978432	0	158	102	3536	102	3378	0.0	0.03019538188277087
chr9	AL161629.1	89987951	89988057	0	107	102	3536	102	3429	0.0	0.02974628171478565
chr9	AL161629.1	89988593	89988795	0	203	102	3536	102	3333	0.0	0.0306030603060306
chr9	AL161629.1	89992609	89992764	0	156	102	3536	102	3380	0.0	0.03017751479289941
chr9	AL161629.1	89971266	89971399	0	134	102	3536	102	3402	0.0	0.029982363315696647
chr9	AL161629.1	89988730	89988795	0	66	102	3536	102	3470	0.0	0.029394812680115272
chr9	SYK	90867130	90867199	0	70	235	5226	235	5156	0.0	0.045577967416602014
chr9	LINC00475	92141998	92142104	0	107	0	3692	0	3585	0.0	0.0
chr9	LINC00475	92157686	92157873	0	188	0	3692	0	3504	0.0	0.0
chr9	ANKRD19P	92828937	92829163	0	227	0	2511	0	2284	0.0	0.0
chr9	SUSD3	93075783	93075972	0	190	0	1264	0	1074	0.0	0.0
chr9	SUSD3	93079470	93079602	0	133	0	1264	0	1131	0.0	0.0
chr9	CARD19	93111878	93111938	0	61	0	1748	0	1687	0.0	0.0
chr9	WNK2	93256298	93256454	0	157	0	12845	0	12688	0.0	0.0
chr9	WNK2	93268839	93268950	0	112	0	12845	0	12733	0.0	0.0
chr9	WNK2	93299069	93299261	0	193	0	12845	0	12652	0.0	0.0
chr9	FAM120A	93558580	93558718	0	139	51	6135	51	5996	0.0	0.008505670446964642
chr9	FAM120A	93530710	93530731	0	22	51	6135	51	6113	0.0	0.008342875838377228
chr9	AL442224.1	93825710	93826515	0	806	0	1617	0	811	0.0	0.0
chr9	AL442224.1	93845166	93845282	0	117	0	1617	0	1500	0.0	0.0
chr9	PTPDC1	94057117	94057179	0	63	1428	6381	1428	6318	0.0	0.22602089268755934
chr9	AL158152.1	94149425	94149562	0	138	0	1242	0	1104	0.0	0.0
chr9	AOPEP	94928424	94928531	0	108	57420	10810	57420	10702	0.0	5.365352270603625
chr9	AOPEP	95060693	95060810	1783	118	57420	10810	55637	10692	15.110169491525424	5.203610175832398
chr9	AOPEP	95082574	95082719	715	146	57420	10810	56705	10664	4.897260273972603	5.317423105776444
chr9	AOPEP	95085929	95086119	0	191	57420	10810	57420	10619	0.0	5.407288821922968
chr9	AL354861.2	95685142	95685251	0	110	0	515	0	405	0.0	0.0
chr9	ERCC6L2	95907077	95907271	0	195	329	16706	329	16511	0.0	0.01992610986614984
chr9	ERCC6L2	95997245	95997413	0	169	329	16706	329	16537	0.0	0.019894781399286448
chr9	ERCC6L2	96004519	96004701	0	183	329	16706	329	16523	0.0	0.019911638322338557
chr9	ERCC6L2	95971543	95971595	0	53	329	16706	329	16653	0.0	0.019756200084068937
chr9	ERCC6L2	95954727	95954922	0	196	329	16706	329	16510	0.0	0.01992731677771048
chr9	ERCC6L2	95967318	95967625	0	308	329	16706	329	16398	0.0	0.020063422368581534
chr9	ERCC6L2	95967458	95967625	0	168	329	16706	329	16538	0.0	0.01989357842544443
chr9	AL449403.1	96093025	96093162	0	138	0	2230	0	2092	0.0	0.0
chr9	AL449403.1	96093025	96093095	0	71	0	2230	0	2159	0.0	0.0
chr9	AL589843.1	96720965	96721130	0	166	51	2839	51	2673	0.0	0.019079685746352413
chr9	AL590705.2	97229036	97229164	0	129	269867	658	269867	529	0.0	510.14555765595463
chr9	STRA6LP	97292555	97292675	0	121	706	7167	706	7046	0.0	0.10019869429463525
chr9	STRA6LP	97314392	97314521	0	130	706	7167	706	7037	0.0	0.10032684382549382
chr9	STRA6LP	97318462	97318582	0	121	706	7167	706	7046	0.0	0.10019869429463525
chr9	STRA6LP	97328019	97328146	0	128	706	7167	706	7039	0.0	0.10029833783207842
chr9	STRA6LP	97364017	97364128	0	112	706	7167	706	7055	0.0	0.10007087172218285
chr9	STRA6LP	97364050	97364128	0	79	706	7167	706	7088	0.0	0.09960496613995486
chr9	NCBP1	97643203	97643360	0	158	786	3175	786	3017	0.0	0.26052369903878025
chr9	NCBP1	97645610	97645732	0	123	786	3175	786	3052	0.0	0.2575360419397117
chr9	GALNT12	98823255	98823425	0	171	0	3177	0	3006	0.0	0.0
chr9	TGFBR1	99146484	99146609	0	126	157608	6833	157608	6707	0.0	23.499030863277174
chr9	TGFBR1	99132508	99132739	0	232	157608	6833	157608	6601	0.0	23.876382366308135
chr9	TGFBR1	99132496	99132739	0	244	157608	6833	157608	6589	0.0	23.919866444073456
chr9	NR4A3	99826729	99826801	0	73	51	6323	51	6250	0.0	0.00816
chr9	STX17	99959916	99960032	2358	117	6048	8893	3690	8776	20.153846153846153	0.420464904284412
chr9	STX17	99916048	99916168	0	121	6048	8893	6048	8772	0.0	0.6894664842681258
chr9	STX17	99913989	99914151	0	163	6048	8893	6048	8730	0.0	0.6927835051546392
chr9	STX17	99945718	99945850	528	133	6048	8893	5520	8760	3.969924812030075	0.6301369863013698
chr9	MSANTD3	100429505	100429662	0	158	9645	3295	9645	3137	0.0	3.074593560726809
chr9	MSANTD3	100445168	100445237	1122	70	9645	3295	8523	3225	16.02857142857143	2.6427906976744184
chr9	ZNF189	101399394	101399530	0	137	102	3438	102	3301	0.0	0.030899727355346865
chr9	ZNF189	101407411	101407532	0	122	102	3438	102	3316	0.0	0.030759951749095297
chr9	TMEM246-AS1	101474875	101475042	0	168	0	1819	0	1651	0.0	0.0
chr9	TMEM246-AS1	101479839	101479923	0	85	0	1819	0	1734	0.0	0.0
chr9	CYLC2	103016887	103016961	0	75	626	2285	626	2210	0.0	0.2832579185520362
chr9	SMC2	104135867	104136060	0	194	867	6461	867	6267	0.0	0.13834370512206798
chr9	NIPSNAP3B	104766324	104766535	0	212	0	1687	0	1475	0.0	0.0
chr9	NIPSNAP3B	104770848	104770998	0	151	0	1687	0	1536	0.0	0.0
chr9	FSD1L	105461519	105461615	0	97	0	9554	0	9457	0.0	0.0
chr9	FSD1L	105479353	105479376	0	24	0	9554	0	9530	0.0	0.0
chr9	FSD1L	105513598	105513631	0	34	0	9554	0	9520	0.0	0.0
chr9	FKTN	105603698	105603816	0	119	191	17148	191	17029	0.0	0.011216160667097304
chr9	FKTN	105573654	105573746	0	93	191	17148	191	17055	0.0	0.011199061858692466
chr9	FKTN	105623049	105623221	0	173	191	17148	191	16975	0.0	0.011251840942562591
chr9	FKTN	105574197	105574332	0	136	191	17148	191	17012	0.0	0.011227368916059252
chr9	FKTN	105570750	105570897	0	148	191	17148	191	17000	0.0	0.011235294117647059
chr9	FKTN	105574197	105574278	0	82	191	17148	191	17066	0.0	0.011191843431384038
chr9	FKTN	105598085	105598183	0	99	191	17148	191	17049	0.0	0.011203003108686726
chr9	FKTN	105600917	105601041	0	125	191	17148	191	17023	0.0	0.0112201139634612
chr9	FKTN	105603863	105603947	0	85	191	17148	191	17063	0.0	0.011193811170368634
chr9	FKTN	105598630	105598701	0	72	191	17148	191	17076	0.0	0.011185289294916842
chr9	FKTN	105598505	105598701	0	197	191	17148	191	16951	0.0	0.011267771812872397
chr9	FKTN	105633355	105633474	0	120	191	17148	191	17028	0.0	0.01121681935635424
chr9	FKTN	105624281	105624396	0	116	191	17148	191	17032	0.0	0.011214185063410051
chr9	TMEM38B	105702706	105702822	0	117	0	4537	0	4420	0.0	0.0
chr9	TMEM38B	105749075	105749111	0	37	0	4537	0	4500	0.0	0.0
chr9	LINC01505	106558471	106558583	0	113	0	12891	0	12778	0.0	0.0
chr9	LINC01505	106588376	106588464	0	89	0	12891	0	12802	0.0	0.0
chr9	LINC01505	106500356	106500505	0	150	0	12891	0	12741	0.0	0.0
chr9	LINC01505	106499486	106499612	0	127	0	12891	0	12764	0.0	0.0
chr9	LINC01505	106588379	106588464	0	86	0	12891	0	12805	0.0	0.0
chr9	LINC01505	106588827	106588940	0	114	0	12891	0	12777	0.0	0.0
chr9	LINC01505	106598531	106598663	0	133	0	12891	0	12758	0.0	0.0
chr9	LINC01505	106456513	106456553	0	41	0	12891	0	12850	0.0	0.0
chr9	LINC01505	106464017	106464165	0	149	0	12891	0	12742	0.0	0.0
chr9	LINC01505	106588827	106589013	0	187	0	12891	0	12704	0.0	0.0
chr9	LINC01505	106564924	106565022	0	99	0	12891	0	12792	0.0	0.0
chr9	LINC01505	106572733	106572889	0	157	0	12891	0	12734	0.0	0.0
chr9	LINC01505	106639338	106639436	0	99	0	12891	0	12792	0.0	0.0
chr9	LINC01505	106666556	106667722	0	1167	0	12891	0	11724	0.0	0.0
chr9	LINC01505	106702168	106702241	0	74	0	12891	0	12817	0.0	0.0
chr9	ZNF462	106938915	106939107	0	193	0	9293	0	9100	0.0	0.0
chr9	ABITRAM	108935637	108935689	0	53	98	2532	98	2479	0.0	0.03953206938281565
chr9	PALM2AKAP2	109931926	109932028	1719	103	6093	18362	4374	18259	16.689320388349515	0.23955309710279862
chr9	PALM2AKAP2	110162093	110162132	0	40	6093	18362	6093	18322	0.0	0.33255103154677434
chr9	PALM2AKAP2	109942685	109943381	0	697	6093	18362	6093	17665	0.0	0.344919332012454
chr9	PALM2AKAP2	110156318	110156497	0	180	6093	18362	6093	18182	0.0	0.33511164888351114
chr9	PALM2AKAP2	110136126	110138539	0	2414	6093	18362	6093	15948	0.0	0.38205417607223474
chr9	MUSK	110767819	110768083	0	265	1735	9194	1735	8929	0.0	0.1943106730876918
chr9	MUSK	110784814	110785016	0	203	1735	9194	1735	8991	0.0	0.19297074852630408
chr9	MUSK	110776631	110776655	0	25	1735	9194	1735	9169	0.0	0.18922456102083107
chr9	MUSK	110728687	110728717	0	31	1735	9194	1735	9163	0.0	0.18934846665939103
chr9	DNAJC25	111642856	111643094	0	239	32952	2609	32952	2370	0.0	13.90379746835443
chr9	HSDL2	112403994	112404158	0	165	0	3320	0	3155	0.0	0.0
chr9	HSDL2	112416840	112416944	0	105	0	3320	0	3215	0.0	0.0
chr9	HSDL2	112408906	112409021	0	116	0	3320	0	3204	0.0	0.0
chr9	KIAA1958	112617870	112617954	0	85	0	13144	0	13059	0.0	0.0
chr9	SLC31A2	113158043	113158096	0	54	2353	2479	2353	2425	0.0	0.9703092783505155
chr9	BSPRY	113368258	113368383	0	126	0	2345	0	2219	0.0	0.0
chr9	RGS3	113583449	113584427	0	979	858	11098	858	10119	0.0	0.08479098725170471
chr9	RGS3	113581558	113581658	0	101	858	11098	858	10997	0.0	0.07802127853050832
chr9	ZNF618	113998258	113998354	0	97	0	10399	0	10302	0.0	0.0
chr9	ZNF618	114008343	114008379	0	37	0	10399	0	10362	0.0	0.0
chr9	ZNF618	114016112	114016172	0	61	0	10399	0	10338	0.0	0.0
chr9	ZNF618	114028732	114028972	0	241	0	10399	0	10158	0.0	0.0
chr9	ZNF618	114028909	114028972	0	64	0	10399	0	10335	0.0	0.0
chr9	COL27A1	114194403	114194457	480	55	47529	14073	47049	14018	8.727272727272727	3.356327578827222
chr9	ATP6V1G1	114592551	114592657	0	107	434	3459	434	3352	0.0	0.12947494033412887
chr9	ATP6V1G1	114592551	114592652	0	102	434	3459	434	3357	0.0	0.12928209711051533
chr9	ATP6V1G1	114596506	114596588	13	83	434	3459	421	3376	0.1566265060240964	0.12470379146919432
chr9	DELEC1	115068995	115069070	0	76	32368	6673	32368	6597	0.0	4.906472639078369
chr9	DELEC1	115157594	115157715	0	122	32368	6673	32368	6551	0.0	4.940925049610747
chr9	DELEC1	115290822	115290937	0	116	32368	6673	32368	6557	0.0	4.936403843220985
chr9	TRIM32	116697372	116697433	0	62	0	3780	0	3718	0.0	0.0
chr9	AL161630.1	117652287	117652447	0	161	0	1469	0	1308	0.0	0.0
chr9	TLR4	117708562	117708729	0	168	72	13281	72	13113	0.0	0.00549073438572409
chr9	AL160272.1	117870088	117870484	0	397	20690	10793	20690	10396	0.0	1.9901885340515584
chr9	TLR4	117708198	117708318	0	121	72	13281	72	13160	0.0	0.00547112462006079
chr9	CUTALP	120844992	120845196	568	205	3518025	7206	3517457	7001	2.770731707317073	502.42208255963436
chr9	CUTALP	120850362	120850657	0	296	3518025	7206	3518025	6910	0.0	509.12083936324166
chr9	CUTALP	120846681	120846803	0	123	3518025	7206	3518025	7083	0.0	496.6857263871241
chr9	CUTALP	120849922	120850006	0	85	3518025	7206	3518025	7121	0.0	494.03524785844684
chr9	CUTALP	120848936	120848979	0	44	3518025	7206	3518025	7162	0.0	491.20706506562414
chr9	CNTRL	121080305	121080478	0	174	0	9472	0	9298	0.0	0.0
chr9	GSN	121248275	121248323	0	49	0	7205	0	7156	0.0	0.0
chr9	GSN	121300055	121300126	0	72	0	7205	0	7133	0.0	0.0
chr9	GSN	121281469	121281562	0	94	0	7205	0	7111	0.0	0.0
chr9	GSN	121282438	121282550	0	113	0	7205	0	7092	0.0	0.0
chr9	DAB2IP	121699324	121699458	0	135	0	8270	0	8135	0.0	0.0
chr9	DAB2IP	121766493	121766730	0	238	0	8270	0	8032	0.0	0.0
chr9	MORN5	122169644	122169756	0	113	0	874	0	761	0.0	0.0
chr9	MRRF	122313226	122313386	0	161	204	11044	204	10883	0.0	0.018744831388403934
chr9	MRRF	122280442	122280598	0	157	204	11044	204	10887	0.0	0.018737944337283
chr9	MRRF	122265461	122265780	0	320	204	11044	204	10724	0.0	0.019022752704214847
chr9	MRRF	122265461	122265545	0	85	204	11044	204	10959	0.0	0.0186148371201752
chr9	MRRF	122285779	122285946	0	168	204	11044	204	10876	0.0	0.01875689591761677
chr9	MRRF	122286038	122286166	0	129	204	11044	204	10915	0.0	0.018689876316994963
chr9	PTGS1	122377898	122378015	0	118	102	5785	102	5667	0.0	0.017998941238750663
chr9	PTGS1	122378774	122378918	0	145	102	5785	102	5640	0.0	0.018085106382978722
chr9	PTGS1	122371612	122371834	0	223	102	5785	102	5562	0.0	0.018338727076591153
chr9	PTGS1	122377927	122378015	0	89	102	5785	102	5696	0.0	0.017907303370786515
chr9	RABGAP1	122971664	122971952	0	289	117	7090	117	6801	0.0	0.017203352448169385
chr9	RABGAP1	123071411	123071501	0	91	117	7090	117	6999	0.0	0.016716673810544362
chr9	RABGAP1	122984484	122984719	0	236	117	7090	117	6854	0.0	0.01707032389845346
chr9	LHX2	124021818	124021867	0	50	51	2480	51	2430	0.0	0.020987654320987655
chr9	NEK6	124292848	124293013	0	166	1580	4451	1580	4285	0.0	0.3687281213535589
chr9	ADGRD2	124453998	124454097	0	100	2969	4523	2969	4423	0.0	0.6712638480669229
chr9	OLFML2A	124795023	124795131	0	109	4055	6780	4055	6671	0.0	0.6078548943186929
chr9	RABEPK	125203007	125203066	0	60	0	3438	0	3378	0.0	0.0
chr9	RABEPK	125213369	125213522	0	154	0	3438	0	3284	0.0	0.0
chr9	RABEPK	125220326	125220397	0	72	0	3438	0	3366	0.0	0.0
chr9	GAPVD1	125337017	125337095	0	79	467	13657	467	13578	0.0	0.034393872440712916
chr9	GAPVD1	125268935	125268984	0	50	467	13657	467	13607	0.0	0.03432057029470126
chr9	GAPVD1	125295457	125295574	0	118	467	13657	467	13539	0.0	0.03449294630327203
chr9	GAPVD1	125342218	125342299	0	82	467	13657	467	13575	0.0	0.03440147329650092
chr9	GAPVD1	125335171	125335252	0	82	467	13657	467	13575	0.0	0.03440147329650092
chr9	GAPVD1	125309928	125310009	0	82	467	13657	467	13575	0.0	0.03440147329650092
chr9	PBX3	125915685	125915927	0	243	16905	4922	16905	4679	0.0	3.61295148536012
chr9	PBX3	125962101	125962214	0	114	16905	4922	16905	4808	0.0	3.5160149750415974
chr9	PBX3	125949377	125949440	0	64	16905	4922	16905	4858	0.0	3.4798270893371757
chr9	ZBTB43	126808792	126808915	0	124	0	2855	0	2731	0.0	0.0
chr9	RALGPS1	127050042	127050132	147	91	120190	10527	120043	10436	1.6153846153846154	11.502778842468379
chr9	GARNL3	127264951	127265021	0	71	331	6297	331	6226	0.0	0.05316415033729521
chr9	GARNL3	127348923	127349035	0	113	331	6297	331	6184	0.0	0.05352522639068564
chr9	GARNL3	127387192	127387331	0	140	331	6297	331	6157	0.0	0.05375994802663635
chr9	SLC2A8	127402556	127402753	51	198	51	3446	0	3248	0.25757575757575757	0.0
chr9	SLC2A8	127405419	127405565	0	147	51	3446	51	3299	0.0	0.015459230069718097
chr9	SLC2A8	127397904	127398111	0	208	51	3446	51	3238	0.0	0.015750463248919086
chr9	SLC2A8	127397375	127397538	0	164	51	3446	51	3282	0.0	0.015539305301645339
chr9	ZNF79	127428551	127428660	0	110	5481	2308	5481	2198	0.0	2.4936305732484074
chr9	LRSAM1	127454997	127455054	0	58	17882	8123	17882	8065	0.0	2.217234965902046
chr9	LRSAM1	127455575	127455620	0	46	17882	8123	17882	8077	0.0	2.213940819611242
chr9	LRSAM1	127482949	127483020	0	72	17882	8123	17882	8051	0.0	2.2210905477580423
chr9	LRSAM1	127487675	127487763	1721	89	17882	8123	16161	8034	19.337078651685392	2.011575802837939
chr9	LRSAM1	127491214	127491295	0	82	17882	8123	17882	8041	0.0	2.2238527546325084
chr9	LRSAM1	127495319	127495418	107	100	17882	8123	17775	8023	1.07	2.215505421912003
chr9	LRSAM1	127497252	127497334	108	83	17882	8123	17774	8040	1.3012048192771084	2.210696517412935
chr9	LRSAM1	127497252	127497362	108	111	17882	8123	17774	8012	0.972972972972973	2.2184223664503246
chr9	LRSAM1	127486404	127486694	0	291	17882	8123	17882	7832	0.0	2.283197139938713
chr9	LRSAM1	127482732	127482813	0	82	17882	8123	17882	8041	0.0	2.2238527546325084
chr9	LRSAM1	127487494	127487553	1632	60	17882	8123	16250	8063	27.2	2.0153788912315513
chr9	LRSAM1	127492801	127492897	0	97	17882	8123	17882	8026	0.0	2.2280089708447544
chr9	LRSAM1	127454997	127455040	0	44	17882	8123	17882	8079	0.0	2.2133927466270578
chr9	LRSAM1	127495319	127495414	59	96	17882	8123	17823	8027	0.6145833333333334	2.220381213404759
chr9	LRSAM1	127497421	127497954	0	534	17882	8123	17882	7589	0.0	2.356305178547898
chr9	LRSAM1	127487536	127487763	2710	228	17882	8123	15172	7895	11.885964912280702	1.9217226092463584
chr9	LRSAM1	127460876	127460998	462	123	17882	8123	17420	8000	3.7560975609756095	2.1775
chr9	LRSAM1	127487494	127487763	4022	270	17882	8123	13860	7853	14.896296296296295	1.7649305997707883
chr9	LRSAM1	127493750	127494081	1823	332	17882	8123	16059	7791	5.490963855421687	2.061224489795918
chr9	STXBP1	127684367	127684493	96	127	109863	8749	109767	8622	0.7559055118110236	12.731036882393877
chr9	STXBP1	127673347	127673427	94	81	109863	8749	109769	8668	1.1604938271604939	12.663705583756345
chr9	STXBP1	127686457	127686537	0	81	109863	8749	109863	8668	0.0	12.67455006922012
chr9	STXBP1	127653890	127654964	459	1075	109863	8749	109404	7674	0.42697674418604653	14.256450351837373
chr9	STXBP1	127654941	127654964	0	24	109863	8749	109863	8725	0.0	12.591747851002866
chr9	STXBP1	127639427	127639617	63432	191	109863	8749	46431	8558	332.1047120418848	5.425449871465296
chr9	STXBP1	127642468	127642563	8376	96	109863	8749	101487	8653	87.25	11.728533456604646
chr9	STXBP1	127683917	127683970	156	54	109863	8749	109707	8695	2.888888888888889	12.617251293847039
chr9	CFAP157	127713019	127713206	561	188	38262	3233	37701	3045	2.984042553191489	12.38128078817734
chr9	TTC16	127724755	127724897	0	143	9462	4244	9462	4101	0.0	2.3072421360643744
chr9	FPGS	127806972	127807087	0	116	364	3747	364	3631	0.0	0.1002478656017626
chr9	FPGS	127807208	127807286	0	79	364	3747	364	3668	0.0	0.09923664122137404
chr9	FPGS	127808557	127808705	0	149	364	3747	364	3598	0.0	0.10116731517509728
chr9	FPGS	127810944	127811011	0	68	364	3747	364	3679	0.0	0.0989399293286219
chr9	FPGS	127806991	127807087	0	97	364	3747	364	3650	0.0	0.09972602739726028
chr9	AL157935.1	127938457	127938662	51	206	6465	2525	6414	2319	0.24757281553398058	2.7658473479948253
chr9	SLC25A25	128102079	128102115	0	37	17744	4949	17744	4912	0.0	3.6123778501628663
chr9	SLC25A25	128099274	128099385	4935	112	17744	4949	12809	4837	44.0625	2.648129005581972
chr9	DNM1	128226034	128226173	0	140	7108	9109	7108	8969	0.0	0.7925075259226224
chr9	DNM1	128239984	128239996	13	13	7108	9109	7095	9096	1.0	0.7800131926121372
chr9	DNM1	128224250	128224389	1878	140	7108	9109	5230	8969	13.414285714285715	0.5831196342959081
chr9	DNM1	128253100	128253137	0	38	7108	9109	7108	9071	0.0	0.7835960754051372
chr9	DNM1	128221109	128221216	0	108	7108	9109	7108	9001	0.0	0.7896900344406177
chr9	DNM1	128226034	128226086	0	53	7108	9109	7108	9056	0.0	0.7848939929328622
chr9	DNM1	128234815	128234935	51	121	7108	9109	7057	8988	0.4214876033057851	0.7851579884290165
chr9	DNM1	128231985	128232124	0	140	7108	9109	7108	8969	0.0	0.7925075259226224
chr9	SWI5	128278633	128278681	0	49	51	2509	51	2460	0.0	0.020731707317073172
chr9	CERCAM	128421203	128421511	51	309	8414	5550	8363	5241	0.1650485436893204	1.5956878458309482
chr9	ODF2	128469182	128469353	15091	172	21668	6418	6577	6246	87.73837209302326	1.052993916106308
chr9	ODF2	128460512	128460666	0	155	21668	6418	21668	6263	0.0	3.4596838575762416
chr9	ODF2	128457197	128457437	0	241	21668	6418	21668	6177	0.0	3.5078517079488423
chr9	ODF2	128460549	128460666	0	118	21668	6418	21668	6300	0.0	3.4393650793650794
chr9	ODF2	128460157	128460299	0	143	21668	6418	21668	6275	0.0	3.4530677290836653
chr9	SPTAN1	128568771	128568897	299	127	7922	15464	7623	15337	2.354330708661417	0.4970333181195801
chr9	SPTAN1	128592982	128593042	0	61	7922	15464	7922	15403	0.0	0.5143153931052392
chr9	SPTAN1	128609650	128609665	0	16	7922	15464	7922	15448	0.0	0.5128171931641636
chr9	SPTAN1	128555348	128555399	39	52	7922	15464	7883	15412	0.75	0.511484557487672
chr9	SPTAN1	128629124	128629187	0	64	7922	15464	7922	15400	0.0	0.5144155844155844
chr9	SPTAN1	128572755	128572824	0	70	7922	15464	7922	15394	0.0	0.5146160841886449
chr9	SPTAN1	128601344	128601400	0	57	7922	15464	7922	15407	0.0	0.5141818653858635
chr9	PKN3	128715368	128715460	66	93	5873	3253	5807	3160	0.7096774193548387	1.8376582278481013
chr9	TBC1D13	128790734	128790775	0	42	51	3944	51	3902	0.0	0.013070220399794977
chr9	LRRC8A	128886014	128886121	0	108	0	5216	0	5108	0.0	0.0
chr9	PHYHD1	128936582	128936645	0	64	0	2479	0	2415	0.0	0.0
chr9	PHYHD1	128937756	128937778	0	23	0	2479	0	2456	0.0	0.0
chr9	PHYHD1	128940598	128940715	0	118	0	2479	0	2361	0.0	0.0
chr9	PHYHD1	128937756	128937944	0	189	0	2479	0	2290	0.0	0.0
chr9	MIGA2	129051299	129051420	0	122	12	6138	12	6016	0.0	0.0019946808510638296
chr9	MIGA2	129063243	129063316	0	74	12	6138	12	6064	0.0	0.001978891820580475
chr9	MIGA2	129039787	129039886	0	100	12	6138	12	6038	0.0	0.001987413050679033
chr9	MIGA2	129063544	129063631	0	88	12	6138	12	6050	0.0	0.0019834710743801653
chr9	DOLPP1	129085022	129085107	0	86	1305	2246	1305	2160	0.0	0.6041666666666666
chr9	DOLPP1	129085517	129085616	0	100	1305	2246	1305	2146	0.0	0.6081081081081081
chr9	DOLPP1	129086138	129086267	0	130	1305	2246	1305	2116	0.0	0.6167296786389413
chr9	PTPA	129120512	129120610	0	99	3929	5645	3929	5546	0.0	0.7084385142445006
chr9	PTPA	129123051	129123138	0	88	3929	5645	3929	5557	0.0	0.7070361705956452
chr9	PTPA	129128984	129129110	0	127	3929	5645	3929	5518	0.0	0.7120333454150054
chr9	PTPA	129127963	129128068	0	106	3929	5645	3929	5539	0.0	0.7093338147680087
chr9	PTPA	129120512	129120628	0	117	3929	5645	3929	5528	0.0	0.7107452966714906
chr9	AL158151.1	129258793	129258882	0	90	6167	5653	6167	5563	0.0	1.1085745101563904
chr9	LINC01503	129341831	129342043	0	213	0	4676	0	4463	0.0	0.0
chr9	LINC01503	129341735	129342043	0	309	0	4676	0	4367	0.0	0.0
chr9	LINC01503	129341751	129342043	0	293	0	4676	0	4383	0.0	0.0
chr9	LINC01503	129356252	129356830	0	579	0	4676	0	4097	0.0	0.0
chr9	LINC01503	129341349	129342043	0	695	0	4676	0	3981	0.0	0.0
chr9	LINC00963	129493418	129493595	0	178	201	11349	201	11171	0.0	0.017993017634947633
chr9	LINC00963	129503322	129503672	0	351	201	11349	201	10998	0.0	0.018276050190943808
chr9	LINC00963	129493415	129493595	0	181	201	11349	201	11168	0.0	0.017997851002865328
chr9	LINC00963	129504891	129505043	0	153	201	11349	201	11196	0.0	0.01795284030010718
chr9	LINC00963	129493477	129493595	0	119	201	11349	201	11230	0.0	0.017898486197684773
chr9	LINC00963	129502396	129503139	0	744	201	11349	201	10605	0.0	0.018953323903818955
chr9	LINC00963	129490843	129491128	0	286	201	11349	201	11063	0.0	0.018168670342583387
chr9	LINC00963	129503325	129503672	0	348	201	11349	201	11001	0.0	0.018271066266703027
chr9	LINC00963	129502909	129503139	0	231	201	11349	201	11118	0.0	0.01807879114948732
chr9	LINC00963	129490810	129491128	0	319	201	11349	201	11030	0.0	0.018223028105167724
chr9	LINC00963	129502396	129502519	0	124	201	11349	201	11225	0.0	0.017906458797327395
chr9	AL391056.1	129577520	129577653	0	134	10635	3654	10635	3520	0.0	3.0213068181818183
chr9	AL391056.1	129580440	129580558	520	119	10635	3654	10115	3535	4.369747899159663	2.8613861386138613
chr9	AL391056.1	129580478	129580558	520	81	10635	3654	10115	3573	6.419753086419753	2.830954380072768
chr9	NTMT1	129632649	129632865	0	217	2598	3032	2598	2815	0.0	0.9229129662522203
chr9	NTMT1	129632649	129632801	0	153	2598	3032	2598	2879	0.0	0.9023966655088572
chr9	GPR107	130114576	130114663	0	88	9323	8332	9323	8244	0.0	1.1308830664725862
chr9	GPR107	130110369	130110426	0	58	9323	8332	9323	8274	0.0	1.1267826927725404
chr9	HMCN2	130427496	130427619	18171	124	114869	18709	96698	18585	146.54032258064515	5.2030131826742
chr9	ASS1	130464110	130464167	0	58	64071	2714	64071	2656	0.0	24.123117469879517
chr9	ASS1	130451601	130452043	6293	443	64071	2714	57778	2271	14.205417607223476	25.44165565830031
chr9	ASS1	130450271	130450333	598	63	64071	2714	63473	2651	9.492063492063492	23.943040362127498
chr9	FUBP3	130580658	130581513	38257	856	114877	6625	76620	5769	44.6927570093458	13.28133125325013
chr9	FUBP3	130607297	130608393	1326	1097	114877	6625	113551	5528	1.2087511394712853	20.541063675832127
chr9	EXOSC2	130698161	130698251	1012	91	522878	2971	521866	2880	11.12087912087912	181.20347222222222
chr9	EXOSC2	130697581	130697627	62599	47	522878	2971	460279	2924	1331.8936170212767	157.4141586867305
chr9	LAMC3	131080314	131080383	35	70	388821	8969	388786	8899	0.5	43.6887290706821
chr9	AIF1L	131106187	131106265	0	79	145827	4638	145827	4559	0.0	31.98661987277912
chr9	NUP214	131135939	131136006	0	68	263360	12057	263360	11989	0.0	21.966802902660774
chr9	NUP214	131147489	131147584	3131	96	263360	12057	260229	11961	32.614583333333336	21.7564584900928
chr9	NUP214	131187288	131187364	0	77	263360	12057	263360	11980	0.0	21.98330550918197
chr9	NUP214	131192207	131192292	0	86	263360	12057	263360	11971	0.0	21.999832929579817
chr9	NUP214	131195232	131195294	0	63	263360	12057	263360	11994	0.0	21.957645489411373
chr9	NUP214	131232283	131232308	0	26	263360	12057	263360	12031	0.0	21.89011719724046
chr9	NUP214	131147486	131147584	3392	99	263360	12057	259968	11958	34.26262626262626	21.74009031610637
chr9	NUP214	131229662	131229825	714	164	263360	12057	262646	11893	4.353658536585366	22.08408307407719
chr9	NUP214	131232161	131232308	1151	148	263360	12057	262209	11909	7.777027027027027	22.01771769250147
chr9	PRRC2B	131459163	131459356	867	194	419902	12462	419035	12268	4.469072164948454	34.15674926638409
chr9	PRRC2B	131474453	131476535	135629	2083	419902	12462	284273	10379	65.11233797407586	27.389247519028807
chr9	PRRC2B	131494404	131494486	328	83	419902	12462	419574	12379	3.9518072289156625	33.89401405606269
chr9	POMT1	131504188	131504340	1326	153	54510	6345	53184	6192	8.666666666666666	8.589147286821705
chr9	POMT1	131506113	131506220	306	108	54510	6345	54204	6237	2.8333333333333335	8.690716690716691
chr9	POMT1	131507367	131507514	3544	148	54510	6345	50966	6197	23.945945945945947	8.224302081652413
chr9	POMT1	131508910	131509022	48	113	54510	6345	54462	6232	0.4247787610619469	8.739088575096277
chr9	POMT1	131513238	131513331	389	94	54510	6345	54121	6251	4.138297872340425	8.657974724044154
chr9	POMT1	131520079	131520193	510	115	54510	6345	54000	6230	4.434782608695652	8.667736757624398
chr9	POMT1	131506402	131506453	71	52	54510	6345	54439	6293	1.3653846153846154	8.650723025583982
chr9	POMT1	131507350	131507514	3554	165	54510	6345	50956	6180	21.53939393939394	8.245307443365697
chr9	POMT1	131506182	131506220	54	39	54510	6345	54456	6306	1.3846153846153846	8.63558515699334
chr9	POMT1	131504453	131504649	0	197	54510	6345	54510	6148	0.0	8.86629798308393
chr9	POMT1	131512040	131512136	0	97	54510	6345	54510	6248	0.0	8.72439180537772
chr9	CFAP77	132482309	132482417	1460	109	420279	2157	418819	2048	13.394495412844037	204.50146484375
chr9	GFI1B	132989060	132989198	0	139	12652	6121	12652	5982	0.0	2.1150117017719827
chr9	GTF3C5	133042086	133042306	0	221	51	3434	51	3213	0.0	0.015873015873015872
chr9	GTF3C5	133054943	133054964	0	22	51	3434	51	3412	0.0	0.014947245017584994
chr9	GTF3C5	133043727	133043926	2	200	51	3434	49	3234	0.01	0.015151515151515152
chr9	ADAMTS13	133433640	133433704	0	65	15942	5712	15942	5647	0.0	2.823091907207367
chr9	ADAMTS13	133457909	133458094	3723	186	15942	5712	12219	5526	20.016129032258064	2.2111834961997827
chr9	ADAMTS13	133443375	133443561	0	187	15942	5712	15942	5525	0.0	2.8854298642533935
chr9	CACFD1	133465321	133465447	107	127	13030	3528	12923	3401	0.84251968503937	3.799764775066157
chr9	CACFD1	133468339	133468464	561	126	13030	3528	12469	3402	4.4523809523809526	3.665196942974721
chr9	DBH	133639845	133639992	0	148	1847	2758	1847	2610	0.0	0.7076628352490422
chr9	FCN2	134882525	134882639	0	115	612	1070	612	955	0.0	0.6408376963350786
chr9	OLFM1	135106748	135106855	51	108	51	6137	0	6029	0.4722222222222222	0.0
chr9	OBP2A	135546777	135546911	204	135	9759	775	9555	640	1.511111111111111	14.9296875
chr9	PAEP	135564243	135564354	9126	112	96857	1461	87731	1349	81.48214285714286	65.03409933283913
chr9	LINC01502	135577633	135577774	0	142	0	2753	0	2611	0.0	0.0
chr9	PAEPP1	135589410	135589484	0	75	0	531	0	456	0.0	0.0
chr9	KCNT1	135714576	135714720	0	145	93300	15507	93300	15362	0.0	6.0734279390704335
chr9	KCNT1	135785309	135785330	36	22	93300	15507	93264	15485	1.6363636363636365	6.0228608330642555
chr9	KCNT1	135788099	135788162	9	64	93300	15507	93291	15443	0.140625	6.040989445056012
chr9	KCNT1	135742771	135742813	0	43	93300	15507	93300	15464	0.0	6.033367822038282
chr9	PMPCA	136412809	136412892	0	84	0	6212	0	6128	0.0	0.0
chr9	PMPCA	136414552	136414647	0	96	0	6212	0	6116	0.0	0.0
chr9	EGFL7	136668240	136668362	0	123	18352	2577	18352	2454	0.0	7.47840260798696
chr9	EGFL7	136663407	136663623	0	217	18352	2577	18352	2360	0.0	7.776271186440678
chr9	TMEM141	136791710	136791777	0	68	816	1297	816	1229	0.0	0.6639544344995931
chr9	CCDC183	136799712	136799790	0	79	2310	2690	2310	2611	0.0	0.8847184986595175
chr9	CCDC183	136805356	136805457	0	102	2310	2690	2310	2588	0.0	0.89258114374034
chr9	PHPT1	136850505	136850560	0	56	3816	1616	3816	1560	0.0	2.4461538461538463
chr9	MAMDC4	136854761	136854850	0	90	42002	5342	42002	5252	0.0	7.997334348819497
chr9	MAMDC4	136858185	136858276	0	92	42002	5342	42002	5250	0.0	8.000380952380953
chr9	MAMDC4	136856256	136856381	117	126	42002	5342	41885	5216	0.9285714285714286	8.030099693251534
chr9	C8G	136945928	136945999	0	72	0	1082	0	1010	0.0	0.0
chr9	LCN12	136953847	136953964	94	118	135	1990	41	1872	0.7966101694915254	0.0219017094017094
chr9	LCN12	136953923	136953964	11	42	135	1990	124	1948	0.2619047619047619	0.06365503080082136
chr9	LCN12	136954723	136954826	0	104	135	1990	135	1886	0.0	0.07158006362672323
chr9	PAXX	136992639	136992700	0	62	204	1290	204	1228	0.0	0.16612377850162866
chr9	PAXX	136993342	136993411	0	70	204	1290	204	1220	0.0	0.16721311475409836
chr9	C9ORF139	137037284	137037394	0	111	4552	2900	4552	2789	0.0	1.6321262101111509
chr9	UAP1L1	137078049	137078254	0	206	0	4721	0	4515	0.0	0.0
chr9	MAN1B1	137088267	137088398	0	132	0	7364	0	7232	0.0	0.0
chr9	GRIN1	137165185	137165296	0	112	102	9609	102	9497	0.0	0.010740233758028852
chr9	GRIN1	137148151	137148214	0	64	102	9609	102	9545	0.0	0.010686223153483498
chr9	GRIN1	137164171	137164215	0	45	102	9609	102	9564	0.0	0.01066499372647428
chr9	NDOR1	137213966	137214068	0	103	78	2822	78	2719	0.0	0.028687017285766826
chr9	STPG3	137252000	137252135	0	136	408	1512	408	1376	0.0	0.29651162790697677
chr9	STPG3	137252000	137252055	0	56	408	1512	408	1456	0.0	0.2802197802197802
chr9	ARRDC1	137613422	137613510	0	89	1137	2585	1137	2496	0.0	0.45552884615384615
chr9	ARRDC1	137613459	137613510	0	52	1137	2585	1137	2533	0.0	0.4488748519542045
chr9	ARRDC1	137613412	137613510	0	99	1137	2585	1137	2486	0.0	0.4573612228479485
chr9	EHMT1	137710966	137711030	140	65	49991	18118	49851	18053	2.1538461538461537	2.7613693015011354
chr9	EHMT1	137752330	137752408	0	79	49991	18118	49991	18039	0.0	2.771273352181385
chr9	EHMT1	137775108	137775252	0	145	49991	18118	49991	17973	0.0	2.781449952706838
chr9	EHMT1	137650859	137651037	102	179	49991	18118	49889	17939	0.5698324022346368	2.781035732203579
chr9	EHMT1	137637501	137637624	0	124	49991	18118	49991	17994	0.0	2.7782038457263534
chr9	EHMT1	137802856	137803010	0	155	49991	18118	49991	17963	0.0	2.782998385570339
chr9	EHMT1	137803243	137803352	0	110	49991	18118	49991	18008	0.0	2.776043980453132
chr9	CACNA1B	138069757	138069763	0	7	537	9765	537	9758	0.0	0.05503176880508301
chr9	FAM157B	138251537	138251596	0	60	0	2085	0	2025	0.0	0.0
chr9	FAM157B	138218598	138218710	0	113	0	2085	0	1972	0.0	0.0
chr9	FAM157B	138233738	138233826	0	89	0	2085	0	1996	0.0	0.0
chr9	AL449043.1	102472	102541	0	70	408	2456	408	2386	0.0	0.17099748533109807
chr9	CBWD1	146101	146158	577	58	126699	10402	126122	10344	9.948275862068966	12.19276875483372
chr9	CBWD1	154708	154795	6235	88	126699	10402	120464	10314	70.85227272727273	11.67965871630793
chr9	CBWD1	163977	164037	5558	61	126699	10402	121141	10341	91.11475409836065	11.714631080166328
chr9	CBWD1	161566	161654	890	89	126699	10402	125809	10313	10.0	12.199069136041889
chr9	CBWD1	177722	177820	3607	99	126699	10402	123092	10303	36.43434343434343	11.947199844705425
chr9	CBWD1	151304	151427	5	124	126699	10402	126694	10278	0.04032258064516129	12.326717260167348
chr9	CBWD1	160000	160140	145	141	126699	10402	126554	10261	1.0283687943262412	12.33349576064711
chr9	CBWD1	147900	148040	185	141	126699	10402	126514	10261	1.3120567375886525	12.32959750511646
chr9	CBWD1	150508	150725	306	218	126699	10402	126393	10184	1.4036697247706422	12.410938727415553
chr9	CBWD1	150641	150725	281	85	126699	10402	126418	10317	3.3058823529411763	12.253368227197829
chr9	CBWD1	164402	164448	0	47	126699	10402	126699	10355	0.0	12.235538387252536
chr9	AL161725.1	456914	457047	0	134	51	4028	51	3894	0.0	0.013097072419106317
chr9	AL161725.1	459715	459866	0	152	51	4028	51	3876	0.0	0.013157894736842105
chr9	VLDLR-AS1	2503269	2503403	0	135	57440	6797	57440	6662	0.0	8.622035424797359
chr9	VLDLR-AS1	2525537	2525717	765	181	57440	6797	56675	6616	4.226519337016574	8.566354292623942
chr9	VLDLR-AS1	2536358	2536453	0	96	57440	6797	57440	6701	0.0	8.571854947022832
chr9	VLDLR-AS1	2425396	2425540	0	145	57440	6797	57440	6652	0.0	8.634996993385448
chr9	VLDLR-AS1	2425396	2425536	0	141	57440	6797	57440	6656	0.0	8.629807692307692
chr9	VLDLR-AS1	2530903	2531129	0	227	57440	6797	57440	6570	0.0	8.742770167427702
chr9	RFX3	3301545	3301620	820	76	123295	10714	122475	10638	10.789473684210526	11.51297236322617
chr9	RFX3	3490278	3490345	0	68	123295	10714	123295	10646	0.0	11.581345106143152
chr9	RFX3	3488775	3488895	1275	121	123295	10714	122020	10593	10.537190082644628	11.518927593693949
chr9	GLIS3	4125733	4125941	1467	209	148230	11957	146763	11748	7.019138755980861	12.492594484167517
chr9	GLIS3	4286037	4286523	5972	487	148230	11957	142258	11470	12.262833675564682	12.40261551874455
chr9	SPATA6L	4604178	4604269	0	92	30426	5395	30426	5303	0.0	5.73750707146898
chr9	SPATA6L	4626425	4626555	612	131	30426	5395	29814	5264	4.67175572519084	5.663753799392097
chr9	SPATA6L	4656040	4656089	0	50	30426	5395	30426	5345	0.0	5.692422825070159
chr9	SPATA6L	4596434	4596530	0	97	30426	5395	30426	5298	0.0	5.742921857304643
chr9	SPATA6L	4629090	4629168	0	79	30426	5395	30426	5316	0.0	5.723476297968397
chr9	SPATA6L	4617402	4617523	0	122	30426	5395	30426	5273	0.0	5.770149819836905
chr9	SPATA6L	4627752	4627856	0	105	30426	5395	30426	5290	0.0	5.751606805293005
chr9	SPATA6L	4646486	4646528	900	43	30426	5395	29526	5352	20.930232558139537	5.516816143497758
chr9	AK3	4722505	4722625	53113	121	925335	4402	872222	4281	438.9504132231405	203.74258350852605
chr9	RLN2	5304095	5304196	0	102	0	1032	0	930	0.0	0.0
chr9	ERMP1	5805026	5805217	15724	192	656103	6309	640379	6117	81.89583333333333	104.68840935098905
chr9	ERMP1	5825091	5825219	13800	129	656103	6309	642303	6180	106.97674418604652	103.93252427184466
chr9	ERMP1	5791233	5791282	791	50	656103	6309	655312	6259	15.82	104.69915321936412
chr9	KIAA2026	5988344	5988545	5995	202	78938	6988	72943	6786	29.678217821782177	10.74904214559387
chr9	KIAA2026	5944870	5944960	1674	91	78938	6988	77264	6897	18.395604395604394	11.202551834130782
chr9	KIAA2026	5933750	5933881	0	132	78938	6988	78938	6856	0.0	11.513710618436406
chr9	GLDC	6534066	6534179	0	114	390166	8660	390166	8546	0.0	45.65480926749356
chr9	GLDC	6540050	6540146	7181	97	390166	8660	382985	8563	74.03092783505154	44.72556347074623
chr9	GLDC	6604587	6604784	35357	198	390166	8660	354809	8462	178.57070707070707	41.92968565350981
chr9	GLDC	6620183	6620319	8670	137	390166	8660	381496	8523	63.284671532846716	44.76076498885369
chr9	AL135923.2	7927002	7927056	0	55	0	1193	0	1138	0.0	0.0
chr9	AL135923.2	7960567	7960662	0	96	0	1193	0	1097	0.0	0.0
chr9	PTPRD	8497241	8497268	150	28	92680	8221	92530	8193	5.357142857142857	11.29378737947028
chr9	PTPRD	8500753	8501059	1298	307	92680	8221	91382	7914	4.228013029315961	11.54687894869851
chr9	PTPRD	8523512	8523524	0	13	92680	8221	92680	8208	0.0	11.291423001949317
chr9	PTPRD	8526626	8526644	0	19	92680	8221	92680	8202	0.0	11.299683004145331
chr9	PTPRD	8527344	8527353	0	10	92680	8221	92680	8211	0.0	11.287297527706734
chr9	PTPRD	8454579	8454594	0	16	92680	8221	92680	8205	0.0	11.295551492992079
chr9	PTPRD	8437197	8437239	0	43	92680	8221	92680	8178	0.0	11.332844216189777
chr9	PTPRD	8454579	8454591	0	13	92680	8221	92680	8208	0.0	11.291423001949317
chr9	PTPRD	8438700	8438820	0	121	92680	8221	92680	8100	0.0	11.441975308641975
chr9	PTPRD	9414751	9414823	0	73	92680	8221	92680	8148	0.0	11.374570446735396
chr9	MPDZ	13112023	13112146	3625	124	174452	9138	170827	9014	29.233870967741936	18.95129798091857
chr9	MPDZ	13115247	13115334	2103	88	174452	9138	172349	9050	23.897727272727273	19.044088397790055
chr9	MPDZ	13122086	13122170	328	85	174452	9138	174124	9053	3.8588235294117648	19.233845134209655
chr9	MPDZ	13136711	13136803	1695	93	174452	9138	172757	9045	18.225806451612904	19.099723604201216
chr9	MPDZ	13143465	13143564	0	100	174452	9138	174452	9038	0.0	19.302057977428635
chr9	MPDZ	13147547	13147658	1071	112	174452	9138	173381	9026	9.5625	19.209062707733214
chr9	MPDZ	13165366	13165408	0	43	174452	9138	174452	9095	0.0	19.181088510170422
chr9	NFIB	14102421	14102510	0	90	384508	12775	384508	12685	0.0	30.31202207331494
chr9	NFIB	14093459	14093464	0	6	384508	12775	384508	12769	0.0	30.11261649306915
chr9	TTC39B	15224339	15224505	0	167	67502	12232	67502	12065	0.0	5.594861168669706
chr9	TTC39B	15224359	15224505	0	147	67502	12232	67502	12085	0.0	5.585601985932975
chr9	C9ORF92	16215215	16215279	0	65	1258	634	1258	569	0.0	2.210896309314587
chr9	BNC2	16727796	16727997	4599	202	199305	6298	194706	6096	22.76732673267327	31.93996062992126
chr9	BNC2	16738359	16738485	856	127	199305	6298	198449	6171	6.74015748031496	32.15832117971156
chr9	SAXO1	18941636	18941839	0	204	2244	9095	2244	8891	0.0	0.25239005736137665
chr9	SLC24A2	19597228	19597279	0	52	0	10759	0	10707	0.0	0.0
chr9	MLLT3	20353524	20353596	0	73	1956	7326	1956	7253	0.0	0.26968151109885563
chr9	MLLT3	20354807	20354879	558	73	1956	7326	1398	7253	7.6438356164383565	0.19274782848476493
chr9	MLLT3	20380206	20380327	0	122	1956	7326	1956	7204	0.0	0.27151582454192114
chr9	MIR31HG	21476898	21477035	7395	138	130177	2820	122782	2682	53.58695652173913	45.780014914243104
chr9	CDKN2A	21968574	21968771	7903	198	2467635	3894	2459732	3696	39.91414141414141	665.5119047619048
chr9	CDKN2A	21993881	21994053	5768	173	2467635	3894	2461867	3721	33.34104046242775	661.6143509809191
chr9	ELAVL2	23765008	23765099	204	92	269909	5152	269705	5060	2.217391304347826	53.301383399209485
chr9	ELAVL2	23693447	23693486	0	40	269909	5152	269909	5112	0.0	52.799100156494525
chr9	IZUMO3	24544742	24544760	0	19	0	1301	0	1282	0.0	0.0
chr9	CAAP1	26886103	26886188	20601	86	294218	3168	273617	3082	239.54651162790697	88.77903958468526
chr9	PLAA	26907833	26907998	84614	166	1059043	5213	974429	5047	509.72289156626505	193.07093322766
chr9	PLAA	26917096	26917165	30223	70	1059043	5213	1028820	5143	431.75714285714287	200.0427765895392
chr9	LINC00032	27250045	27250174	0	130	51	3760	51	3630	0.0	0.014049586776859505
chr9	LINC00032	27280427	27280615	0	189	51	3760	51	3571	0.0	0.014281713805656678
chr9	EQTN	27292400	27292487	0	88	0	1420	0	1332	0.0	0.0
chr9	C9ORF72	27554592	27554625	0	34	66856	5415	66856	5381	0.0	12.42445642073964
chr9	C9ORF72	27571135	27571260	663	126	66856	5415	66193	5289	5.261904761904762	12.515220268481755
chr9	DDX58	32492390	32492538	370	149	61829	4658	61459	4509	2.4832214765100673	13.630294965624307
chr9	TOPORS	32550773	32550968	6000	196	226263	4134	220263	3938	30.612244897959183	55.93270695784662
chr9	NDUFB6	32558909	32558954	57101	46	467954	1390	410853	1344	1241.3260869565217	305.69419642857144
chr9	NDUFB6	32570959	32571052	79618	94	467954	1390	388336	1296	847.0	299.641975308642
chr9	APTX	32984630	32984857	79929	228	512100	14598	432171	14370	350.5657894736842	30.074530271398746
chr9	APTX	32985970	32986030	16432	61	512100	14598	495668	14537	269.37704918032784	34.09699387769141
chr9	APTX	32988082	32988124	10934	43	512100	14598	501166	14555	254.27906976744185	34.432566128478186
chr9	APTX	32987543	32987731	39386	189	512100	14598	472714	14409	208.39153439153438	32.80685682559511
chr9	APTX	32997242	32997348	5811	107	512100	14598	506289	14491	54.308411214953274	34.938168518390725
chr9	APTX	32988082	32988129	11413	48	512100	14598	500687	14550	237.77083333333334	34.411477663230244
chr9	APTX	32989758	32989895	35797	138	512100	14598	476303	14460	259.3985507246377	32.939349930843704
chr9	APTX	32987543	32987846	59925	304	512100	14598	452175	14294	197.12171052631578	31.633902336644745
chr9	APTX	32988091	32988124	9163	34	512100	14598	502937	14564	269.5	34.532889316121945
chr9	APTX	32989434	32989480	3169	47	512100	14598	508931	14551	67.42553191489361	34.97567177513573
chr9	BAG1	33262104	33262246	7334	143	652968	7084	645634	6941	51.28671328671329	93.01743264659271
chr9	AQP7	33386076	33386195	0	120	0	3491	0	3371	0.0	0.0
chr9	AQP7	33386968	33387092	0	125	0	3491	0	3366	0.0	0.0
chr9	AQP7	33395077	33395195	0	119	0	3491	0	3372	0.0	0.0
chr9	AQP7	33395077	33395513	0	437	0	3491	0	3054	0.0	0.0
chr9	AQP7	33386403	33386541	0	139	0	3491	0	3352	0.0	0.0
chr9	AQP7	33394126	33394277	0	152	0	3491	0	3339	0.0	0.0
chr9	AQP7	33401535	33401672	0	138	0	3491	0	3353	0.0	0.0
chr9	AQP3	33442300	33442518	0	219	0	2489	0	2270	0.0	0.0
chr9	UBAP2	33932561	33932628	9427	68	1026072	8530	1016645	8462	138.63235294117646	120.14240132356417
chr9	UBAP2	33956078	33956146	6785	69	1026072	8530	1019287	8461	98.33333333333333	120.46885710908876
chr9	UBAP2	33963725	33963791	11617	67	1026072	8530	1014455	8463	173.38805970149255	119.86943164362519
chr9	UBAP2	34017049	34017189	21098	141	1026072	8530	1004974	8389	149.63120567375887	119.7966384551198
chr9	CNTFR	34581094	34581205	0	112	1491	2109	1491	1997	0.0	0.7466199298948423
chr9	DCTN3	34616029	34616113	89482	85	779248	2217	689766	2132	1052.729411764706	323.53001876172607
chr9	SIGMAR1	34636996	34637089	156524	94	1881737	1897	1725213	1803	1665.1489361702127	956.8569051580699
chr9	FANCG	35078140	35078343	64767	204	959169	2822	894402	2618	317.4852941176471	341.6355996944232
chr9	FANCG	35074370	35074494	59534	125	959169	2822	899635	2697	476.272	333.568780126066
chr9	PIGO	35090065	35090280	34893	216	837939	4627	803046	4411	161.54166666666666	182.0553162548175
chr9	PIGO	35095878	35095976	1868	99	837939	4627	836071	4528	18.86868686868687	184.6446554770318
chr9	PIGO	35096154	35096480	2190	327	837939	4627	835749	4300	6.697247706422019	194.36023255813953
chr9	STOML2	35102685	35102823	114804	139	2225602	1815	2110798	1676	825.9280575539568	1259.4260143198092
chr9	STOML2	35101425	35101560	231072	136	2225602	1815	1994530	1679	1699.0588235294117	1187.9273377010124
chr9	CD72	35618507	35618519	0	13	50728	2901	50728	2888	0.0	17.565096952908586
chr9	SIT1	35650501	35650637	0	137	0	1331	0	1194	0.0	0.0
chr9	ARHGEF39	35662945	35663074	19021	130	655104	5665	636083	5535	146.3153846153846	114.92014453477869
chr9	ARHGEF39	35664755	35664850	8138	96	655104	5665	646966	5569	84.77083333333333	116.17274196444605
chr9	ARHGEF39	35662511	35662741	24678	231	655104	5665	630426	5434	106.83116883116882	116.01509017298491
chr9	TLN1	35704668	35704815	152054	148	6958652	9893	6806598	9745	1027.3918918918919	698.4708055413032
chr9	SPAG8	35810246	35810309	955	64	101098	2480	100143	2416	14.921875	41.44991721854305
chr9	SPAG8	35809403	35809512	39750	110	101098	2480	61348	2370	361.3636363636364	25.88523206751055
chr9	SPAG8	35809403	35810309	84268	907	101098	2480	16830	1573	92.90848952590959	10.6993006993007
chr9	FAM221B	35821437	35821628	0	192	0	3950	0	3758	0.0	0.0
chr9	FAM221B	35826791	35826937	0	147	0	3950	0	3803	0.0	0.0
chr9	FAM221B	35826791	35826969	0	179	0	3950	0	3771	0.0	0.0
chr9	GNE	36222776	36222998	65914	223	1031627	5867	965713	5644	295.57847533632287	171.10435861091423
chr9	GNE	36236831	36236984	33827	154	1031627	5867	997800	5713	219.65584415584416	174.6542972168738
chr9	GNE	36249191	36249397	32612	207	1031627	5867	999015	5660	157.54589371980677	176.50441696113074
chr9	RNF38	36390466	36390616	2204	151	324988	5993	322784	5842	14.596026490066226	55.25231085244779
chr9	RNF38	36372495	36372593	0	99	324988	5993	324988	5894	0.0	55.138785205293516
chr9	PAX5	36846842	36846929	50	88	38189	9583	38139	9495	0.5681818181818182	4.016745655608215
chr9	PAX5	36882003	36882105	0	103	38189	9583	38189	9480	0.0	4.02837552742616
chr9	PAX5	36923354	36923484	765	131	38189	9583	37424	9452	5.8396946564885495	3.9593736775285655
chr9	PAX5	37002647	37002776	54	130	38189	9583	38135	9453	0.4153846153846154	4.03416904686343
chr9	PAX5	37014996	37015194	1785	199	38189	9583	36404	9384	8.969849246231156	3.8793691389599316
chr9	PAX5	37020635	37020801	1786	167	38189	9583	36403	9416	10.694610778443113	3.8660790144435
chr9	PAX5	36966548	36966724	911	177	38189	9583	37278	9406	5.146892655367232	3.963214969168616
chr9	PAX5	37006472	37006537	0	66	38189	9583	38189	9517	0.0	4.012714090574761
chr9	PAX5	36930887	36930944	0	58	38189	9583	38189	9525	0.0	4.009343832020997
chr9	FBXO10	37525101	37525172	10860	72	672424	6042	661564	5970	150.83333333333334	110.8147403685092
chr9	FBXO10	37575521	37575661	2249	141	672424	6042	670175	5901	15.950354609929079	113.56973394339943
chr9	AL138752.2	38015373	38015480	0	108	1549558	2603	1549558	2495	0.0	621.0653306613226
chr9	EXOSC3	37781985	37782137	78389	153	636576	6782	558187	6629	512.3464052287582	84.20380147835269
chr9	FAM95C	38541455	38541562	6853	108	137254	3767	130401	3659	63.4537037037037	35.638425799398746
chr9	FAM95C	38573083	38573129	195	47	137254	3767	137059	3720	4.148936170212766	36.843817204301075
chr9	FAM95C	38541288	38541562	11133	275	137254	3767	126121	3492	40.483636363636364	36.11712485681558
chr9	CNTNAP3	39078689	39078920	3201	232	319969	8468	316768	8236	13.797413793103448	38.46138902379796
chr9	CNTNAP3	39099910	39100150	11326	241	319969	8468	308643	8227	46.995850622406635	37.51586240427859
chr9	CNTNAP3	39109159	39109287	14033	129	319969	8468	305936	8339	108.78294573643412	36.68737258664108
chr9	CNTNAP3	39118102	39118259	9312	158	319969	8468	310657	8310	58.936708860759495	37.3835138387485
chr9	GLIDR	39809485	39809615	0	131	357	6332	357	6201	0.0	0.05757135945815191
chr9	GLIDR	39778893	39778944	0	52	357	6332	357	6280	0.0	0.056847133757961785
chr9	BX255923.2	41102462	41102531	0	70	408	4157	408	4087	0.0	0.09982872522632738
chr9	CBWD6	41156382	41156439	0	58	0	9106	0	9048	0.0	0.0
chr9	CBWD6	41165000	41165087	0	88	0	9106	0	9018	0.0	0.0
chr9	CBWD6	41174292	41174352	0	61	0	9106	0	9045	0.0	0.0
chr9	CBWD6	41188009	41188107	0	99	0	9106	0	9007	0.0	0.0
chr9	CBWD6	41171846	41171934	0	89	0	9106	0	9017	0.0	0.0
chr9	CBWD6	41161600	41161723	0	124	0	9106	0	8982	0.0	0.0
chr9	CBWD6	41170283	41170423	0	141	0	9106	0	8965	0.0	0.0
chr9	CBWD6	41160804	41161021	0	218	0	9106	0	8888	0.0	0.0
chr9	CBWD6	41160937	41161021	0	85	0	9106	0	9021	0.0	0.0
chr9	CBWD6	41170278	41170423	0	146	0	9106	0	8960	0.0	0.0
chr9	CNTNAP3B	41898768	41898999	0	232	7500	11751	7500	11519	0.0	0.6510981856063894
chr9	CNTNAP3B	41938243	41938400	0	158	7500	11751	7500	11593	0.0	0.6469421202449754
chr9	CNTNAP3B	41920069	41920309	0	241	7500	11751	7500	11510	0.0	0.6516072980017377
chr9	CNTNAP3B	41926655	41926778	0	124	7500	11751	7500	11627	0.0	0.6450503139244861
chr9	AL590399.3	62350469	62350559	0	91	0	790	0	699	0.0	0.0
chr9	LERFS	62859071	62859193	0	123	0	5599	0	5476	0.0	0.0
chr9	LERFS	62866966	62867110	0	145	0	5599	0	5454	0.0	0.0
chr9	LERFS	62867696	62867876	0	181	0	5599	0	5418	0.0	0.0
chr9	LERFS	62867696	62868233	0	538	0	5599	0	5061	0.0	0.0
chr9	LERFS	62873366	62873691	0	326	0	5599	0	5273	0.0	0.0
chr9	LERFS	62877148	62877428	0	281	0	5599	0	5318	0.0	0.0
chr9	LERFS	62880522	62880630	0	109	0	5599	0	5490	0.0	0.0
chr9	AL591379.1	63116963	63117071	0	109	0	5055	0	4946	0.0	0.0
chr9	AL591379.1	63125168	63125267	0	100	0	5055	0	4955	0.0	0.0
chr9	BMS1P10	63374871	63374969	0	99	0	1608	0	1509	0.0	0.0
chr9	AL669942.1	66049861	66049989	0	129	561	4138	561	4009	0.0	0.13993514592167622
chr9	AL669942.1	66051212	66051416	0	205	561	4138	561	3933	0.0	0.14263920671243327
chr9	AL669942.1	66049861	66050023	0	163	561	4138	561	3975	0.0	0.14113207547169812
chr9	AL669942.1	66050189	66050259	0	71	561	4138	561	4067	0.0	0.13793951315465947
chr9	ANKRD20A3P	66149224	66149339	0	116	0	9250	0	9134	0.0	0.0
chr9	ANKRD20A3P	66158324	66158440	0	117	0	9250	0	9133	0.0	0.0
chr9	ANKRD20A3P	66151583	66151809	0	227	0	9250	0	9023	0.0	0.0
chr9	PGM5-AS1	68356289	68356361	0	73	0	2358	0	2285	0.0	0.0
chr9	PGM5-AS1	68356289	68356346	0	58	0	2358	0	2300	0.0	0.0
chr9	AL161457.2	68398047	68398166	561	120	6432	4013	5871	3893	4.675	1.508091446185461
chr9	AL161457.2	68398442	68398689	1054	248	6432	4013	5378	3765	4.25	1.4284196547144754
chr9	AL161457.2	68405723	68406008	51	286	6432	4013	6381	3727	0.17832167832167833	1.7121008854306412
chr9	BANCR	69306147	69306290	0	144	0	853	0	709	0.0	0.0
chr9	APBA1	69458155	69458188	0	34	0	11461	0	11427	0.0	0.0
chr9	MAMDC2-AS1	70082804	70082900	0	97	5519	9867	5519	9770	0.0	0.56489252814739
chr9	MAMDC2-AS1	70081973	70082074	0	102	5519	9867	5519	9765	0.0	0.5651817716333846
chr9	MAMDC2-AS1	70079245	70079359	451	115	5519	9867	5068	9752	3.9217391304347826	0.5196882690730107
chr9	MAMDC2-AS1	70082621	70082662	0	42	5519	9867	5519	9825	0.0	0.5617302798982188
chr9	MAMDC2-AS1	70157511	70157742	0	232	5519	9867	5519	9635	0.0	0.5728074727555786
chr9	MAMDC2-AS1	70172559	70172865	0	307	5519	9867	5519	9560	0.0	0.5773012552301255
chr9	SMC5-AS1	70218314	70218485	405	172	507	2197	102	2025	2.354651162790698	0.05037037037037037
chr9	TRPM3	70621243	70621273	0	31	5456	14073	5456	14042	0.0	0.388548639794901
chr9	TRPM3	70625481	70625517	0	37	5456	14073	5456	14036	0.0	0.3887147335423197
chr9	TRPM3	70811169	70811244	0	76	5456	14073	5456	13997	0.0	0.38979781381724654
chr9	CEMIP2	71734805	71734994	660	190	7737	9281	7077	9091	3.473684210526316	0.7784622153778462
chr9	C9ORF57	72059512	72059656	0	145	102	1764	102	1619	0.0	0.06300185299567634
chr9	C9ORF57	72059234	72059384	0	151	102	1764	102	1613	0.0	0.06323620582765034
chr9	ZFAND5	72363469	72363606	0	138	969	6883	969	6745	0.0	0.14366197183098592
chr9	NMRK1	75069741	75069813	0	73	204	3129	204	3056	0.0	0.06675392670157068
chr9	NMRK1	75078325	75078582	0	258	204	3129	204	2871	0.0	0.07105538140020899
chr9	RFK	76392417	76392569	0	153	0	3275	0	3122	0.0	0.0
chr9	RFK	76388182	76388286	0	105	0	3275	0	3170	0.0	0.0
chr9	PRUNE2	76641971	76641980	0	10	1255	13950	1255	13940	0.0	0.0900286944045911
chr9	AL512634.1	79138787	79139042	0	256	102	2916	102	2660	0.0	0.038345864661654135
chr9	LNCARSR	79529003	79529171	0	169	1428	4277	1428	4108	0.0	0.3476144109055501
chr9	LNCARSR	79534083	79534183	0	101	1428	4277	1428	4176	0.0	0.34195402298850575
chr9	LNCARSR	79527609	79527864	0	256	1428	4277	1428	4021	0.0	0.3551355384232778
chr9	TLE1	81673881	81673991	0	111	0	5206	0	5095	0.0	0.0
chr9	UBQLN1	83666349	83666433	0	85	0	4127	0	4042	0.0	0.0
chr9	UBQLN1	83666349	83666394	0	46	0	4127	0	4081	0.0	0.0
chr9	GKAP1	83768817	83768970	0	154	102	3420	102	3266	0.0	0.031230863441518677
chr9	GKAP1	83792950	83793017	0	68	102	3420	102	3352	0.0	0.030429594272076373
chr9	KIF27	83880296	83880494	0	199	357	7758	357	7559	0.0	0.04722846937425585
chr9	KIF27	83903059	83904018	51	960	357	7758	306	6798	0.053125	0.04501323918799647
chr9	HNRNPK	83973901	83973973	0	73	0	4998	0	4925	0.0	0.0
chr9	HNRNPK	83975461	83975505	0	45	0	4998	0	4953	0.0	0.0
chr9	AL583827.1	85401684	85401963	0	280	140	4823	140	4543	0.0	0.030816640986132512
chr9	AGTPBP1	85660935	85660973	0	39	2949	4966	2949	4927	0.0	0.5985386645017252
chr9	AGTPBP1	85678334	85678398	0	65	2949	4966	2949	4901	0.0	0.6017139359314425
chr9	AGTPBP1	85712501	85712566	0	66	2949	4966	2949	4900	0.0	0.6018367346938776
chr9	AL353743.2	85786437	85786551	0	115	255	7271	255	7156	0.0	0.03563443264393516
chr9	AL353743.2	85787883	85788038	0	156	255	7271	255	7115	0.0	0.035839775122979624
chr9	AL353743.2	85792180	85792252	0	73	255	7271	255	7198	0.0	0.03542650736315643
chr9	AL353743.2	85787825	85788038	0	214	255	7271	255	7057	0.0	0.03613433470313164
chr9	AL353743.2	85803437	85803609	0	173	255	7271	255	7098	0.0	0.035925612848689774
chr9	AL353743.2	85792180	85792250	0	71	255	7271	255	7200	0.0	0.035416666666666666
chr9	GOLM1	86052536	86052591	0	56	0	4247	0	4191	0.0	0.0
chr9	GOLM1	86084919	86085039	0	121	0	4247	0	4126	0.0	0.0
chr9	C9ORF153	86227854	86228030	0	177	2196	2935	2196	2758	0.0	0.7962291515591008
chr9	C9ORF153	86227543	86228030	0	488	2196	2935	2196	2447	0.0	0.8974254188802615
chr9	TUT7	86309462	86309576	0	115	47639	6736	47639	6621	0.0	7.195136686301163
chr9	TUT7	86326370	86326491	0	122	47639	6736	47639	6614	0.0	7.202751738736015
chr9	CDK20	87970567	87970630	0	64	102	2638	102	2574	0.0	0.039627039627039624
chr9	CDK20	87969795	87969919	0	125	102	2638	102	2513	0.0	0.04058893752487067
chr9	LINC02843	88640510	88640581	484	72	6570	1616	6086	1544	6.722222222222222	3.9417098445595853
chr9	LINC02843	88644362	88644506	972	145	6570	1616	5598	1471	6.703448275862069	3.805574439157036
chr9	SEMA4D	89418362	89418437	0	76	51	13525	51	13449	0.0	0.0037921035021191165
chr9	SEMA4D	89418055	89418118	0	64	51	13525	51	13461	0.0	0.003788722977490528
chr9	SEMA4D	89455887	89455953	0	67	51	13525	51	13458	0.0	0.003789567543468569
chr9	LINC01508	90380068	90380201	0	134	6954	2013	6954	1879	0.0	3.700904736562001
chr9	LINC01508	90385015	90385583	0	569	6954	2013	6954	1444	0.0	4.815789473684211
chr9	LINC01501	90469533	90469741	0	209	14093	4017	14093	3808	0.0	3.700892857142857
chr9	LINC01501	90505722	90505780	0	59	14093	4017	14093	3958	0.0	3.5606366851945426
chr9	LINC01501	90567163	90567217	0	55	14093	4017	14093	3962	0.0	3.5570418980312972
chr9	LINC01501	90507257	90507340	0	84	14093	4017	14093	3933	0.0	3.5832697686244597
chr9	DIRAS2	90626057	90626175	0	119	272	4446	272	4327	0.0	0.06286110469147216
chr9	DIRAS2	90625875	90626175	17	301	272	4446	255	4145	0.05647840531561462	0.061519903498190594
chr9	AUH	91216058	91216106	0	49	0	2275	0	2226	0.0	0.0
chr9	AUH	91325317	91325404	0	88	0	2275	0	2187	0.0	0.0
chr9	SPTLC1	92050295	92050491	0	197	100	5615	100	5418	0.0	0.01845699520118125
chr9	SPTLC1	92076797	92077035	0	239	100	5615	100	5376	0.0	0.018601190476190476
chr9	SPTLC1	92046274	92046334	0	61	100	5615	100	5554	0.0	0.018005041411595247
chr9	SPTLC1	92070123	92070296	0	174	100	5615	100	5441	0.0	0.01837897445322551
chr9	SPTLC1	92079433	92079566	0	134	100	5615	100	5481	0.0	0.01824484583105273
chr9	IARS1	92288125	92288282	0	158	51	7080	51	6922	0.0	0.00736781277087547
chr9	IARS1	92240642	92240691	0	50	51	7080	51	7030	0.0	0.007254623044096728
chr9	NOL8	92311145	92311259	0	115	0	7731	0	7616	0.0	0.0
chr9	NOL8	92324022	92324209	0	188	0	7731	0	7543	0.0	0.0
chr9	NOL8	92323235	92323351	0	117	0	7731	0	7614	0.0	0.0
chr9	NOL8	92319942	92320379	0	438	0	7731	0	7293	0.0	0.0
chr9	NOL8	92324022	92324251	0	230	0	7731	0	7501	0.0	0.0
chr9	NOL8	92319942	92320137	0	196	0	7731	0	7535	0.0	0.0
chr9	NOL8	92324022	92324080	0	59	0	7731	0	7672	0.0	0.0
chr9	ZNF484	92875014	92875059	0	46	0	4816	0	4770	0.0	0.0
chr9	ZNF484	92862139	92862165	0	27	0	4816	0	4789	0.0	0.0
chr9	FAM120AOS	93448368	93448489	0	122	102	9563	102	9441	0.0	0.010803940260565617
chr9	LINC02603	94223128	94223308	0	181	3439	2651	3439	2470	0.0	1.3923076923076922
chr9	LINC02603	94200813	94200872	0	60	3439	2651	3439	2591	0.0	1.3272867618680046
chr9	FBP1	94617767	94617860	0	94	0	1759	0	1665	0.0	0.0
chr9	FBP1	94639140	94639334	0	195	0	1759	0	1564	0.0	0.0
chr9	FANCC	95186500	95186645	0	146	13019	11365	13019	11219	0.0	1.1604421071396738
chr9	FANCC	95186500	95186595	0	96	13019	11365	13019	11269	0.0	1.155293282456296
chr9	FANCC	95310241	95310355	0	115	13019	11365	13019	11250	0.0	1.1572444444444445
chr9	FANCC	95220921	95221065	0	145	13019	11365	13019	11220	0.0	1.1603386809269163
chr9	FANCC	95265595	95265754	0	160	13019	11365	13019	11205	0.0	1.161892012494422
chr9	PTCH1	95477546	95477702	14722	157	103303	17222	88581	17065	93.77070063694268	5.190799882801055
chr9	PTCH1	95506406	95506599	306	194	103303	17222	102997	17028	1.577319587628866	6.048684519614752
chr9	PTCH1	95474011	95474143	24118	133	103303	17222	79185	17089	181.33834586466165	4.633682485809585
chr9	PTCH1	95485684	95485874	0	191	103303	17222	103303	17031	0.0	6.065586283835359
chr9	LINC00476	95851823	95852029	0	207	105348	6299	105348	6092	0.0	17.29284307288247
chr9	LINC00476	95874508	95874548	7184	41	105348	6299	98164	6258	175.21951219512195	15.686161713007351
chr9	LINC00476	95874508	95874622	12419	115	105348	6299	92929	6184	107.99130434782609	15.027328589909443
chr9	AL449403.2	96115640	96115760	0	121	78	3722	78	3601	0.0	0.021660649819494584
chr9	HSD17B3	96240757	96240907	20	151	262	2354	242	2203	0.13245033112582782	0.10985020426690877
chr9	HSD17B3	96246555	96246590	0	36	262	2354	262	2318	0.0	0.11302847282139776
chr9	HSD17B3	96252802	96252910	0	109	262	2354	262	2245	0.0	0.11670378619153675
chr9	HSD17B3	96254867	96254943	0	77	262	2354	262	2277	0.0	0.11506368028107158
chr9	SLC35D2	96321997	96322080	3295	84	27873	3843	24578	3759	39.226190476190474	6.538441074753924
chr9	HSD17B3	96239822	96239960	0	139	262	2354	262	2215	0.0	0.1182844243792325
chr9	SLC35D2	96363217	96363387	0	171	27873	3843	27873	3672	0.0	7.590686274509804
chr9	CDC14B	96509672	96509789	0	118	51	10496	51	10378	0.0	0.004914241665060705
chr9	CDC14B	96515648	96515792	0	145	51	10496	51	10351	0.0	0.004927060187421505
chr9	PRXL2C	96645892	96646024	0	133	0	2942	0	2809	0.0	0.0
chr9	ZNF782	96844889	96845016	0	128	12646	4860	12646	4732	0.0	2.6724429416737108
chr9	ZNF782	96852852	96853069	0	218	12646	4860	12646	4642	0.0	2.7242567858681603
chr9	MFSD14C	96972852	96972948	0	97	8929	11896	8929	11799	0.0	0.7567590473768964
chr9	MFSD14C	96902916	96903108	0	193	8929	11896	8929	11703	0.0	0.76296676065966
chr9	ANKRD18CP	97204860	97205034	55	175	3019	2996	2964	2821	0.3142857142857143	1.0506912442396312
chr9	XPA	97682199	97682430	0	232	4232	1824	4232	1592	0.0	2.658291457286432
chr9	XPA	97689533	97689639	2295	107	4232	1824	1937	1717	21.44859813084112	1.128130460104834
chr9	PTCSC2	97805487	97805629	0	143	1348	2293	1348	2150	0.0	0.6269767441860465
chr9	PTCSC2	97805839	97806024	0	186	1348	2293	1348	2107	0.0	0.6397721879449454
chr9	PTCSC2	97804250	97804390	51	141	1348	2293	1297	2152	0.3617021276595745	0.6026951672862454
chr9	PTCSC2	97724412	97724530	0	119	1348	2293	1348	2174	0.0	0.6200551977920883
chr9	PTCSC2	97805361	97805629	0	269	1348	2293	1348	2024	0.0	0.66600790513834
chr9	TRMO	97916163	97916338	0	176	15565	4155	15565	3979	0.0	3.911786881125911
chr9	TRMO	97910917	97912975	13882	2059	15565	4155	1683	2096	6.742107819329772	0.8029580152671756
chr9	TRMO	97913978	97914026	0	49	15565	4155	15565	4106	0.0	3.7907939600584513
chr9	TRMO	97912872	97912975	0	104	15565	4155	15565	4051	0.0	3.8422611700814615
chr9	TBC1D2	98251784	98251926	0	143	4122	3592	4122	3449	0.0	1.1951290229051899
chr9	GABBR2	98311094	98311205	0	112	1173	7372	1173	7260	0.0	0.1615702479338843
chr9	AL136084.1	98848927	98849141	0	215	0	4560	0	4345	0.0	0.0
chr9	AL136084.1	98869964	98870064	0	101	0	4560	0	4459	0.0	0.0
chr9	AL136084.1	98870802	98870984	0	183	0	4560	0	4377	0.0	0.0
chr9	AL136084.1	98870890	98870984	0	95	0	4560	0	4465	0.0	0.0
chr9	AL136084.1	98870432	98870771	0	340	0	4560	0	4220	0.0	0.0
chr9	AL136084.1	98869586	98869683	0	98	0	4560	0	4462	0.0	0.0
chr9	AL136084.1	98871359	98871396	0	38	0	4560	0	4522	0.0	0.0
chr9	AL136084.1	98869980	98870064	0	85	0	4560	0	4475	0.0	0.0
chr9	ALG2	99220978	99221137	382	160	6294	2973	5912	2813	2.3875	2.1016708140774973
chr9	NAMA	99369731	99369868	0	138	1825	5398	1825	5260	0.0	0.34695817490494296
chr9	NAMA	99372920	99373114	408	195	1825	5398	1417	5203	2.0923076923076924	0.2723428791082068
chr9	AL359710.1	99454537	99454643	62	107	108	3770	46	3663	0.5794392523364486	0.012558012558012558
chr9	AL359710.1	99805870	99805991	0	122	108	3770	108	3648	0.0	0.029605263157894735
chr9	ALDOB	101435708	101435762	0	55	0	2838	0	2783	0.0	0.0
chr9	PGAP4	101480670	101480725	0	56	15182	5556	15182	5500	0.0	2.7603636363636364
chr9	ABCA1	104903613	104903771	0	159	0	11395	0	11236	0.0	0.0
chr9	LINC01509	107430714	107430901	0	188	0	1125	0	937	0.0	0.0
chr9	LINC01509	107427280	107427335	0	56	0	1125	0	1069	0.0	0.0
chr9	ELP1	108874894	108874970	0	77	379	16260	379	16183	0.0	0.023419637891614657
chr9	ELP1	108879445	108879557	0	113	379	16260	379	16147	0.0	0.023471852356474886
chr9	ELP1	108918810	108918901	0	92	379	16260	379	16168	0.0	0.023441365660564078
chr9	ELP1	108930996	108931201	0	206	379	16260	379	16054	0.0	0.023607823595365642
chr9	ELP1	108875632	108875735	0	104	379	16260	379	16156	0.0	0.023458776924981432
chr9	ELP1	108930996	108931056	0	61	379	16260	379	16199	0.0	0.02339650595715785
chr9	ELP1	108898135	108898234	0	100	379	16260	379	16160	0.0	0.023452970297029703
chr9	ELP1	108930996	108931199	0	204	379	16260	379	16056	0.0	0.023604882909815644
chr9	ELP1	108919252	108919349	0	98	379	16260	379	16162	0.0	0.023450068060883553
chr9	ELP1	108884795	108884912	0	118	379	16260	379	16142	0.0	0.023479122785280634
chr9	ELP1	108870453	108870553	0	101	379	16260	379	16159	0.0	0.02345442168451018
chr9	ELP1	108874894	108874963	0	70	379	16260	379	16190	0.0	0.023409512044471895
chr9	ELP1	108877612	108877800	0	189	379	16260	379	16071	0.0	0.02358285109825151
chr9	ELP1	108920690	108920783	0	94	379	16260	379	16166	0.0	0.023444265742917234
chr9	TMEM245	109085996	109086020	0	25	51	9521	51	9496	0.0	0.005370682392586352
chr9	FRRS1L	109149635	109149720	0	86	51	14539	51	14453	0.0	0.0035286791669549575
chr9	FRRS1L	109148442	109148567	0	126	51	14539	51	14413	0.0	0.00353847221258586
chr9	FRRS1L	109150701	109150860	0	160	51	14539	51	14379	0.0	0.0035468391404131026
chr9	PTPN3	109422717	109422852	0	136	0	7175	0	7039	0.0	0.0
chr9	TXN	110250819	110250879	542	61	1077	1015	535	954	8.885245901639344	0.560796645702306
chr9	TXNDC8	110329231	110329291	0	61	0	2145	0	2084	0.0	0.0
chr9	LPAR1	110973480	110973558	0	79	0	4168	0	4089	0.0	0.0
chr9	LPAR1	110945373	110945401	0	29	0	4168	0	4139	0.0	0.0
chr9	ECPAS	111472896	111473000	0	105	139	7307	139	7202	0.0	0.019300194390447098
chr9	PTGR1	111592925	111592982	0	58	0	3783	0	3725	0.0	0.0
chr9	PTGR1	111594221	111594267	0	47	0	3783	0	3736	0.0	0.0
chr9	PTGR1	111564156	111564262	0	107	0	3783	0	3676	0.0	0.0
chr9	PTGR1	111589263	111589382	0	120	0	3783	0	3663	0.0	0.0
chr9	SHOC1	111718183	111718288	413	106	150911	6306	150498	6200	3.8962264150943398	24.273870967741935
chr9	SUSD1	112052398	112052438	0	41	1776	4096	1776	4055	0.0	0.4379778051787916
chr9	SUSD1	112042100	112042165	707	66	1776	4096	1069	4030	10.712121212121213	0.2652605459057072
chr9	SUSD1	112052154	112052349	0	196	1776	4096	1776	3900	0.0	0.4553846153846154
chr9	PTBP3	112275843	112276013	0	171	12773	8252	12773	8081	0.0	1.5806212102462567
chr9	PTBP3	112330440	112330474	0	35	12773	8252	12773	8217	0.0	1.5544602653036388
chr9	PTBP3	112297831	112297916	0	86	12773	8252	12773	8166	0.0	1.5641685035513102
chr9	C9ORF147	112484929	112485163	0	235	0	2401	0	2166	0.0	0.0
chr9	INIP	112689526	112689617	0	92	3344	4342	3344	4250	0.0	0.7868235294117647
chr9	INIP	112716460	112716541	0	82	3344	4342	3344	4260	0.0	0.7849765258215963
chr9	FAM225B	113104914	113104985	0	72	51	5941	51	5869	0.0	0.008689725677287442
chr9	FAM225B	113104914	113104982	0	69	51	5941	51	5872	0.0	0.008685286103542234
chr9	WDR31	113330983	113331113	0	131	102	4343	102	4212	0.0	0.024216524216524215
chr9	WDR31	113336287	113336440	0	154	102	4343	102	4189	0.0	0.024349486751014563
chr9	WDR31	113330983	113331116	0	134	102	4343	102	4209	0.0	0.024233784746970778
chr9	ALAD	113398077	113398124	0	48	51	4673	51	4625	0.0	0.011027027027027026
chr9	KIF12	114092154	114092174	0	21	51	2858	51	2837	0.0	0.017976735988720478
chr9	KIF12	114094180	114094271	0	92	51	2858	51	2766	0.0	0.01843817787418655
chr9	KIF12	114096050	114096207	0	158	51	2858	51	2700	0.0	0.01888888888888889
chr9	KIF12	114097300	114097436	0	137	51	2858	51	2721	0.0	0.018743109151047408
chr9	KIF12	114098301	114098429	0	129	51	2858	51	2729	0.0	0.01868816416269696
chr9	KIF12	114098301	114098414	0	114	51	2858	51	2744	0.0	0.01858600583090379
chr9	AKNA	114368199	114368246	0	48	184595	10625	184595	10577	0.0	17.452491254609058
chr9	WHRN	114423313	114423523	182	211	7805	5296	7623	5085	0.8625592417061612	1.4991150442477876
chr9	TNC	115048259	115048532	0	274	31097	9672	31097	9398	0.0	3.308895509682911
chr9	TNC	115062916	115063189	0	274	31097	9672	31097	9398	0.0	3.308895509682911
chr9	TNC	115052739	115053015	0	277	31097	9672	31097	9395	0.0	3.3099521021820117
chr9	TNC	115057152	115057425	0	274	31097	9672	31097	9398	0.0	3.308895509682911
chr9	TNC	115059729	115060002	0	274	31097	9672	31097	9398	0.0	3.308895509682911
chr9	TNC	115115002	115115106	0	105	31097	9672	31097	9567	0.0	3.250444235392495
chr9	AL691420.1	115742952	115743070	14	119	3702	2999	3688	2880	0.11764705882352941	1.2805555555555554
chr9	AL691420.1	115741127	115741291	0	165	3702	2999	3702	2834	0.0	1.3062808750882144
chr9	ASTN2	117141325	117141478	0	154	49233	8314	49233	8160	0.0	6.033455882352941
chr9	CDK5RAP2	120407011	120407248	0	238	0	9012	0	8774	0.0	0.0
chr9	CDK5RAP2	120443619	120443742	0	124	0	9012	0	8888	0.0	0.0
chr9	CDK5RAP2	120529977	120530140	0	164	0	9012	0	8848	0.0	0.0
chr9	CDK5RAP2	120453455	120453873	0	419	0	9012	0	8593	0.0	0.0
chr9	CDK5RAP2	120460571	120460667	0	97	0	9012	0	8915	0.0	0.0
chr9	CDK5RAP2	120460571	120460747	0	177	0	9012	0	8835	0.0	0.0
chr9	CDK5RAP2	120517756	120517886	0	131	0	9012	0	8881	0.0	0.0
chr9	PSMD5	120829098	120829208	0	111	0	3876	0	3765	0.0	0.0
chr9	PSMD5	120831330	120831459	0	130	0	3876	0	3746	0.0	0.0
chr9	PSMD5	120833311	120833456	0	146	0	3876	0	3730	0.0	0.0
chr9	PHF19	120861917	120862005	0	89	0	6613	0	6524	0.0	0.0
chr9	GGTA1	121479065	121479334	0	270	0	4510	0	4240	0.0	0.0
chr9	TTLL11	122031722	122031856	0	135	0	2780	0	2645	0.0	0.0
chr9	LHX6	122209613	122209717	0	105	0	5315	0	5210	0.0	0.0
chr9	LHX6	122227799	122227859	0	61	0	5315	0	5254	0.0	0.0
chr9	STRBP	123115763	123115883	0	121	8940	7338	8940	7217	0.0	1.2387418594984065
chr9	STRBP	123236829	123236966	1115	138	8940	7338	7825	7200	8.079710144927537	1.0868055555555556
chr9	STRBP	123180867	123180975	30	109	8940	7338	8910	7229	0.27522935779816515	1.2325356204177618
chr9	STRBP	123168188	123168258	36	71	8940	7338	8904	7267	0.5070422535211268	1.2252648961056831
chr9	DENND1A	123450692	123450749	0	58	28571	10288	28571	10230	0.0	2.7928641251221897
chr9	DENND1A	123769513	123769563	0	51	28571	10288	28571	10237	0.0	2.7909543811663573
chr9	DENND1A	123676719	123676789	0	71	28571	10288	28571	10217	0.0	2.7964177351473034
chr9	PSMB7	124405316	124405432	0	117	0	1801	0	1684	0.0	0.0
chr9	NR5A1	124493029	124493149	59	121	2549	3421	2490	3300	0.48760330578512395	0.7545454545454545
chr9	RPL35	124858457	124858537	0	81	0	1186	0	1105	0.0	0.0
chr9	RPL35	124858275	124858537	0	263	0	1186	0	923	0.0	0.0
chr9	SCAI	125065989	125066058	0	70	48533	13057	48533	12987	0.0	3.737044737044737
chr9	SCAI	124975246	124975389	0	144	48533	13057	48533	12913	0.0	3.7584604661968557
chr9	SCAI	124974174	124974276	0	103	48533	13057	48533	12954	0.0	3.746564767639339
chr9	PPP6C	125160840	125160906	0	67	67	4370	67	4303	0.0	0.015570532186846387
chr9	PPP6C	125171908	125172001	0	94	67	4370	67	4276	0.0	0.0156688493919551
chr9	MAPKAP1	125672315	125672643	1363	329	1878	6398	515	6069	4.142857142857143	0.084857472400725
chr9	MAPKAP1	125467971	125468109	0	139	1878	6398	1878	6259	0.0	0.3000479309793897
chr9	MAPKAP1	125484442	125484583	0	142	1878	6398	1878	6256	0.0	0.3001918158567775
chr9	MAPKAP1	125506309	125506417	0	109	1878	6398	1878	6289	0.0	0.29861663221497853
chr9	MAPKAP1	125669817	125669907	0	91	1878	6398	1878	6307	0.0	0.29776438877437766
chr9	MAPKAP1	125447324	125447487	0	164	1878	6398	1878	6234	0.0	0.3012512030798845
chr9	MAPKAP1	125599834	125599927	0	94	1878	6398	1878	6304	0.0	0.2979060913705584
chr9	MAPKAP1	125652116	125652257	51	142	1878	6398	1827	6256	0.3591549295774648	0.292039641943734
chr9	MAPKAP1	125672399	125672643	1339	245	1878	6398	539	6153	5.46530612244898	0.0875995449374289
chr9	MAPKAP1	125696216	125696404	56	189	1878	6398	1822	6209	0.2962962962962963	0.29344499919471734
chr9	ANGPTL2	127107914	127108780	5202	867	31333	3631	26131	2764	6.0	9.454052098408104
chr9	RPL12	127449609	127449708	0	100	168	961	168	861	0.0	0.1951219512195122
chr9	PTRH1	127714378	127714424	1519	47	21421	3493	19902	3446	32.319148936170215	5.77539175856065
chr9	PTRH1	127714602	127714702	3153	101	21421	3493	18268	3392	31.217821782178216	5.38561320754717
chr9	TOR2A	127734298	127734564	0	267	816	2500	816	2233	0.0	0.36542767577250335
chr9	TOR2A	127732563	127732691	51	129	816	2500	765	2371	0.3953488372093023	0.322648671446647
chr9	SH2D3C	127761610	127761650	0	41	1211	4525	1211	4484	0.0	0.27007136485280997
chr9	SH2D3C	127766900	127767271	136	372	1211	4525	1075	4153	0.3655913978494624	0.2588490248013484
chr9	AK1	127872689	127872853	0	165	2352	2602	2352	2437	0.0	0.9651210504718917
chr9	AL157935.2	127879513	127879624	0	112	5095	3832	5095	3720	0.0	1.3696236559139785
chr9	ST6GALNAC6	127890636	127891043	0	408	18767	5316	18767	4908	0.0	3.823757131214344
chr9	AL157935.2	127878386	127878479	240	94	5095	3832	4855	3738	2.5531914893617023	1.2988228999464955
chr9	ST6GALNAC6	127890655	127891043	0	389	18767	5316	18767	4927	0.0	3.809011568906028
chr9	ST6GALNAC6	127897955	127898010	0	56	18767	5316	18767	5260	0.0	3.5678707224334603
chr9	AL157935.2	127878386	127878423	0	38	5095	3832	5095	3794	0.0	1.3429098576700054
chr9	ST6GALNAC4	127909950	127910058	5246	109	110290	2639	105044	2530	48.12844036697248	41.51936758893281
chr9	ST6GALNAC4	127912267	127912680	1071	414	110290	2639	109219	2225	2.5869565217391304	49.08719101123595
chr9	ST6GALNAC4	127916407	127916494	0	88	110290	2639	110290	2551	0.0	43.23402587220698
chr9	PIP5KL1	127925866	127925979	0	114	2124	2806	2124	2692	0.0	0.7890044576523031
chr9	PIP5KL1	127927152	127927208	0	57	2124	2806	2124	2749	0.0	0.7726445980356493
chr9	PIP5KL1	127925957	127925979	0	23	2124	2806	2124	2783	0.0	0.763205174272368
chr9	DPM2	127936552	127936655	0	104	2440	2505	2440	2401	0.0	1.0162432319866723
chr9	FAM102A	127953804	127953925	0	122	18617	6585	18617	6463	0.0	2.8805508277889524
chr9	PTGES2	128124778	128124871	0	94	118958	4049	118958	3955	0.0	30.07787610619469
chr9	PTGES2	128125895	128126260	9643	366	118958	4049	109315	3683	26.346994535519126	29.680966603312516
chr9	CIZ1	128187862	128187934	0	73	42315	7924	42315	7851	0.0	5.389759266335498
chr9	CIZ1	128190328	128190444	0	117	42315	7924	42315	7807	0.0	5.4201357755860124
chr9	CIZ1	128169622	128169700	0	79	42315	7924	42315	7845	0.0	5.393881453154876
chr9	CIZ1	128185546	128185776	0	231	42315	7924	42315	7693	0.0	5.500454959053685
chr9	GOLGA2	128267193	128267274	0	82	3345	5622	3345	5540	0.0	0.6037906137184116
chr9	GOLGA2	128272784	128272865	0	82	3345	5622	3345	5540	0.0	0.6037906137184116
chr9	DYNC2I2	128636917	128637027	0	111	51	2612	51	2501	0.0	0.02039184326269492
chr9	ZER1	128755407	128755659	0	253	0	4387	0	4134	0.0	0.0
chr9	SPOUT1	128823746	128823894	0	149	0	4538	0	4389	0.0	0.0
chr9	KYAT1	128838217	128838367	37	151	307	3604	270	3453	0.24503311258278146	0.07819287576020852
chr9	KYAT1	128840610	128840672	0	63	307	3604	307	3541	0.0	0.08669867269133014
chr9	KYAT1	128842066	128842184	51	119	307	3604	256	3485	0.42857142857142855	0.07345767575322812
chr9	SH3GLB2	129012235	129012298	0	64	0	4688	0	4624	0.0	0.0
chr9	SH3GLB2	129009452	129009467	0	16	0	4688	0	4672	0.0	0.0
chr9	SH3GLB2	129013007	129013019	0	13	0	4688	0	4675	0.0	0.0
chr9	SH3GLB2	129015739	129015860	0	122	0	4688	0	4566	0.0	0.0
chr9	SH3GLB2	129015739	129015864	0	126	0	4688	0	4562	0.0	0.0
chr9	CRAT	129104187	129104306	0	120	492	3826	492	3706	0.0	0.13275769023205614
chr9	CRAT	129109178	129109277	0	100	492	3826	492	3726	0.0	0.1320450885668277
chr9	CRAT	129108762	129108903	0	142	492	3826	492	3684	0.0	0.13355048859934854
chr9	CRAT	129108407	129108478	0	72	492	3826	492	3754	0.0	0.13106020245071923
chr9	ASB6	129638572	129638659	304	88	13464	4628	13160	4540	3.4545454545454546	2.898678414096916
chr9	ASB6	129639201	129639310	0	110	13464	4628	13464	4518	0.0	2.9800796812749004
chr9	TOR1A	129818177	129818297	0	121	0	4005	0	3884	0.0	0.0
chr9	C9ORF78	129834706	129834766	0	61	4539	4970	4539	4909	0.0	0.9246282338561825
chr9	FNBP1	129915965	129915980	0	16	11016	6618	11016	6602	0.0	1.6685852771887306
chr9	FNBP1	129923843	129924026	0	184	11016	6618	11016	6434	0.0	1.712154180913895
chr9	FNBP1	129923843	129923996	0	154	11016	6618	11016	6464	0.0	1.7042079207920793
chr9	AL157938.2	131136721	131136822	0	102	18166	3038	18166	2936	0.0	6.187329700272479
chr9	AL157938.2	131153152	131153345	7323	194	18166	3038	10843	2844	37.74742268041237	3.8125879043600563
chr9	AL157938.2	131141677	131141766	612	90	18166	3038	17554	2948	6.8	5.954545454545454
chr9	AL157938.2	131133626	131133715	9211	90	18166	3038	8955	2948	102.34444444444445	3.037652645861601
chr9	AL157938.2	131163282	131163333	0	52	18166	3038	18166	2986	0.0	6.083724045545881
chr9	AL157938.2	131164358	131164706	0	349	18166	3038	18166	2689	0.0	6.755671253253998
chr9	AL157938.2	131165164	131165270	0	107	18166	3038	18166	2931	0.0	6.197884680996247
chr9	UCK1	131528943	131529038	0	96	4342	2576	4342	2480	0.0	1.7508064516129032
chr9	UCK1	131526444	131526503	0	60	4342	2576	4342	2516	0.0	1.7257551669316376
chr9	RAPGEF1	131630235	131630324	0	90	72254	7031	72254	6941	0.0	10.409739230658406
chr9	RAPGEF1	131650128	131650242	0	115	72254	7031	72254	6916	0.0	10.447368421052632
chr9	RAPGEF1	131603960	131604053	0	94	72254	7031	72254	6937	0.0	10.415741675075681
chr9	MED27	131893884	131893992	16877	109	352392	3869	335515	3760	154.8348623853211	89.23271276595744
chr9	SETX	132269402	132269489	720	88	56342	11836	55622	11748	8.181818181818182	4.734593122233572
chr9	TTF1	132401454	132402828	44154	1375	181015	3226	136861	1851	32.112	73.93895191788222
chr9	AK8	132875114	132875199	0	86	5565	2747	5565	2661	0.0	2.0913190529875987
chr9	TSC1	132903650	132903817	0	168	755473	16580	755473	16412	0.0	46.031745064586886
chr9	TSC1	132904410	132904454	0	45	755473	16580	755473	16535	0.0	45.689325672815244
chr9	TSC1	132921362	132921436	0	75	755473	16580	755473	16505	0.0	45.77237200848228
chr9	TSC1	132925586	132925739	0	154	755473	16580	755473	16426	0.0	45.99251187142335
chr9	TSC1	132927200	132927304	0	105	755473	16580	755473	16475	0.0	45.855720789074354
chr9	TSC1	132935032	132935095	0	64	755473	16580	755473	16516	0.0	45.741886655364496
chr9	TSC1	132903650	132903802	0	153	755473	16580	755473	16427	0.0	45.98971205941438
chr9	TSC1	132928766	132928952	0	187	755473	16580	755473	16393	0.0	46.08509729762704
chr9	TSC1	132924814	132924939	0	126	755473	16580	755473	16454	0.0	45.91424577610307
chr9	TSC1	132924814	132924906	0	93	755473	16580	755473	16487	0.0	45.8223448777825
chr9	TSC1	132924814	132925007	0	194	755473	16580	755473	16386	0.0	46.104784572195776
chr9	TSC1	132931208	132931304	0	97	755473	16580	755473	16483	0.0	45.8334647818965
chr9	RALGDS	133107084	133107300	0	217	0	5371	0	5154	0.0	0.0
chr9	GBGT1	133156014	133156102	0	89	0	4024	0	3935	0.0	0.0
chr9	RALGDS	133104447	133104551	0	105	0	5371	0	5266	0.0	0.0
chr9	GBGT1	133156014	133156065	0	52	0	4024	0	3972	0.0	0.0
chr9	OBP2B	133208468	133208602	0	135	0	1102	0	967	0.0	0.0
chr9	OBP2B	133207839	133207945	0	107	0	1102	0	995	0.0	0.0
chr9	MED22	133346539	133346700	0	162	2808	7240	2808	7078	0.0	0.39672223792031647
chr9	SURF1	133356268	133356320	0	53	0	1767	0	1714	0.0	0.0
chr9	SURF4	133366598	133366675	0	78	119	2035	119	1957	0.0	0.060807358201328564
chr9	SURF4	133364839	133365026	119	188	119	2035	0	1847	0.6329787234042553	0.0
chr9	SURF4	133375238	133375388	0	151	119	2035	119	1884	0.0	0.06316348195329087
chr9	REXO4	133414664	133415011	102	348	102	2663	0	2315	0.29310344827586204	0.0
chr9	REXO4	133414664	133414833	96	170	102	2663	6	2493	0.5647058823529412	0.0024067388688327317
chr9	SLC2A6	133473414	133473600	231	187	20983	2985	20752	2798	1.2352941176470589	7.416726233023589
chr9	SLC2A6	133478253	133478416	408	164	20983	2985	20575	2821	2.4878048780487805	7.293512938674229
chr9	VAV2	133769416	133769503	11215	88	1199903	5715	1188688	5627	127.44318181818181	211.2472009952017
chr9	VAV2	133787245	133787260	468	16	1199903	5715	1199435	5699	29.25	210.46411651166872
chr9	VAV2	133810190	133810205	234	16	1199903	5715	1199669	5699	14.625	210.5051763467275
chr9	BRD3	134040033	134040269	0	237	25148	6896	25148	6659	0.0	3.77654302447815
chr9	SOHLH1	135693969	135694035	0	67	628	3499	628	3432	0.0	0.18298368298368298
chr9	CAMSAP1	135815889	135816005	0	117	9989	7044	9989	6927	0.0	1.4420384004619604
chr9	CAMSAP1	135862466	135862608	0	143	9989	7044	9989	6901	0.0	1.4474713809592812
chr9	CAMSAP1	135865331	135865364	0	34	9989	7044	9989	7010	0.0	1.4249643366619116
chr9	DNLZ	136362988	136363128	0	141	0	3102	0	2961	0.0	0.0
chr9	ENTR1	136408998	136409067	0	70	0	2733	0	2663	0.0	0.0
chr9	ENTR1	136410089	136410239	0	151	0	2733	0	2582	0.0	0.0
chr9	SEC16A	136445051	136445111	0	61	0	10006	0	9945	0.0	0.0
chr9	SEC16A	136445644	136445719	0	76	0	10006	0	9930	0.0	0.0
chr9	AGPAT2	136676584	136676680	47	97	12124	1830	12077	1733	0.4845360824742268	6.968840161569533
chr9	LCN10	136740835	136740943	144	109	3162	3360	3018	3251	1.3211009174311927	0.9283297446939404
chr9	LCN10	136741251	136741361	0	111	3162	3360	3162	3249	0.0	0.9732225300092336
chr9	LCN10	136741655	136741737	0	83	3162	3360	3162	3277	0.0	0.9649069270674397
chr9	LCN10	136740835	136741014	297	180	3162	3360	2865	3180	1.65	0.9009433962264151
chr9	ABCA2	137010192	137010371	0	180	786526	10294	786526	10114	0.0	77.76606683804627
chr9	ABCA2	137023837	137023840	571	4	786526	10294	785955	10290	142.75	76.38046647230321
chr9	AL807752.6	137032735	137032879	440	145	4964	895	4524	750	3.0344827586206895	6.032
chr9	ENTPD2	137051210	137051370	0	161	0	2649	0	2488	0.0	0.0
chr9	DPP7	137111940	137112029	0	90	0	2550	0	2460	0.0	0.0
chr9	DPP7	137111872	137112029	0	158	0	2550	0	2392	0.0	0.0
chr9	DPP7	137113360	137113496	0	137	0	2550	0	2413	0.0	0.0
chr9	DPP7	137113205	137113287	0	83	0	2550	0	2467	0.0	0.0
chr9	EXD3	137352065	137352201	0	137	9659	7522	9659	7385	0.0	1.307921462423832
chr9	EXD3	137354566	137354773	0	208	9659	7522	9659	7314	0.0	1.3206179928903472
chr9	EXD3	137307607	137307646	0	40	9659	7522	9659	7482	0.0	1.2909649826249665
chr9	EXD3	137354699	137354773	0	75	9659	7522	9659	7447	0.0	1.2970323620249764
chr9	EXD3	137365126	137366156	2798	1031	9659	7522	6861	6491	2.713870029097963	1.0570020027730704
chr9	EXD3	137374611	137374763	74	153	9659	7522	9585	7369	0.48366013071895425	1.3007192292034198
chr9	ENTPD8	137435718	137435829	0	112	16	2728	16	2616	0.0	0.0061162079510703364
chr9	NSMF	137453730	137453820	0	91	51	3951	51	3860	0.0	0.013212435233160623
chr9	NSMF	137455238	137455307	0	70	51	3951	51	3881	0.0	0.013140943055913424
chr9	NSMF	137455628	137455634	0	7	51	3951	51	3944	0.0	0.01293103448275862
chr9	PNPLA7	137547584	137547659	0	76	2555	9077	2555	9001	0.0	0.2838573491834241
chr9	DPH7	137564892	137564958	0	67	1648	4023	1648	3956	0.0	0.416582406471183
chr9	DPH7	137577469	137577603	1530	135	1648	4023	118	3888	11.333333333333334	0.030349794238683128
chr9	DPH7	137577576	137577603	0	28	1648	4023	1648	3995	0.0	0.4125156445556946
chr9	AL772363.1	137874063	137874232	0	170	0	4409	0	4239	0.0	0.0
chr10	TUBB8	48614	48725	0	112	0	2879	0	2767	0.0	0.0
chr10	TUBB8	48803	48912	0	110	0	2879	0	2769	0.0	0.0
chr10	TUBB8	48424	48725	0	302	0	2879	0	2577	0.0	0.0
chr10	DIP2C	311536	311566	0	31	18242	8604	18242	8573	0.0	2.1278432287413973
chr10	DIP2C	484780	484948	0	169	18242	8604	18242	8435	0.0	2.162655601659751
chr10	LARP4B	870012	870083	420	72	68343	8723	67923	8651	5.833333333333333	7.851462258698416
chr10	LARP4B	924382	924433	0	52	68343	8723	68343	8671	0.0	7.881789874293623
chr10	IDI1	1043998	1044171	1479	174	8799	4349	7320	4175	8.5	1.7532934131736526
chr10	LINC00700	1997870	1997954	0	85	51	4424	51	4339	0.0	0.01175386033648306
chr10	LINC02662	2172739	2172834	0	96	0	630	0	534	0.0	0.0
chr10	LINC02645	2501557	2501809	0	253	0	5534	0	5281	0.0	0.0
chr10	LINC02645	2454982	2455121	0	140	0	5534	0	5394	0.0	0.0
chr10	LINC02645	2485696	2485828	0	133	0	5534	0	5401	0.0	0.0
chr10	LINC02645	2451203	2451331	0	129	0	5534	0	5405	0.0	0.0
chr10	PITRM1	3140686	3140812	0	127	1624774	11641	1624774	11514	0.0	141.11290602744484
chr10	PITRM1	3143605	3143731	177496	127	1624774	11641	1447278	11514	1397.6062992125985	125.69723814486711
chr10	PITRM1	3156929	3157064	657	136	1624774	11641	1624117	11505	4.830882352941177	141.16618861364623
chr10	PITRM1	3170103	3170206	15250	104	1624774	11641	1609524	11537	146.6346153846154	139.50975123515644
chr10	PITRM1	3170777	3170953	6421	177	1624774	11641	1618353	11464	36.27683615819209	141.16826587578507
chr10	PITRM1	3170733	3170953	8160	221	1624774	11641	1616614	11420	36.92307692307692	141.5598949211909
chr10	PITRM1	3140686	3140765	0	80	1624774	11641	1624774	11561	0.0	140.53922671049216
chr10	LINC02668	3238260	3240502	51	2243	7	3685	-44	1442	0.022737405260811413	-0.030513176144244106
chr10	LINC02669	3499183	3499234	0	52	1233	6362	1233	6310	0.0	0.1954041204437401
chr10	LINC02669	3496152	3496236	0	85	1233	6362	1233	6277	0.0	0.19643141628166322
chr10	LINC02669	3496393	3496598	0	206	1233	6362	1233	6156	0.0	0.20029239766081872
chr10	LINC02669	3487331	3488352	0	1022	1233	6362	1233	5340	0.0	0.23089887640449439
chr10	LINC02669	3491883	3491966	0	84	1233	6362	1233	6278	0.0	0.19640012742911755
chr10	LINC02669	3499183	3499255	63	73	1233	6362	1170	6289	0.863013698630137	0.1860391159166799
chr10	KLF6	3780105	3780229	0	125	29	4846	29	4721	0.0	0.006142766363058674
chr10	MANCR	4656033	4656252	0	220	0	2838	0	2618	0.0	0.0
chr10	MANCR	4656702	4656925	0	224	0	2838	0	2614	0.0	0.0
chr10	AKR1C2	4999199	4999277	0	79	1067	5845	1067	5766	0.0	0.18505029483177246
chr10	AKR1C8P	5158599	5158709	0	111	561	2345	561	2234	0.0	0.25111906893464636
chr10	AKR1C8P	5161711	5161767	0	57	561	2345	561	2288	0.0	0.24519230769230768
chr10	AKR1C7P	5278077	5278191	0	115	0	903	0	788	0.0	0.0
chr10	CALML3-AS1	5524308	5524420	0	113	357	9210	357	9097	0.0	0.039243706716499946
chr10	AL732437.3	5550643	5550810	0	168	0	1372	0	1204	0.0	0.0
chr10	LASTR	5602357	5602496	0	140	2244	4818	2244	4678	0.0	0.4796921761436511
chr10	LASTR	5596010	5596099	0	90	2244	4818	2244	4728	0.0	0.4746192893401015
chr10	LASTR	5609686	5609797	0	112	2244	4818	2244	4706	0.0	0.4768380790480238
chr10	LASTR	5617300	5617400	0	101	2244	4818	2244	4717	0.0	0.47572609709561164
chr10	ASB13	5651212	5651363	0	152	102	3010	102	2858	0.0	0.03568929321203639
chr10	ASB13	5642472	5642553	0	82	102	3010	102	2928	0.0	0.03483606557377049
chr10	GDI2	5766493	5766638	13	146	5551	3932	5538	3786	0.08904109589041095	1.462757527733756
chr10	GDI2	5794884	5795019	102	136	5551	3932	5449	3796	0.75	1.4354583772391991
chr10	GDI2	5800597	5800705	117	109	5551	3932	5434	3823	1.073394495412844	1.4213968087889093
chr10	GDI2	5794884	5794989	78	106	5551	3932	5473	3826	0.7358490566037735	1.430475692629378
chr10	GDI2	5811873	5811956	315	84	5551	3932	5236	3848	3.75	1.3607068607068606
chr10	ANKRD16	5880297	5880376	0	80	0	3068	0	2988	0.0	0.0
chr10	IL15RA	5963742	5963841	649	100	239509	3649	238860	3549	6.49	67.30346576500423
chr10	IL15RA	5968775	5968928	210	154	239509	3649	239299	3495	1.3636363636363635	68.4689556509299
chr10	IL15RA	5966144	5966339	23331	196	239509	3649	216178	3453	119.03571428571429	62.60584998551984
chr10	IL15RA	5958240	5958351	46799	112	239509	3649	192710	3537	417.8482142857143	54.48402601074357
chr10	IL15RA	5968593	5968703	0	111	239509	3649	239509	3538	0.0	67.69615602035049
chr10	IL15RA	5963742	5963838	607	97	239509	3649	238902	3552	6.257731958762887	67.25844594594595
chr10	IL2RA	6021477	6021693	0	217	72	3971	72	3754	0.0	0.019179541822056473
chr10	IL2RA	6019869	6019941	0	73	72	3971	72	3898	0.0	0.018471010774756286
chr10	IL2RA	6021504	6021693	0	190	72	3971	72	3781	0.0	0.019042581327691085
chr10	PRKCQ	6441892	6442081	0	190	0	3314	0	3124	0.0	0.0
chr10	PRKCQ	6507435	6507496	0	62	0	3314	0	3252	0.0	0.0
chr10	AL392086.3	6826610	6826702	0	93	398	14045	398	13952	0.0	0.02852637614678899
chr10	AL392086.3	6826610	6826786	0	177	398	14045	398	13868	0.0	0.02869916354196712
chr10	AL392086.3	6986535	6986693	0	159	398	14045	398	13886	0.0	0.02866196168803111
chr10	LINC02642	7469685	7469741	0	57	51	2960	51	2903	0.0	0.01756803306923872
chr10	CELF2-DT	10422597	10422774	0	178	0	6941	0	6763	0.0	0.0
chr10	CELF2-DT	10433923	10434031	0	109	0	6941	0	6832	0.0	0.0
chr10	SFTA1P	10784833	10784962	0	130	0	1202	0	1072	0.0	0.0
chr10	SFTA1P	10792371	10792525	0	155	0	1202	0	1047	0.0	0.0
chr10	LINC00710	10947445	10947556	0	112	0	6504	0	6392	0.0	0.0
chr10	LINC00710	10936623	10936716	0	94	0	6504	0	6410	0.0	0.0
chr10	LINC00710	10946785	10947556	0	772	0	6504	0	5732	0.0	0.0
chr10	LINC00710	10929600	10929655	0	56	0	6504	0	6448	0.0	0.0
chr10	LINC00710	10925002	10925188	0	187	0	6504	0	6317	0.0	0.0
chr10	LINC00710	10946024	10946094	0	71	0	6504	0	6433	0.0	0.0
chr10	LINC00710	10946785	10947319	0	535	0	6504	0	5969	0.0	0.0
chr10	LINC00710	10935233	10935413	0	181	0	6504	0	6323	0.0	0.0
chr10	LINC00710	10937437	10937561	0	125	0	6504	0	6379	0.0	0.0
chr10	LINC00710	10936623	10937561	0	939	0	6504	0	5565	0.0	0.0
chr10	LINC00710	10946785	10947122	0	338	0	6504	0	6166	0.0	0.0
chr10	LINC00710	10936623	10936704	0	82	0	6504	0	6422	0.0	0.0
chr10	CELF2-AS2	11071809	11072875	0	1067	0	4185	0	3118	0.0	0.0
chr10	CELF2-AS2	11078760	11078929	0	170	0	4185	0	4015	0.0	0.0
chr10	CELF2-AS2	11073983	11074084	0	102	0	4185	0	4083	0.0	0.0
chr10	CELF2-AS2	11099444	11099498	0	55	0	4185	0	4130	0.0	0.0
chr10	CELF2-AS2	11102113	11102182	0	70	0	4185	0	4115	0.0	0.0
chr10	CELF2-AS2	11104965	11105073	0	109	0	4185	0	4076	0.0	0.0
chr10	NUDT5	12184493	12184532	0	40	38616	4491	38616	4451	0.0	8.675803190294316
chr10	UCMA	13233734	13233800	54	67	2538	875	2484	808	0.8059701492537313	3.0742574257425743
chr10	PHYH	13298186	13298245	0	60	204	3388	204	3328	0.0	0.06129807692307692
chr10	SEPHS1	13322834	13323047	40211	214	80659	3895	40448	3681	187.9018691588785	10.988318391741375
chr10	SEPHS1	13344757	13345028	454	272	80659	3895	80205	3623	1.6691176470588236	22.137731162020426
chr10	BEND7	13500509	13500679	0	171	0	5715	0	5544	0.0	0.0
chr10	BEND7	13446484	13446541	0	58	0	5715	0	5657	0.0	0.0
chr10	FRMD4A	13651902	13651974	0	73	103572	13266	103572	13193	0.0	7.850526794512241
chr10	FRMD4A	13693481	13693517	1100	37	103572	13266	102472	13229	29.72972972972973	7.746012548189584
chr10	FRMD4A	13759164	13759506	892	343	103572	13266	102680	12923	2.6005830903790086	7.945523485258841
chr10	FRMD4A	13753055	13753100	0	46	103572	13266	103572	13220	0.0	7.834493192133132
chr10	FRMD4A	14388680	14388903	0	224	103572	13266	103572	13042	0.0	7.941420027603129
chr10	FAM107B	14553321	14553387	0	67	1566	6879	1566	6812	0.0	0.22988843217850852
chr10	FAM107B	14527936	14528039	0	104	1566	6879	1566	6775	0.0	0.2311439114391144
chr10	FAM107B	14556361	14556405	0	45	1566	6879	1566	6834	0.0	0.22914837576821773
chr10	FAM107B	14542578	14542686	0	109	1566	6879	1566	6770	0.0	0.231314623338257
chr10	CDNF	14825478	14825620	0	143	51	1710	51	1567	0.0	0.03254626675175495
chr10	CDNF	14834216	14834333	0	118	51	1710	51	1592	0.0	0.032035175879396985
chr10	CDNF	14836250	14836294	0	45	51	1710	51	1665	0.0	0.03063063063063063
chr10	CDNF	14825493	14825620	0	128	51	1710	51	1582	0.0	0.032237673830594185
chr10	DCLRE1C	14926842	14926897	0	56	96849	9612	96849	9556	0.0	10.134889074926747
chr10	DCLRE1C	14936537	14936593	0	57	96849	9612	96849	9555	0.0	10.135949764521193
chr10	DCLRE1C	14945104	14945189	1164	86	96849	9612	95685	9526	13.534883720930232	10.04461473861012
chr10	DCLRE1C	14949035	14949087	1781	53	96849	9612	95068	9559	33.60377358490566	9.945391777382572
chr10	DCLRE1C	14945434	14945565	10447	132	96849	9612	86402	9480	79.14393939393939	9.114135021097047
chr10	DCLRE1C	14942113	14942435	5525	323	96849	9612	91324	9289	17.105263157894736	9.831413499838519
chr10	DCLRE1C	14947524	14947609	4258	86	96849	9612	92591	9526	49.51162790697674	9.719819441528449
chr10	DCLRE1C	14942113	14942240	2380	128	96849	9612	94469	9484	18.59375	9.960881484605652
chr10	NMT2	15140986	15141029	117	44	13834	5881	13717	5837	2.659090909090909	2.3500085660442007
chr10	FAM171A1	15215995	15216110	0	116	87353	4190	87353	4074	0.0	21.441580756013746
chr10	FAM171A1	15254720	15254879	82888	160	87353	4190	4465	4030	518.05	1.1079404466501241
chr10	MINDY3	15838227	15838279	0	53	2226	4097	2226	4044	0.0	0.5504451038575667
chr10	MINDY3	15837541	15837633	0	93	2226	4097	2226	4004	0.0	0.5559440559440559
chr10	RSU1	16816972	16817084	0	113	1923	4135	1923	4022	0.0	0.47812033814022875
chr10	RSU1	16782033	16782084	1209	52	1923	4135	714	4083	23.25	0.17487141807494488
chr10	TRDMT1	17161482	17161548	83	67	1051	15469	968	15402	1.2388059701492538	0.0628489806518634
chr10	TRDMT1	17162165	17162237	0	73	1051	15469	1051	15396	0.0	0.0682644842816316
chr10	TRDMT1	17168840	17168917	0	78	1051	15469	1051	15391	0.0	0.0682866610356702
chr10	TRDMT1	17169309	17169539	0	231	1051	15469	1051	15238	0.0	0.06897230607691299
chr10	VIM-AS1	17216166	17216274	0	109	3825	2013	3825	1904	0.0	2.0089285714285716
chr10	ST8SIA6	17379356	17379425	0	70	9841	4110	9841	4040	0.0	2.4358910891089107
chr10	HACD1	17599289	17599411	0	123	1634	3130	1634	3007	0.0	0.5433987362820086
chr10	AL157895.1	19724926	19724981	0	56	0	4681	0	4625	0.0	0.0
chr10	NEBL	20793332	20793376	0	45	204	16049	204	16004	0.0	0.01274681329667583
chr10	NEBL	20818703	20818834	51	132	204	16049	153	15917	0.38636363636363635	0.009612364138970911
chr10	DNAJC1	21920797	21920963	0	167	1275	2503	1275	2336	0.0	0.545804794520548
chr10	DNAJC1	21928505	21928552	0	48	1275	2503	1275	2455	0.0	0.5193482688391039
chr10	AL513128.3	22469769	22469887	0	119	0	1708	0	1589	0.0	0.0
chr10	PIP4K2A	22569012	22569054	0	43	26282	5125	26282	5082	0.0	5.171585989767808
chr10	AL139815.1	22970096	22970162	0	67	0	2374	0	2307	0.0	0.0
chr10	ARHGAP21	24591224	24591330	0	107	88	9962	88	9855	0.0	0.008929477422628108
chr10	ARHGAP21	24622732	24622762	0	31	88	9962	88	9931	0.0	0.008861141878964857
chr10	ARHGAP21	24590453	24590550	0	98	88	9962	88	9864	0.0	0.008921330089213302
chr10	ARHGAP21	24590205	24590479	0	275	88	9962	88	9687	0.0	0.009084339836894807
chr10	PRTFDC1	24851387	24851464	0	78	10849	2334	10849	2256	0.0	4.80895390070922
chr10	ENKUR	24999400	24999546	0	147	102	4084	102	3937	0.0	0.02590805181610363
chr10	ABI1	26759061	26759235	0	175	51	4231	51	4056	0.0	0.01257396449704142
chr10	ABI1	26771074	26771089	0	16	51	4231	51	4215	0.0	0.012099644128113879
chr10	ABI1	26755654	26755741	0	88	51	4231	51	4143	0.0	0.012309920347574221
chr10	ABI1	26763879	26763960	0	82	51	4231	51	4149	0.0	0.012292118582791034
chr10	ABI1	26759061	26759238	0	178	51	4231	51	4053	0.0	0.012583271650629163
chr10	ABI1	26777064	26777241	0	178	51	4231	51	4053	0.0	0.012583271650629163
chr10	ABI1	26839732	26839783	0	52	51	4231	51	4179	0.0	0.012203876525484566
chr10	ANKRD26	27005616	27005723	0	108	160364	13297	160364	13189	0.0	12.15892031238153
chr10	ANKRD26	27061143	27061242	290	100	160364	13297	160074	13197	2.9	12.129574903387134
chr10	ANKRD26	27082802	27082833	0	32	160364	13297	160364	13265	0.0	12.089257444402563
chr10	ANKRD26	27030392	27030600	2770	209	160364	13297	157594	13088	13.253588516746412	12.041106356968216
chr10	ANKRD26	27098179	27098326	0	148	160364	13297	160364	13149	0.0	12.195908434101453
chr10	ANKRD26	27037663	27037782	9021	120	160364	13297	151343	13177	75.175	11.485391211960234
chr10	ANKRD26	27060817	27060881	78	65	160364	13297	160286	13232	1.2	12.11351269649335
chr10	ANKRD26	27080031	27080153	0	123	160364	13297	160364	13174	0.0	12.172764536207682
chr10	ANKRD26	27080648	27080771	0	124	160364	13297	160364	13173	0.0	12.173688605480908
chr10	YME1L1	27142386	27142485	0	100	11007	5725	11007	5625	0.0	1.9568
chr10	YME1L1	27147497	27147668	0	172	11007	5725	11007	5553	0.0	1.9821717990275527
chr10	YME1L1	27153226	27153281	0	56	11007	5725	11007	5669	0.0	1.9416122772975835
chr10	ACBD5	27208245	27208445	0	201	1481	11777	1481	11576	0.0	0.12793711126468554
chr10	ACBD5	27215534	27215641	0	108	1481	11777	1481	11669	0.0	0.12691747364812753
chr10	ACBD5	27217979	27218183	0	205	1481	11777	1481	11572	0.0	0.1279813342550985
chr10	ACBD5	27223206	27223239	0	34	1481	11777	1481	11743	0.0	0.12611768713275995
chr10	ACBD5	27231747	27231820	0	74	1481	11777	1481	11703	0.0	0.12654874818422626
chr10	ACBD5	27235091	27235212	0	122	1481	11777	1481	11655	0.0	0.12706992706992706
chr10	ACBD5	27204439	27204549	0	111	1481	11777	1481	11666	0.0	0.12695011143493914
chr10	ACBD5	27234357	27234488	0	132	1481	11777	1481	11645	0.0	0.12717904680120223
chr10	ACBD5	27221695	27221746	0	52	1481	11777	1481	11725	0.0	0.12631130063965884
chr10	ACBD5	27198983	27199101	0	119	1481	11777	1481	11658	0.0	0.1270372276548293
chr10	ACBD5	27220372	27220464	255	93	1481	11777	1226	11684	2.7419354838709675	0.10492981855528928
chr10	ARMC4	27835980	27836040	0	61	3463	6364	3463	6303	0.0	0.5494209106774551
chr10	ARMC4	27853241	27853363	0	123	3463	6364	3463	6241	0.0	0.5548790257971479
chr10	MPP7	28254773	28254876	0	104	0	6190	0	6086	0.0	0.0
chr10	MPP7	28280099	28280140	0	42	0	6190	0	6148	0.0	0.0
chr10	LINC00837	28794541	28794643	0	103	1683	4864	1683	4761	0.0	0.3534971644612476
chr10	SVIL	29532528	29533458	0	931	1861	12477	1861	11546	0.0	0.16118136151047982
chr10	SVIL	29526960	29527056	0	97	1861	12477	1861	12380	0.0	0.15032310177705976
chr10	SVIL	29508341	29508389	0	49	1861	12477	1861	12428	0.0	0.14974251689732862
chr10	MTPAP	30373659	30373853	0	195	570	8335	570	8140	0.0	0.07002457002457002
chr10	ZNF438	30857679	30857778	0	100	0	4283	0	4183	0.0	0.0
chr10	ZNF438	30910359	30910440	0	82	0	4283	0	4201	0.0	0.0
chr10	ZNF438	30984368	30984426	0	59	0	4283	0	4224	0.0	0.0
chr10	ZNF438	30875330	30875509	0	180	0	4283	0	4103	0.0	0.0
chr10	ZEB1-AS1	31309892	31310015	0	124	4044	3673	4044	3549	0.0	1.139475908706678
chr10	ARHGAP12	31839304	31839319	0	16	40482	5865	40482	5849	0.0	6.921183108223628
chr10	ARHGAP12	31854065	31854206	0	142	40482	5865	40482	5723	0.0	7.073562816704525
chr10	ARHGAP12	31839636	31839711	0	76	40482	5865	40482	5789	0.0	6.992917602349283
chr10	KIF5B	32018315	32018387	0	73	174	5892	174	5819	0.0	0.02990204502491837
chr10	EPC1	32273921	32274038	816	118	11484	6820	10668	6702	6.915254237288136	1.5917636526410026
chr10	EPC1	32273013	32273082	0	70	11484	6820	11484	6750	0.0	1.7013333333333334
chr10	ITGB1	32901511	32901635	0	125	3849	12473	3849	12348	0.0	0.3117103984450923
chr10	ITGB1	32907062	32907143	0	82	3849	12473	3849	12391	0.0	0.3106286821079816
chr10	ITGB1	32936241	32936423	0	183	3849	12473	3849	12290	0.0	0.3131814483319772
chr10	ITGB1	32953592	32953809	0	218	3849	12473	3849	12255	0.0	0.3140758873929009
chr10	ITGB1	32936349	32936423	0	75	3849	12473	3849	12398	0.0	0.3104532989191805
chr10	ITGB1	32933350	32933583	0	234	3849	12473	3849	12239	0.0	0.31448647765340304
chr10	ITGB1	32933481	32933583	0	103	3849	12473	3849	12370	0.0	0.31115602263540826
chr10	ITGB1	32938553	32938730	0	178	3849	12473	3849	12295	0.0	0.31305408702724685
chr10	ITGB1	32921570	32921702	0	133	3849	12473	3849	12340	0.0	0.3119124797406807
chr10	ITGB1	32906464	32906580	0	117	3849	12473	3849	12356	0.0	0.31150857882809974
chr10	ITGB1	32906464	32906562	0	99	3849	12473	3849	12374	0.0	0.31105543882333925
chr10	ITGB1	32951674	32951758	0	85	3849	12473	3849	12388	0.0	0.31070390700678074
chr10	NRP1	33182697	33182748	0	52	344357	9558	344357	9506	0.0	36.2252261729434
chr10	NRP1	33202911	33202995	243	85	344357	9558	344114	9473	2.8588235294117648	36.325767972131324
chr10	NRP1	33202890	33202995	243	106	344357	9558	344114	9452	2.292452830188679	36.406474820143885
chr10	NRP1	33270674	33270856	0	183	344357	9558	344357	9375	0.0	36.731413333333336
chr10	LINC00838	33770210	33770567	0	358	0	3582	0	3224	0.0	0.0
chr10	LINC00838	33771553	33771720	0	168	0	3582	0	3414	0.0	0.0
chr10	PARD3	34284134	34284245	0	112	3679	6541	3679	6429	0.0	0.572250738839633
chr10	PARD3	34336198	34336243	0	46	3679	6541	3679	6495	0.0	0.5664357197844496
chr10	PARD3	34450316	34450448	0	133	3679	6541	3679	6408	0.0	0.5741260923845194
chr10	PARD3	34372497	34372536	0	40	3679	6541	3679	6501	0.0	0.5659129364713121
chr10	CUL2	35011847	35011964	0	118	3374	5181	3374	5063	0.0	0.666403318190796
chr10	CUL2	35089895	35090001	0	107	3374	5181	3374	5074	0.0	0.6649586125344895
chr10	CUL2	35087754	35087876	0	123	3374	5181	3374	5058	0.0	0.6670620798734678
chr10	AL392046.1	35119985	35120035	0	51	445	1393	445	1342	0.0	0.3315946348733234
chr10	ZNF248	37856434	37856532	0	99	1173	6037	1173	5938	0.0	0.1975412596833951
chr10	BX322639.1	42340500	42340556	0	57	460	7215	460	7158	0.0	0.06426376082704666
chr10	CCNYL2	42427199	42427251	0	53	0	3845	0	3792	0.0	0.0
chr10	CCNYL2	42446168	42446204	0	37	0	3845	0	3808	0.0	0.0
chr10	CCNYL2	42430157	42430225	0	69	0	3845	0	3776	0.0	0.0
chr10	ZNF37BP	42525539	42525660	0	122	0	2664	0	2542	0.0	0.0
chr10	ZNF33B	42632294	42632439	0	146	0	2830	0	2684	0.0	0.0
chr10	ZNF33B	42636919	42636972	0	54	0	2830	0	2776	0.0	0.0
chr10	LINC01518	42690732	42690842	0	111	0	2507	0	2396	0.0	0.0
chr10	ZNF239	43573636	43573677	0	42	0	2513	0	2471	0.0	0.0
chr10	ZNF239	43567898	43568021	0	124	0	2513	0	2389	0.0	0.0
chr10	LINC02659	43903427	43903589	51	163	20329	1824	20278	1661	0.3128834355828221	12.208308248043348
chr10	LINC02659	43903427	43904221	9738	795	20329	1824	10591	1029	12.249056603773585	10.29251700680272
chr10	LINC02659	43903427	43903600	51	174	20329	1824	20278	1650	0.29310344827586204	12.28969696969697
chr10	TMEM72-AS1	44825501	44825581	0	81	0	9465	0	9384	0.0	0.0
chr10	TMEM72-AS1	44830999	44831245	0	247	0	9465	0	9218	0.0	0.0
chr10	TMEM72-AS1	44885207	44885300	0	94	0	9465	0	9371	0.0	0.0
chr10	TMEM72-AS1	44834065	44835319	0	1255	0	9465	0	8210	0.0	0.0
chr10	TMEM72-AS1	44923080	44923226	0	147	0	9465	0	9318	0.0	0.0
chr10	TMEM72-AS1	44823189	44823288	0	100	0	9465	0	9365	0.0	0.0
chr10	TMEM72-AS1	44873634	44874087	0	454	0	9465	0	9011	0.0	0.0
chr10	TMEM72-AS1	44826151	44826368	0	218	0	9465	0	9247	0.0	0.0
chr10	TMEM72-AS1	44845339	44845407	0	69	0	9465	0	9396	0.0	0.0
chr10	TMEM72-AS1	44830569	44830681	0	113	0	9465	0	9352	0.0	0.0
chr10	TMEM72-AS1	44830569	44830707	0	139	0	9465	0	9326	0.0	0.0
chr10	TMEM72-AS1	44937291	44937407	0	117	0	9465	0	9348	0.0	0.0
chr10	TMEM72-AS1	44834065	44835315	0	1251	0	9465	0	8214	0.0	0.0
chr10	AL358394.3	45121043	45121171	0	129	0	1228	0	1099	0.0	0.0
chr10	CEP164P1	45066332	45066522	0	191	0	4368	0	4177	0.0	0.0
chr10	CEP164P1	45070477	45070663	0	187	0	4368	0	4181	0.0	0.0
chr10	MARCHF8	45463150	45463996	1326	847	4346	7527	3020	6680	1.5655253837072018	0.45209580838323354
chr10	MARCHF8	45553111	45553204	0	94	4346	7527	4346	7433	0.0	0.5846898964079107
chr10	ZFAND4	45652983	45653059	0	77	0	6248	0	6171	0.0	0.0
chr10	ZFAND4	45662579	45662681	0	103	0	6248	0	6145	0.0	0.0
chr10	ZFAND4	45640240	45640421	0	182	0	6248	0	6066	0.0	0.0
chr10	FAM21FP	45720993	45721064	0	72	51	1544	51	1472	0.0	0.034646739130434784
chr10	AGAP4	45841652	45841687	0	36	350	3384	350	3348	0.0	0.10454002389486261
chr10	AGAP4	45844325	45844394	0	70	350	3384	350	3314	0.0	0.1056125528062764
chr10	AGAP4	45846686	45846755	0	70	350	3384	350	3314	0.0	0.1056125528062764
chr10	NCOA4	46014853	46014942	0	90	443	4093	443	4003	0.0	0.11066699975018736
chr10	NCOA4	46016539	46016694	0	156	443	4093	443	3937	0.0	0.11252222504445009
chr10	NCOA4	46015125	46015266	0	142	443	4093	443	3951	0.0	0.11212351303467477
chr10	NCOA4	46009123	46009212	0	90	443	4093	443	4003	0.0	0.11066699975018736
chr10	NCOA4	46027431	46027528	0	98	443	4093	443	3995	0.0	0.11088861076345431
chr10	MSMB	46038965	46039071	0	107	0	931	0	824	0.0	0.0
chr10	NPY4R	46463729	46463885	0	157	0	2036	0	1879	0.0	0.0
chr10	ANXA8	47473969	47474065	0	97	0	4421	0	4324	0.0	0.0
chr10	ANXA8	47475492	47475572	0	81	0	4421	0	4340	0.0	0.0
chr10	ANXA8	47476231	47476322	0	92	0	4421	0	4329	0.0	0.0
chr10	AL591684.2	47543015	47543203	0	189	0	1637	0	1448	0.0	0.0
chr10	FO681492.1	47761440	47761645	0	206	8260	4347	8260	4141	0.0	1.9946872736054093
chr10	AC245041.2	47956025	47956164	0	140	7238	2162	7238	2022	0.0	3.579624134520277
chr10	FRMPD2	48244783	48244849	0	67	21621	8540	21621	8473	0.0	2.551752625988434
chr10	FRMPD2	48249020	48249178	0	159	21621	8540	21621	8381	0.0	2.579763751342322
chr10	ARHGAP22	48582952	48583152	0	201	7	6564	7	6363	0.0	0.0011001100110011
chr10	TMEM273	49165204	49165283	0	80	0	3704	0	3624	0.0	0.0
chr10	TMEM273	49165765	49165796	0	32	0	3704	0	3672	0.0	0.0
chr10	TMEM273	49165204	49165361	0	158	0	3704	0	3546	0.0	0.0
chr10	ERCC6	49476214	49476310	0	97	13444	12679	13444	12582	0.0	1.0685105706564935
chr10	ERCC6	49493116	49493252	0	137	13444	12679	13444	12542	0.0	1.071918354329453
chr10	ERCC6	49475326	49475496	0	171	13444	12679	13444	12508	0.0	1.0748321074512313
chr10	OGDHL	49756775	49756946	0	172	1173	5631	1173	5459	0.0	0.21487451914270012
chr10	OGDHL	49758388	49758593	0	206	1173	5631	1173	5425	0.0	0.21622119815668203
chr10	PARG	49922546	49922669	0	124	0	5150	0	5026	0.0	0.0
chr10	PARG	49935075	49935142	0	68	0	5150	0	5082	0.0	0.0
chr10	FAM21EP	50056783	50056911	0	129	0	2561	0	2432	0.0	0.0
chr10	ASAH2	50196772	50196919	0	148	0	7300	0	7152	0.0	0.0
chr10	ASAH2	50211029	50211134	0	106	0	7300	0	7194	0.0	0.0
chr10	ASAH2	50198300	50198369	0	70	0	7300	0	7230	0.0	0.0
chr10	SGMS1	50327204	50327322	0	119	0	6440	0	6321	0.0	0.0
chr10	A1CF	50859841	50859985	0	145	0	9619	0	9474	0.0	0.0
chr10	A1CF	50864032	50864080	0	49	0	9619	0	9570	0.0	0.0
chr10	A1CF	50862888	50862981	0	94	0	9619	0	9525	0.0	0.0
chr10	A1CF	50850664	50850807	0	144	0	9619	0	9475	0.0	0.0
chr10	PRKG1-AS1	52304228	52304302	0	75	153	6321	153	6246	0.0	0.024495677233429394
chr10	LNCAROD	52723869	52724018	51	150	51	2115	0	1965	0.34	0.0
chr10	PCDH15	53820164	53820230	0	67	133	15436	133	15369	0.0	0.008653783590344199
chr10	PCDH15	53828564	53828573	0	10	133	15436	133	15426	0.0	0.00862180733826008
chr10	PCDH15	54089983	54090063	0	81	133	15436	133	15355	0.0	0.008661673721914686
chr10	PCDH15	54527811	54527877	0	67	133	15436	133	15369	0.0	0.008653783590344199
chr10	PCDH15	53825135	53825141	0	7	133	15436	133	15429	0.0	0.008620130922289195
chr10	PCDH15	54528387	54528402	0	16	133	15436	133	15420	0.0	0.008625162127107653
chr10	PCDH15	54195682	54195889	0	208	133	15436	133	15228	0.0	0.00873391121618072
chr10	PCDH15	53811548	53811619	0	72	133	15436	133	15364	0.0	0.008656599843790679
chr10	PCDH15	54189363	54189384	0	22	133	15436	133	15414	0.0	0.00862851952770209
chr10	PCDH15	54132874	54133007	0	134	133	15436	133	15302	0.0	0.00869167429094236
chr10	FAM13C	59361025	59361110	0	86	51	6772	51	6686	0.0	0.007627879150463655
chr10	FAM13C	59302800	59302864	0	65	51	6772	51	6707	0.0	0.007603995825257194
chr10	FAM13C	59327624	59327713	0	90	51	6772	51	6682	0.0	0.007632445375636037
chr10	MRLN	59738997	59739119	0	123	0	2534	0	2411	0.0	0.0
chr10	MRLN	59738997	59739095	0	99	0	2534	0	2435	0.0	0.0
chr10	ANK3	60068636	60076448	204	7813	54213	22486	54009	14673	0.026110328938947908	3.6808423635248415
chr10	ANK3	60082149	60082176	0	28	54213	22486	54213	22458	0.0	2.4139727491317124
chr10	ANK3	60166590	60166653	0	64	54213	22486	54213	22422	0.0	2.4178485416109177
chr10	ANK3	60059697	60060006	1587	310	54213	22486	52626	22176	5.119354838709677	2.3731060606060606
chr10	ANK3	60053676	60053727	0	52	54213	22486	54213	22434	0.0	2.4165552286707674
chr10	ANK3	60145967	60146021	17908	55	54213	22486	36305	22431	325.6	1.6185190138647407
chr10	ANK3	60073871	60076454	102	2584	54213	22486	54111	19902	0.039473684210526314	2.7188724751281277
chr10	ANK3	60059697	60060033	2235	337	54213	22486	51978	22149	6.632047477744807	2.346742516592171
chr10	ANK3	60068648	60068869	0	222	54213	22486	54213	22264	0.0	2.4350071864894
chr10	ANK3	60111733	60111766	0	34	54213	22486	54213	22452	0.0	2.414617851416355
chr10	ANK3	60108187	60108286	102	100	54213	22486	54111	22386	1.02	2.4171803805950147
chr10	ANK3	60137341	60137353	0	13	54213	22486	54213	22473	0.0	2.4123615004672274
chr10	RHOBTB1	60886111	60886230	0	120	0	2915	0	2795	0.0	0.0
chr10	RTKN2	62215028	62215091	0	64	0	9807	0	9743	0.0	0.0
chr10	AC024597.1	62371932	62372024	0	93	0	2592	0	2499	0.0	0.0
chr10	AC024597.1	62344690	62344823	0	134	0	2592	0	2458	0.0	0.0
chr10	JMJD1C	63200475	63200677	0	203	0	11063	0	10860	0.0	0.0
chr10	JMJD1C	63219877	63219983	0	107	0	11063	0	10956	0.0	0.0
chr10	JMJD1C	63198512	63198727	0	216	0	11063	0	10847	0.0	0.0
chr10	JMJD1C	63264650	63264764	0	115	0	11063	0	10948	0.0	0.0
chr10	DNAJC12	67816039	67816129	0	91	357	2146	357	2055	0.0	0.17372262773722627
chr10	DNAJC12	67816039	67816133	0	95	357	2146	357	2051	0.0	0.17406143344709898
chr10	DNAJC12	67827541	67827683	0	143	357	2146	357	2003	0.0	0.1782326510234648
chr10	HERC4	67959112	67959136	0	25	102	15726	102	15701	0.0	0.006496401503088976
chr10	HERC4	68032777	68032869	0	93	102	15726	102	15633	0.0	0.006524659374400307
chr10	HERC4	68044403	68044563	0	161	102	15726	102	15565	0.0	0.006553164150337295
chr10	HERC4	67988042	67988144	0	103	102	15726	102	15623	0.0	0.006528835690968444
chr10	HERC4	68039416	68039488	0	73	102	15726	102	15653	0.0	0.006516322749632659
chr10	PBLD	68296265	68296364	0	100	18	3053	18	2953	0.0	0.0060954961056552655
chr10	RUFY2	68345701	68345911	0	211	222	8004	222	7793	0.0	0.028487103811112538
chr10	RUFY2	68386058	68386128	0	71	222	8004	222	7933	0.0	0.027984369091138283
chr10	RUFY2	68396779	68396881	0	103	222	8004	222	7901	0.0	0.02809770915074041
chr10	RUFY2	68345830	68345911	0	82	222	8004	222	7922	0.0	0.02802322645796516
chr10	RUFY2	68404670	68404844	0	175	222	8004	222	7829	0.0	0.02835611189168476
chr10	DNA2	68470488	68470612	0	125	0	4023	0	3898	0.0	0.0
chr10	SLC25A16	68493448	68493570	0	123	102	6889	102	6766	0.0	0.01507537688442211
chr10	SLC25A16	68517083	68517185	0	103	102	6889	102	6786	0.0	0.015030946065428824
chr10	SLC25A16	68496433	68496512	0	80	102	6889	102	6809	0.0	0.01498017330004406
chr10	SLC25A16	68517083	68517265	0	183	102	6889	102	6706	0.0	0.01521025946913212
chr10	LINC02636	70001386	70001494	0	109	0	1534	0	1425	0.0	0.0
chr10	SAR1A	70162689	70162759	0	71	29346	3902	29346	3831	0.0	7.660140955364135
chr10	SAR1A	70155087	70155124	0	38	29346	3902	29346	3864	0.0	7.59472049689441
chr10	PPA1	70210194	70210419	140	226	32276	3893	32136	3667	0.6194690265486725	8.76356694845923
chr10	LRRC20	70323862	70324030	0	169	305	3632	305	3463	0.0	0.08807392434305515
chr10	LRRC20	70340552	70340702	0	151	305	3632	305	3481	0.0	0.08761850043091066
chr10	LRRC20	70376451	70376596	102	146	305	3632	203	3486	0.6986301369863014	0.05823293172690763
chr10	PRF1	70600363	70600906	306	544	784	2521	478	1977	0.5625	0.24178047546788062
chr10	PSAP	71823887	71823896	0	10	803	3204	803	3194	0.0	0.2514088916718848
chr10	ASCC1	72128081	72128167	0	87	12963	5932	12963	5845	0.0	2.217792985457656
chr10	ASCC1	72152868	72152988	0	121	12963	5932	12963	5811	0.0	2.230769230769231
chr10	ASCC1	72102333	72102412	0	80	12963	5932	12963	5852	0.0	2.21514012303486
chr10	ASCC1	72102849	72102967	0	119	12963	5932	12963	5813	0.0	2.230001720282126
chr10	ASCC1	72204421	72204505	0	85	12963	5932	12963	5847	0.0	2.217034376603386
chr10	ASCC1	72208024	72208146	0	123	12963	5932	12963	5809	0.0	2.2315372697538303
chr10	ASCC1	72181934	72181994	10600	61	12963	5932	2363	5871	173.7704918032787	0.40248679952307953
chr10	ASCC1	72132233	72132341	0	109	12963	5932	12963	5823	0.0	2.226172076249356
chr10	ASCC1	72133056	72133181	0	126	12963	5932	12963	5806	0.0	2.23269032035825
chr10	ASCC1	72198448	72198665	0	218	12963	5932	12963	5714	0.0	2.268638431921596
chr10	ASCC1	72215781	72215854	0	74	12963	5932	12963	5858	0.0	2.212871287128713
chr10	ASCC1	72212187	72212285	0	99	12963	5932	12963	5833	0.0	2.2223555631750385
chr10	ASCC1	72215781	72216109	0	329	12963	5932	12963	5603	0.0	2.313582009637694
chr10	MICU1	72379463	72379583	0	121	6218	3871	6218	3750	0.0	1.6581333333333332
chr10	MICU1	72524734	72524746	0	13	6218	3871	6218	3858	0.0	1.6117159149818558
chr10	MICU1	72509397	72509403	119	7	6218	3871	6099	3864	17.0	1.578416149068323
chr10	MICU1	72477492	72477603	0	112	6218	3871	6218	3759	0.0	1.6541633413141794
chr10	P4HA1	73016845	73016899	0	55	0	3109	0	3054	0.0	0.0
chr10	ECD	73152292	73152421	0	130	0	2757	0	2627	0.0	0.0
chr10	ECD	73154255	73154448	0	194	0	2757	0	2563	0.0	0.0
chr10	ECD	73163732	73163950	0	219	0	2757	0	2538	0.0	0.0
chr10	ECD	73141386	73141485	0	100	0	2757	0	2657	0.0	0.0
chr10	CFAP70	73272927	73273017	0	91	0	3807	0	3716	0.0	0.0
chr10	CFAP70	73269613	73269715	0	103	0	3807	0	3704	0.0	0.0
chr10	ANXA7	73400802	73400857	0	56	20	2878	20	2822	0.0	0.007087172218284904
chr10	ANXA7	73396043	73396109	0	67	20	2878	20	2811	0.0	0.007114905727499111
chr10	PPP3CB	73439871	73439901	0	31	0	4509	0	4478	0.0	0.0
chr10	PPP3CB	73448663	73448690	0	28	0	4509	0	4481	0.0	0.0
chr10	USP54	73504849	73504990	0	142	494560	9532	494560	9390	0.0	52.66879659211928
chr10	USP54	73520907	73521027	0	121	494560	9532	494560	9411	0.0	52.55126979067049
chr10	USP54	73530703	73530835	0	133	494560	9532	494560	9399	0.0	52.61836365570805
chr10	USP54	73534599	73534770	0	172	494560	9532	494560	9360	0.0	52.837606837606835
chr10	USP54	73519796	73519992	0	197	494560	9532	494560	9335	0.0	52.97911087305838
chr10	AGAP5	73697094	73697163	0	70	0	2842	0	2772	0.0	0.0
chr10	AGAP5	73681007	73681341	0	335	0	2842	0	2507	0.0	0.0
chr10	BMS1P4	73720006	73720194	1581	189	2540	2675	959	2486	8.365079365079366	0.38576025744167336
chr10	CAMK2G	73828088	73828121	0	34	544	6806	544	6772	0.0	0.08033077377436504
chr10	CAMK2G	73839538	73839601	0	64	544	6806	544	6742	0.0	0.08068822307920498
chr10	CAMK2G	73819531	73819645	37	115	544	6806	507	6691	0.3217391304347826	0.0757734269914811
chr10	CAMK2G	73825278	73825347	0	70	544	6806	544	6736	0.0	0.08076009501187649
chr10	CAMK2G	73819531	73819617	9	87	544	6806	535	6719	0.10344827586206896	0.07962494418812323
chr10	CAMK2G	73825320	73825347	0	28	544	6806	544	6778	0.0	0.08025966361758631
chr10	AP3M1	74138805	74138931	102	127	10969	5701	10867	5574	0.8031496062992126	1.9495873699318262
chr10	AC022540.1	74516722	74516901	0	180	1279	1237	1279	1057	0.0	1.2100283822138127
chr10	DUSP13	75105660	75105868	0	209	590	2053	590	1844	0.0	0.3199566160520607
chr10	DUSP13	75107991	75108209	0	219	590	2053	590	1834	0.0	0.321701199563795
chr10	DUSP13	75099030	75099120	0	91	590	2053	590	1962	0.0	0.3007135575942915
chr10	DUSP13	75101866	75101961	492	96	590	2053	98	1957	5.125	0.050076647930505876
chr10	DUSP13	75103893	75104097	0	205	590	2053	590	1848	0.0	0.31926406926406925
chr10	DUSP13	75107991	75108283	0	293	590	2053	590	1760	0.0	0.3352272727272727
chr10	AC010997.3	75280269	75280331	0	63	2118	569	2118	506	0.0	4.1857707509881426
chr10	KCNMA1	76889450	76889569	0	120	35590	29771	35590	29651	0.0	1.2002967859431386
chr10	KCNMA1	77011966	77012043	0	78	35590	29771	35590	29693	0.0	1.1985989963964572
chr10	KCNMA1	77025445	77025457	0	13	35590	29771	35590	29758	0.0	1.1959809126957457
chr10	KCNMA1	77073096	77073252	0	157	35590	29771	35590	29614	0.0	1.2017964476261227
chr10	KCNMA1	77108480	77108572	102	93	35590	29771	35488	29678	1.096774193548387	1.1957679088887392
chr10	KCNMA1	77403861	77404023	0	163	35590	29771	35590	29608	0.0	1.2020399891921103
chr10	KCNMA1	77008184	77008193	0	10	35590	29771	35590	29761	0.0	1.1958603541547663
chr10	KCNMA1	76914056	76914137	0	82	35590	29771	35590	29689	0.0	1.1987604836808246
chr10	KCNMA1	76884988	76885017	0	30	35590	29771	35590	29741	0.0	1.1966645371709088
chr10	KCNMA1	77001406	77001580	0	175	35590	29771	35590	29596	0.0	1.2025273685633193
chr10	KCNMA1	76977542	76977638	34	97	35590	29771	35556	29674	0.35051546391752575	1.1982206645548292
chr10	KCNMA1	77108285	77108377	32	93	35590	29771	35558	29678	0.34408602150537637	1.1981265583934226
chr10	KCNMA1	76974486	76974573	0	88	35590	29771	35590	29683	0.0	1.1990027962133207
chr10	KCNMA1	77012518	77012557	0	40	35590	29771	35590	29731	0.0	1.19706703440853
chr10	KCNMA1	76952036	76952159	0	124	35590	29771	35590	29647	0.0	1.2004587310689108
chr10	KCNMA1	77493797	77493929	0	133	35590	29771	35590	29638	0.0	1.200823267426952
chr10	KCNMA1	77249564	77249679	0	116	35590	29771	35590	29655	0.0	1.2001348845051425
chr10	DLG5	77821081	77822101	0	1021	810	9074	810	8053	0.0	0.10058363342853595
chr10	DLG5	77845210	77845437	0	228	810	9074	810	8846	0.0	0.09156680985756274
chr10	POLR3A	78009536	78009675	0	140	93	8919	93	8779	0.0	0.010593461669894066
chr10	ZMIZ1-AS1	78960504	78960716	0	213	18159	4634	18159	4421	0.0	4.107441755258991
chr10	ZMIZ1-AS1	79066447	79066586	0	140	18159	4634	18159	4494	0.0	4.040720961281709
chr10	ZMIZ1-AS1	79050281	79050417	0	137	18159	4634	18159	4497	0.0	4.038025350233489
chr10	ZMIZ1-AS1	79054595	79054728	0	134	18159	4634	18159	4500	0.0	4.035333333333333
chr10	SFTPA2	79559968	79559998	0	31	105956	2541	105956	2510	0.0	42.21354581673307
chr10	SFTPA2	79559968	79560163	0	196	105956	2541	105956	2345	0.0	45.183795309168445
chr10	SFTPA2	79559667	79559730	0	64	105956	2541	105956	2477	0.0	42.7759386354461
chr10	NUTM2B-AS1	79806038	79806122	0	85	1990601	19359	1990601	19274	0.0	103.27908062675107
chr10	NUTM2B-AS1	79808758	79808832	3232	75	1990601	19359	1987369	19284	43.093333333333334	103.05792366728895
chr10	NUTM2B-AS1	79808758	79808963	5465	206	1990601	19359	1985136	19153	26.52912621359223	103.64621730277241
chr10	NUTM2B-AS1	79808762	79808832	3128	71	1990601	19359	1987473	19288	44.056338028169016	103.04194317710494
chr10	NUTM2B-AS1	79812112	79812177	2990	66	1990601	19359	1987611	19293	45.303030303030305	103.02239154097342
chr10	NUTM2B-AS1	79801949	79802003	886	55	1990601	19359	1989715	19304	16.10909090909091	103.07267923746373
chr10	NUTM2B-AS1	79808762	79808963	5361	202	1990601	19359	1985240	19157	26.53960396039604	103.63000469802161
chr10	TMEM254-AS1	80056318	80056405	0	88	0	3144	0	3056	0.0	0.0
chr10	ANXA11	80157640	80157763	0	124	102	8534	102	8410	0.0	0.012128418549346017
chr10	ANXA11	80176106	80176155	0	50	102	8534	102	8484	0.0	0.012022630834512023
chr10	ANXA11	80180940	80181136	0	197	102	8534	102	8337	0.0	0.012234616768621807
chr10	ANXA11	80171612	80171881	0	270	102	8534	102	8264	0.0	0.012342691190706679
chr10	ANXA11	80156377	80156498	0	122	102	8534	102	8412	0.0	0.012125534950071327
chr10	MAT1A	80283915	80284038	0	124	0	3083	0	2959	0.0	0.0
chr10	DYDC1	80354360	80354483	0	124	0	1245	0	1121	0.0	0.0
chr10	DYDC1	80354360	80354458	0	99	0	1245	0	1146	0.0	0.0
chr10	LRIT2	84222827	84222857	0	31	357	3060	357	3029	0.0	0.11786068009243975
chr10	LINC02647	85419420	85419511	0	92	0	1989	0	1897	0.0	0.0
chr10	GRID1	85619866	85620033	0	168	153	6249	153	6081	0.0	0.025160335471139616
chr10	AL844892.2	86397287	86397455	0	169	0	3563	0	3394	0.0	0.0
chr10	AL844892.2	86397287	86397458	0	172	0	3563	0	3391	0.0	0.0
chr10	WAPL	86451966	86452131	0	166	193	7092	193	6926	0.0	0.027866012128212533
chr10	MMRN2	86945560	86945689	0	130	0	5016	0	4886	0.0	0.0
chr10	NUTM2A-AS1	87246114	87246212	0	99	0	19888	0	19789	0.0	0.0
chr10	NUTM2A-AS1	87307956	87308060	0	105	0	19888	0	19783	0.0	0.0
chr10	NUTM2A-AS1	87333825	87334814	0	990	0	19888	0	18898	0.0	0.0
chr10	NUTM2A-AS1	87330891	87330965	0	75	0	19888	0	19813	0.0	0.0
chr10	NUTM2A-AS1	87330891	87331096	0	206	0	19888	0	19682	0.0	0.0
chr10	NUTM2A-AS1	87291935	87292533	0	599	0	19888	0	19289	0.0	0.0
chr10	NUTM2A-AS1	87329771	87329843	0	73	0	19888	0	19815	0.0	0.0
chr10	RNLS	88572902	88573061	0	160	12753	4798	12753	4638	0.0	2.7496765847347997
chr10	PANK1	89593812	89593989	0	178	5383	7649	5383	7471	0.0	0.7205193414536206
chr10	AL157400.3	89699523	89699671	0	149	3312	3244	3312	3095	0.0	1.070113085621971
chr10	HTR7	90743592	90743690	0	99	0	3476	0	3377	0.0	0.0
chr10	IDE	92463730	92464003	0	274	199	14554	199	14280	0.0	0.013935574229691878
chr10	IDE	92479276	92479421	0	146	199	14554	199	14408	0.0	0.013811771238201
chr10	IDE	92478644	92478789	0	146	199	14554	199	14408	0.0	0.013811771238201
chr10	IDE	92504793	92504897	0	105	199	14554	199	14449	0.0	0.01377257941726071
chr10	IDE	92507574	92507666	0	93	199	14554	199	14461	0.0	0.013761150681142384
chr10	IDE	92483254	92483337	0	84	199	14554	199	14470	0.0	0.013752591568762958
chr10	IDE	92465675	92465843	0	169	199	14554	199	14385	0.0	0.013833854709767118
chr10	IDE	92559033	92559215	0	183	199	14554	199	14371	0.0	0.013847331431354812
chr10	IDE	92465026	92465104	0	79	199	14554	199	14475	0.0	0.013747841105354059
chr10	IDE	92480792	92480916	0	125	199	14554	199	14429	0.0	0.013791669554369673
chr10	IDE	92554880	92554917	0	38	199	14554	199	14516	0.0	0.013709010746762193
chr10	IDE	92462483	92462604	0	122	199	14554	199	14432	0.0	0.01378880266075388
chr10	IDE	92479276	92480916	0	1641	199	14554	199	12913	0.0	0.015410826299078449
chr10	IDE	92554721	92554769	0	49	199	14554	199	14505	0.0	0.013719407100999656
chr10	MYOF	93341912	93341969	0	58	12518	8547	12518	8489	0.0	1.4746142066203323
chr10	MYOF	93323269	93323358	0	90	12518	8547	12518	8457	0.0	1.4801939221946316
chr10	MYOF	93392916	93392955	0	40	12518	8547	12518	8507	0.0	1.471494063712237
chr10	PLCE1-AS2	94106020	94106194	339	175	53606	4224	53267	4049	1.937142857142857	13.155593973820697
chr10	PLCE1-AS2	94108357	94108391	469	35	53606	4224	53137	4189	13.4	12.68488899498687
chr10	PLCE1-AS2	94107066	94107155	0	90	53606	4224	53606	4134	0.0	12.967102080309628
chr10	PLCE1-AS1	94280593	94280629	0	37	1581	2916	1581	2879	0.0	0.549149010072942
chr10	CYP2C8	95068566	95068628	0	63	4825	2543	4825	2480	0.0	1.9455645161290323
chr10	CYP2C8	95067528	95067691	51	164	4825	2543	4774	2379	0.31097560975609756	2.0067255149222363
chr10	CYP2C8	95040921	95040960	0	40	4825	2543	4825	2503	0.0	1.9276867758689573
chr10	PDLIM1	95271632	95271784	7	153	20979	2235	20972	2082	0.0457516339869281	10.073006724303553
chr10	SORBS1	95322745	95322805	0	61	3498	10991	3498	10930	0.0	0.3200365965233303
chr10	SORBS1	95336520	95337294	0	775	3498	10991	3498	10216	0.0	0.34240407204385276
chr10	SORBS1	95351208	95351376	0	169	3498	10991	3498	10822	0.0	0.3232304564775457
chr10	SORBS1	95371325	95371427	0	103	3498	10991	3498	10888	0.0	0.3212711241734019
chr10	SORBS1	95371983	95372049	0	67	3498	10991	3498	10924	0.0	0.32021237641889416
chr10	SORBS1	95406117	95406147	0	31	3498	10991	3498	10960	0.0	0.31916058394160585
chr10	SORBS1	95414493	95414862	51	370	3498	10991	3447	10621	0.13783783783783785	0.3245457113266171
chr10	SORBS1	95422189	95422216	38	28	3498	10991	3460	10963	1.3571428571428572	0.3156070418681018
chr10	SORBS1	95434621	95434717	682	97	3498	10991	2816	10894	7.030927835051546	0.2584909124288599
chr10	SORBS1	95336520	95336805	0	286	3498	10991	3498	10705	0.0	0.3267631947687996
chr10	SORBS1	95386990	95387119	0	130	3498	10991	3498	10861	0.0	0.3220697909953043
chr10	SORBS1	95394610	95394673	0	64	3498	10991	3498	10927	0.0	0.32012446234099023
chr10	SORBS1	95375972	95376056	0	85	3498	10991	3498	10906	0.0	0.32074087658169814
chr10	SORBS1	95355626	95357105	408	1480	3498	10991	3090	9511	0.2756756756756757	0.3248869729786563
chr10	SORBS1	95414493	95414655	0	163	3498	10991	3498	10828	0.0	0.32305134835611377
chr10	SORBS1	95395000	95395075	0	76	3498	10991	3498	10915	0.0	0.32047640861200183
chr10	SORBS1	95351215	95351376	0	162	3498	10991	3498	10829	0.0	0.32302151629882725
chr10	SORBS1	95415468	95416185	204	718	3498	10991	3294	10273	0.2841225626740947	0.32064635452156137
chr10	ENTPD1-AS1	95847391	95847485	0	95	15646	22304	15646	22209	0.0	0.7044891710567788
chr10	ENTPD1-AS1	95904829	95904935	54	107	15646	22304	15592	22197	0.5046728971962616	0.7024372662972473
chr10	ENTPD1-AS1	95878224	95878263	0	40	15646	22304	15646	22264	0.0	0.7027488321954725
chr10	ENTPD1-AS1	95981465	95981593	0	129	15646	22304	15646	22175	0.0	0.7055693348365276
chr10	ENTPD1-AS1	95904829	95904938	57	110	15646	22304	15589	22194	0.5181818181818182	0.7023970442461926
chr10	ENTPD1-AS1	95897557	95897679	1158	123	15646	22304	14488	22181	9.414634146341463	0.6531716333799198
chr10	BLNK	96196907	96197063	0	157	2670	6204	2670	6047	0.0	0.4415412601289896
chr10	BLNK	96215320	96215389	0	70	2670	6204	2670	6134	0.0	0.43527877404629933
chr10	BLNK	96223825	96223989	45	165	2670	6204	2625	6039	0.2727272727272727	0.43467461500248383
chr10	OPALIN	96351377	96351410	0	34	20903	3882	20903	3848	0.0	5.432172557172557
chr10	OPALIN	96355254	96355290	0	37	20903	3882	20903	3845	0.0	5.436410923276983
chr10	TLL2	96432806	96432962	0	157	101924	7697	101924	7540	0.0	13.517771883289125
chr10	ARHGAP19	97256317	97256404	0	88	204	6182	204	6094	0.0	0.033475549721037084
chr10	ARHGAP19	97258659	97258754	0	96	204	6182	204	6086	0.0	0.0335195530726257
chr10	RRP12	97379627	97379770	1305	144	948254	8568	946949	8424	9.0625	112.41084995251661
chr10	RRP12	97390422	97390539	212	118	948254	8568	948042	8450	1.7966101694915255	112.19431952662723
chr10	EXOSC1	97437699	97437750	182	52	9554	1956	9372	1904	3.5	4.9222689075630255
chr10	EXOSC1	97443236	97443311	7129	76	9554	1956	2425	1880	93.80263157894737	1.2898936170212767
chr10	EXOSC1	97437190	97437275	0	86	9554	1956	9554	1870	0.0	5.109090909090909
chr10	MMS19	97459361	97459526	0	166	35	4976	35	4810	0.0	0.007276507276507277
chr10	MMS19	97459361	97459505	0	145	35	4976	35	4831	0.0	0.007244876837093769
chr10	MMS19	97476834	97476963	0	130	35	4976	35	4846	0.0	0.007222451506397029
chr10	MMS19	97484102	97484151	0	50	35	4976	35	4926	0.0	0.007105156313438896
chr10	MMS19	97498272	97498392	0	121	35	4976	35	4855	0.0	0.007209062821833162
chr10	MMS19	97480240	97480357	0	118	35	4976	35	4858	0.0	0.007204610951008645
chr10	MMS19	97476834	97476919	0	86	35	4976	35	4890	0.0	0.007157464212678937
chr10	MORN4	97616677	97616787	0	111	10625	2517	10625	2406	0.0	4.416043225270158
chr10	CRTAC1	97882785	97882828	0	44	3990	3570	3990	3526	0.0	1.1315938740782756
chr10	PYROXD2	98388353	98388508	0	156	0	3885	0	3729	0.0	0.0
chr10	HPS1	98425817	98425985	0	169	216	5322	216	5153	0.0	0.04191732971084805
chr10	HPS1	98429790	98429889	0	100	216	5322	216	5222	0.0	0.04136346227499042
chr10	HPS1	98431130	98431291	0	162	216	5322	216	5160	0.0	0.04186046511627907
chr10	HPS1	98435271	98435414	0	144	216	5322	216	5178	0.0	0.04171494785631518
chr10	HPSE2	98743882	98744056	0	175	18700	4434	18700	4259	0.0	4.390702042733036
chr10	HPSE2	99144237	99144399	0	163	18700	4434	18700	4271	0.0	4.3783657223132755
chr10	HPSE2	98461749	98461819	0	71	18700	4434	18700	4363	0.0	4.286041714416686
chr10	SLC25A28	99613695	99613924	0	230	51	1835	51	1605	0.0	0.03177570093457944
chr10	CWF19L1	100256261	100256476	0	216	0	3999	0	3783	0.0	0.0
chr10	CWF19L1	100260217	100260319	0	103	0	3999	0	3896	0.0	0.0
chr10	SEC31B	100489251	100489398	32	148	51	7409	19	7261	0.21621621621621623	0.002616719460129459
chr10	SEC31B	100490007	100490322	0	316	51	7409	51	7093	0.0	0.007190187508811504
chr10	SEC31B	100497134	100497280	0	147	51	7409	51	7262	0.0	0.007022858716606995
chr10	SEC31B	100498704	100498804	0	101	51	7409	51	7308	0.0	0.0069786535303776685
chr10	SEC31B	100501653	100501710	0	58	51	7409	51	7351	0.0	0.0069378315875391105
chr10	SEC31B	100507424	100507567	0	144	51	7409	51	7265	0.0	0.007019958706125258
chr10	SEC31B	100509315	100509511	0	197	51	7409	51	7212	0.0	0.007071547420965058
chr10	SEC31B	100500109	100500159	0	51	51	7409	51	7358	0.0	0.006931231312856755
chr10	NDUFB8	100526398	100526554	0	157	0	2005	0	1848	0.0	0.0
chr10	AL133352.1	100523976	100524139	0	164	0	2152	0	1988	0.0	0.0
chr10	MRPL43	100987089	100987196	0	108	51	2672	51	2564	0.0	0.019890795631825272
chr10	MRPL43	100983947	100984074	0	128	51	2672	51	2544	0.0	0.020047169811320754
chr10	MRPL43	100986748	100986975	0	228	51	2672	51	2444	0.0	0.020867430441898527
chr10	MRPL43	100984033	100984074	0	42	51	2672	51	2630	0.0	0.019391634980988594
chr10	PDZD7	101030511	101030684	0	174	408	6620	408	6446	0.0	0.06329506670803599
chr10	POLL	101585315	101585478	88	164	6760	5429	6672	5265	0.5365853658536586	1.2672364672364673
chr10	POLL	101587121	101587200	0	80	6760	5429	6760	5349	0.0	1.2637876238549262
chr10	POLL	101584601	101584720	204	120	6760	5429	6556	5309	1.7	1.234884158975325
chr10	POLL	101587245	101587382	0	138	6760	5429	6760	5291	0.0	1.2776412776412776
chr10	FGF8	101775129	101775216	0	88	0	1427	0	1339	0.0	0.0
chr10	FGF8	101775739	101775776	0	38	0	1427	0	1389	0.0	0.0
chr10	NPM3	101782257	101782351	0	95	102	934	102	839	0.0	0.12157330154946365
chr10	NPM3	101782838	101782924	0	87	102	934	102	847	0.0	0.1204250295159386
chr10	OGA	101793912	101793998	0	87	74	5834	74	5747	0.0	0.012876283278232122
chr10	OGA	101806044	101806143	0	100	74	5834	74	5734	0.0	0.012905476107429368
chr10	OGA	101800241	101800400	0	160	74	5834	74	5674	0.0	0.013041945717307015
chr10	KCNIP2	101828150	101828258	0	109	22	2412	22	2303	0.0	0.009552757273122015
chr10	KCNIP2	101828388	101828459	0	72	22	2412	22	2340	0.0	0.009401709401709401
chr10	KCNIP2	101829843	101829897	0	55	22	2412	22	2357	0.0	0.009333899024183284
chr10	KCNIP2	101829843	101829942	0	100	22	2412	22	2312	0.0	0.009515570934256055
chr10	KCNIP2	101831071	101831167	0	97	22	2412	22	2315	0.0	0.009503239740820735
chr10	ARMH3	101993537	101993603	949	67	69531	4773	68582	4706	14.164179104477611	14.573310667233319
chr10	CUEDC2	102425114	102425198	27	85	27	1207	0	1122	0.3176470588235294	0.0
chr10	ACTR1A	102490548	102490613	0	66	56	3747	56	3681	0.0	0.015213257267046998
chr10	ACTR1A	102481836	102481898	0	63	56	3747	56	3684	0.0	0.01520086862106406
chr10	ACTR1A	102482000	102482175	0	176	56	3747	56	3571	0.0	0.0156818818258191
chr10	CYP17A1	102834035	102834122	0	88	51	2831	51	2743	0.0	0.01859278162595698
chr10	CYP17A1	102832992	102833208	0	217	51	2831	51	2614	0.0	0.019510328997704666
chr10	AL358790.1	102851507	102851629	0	123	0	927	0	804	0.0	0.0
chr10	NT5C2	103090610	103090787	0	178	4866	8572	4866	8394	0.0	0.5796997855611151
chr10	NT5C2	103111744	103111805	0	62	4866	8572	4866	8510	0.0	0.5717978848413631
chr10	NT5C2	103139405	103139479	0	75	4866	8572	4866	8497	0.0	0.5726727080145934
chr10	NT5C2	103199407	103199505	0	99	4866	8572	4866	8473	0.0	0.5742948188363035
chr10	NT5C2	103181184	103181328	0	145	4866	8572	4866	8427	0.0	0.5774296902812389
chr10	NT5C2	103098047	103098088	0	42	4866	8572	4866	8530	0.0	0.5704572098475967
chr10	NT5C2	103105357	103105381	0	25	4866	8572	4866	8547	0.0	0.5693225693225693
chr10	NT5C2	103187124	103187246	0	123	4866	8572	4866	8449	0.0	0.5759261451059297
chr10	NT5C2	103111692	103111805	0	114	4866	8572	4866	8458	0.0	0.5753133128399148
chr10	NT5C2	103197764	103197857	0	94	4866	8572	4866	8478	0.0	0.5739561217268223
chr10	NT5C2	103100751	103100964	0	214	4866	8572	4866	8358	0.0	0.5821966977745873
chr10	NT5C2	103100751	103100943	0	193	4866	8572	4866	8379	0.0	0.5807375581811672
chr10	NT5C2	103136248	103136372	102	125	4866	8572	4764	8447	0.816	0.5639872143956435
chr10	NT5C2	103090610	103090638	0	29	4866	8572	4866	8543	0.0	0.5695891373053962
chr10	PCGF6	103347394	103347450	1802	57	34068	3020	32266	2963	31.614035087719298	10.889638879514006
chr10	PCGF6	103330251	103330368	255	118	34068	3020	33813	2902	2.1610169491525424	11.651619572708476
chr10	ATP5MD	103394198	103394394	204	197	204	930	0	733	1.0355329949238579	0.0
chr10	ATP5MD	103395745	103396032	0	288	204	930	204	642	0.0	0.3177570093457944
chr10	CALHM2	103451082	103451285	306	204	10959	2801	10653	2597	1.5	4.1020408163265305
chr10	SH3PXD2A	103622469	103622553	195	85	58445	11774	58250	11689	2.2941176470588234	4.983317649071777
chr10	COL17A1	104074183	104074231	0	49	4518	6693	4518	6644	0.0	0.6800120409391932
chr10	COL17A1	104035262	104035373	0	112	4518	6693	4518	6581	0.0	0.6865218051967786
chr10	COL17A1	104063537	104063643	0	107	4518	6693	4518	6586	0.0	0.686000607348922
chr10	COL17A1	104073950	104074019	0	70	4518	6693	4518	6623	0.0	0.6821682017212743
chr10	CFAP43	104146262	104146349	0	88	172932	7224	172932	7136	0.0	24.233744394618835
chr10	ITPRIP	104334788	104334997	969	210	21343	7302	20374	7092	4.614285714285714	2.8728144388042867
chr10	SORCS1	106579090	106579251	0	162	35	6402	35	6240	0.0	0.005608974358974359
chr10	LINC01435	107901008	107901087	0	80	102	6685	102	6605	0.0	0.015442846328538986
chr10	LINC01435	107859148	107859227	0	80	102	6685	102	6605	0.0	0.015442846328538986
chr10	LINC01435	108053924	108054103	0	180	102	6685	102	6505	0.0	0.015680245964642583
chr10	LINC01435	108053430	108053489	0	60	102	6685	102	6625	0.0	0.01539622641509434
chr10	LINC01435	107873760	107873852	0	93	102	6685	102	6592	0.0	0.015473300970873786
chr10	LINC01435	107903081	107903166	0	86	102	6685	102	6599	0.0	0.015456887407182906
chr10	LINC01435	108060611	108060755	0	145	102	6685	102	6540	0.0	0.015596330275229359
chr10	XPNPEP1	109880187	109880238	0	52	474	6715	474	6663	0.0	0.07113912651958577
chr10	XPNPEP1	109886245	109886341	0	97	474	6715	474	6618	0.0	0.07162284678150499
chr10	XPNPEP1	109888048	109888192	0	145	474	6715	474	6570	0.0	0.07214611872146119
chr10	XPNPEP1	109875527	109875599	0	73	474	6715	474	6642	0.0	0.07136404697380307
chr10	XPNPEP1	109891721	109891826	0	106	474	6715	474	6609	0.0	0.07172038129822969
chr10	XPNPEP1	109893011	109893075	0	65	474	6715	474	6650	0.0	0.0712781954887218
chr10	XPNPEP1	109907690	109907815	0	126	474	6715	474	6589	0.0	0.07193807861587494
chr10	XPNPEP1	109915010	109915099	0	90	474	6715	474	6625	0.0	0.07154716981132075
chr10	XPNPEP1	109915022	109915099	0	78	474	6715	474	6637	0.0	0.0714178092511677
chr10	ADD3-AS1	109997448	109997575	0	128	0	7304	0	7176	0.0	0.0
chr10	ADD3-AS1	109951843	109951965	0	123	0	7304	0	7181	0.0	0.0
chr10	SMNDC1	110300546	110300736	0	191	0	5412	0	5221	0.0	0.0
chr10	BBIP1	110901537	110901612	0	76	51	7695	51	7619	0.0	0.0066937918361989765
chr10	BBIP1	110918120	110918213	0	94	51	7695	51	7601	0.0	0.006709643467964741
chr10	BBIP1	110908523	110908551	0	29	51	7695	51	7666	0.0	0.006652752413253326
chr10	BBIP1	110901025	110901279	0	255	51	7695	51	7440	0.0	0.0068548387096774195
chr10	BBIP1	110907679	110907836	0	158	51	7695	51	7537	0.0	0.006766618017778957
chr10	BBIP1	110910749	110911039	0	291	51	7695	51	7404	0.0	0.006888168557536467
chr10	BBIP1	110901025	110901122	0	98	51	7695	51	7597	0.0	0.006713176253784389
chr10	GUCY2GP	112339998	112340036	0	39	12891	3290	12891	3251	0.0	3.9652414641648726
chr10	AL157786.1	112408401	112408694	0	294	0	2873	0	2579	0.0	0.0
chr10	NRAP	113642933	113643038	0	106	0	5711	0	5605	0.0	0.0
chr10	CCDC186	114125885	114126105	0	221	203	9021	203	8800	0.0	0.023068181818181818
chr10	CCDC186	114173140	114173265	0	126	203	9021	203	8895	0.0	0.022821810005621137
chr10	AFAP1L2	114398850	114398904	0	55	173	5809	173	5754	0.0	0.030066041014946126
chr10	ABLIM1	114447879	114448020	47	142	6431	10244	6384	10102	0.33098591549295775	0.6319540685012869
chr10	ABLIM1	114485296	114485380	0	85	6431	10244	6431	10159	0.0	0.6330347475145192
chr10	ABLIM1	114453378	114453483	0	106	6431	10244	6431	10138	0.0	0.6343460248569738
chr10	ABLIM1	114473878	114473956	0	79	6431	10244	6431	10165	0.0	0.6326610919822921
chr10	ABLIM1	114447879	114448026	47	148	6431	10244	6384	10096	0.31756756756756754	0.6323296354992076
chr10	ABLIM1	114463044	114463164	0	121	6431	10244	6431	10123	0.0	0.6352859824162798
chr10	ABLIM1	114481478	114481526	0	49	6431	10244	6431	10195	0.0	0.6307994114762139
chr10	GFRA1	116211630	116211645	0	16	28913	9508	28913	9492	0.0	3.0460387694900968
chr10	HSPA12A	116681790	116681877	0	88	23844	21134	23844	21046	0.0	1.132946878266654
chr10	HSPA12A	116705150	116705278	0	129	23844	21134	23844	21005	0.0	1.1351582956438944
chr10	HSPA12A	116707199	116707285	0	87	23844	21134	23844	21047	0.0	1.1328930488905782
chr10	HSPA12A	116834934	116835022	0	89	23844	21134	23844	21045	0.0	1.133000712758375
chr10	HSPA12A	116705150	116705376	0	227	23844	21134	23844	20907	0.0	1.1404792653178362
chr10	SHTN1	116979255	116979308	0	54	9201	8273	9201	8219	0.0	1.1194792553838666
chr10	AL513324.1	117828804	117828915	0	112	0	2042	0	1930	0.0	0.0
chr10	AL513324.1	117827598	117828198	0	601	0	2042	0	1441	0.0	0.0
chr10	RAB11FIP2	118033981	118034041	0	61	0	5673	0	5612	0.0	0.0
chr10	FAM204A	118335395	118335426	0	32	0	3598	0	3566	0.0	0.0
chr10	FAM204A	118341726	118341927	0	202	0	3598	0	3396	0.0	0.0
chr10	FAM204A	118322304	118322411	0	108	0	3598	0	3490	0.0	0.0
chr10	CACUL1	118693701	118693749	0	49	5520	12418	5520	12369	0.0	0.4462769827795295
chr10	SFXN4	119146235	119146353	0	119	0	1930	0	1811	0.0	0.0
chr10	SFXN4	119161054	119161081	0	28	0	1930	0	1902	0.0	0.0
chr10	TIAL1	119580470	119580846	0	377	62	6812	62	6435	0.0	0.009634809634809635
chr10	TIAL1	119580470	119580538	0	69	62	6812	62	6743	0.0	0.009194720450837905
chr10	WDR11-AS1	120791727	120791926	0	200	47252	6721	47252	6521	0.0	7.24612789449471
chr10	WDR11-AS1	120830218	120830343	800	126	47252	6721	46452	6595	6.349206349206349	7.043517816527673
chr10	WDR11-AS1	120808232	120808341	0	110	47252	6721	47252	6611	0.0	7.147481470276811
chr10	WDR11-AS1	120791313	120791597	84	285	47252	6721	47168	6436	0.29473684210526313	7.328775637041641
chr10	FGFR2	121483697	121483803	0	107	89910	7609	89910	7502	0.0	11.984804052252732
chr10	FGFR2	121565437	121565704	0	268	89910	7609	89910	7341	0.0	12.247650183898651
chr10	FGFR2	121564501	121564579	0	79	89910	7609	89910	7530	0.0	11.9402390438247
chr10	FGFR2	121517318	121517463	0	146	89910	7609	89910	7463	0.0	12.047434007771674
chr10	FGFR2	121518681	121518829	31	149	89910	7609	89879	7460	0.2080536912751678	12.048123324396784
chr10	FGFR2	121517466	121517472	0	7	89910	7609	89910	7602	0.0	11.827150749802684
chr10	FGFR2	121565636	121565704	0	69	89910	7609	89910	7540	0.0	11.924403183023873
chr10	ATE1	121898840	121898969	0	130	51	5400	51	5270	0.0	0.00967741935483871
chr10	ATE1	121899865	121899994	0	130	51	5400	51	5270	0.0	0.00967741935483871
chr10	NSMCE4A	121961840	121962107	0	268	1573	3380	1573	3112	0.0	0.5054627249357326
chr10	AC063960.2	122152509	122152814	0	306	0	4404	0	4098	0.0	0.0
chr10	CUZD1	122841177	122841328	0	152	0	2846	0	2694	0.0	0.0
chr10	FAM24B	122850423	122850550	0	128	0	1181	0	1053	0.0	0.0
chr10	FAM24B	122850423	122850520	0	98	0	1181	0	1083	0.0	0.0
chr10	IKZF5	123007025	123007176	0	152	51	4668	51	4516	0.0	0.011293179805137289
chr10	OAT	124411972	124412200	0	229	0	3121	0	2892	0.0	0.0
chr10	EEF1AKMT2	124762299	124762558	0	260	30241	5827	30241	5567	0.0	5.4321896892401655
chr10	CTBP2	125110989	125111093	0	105	924	9202	924	9097	0.0	0.10157194679564692
chr10	CTBP2	125133511	125133612	0	102	924	9202	924	9100	0.0	0.10153846153846154
chr10	CTBP2	125088190	125088319	0	130	924	9202	924	9072	0.0	0.10185185185185185
chr10	EDRF1-DT	125711473	125711588	0	116	98	3240	98	3124	0.0	0.03137003841229193
chr10	EDRF1-AS1	125749374	125749528	0	155	51	1922	51	1767	0.0	0.028862478777589132
chr10	EDRF1-AS1	125749374	125749646	0	273	51	1922	51	1649	0.0	0.030927835051546393
chr10	EDRF1-AS1	125749374	125749547	0	174	51	1922	51	1748	0.0	0.02917620137299771
chr10	MMP21	125772610	125772750	0	141	0	3450	0	3309	0.0	0.0
chr10	MMP21	125767531	125767704	0	174	0	3450	0	3276	0.0	0.0
chr10	MMP21	125772217	125772359	0	143	0	3450	0	3307	0.0	0.0
chr10	UROS	125789282	125789528	0	247	2142	8118	2142	7871	0.0	0.27213822894168466
chr10	UROS	125798064	125798145	174	82	2142	8118	1968	8036	2.1219512195121952	0.24489795918367346
chr10	UROS	125816176	125816260	0	85	2142	8118	2142	8033	0.0	0.2666500684675713
chr10	UROS	125795061	125795158	0	98	2142	8118	2142	8020	0.0	0.26708229426433916
chr10	UROS	125789282	125789363	0	82	2142	8118	2142	8036	0.0	0.2665505226480836
chr10	UROS	125802949	125803024	0	76	2142	8118	2142	8042	0.0	0.26635165381745834
chr10	UROS	125796789	125796861	0	73	2142	8118	2142	8045	0.0	0.26625233064014914
chr10	UROS	125802988	125803024	0	37	2142	8118	2142	8081	0.0	0.2650662046776389
chr10	UROS	125792578	125792744	0	167	2142	8118	2142	7951	0.0	0.269400075462206
chr10	UROS	125794021	125794388	0	368	2142	8118	2142	7750	0.0	0.27638709677419354
chr10	UROS	125797411	125797425	0	15	2142	8118	2142	8103	0.0	0.26434653831914107
chr10	C10ORF90	126464695	126464986	2144	292	44206	5430	42062	5138	7.342465753424658	8.186453873102375
chr10	C10ORF90	126512022	126512116	51	95	44206	5430	44155	5335	0.5368421052631579	8.27647610121837
chr10	AL359094.1	127015009	127015163	0	155	0	4247	0	4092	0.0	0.0
chr10	AL359094.1	127015922	127016097	0	176	0	4247	0	4071	0.0	0.0
chr10	AL359094.1	127007410	127007573	0	164	0	4247	0	4083	0.0	0.0
chr10	AL359094.1	127016497	127016581	0	85	0	4247	0	4162	0.0	0.0
chr10	AL359094.1	127018587	127018657	0	71	0	4247	0	4176	0.0	0.0
chr10	AL359094.1	127018587	127018960	0	374	0	4247	0	3873	0.0	0.0
chr10	INSYN2A	127153851	127153923	0	73	51	4846	51	4773	0.0	0.010685103708359522
chr10	MKI67	128114927	128116007	408	1081	6314	12634	5906	11553	0.3774283071230342	0.5112092097290747
chr10	AL157832.2	129694118	129694315	0	198	1224	2125	1224	1927	0.0	0.6351842241826674
chr10	EBF3	129839082	129839195	96	114	5757	5469	5661	5355	0.8421052631578947	1.0571428571428572
chr10	CFAP46	132810584	132810721	0	138	51	10758	51	10620	0.0	0.00480225988700565
chr10	MIR202HG	133247553	133247701	0	149	102	1310	102	1161	0.0	0.08785529715762273
chr10	ADAM8	133263687	133263765	0	79	0	4784	0	4705	0.0	0.0
chr10	ADAM8	133269896	133269974	0	79	0	4784	0	4705	0.0	0.0
chr10	ADAM8	133275483	133275587	0	105	0	4784	0	4679	0.0	0.0
chr10	ADAM8	133274795	133274990	0	196	0	4784	0	4588	0.0	0.0
chr10	TUBGCP2	133302791	133302980	0	190	59	7717	59	7527	0.0	0.007838448252956026
chr10	TUBGCP2	133297320	133297404	59	85	59	7717	0	7632	0.6941176470588235	0.0
chr10	FUOM	133357186	133357255	0	70	0	1277	0	1207	0.0	0.0
chr10	ZMYND11	221194	221356	0	163	565	5345	565	5182	0.0	0.10903126206098032
chr10	ZMYND11	237584	237677	0	94	565	5345	565	5251	0.0	0.10759855265663683
chr10	ZMYND11	240892	240970	0	79	565	5345	565	5266	0.0	0.10729206228636537
chr10	ZMYND11	218454	218499	0	46	565	5345	565	5299	0.0	0.10662389130024533
chr10	ZMYND11	197910	198005	361	96	565	5345	204	5249	3.7604166666666665	0.03886454562773862
chr10	PRR26	665955	666103	0	149	2550	6630	2550	6481	0.0	0.3934577997222651
chr10	GTPBP4	995928	996032	0	105	10426	6138	10426	6033	0.0	1.728161776893751
chr10	IDI2-AS1	1035813	1035976	0	164	41195	3053	41195	2889	0.0	14.25925925925926
chr10	IDI2-AS1	1035289	1035422	0	134	41195	3053	41195	2919	0.0	14.112709832134293
chr10	IDI2-AS1	1035289	1035506	204	218	41195	3053	40991	2835	0.9357798165137615	14.458906525573193
chr10	AL713851.1	2559890	2560007	0	118	0	4358	0	4240	0.0	0.0
chr10	AL713851.1	2559334	2559407	0	74	0	4358	0	4284	0.0	0.0
chr10	PFKP	3103778	3103944	0	167	6806	6142	6806	5975	0.0	1.1390794979079497
chr10	PFKP	3100920	3101000	0	81	6806	6142	6806	6061	0.0	1.1229170103943245
chr10	PITRM1-AS1	3142971	3143088	408	118	735417	4376	735009	4258	3.457627118644068	172.61836542977923
chr10	LINC02660	3932655	3932972	36	318	36	1114	0	796	0.11320754716981132	0.0
chr10	LINC02660	3934519	3934627	0	109	36	1114	36	1005	0.0	0.03582089552238806
chr10	LINC00705	4659230	4659348	0	119	0	3203	0	3084	0.0	0.0
chr10	LINC00705	4671475	4671659	0	185	0	3203	0	3018	0.0	0.0
chr10	AKR1E2	4824961	4825038	0	78	0	2430	0	2352	0.0	0.0
chr10	AKR1E2	4833349	4833466	0	118	0	2430	0	2312	0.0	0.0
chr10	AKR1E2	4830674	4830842	0	169	0	2430	0	2261	0.0	0.0
chr10	AKR1E2	4837458	4837581	0	124	0	2430	0	2306	0.0	0.0
chr10	AKR1C3	5077899	5077977	0	79	306	3925	306	3846	0.0	0.07956318252730109
chr10	TASOR2	5735303	5735546	0	244	17156	10604	17156	10360	0.0	1.655984555984556
chr10	TASOR2	5709529	5709663	377	135	17156	10604	16779	10469	2.7925925925925927	1.6027318750597002
chr10	TASOR2	5714134	5714207	0	74	17156	10604	17156	10530	0.0	1.629249762583096
chr10	TASOR2	5717658	5717750	0	93	17156	10604	17156	10511	0.0	1.6321948434972886
chr10	TASOR2	5712393	5712539	0	147	17156	10604	17156	10457	0.0	1.6406235057855982
chr10	FBH1	5903019	5903175	3009	157	34128	6628	31119	6471	19.1656050955414	4.808993973110802
chr10	FBH1	5924750	5924801	1646	52	34128	6628	32482	6576	31.653846153846153	4.939476885644769
chr10	RBM17	6097047	6097188	0	142	0	6244	0	6102	0.0	0.0
chr10	PFKFB3	6221640	6221745	1124	106	18330	6138	17206	6032	10.60377358490566	2.852453580901857
chr10	PFKFB3	6226191	6226365	46	175	18330	6138	18284	5963	0.26285714285714284	3.0662418245849405
chr10	PFKFB3	6225160	6225248	130	89	18330	6138	18200	6049	1.4606741573033708	3.0087617788064143
chr10	PFKFB3	6231262	6231314	180	53	18330	6138	18150	6085	3.3962264150943398	2.9827444535743632
chr10	PFKFB3	6228195	6228218	72	24	18330	6138	18258	6114	3.0	2.986261040235525
chr10	PFKFB3	6229108	6229180	0	73	18330	6138	18330	6065	0.0	3.0222588623248146
chr10	PFKFB3	6224505	6224623	204	119	18330	6138	18126	6019	1.7142857142857142	3.011463698288752
chr10	LINC02649	6331500	6331603	0	104	6617	5103	6617	4999	0.0	1.3236647329465894
chr10	PRKCQ-AS1	6582137	6582201	0	65	102	5311	102	5246	0.0	0.019443385436523065
chr10	PRKCQ-AS1	6586762	6586880	102	119	102	5311	0	5192	0.8571428571428571	0.0
chr10	PRKCQ-AS1	6585557	6585712	0	156	102	5311	102	5155	0.0	0.019786614936954414
chr10	PRKCQ-AS1	6596845	6596894	0	50	102	5311	102	5261	0.0	0.019387949059114236
chr10	PRKCQ-AS1	6584117	6584195	0	79	102	5311	102	5232	0.0	0.0194954128440367
chr10	PRKCQ-AS1	6585797	6585846	0	50	102	5311	102	5261	0.0	0.019387949059114236
chr10	PRKCQ-AS1	6615369	6615637	0	269	102	5311	102	5042	0.0	0.02023006743355811
chr10	LINC00707	6812249	6812556	0	308	89	9845	89	9537	0.0	0.009332075076019714
chr10	LINC00707	6817048	6817126	0	79	89	9845	89	9766	0.0	0.009113250051198033
chr10	ITIH2	7705107	7705182	0	76	0	3352	0	3276	0.0	0.0
chr10	ITIH2	7707200	7707233	0	34	0	3352	0	3318	0.0	0.0
chr10	ITIH2	7709021	7709191	0	171	0	3352	0	3181	0.0	0.0
chr10	ATP5F1C	7806973	7807010	0	38	7139	2320	7139	2282	0.0	3.1283961437335672
chr10	ATP5F1C	7796120	7796155	120	36	7139	2320	7019	2284	3.3333333333333335	3.073117338003503
chr10	GATA3	8063992	8064138	0	147	11081	3404	11081	3257	0.0	3.4022106232729508
chr10	GATA3	8063995	8064138	0	144	11081	3404	11081	3260	0.0	3.399079754601227
chr10	CELF2	11217424	11217507	0	84	0	9833	0	9749	0.0	0.0
chr10	CELF2	11266597	11266677	0	81	0	9833	0	9752	0.0	0.0
chr10	CELF2	11325835	11325979	0	145	0	9833	0	9688	0.0	0.0
chr10	CELF2	10846062	10846156	0	95	0	9833	0	9738	0.0	0.0
chr10	CELF2	11320856	11320898	0	43	0	9833	0	9790	0.0	0.0
chr10	DHTKD1	12084539	12084751	0	213	4057	5312	4057	5099	0.0	0.7956462051382625
chr10	DHTKD1	12087534	12087729	0	196	4057	5312	4057	5116	0.0	0.7930023455824863
chr10	DHTKD1	12106245	12106396	0	152	4057	5312	4057	5160	0.0	0.7862403100775194
chr10	SEC61A2	12136104	12136170	24748	67	503893	3933	479145	3866	369.3731343283582	123.93817899637868
chr10	SEC61A2	12155777	12155931	399	155	503893	3933	503494	3778	2.574193548387097	133.26998411858125
chr10	SEC61A2	12157907	12158105	16	199	503893	3933	503877	3734	0.08040201005025126	134.9429566148902
chr10	SEC61A2	12167752	12167893	30	142	503893	3933	503863	3791	0.2112676056338028	132.9103139013453
chr10	SEC61A2	12149851	12149961	21776	111	503893	3933	482117	3822	196.18018018018017	126.14259549973836
chr10	SEC61A2	12156906	12157067	1173	162	503893	3933	502720	3771	7.2407407407407405	133.31211880137894
chr10	SEC61A2	12160929	12161121	0	193	503893	3933	503893	3740	0.0	134.7307486631016
chr10	CDC123	12215739	12215835	40146	97	49683	2312	9537	2215	413.87628865979383	4.305643340857788
chr10	CDC123	12237143	12237266	24	124	49683	2312	49659	2188	0.1935483870967742	22.696069469835468
chr10	CDC123	12246148	12246277	34	130	49683	2312	49649	2182	0.26153846153846155	22.753895508707608
chr10	CDC123	12249580	12249718	0	139	49683	2312	49683	2173	0.0	22.863782788771285
chr10	CAMK1D	12553224	12553356	0	133	5751	8709	5751	8576	0.0	0.6705923507462687
chr10	OPTN	13110273	13110476	0	204	3345	5158	3345	4954	0.0	0.6752119499394429
chr10	OPTN	13108137	13108289	0	153	3345	5158	3345	5005	0.0	0.6683316683316683
chr10	OPTN	13110179	13110476	0	298	3345	5158	3345	4860	0.0	0.6882716049382716
chr10	OPTN	13108961	13109015	0	55	3345	5158	3345	5103	0.0	0.6554967666078777
chr10	MCM10	13164127	13164209	0	83	52650	5383	52650	5300	0.0	9.933962264150944
chr10	PRPF18	13591767	13591888	0	122	0	1856	0	1734	0.0	0.0
chr10	PRPF18	13597644	13597671	0	28	0	1856	0	1828	0.0	0.0
chr10	AL157392.3	13643487	13643765	0	279	14329	9029	14329	8750	0.0	1.6376
chr10	AL157392.3	13652407	13652489	0	83	14329	9029	14329	8946	0.0	1.6017214397496087
chr10	AL157392.3	13647132	13647276	0	145	14329	9029	14329	8884	0.0	1.6128995947771274
chr10	AL157392.3	13648625	13648768	0	144	14329	9029	14329	8885	0.0	1.612718064153067
chr10	AL157392.3	13648084	13648230	0	147	14329	9029	14329	8882	0.0	1.6132627786534564
chr10	AL157392.3	13652845	13652882	60	38	14329	9029	14269	8991	1.5789473684210527	1.5870314759203648
chr10	AL157392.3	13642027	13642155	0	129	14329	9029	14329	8900	0.0	1.61
chr10	AL157392.3	13646614	13646780	0	167	14329	9029	14329	8862	0.0	1.6169036334913112
chr10	AL157392.3	13654352	13654427	0	76	14329	9029	14329	8953	0.0	1.6004691164972635
chr10	AL157392.3	13652845	13652929	102	85	14329	9029	14227	8944	1.2	1.590675313059034
chr10	AL157392.3	13648619	13648768	0	150	14329	9029	14329	8879	0.0	1.6138078612456357
chr10	AL157392.3	13651369	13651426	0	58	14329	9029	14329	8971	0.0	1.597257830788095
chr10	AL157392.3	13652845	13653148	204	304	14329	9029	14125	8725	0.6710526315789473	1.6189111747851004
chr10	AL157392.3	13654088	13654258	51	171	14329	9029	14278	8858	0.2982456140350877	1.6118762700383833
chr10	AC069544.2	14842133	14842846	0	714	102	4769	102	4055	0.0	0.025154130702836005
chr10	SUV39H2	14881499	14881645	335	147	6896	3572	6561	3425	2.2789115646258504	1.9156204379562043
chr10	SUV39H2	14896845	14896977	1683	133	6896	3572	5213	3439	12.654135338345865	1.5158476301250363
chr10	SUV39H2	14896845	14897517	1683	673	6896	3572	5213	2899	2.50074294205052	1.798206278026906
chr10	MEIG1	14966439	14966606	216	168	2767	1428	2551	1260	1.2857142857142858	2.0246031746031745
chr10	OLAH	15071794	15071877	0	84	564	2300	564	2216	0.0	0.2545126353790614
chr10	OLAH	15056823	15056982	0	160	564	2300	564	2140	0.0	0.2635514018691589
chr10	RPP38	15102217	15102336	0	120	587	1880	587	1760	0.0	0.33352272727272725
chr10	LINC02654	16283732	16283908	0	177	0	2554	0	2377	0.0	0.0
chr10	LINC02654	16283729	16283908	0	180	0	2554	0	2374	0.0	0.0
chr10	LINC02654	16283735	16283908	0	174	0	2554	0	2380	0.0	0.0
chr10	PTER	16484336	16484816	0	481	2907	4009	2907	3528	0.0	0.8239795918367347
chr10	PTER	16505019	16505160	0	142	2907	4009	2907	3867	0.0	0.7517455391776571
chr10	PTER	16437356	16437490	0	135	2907	4009	2907	3874	0.0	0.7503871966959216
chr10	STAM	17672974	17673078	0	105	10880	4145	10880	4040	0.0	2.6930693069306932
chr10	SLC39A12	17993180	17993291	0	112	1275	2821	1275	2709	0.0	0.4706533776301218
chr10	SLC39A12	17953190	17953537	0	348	1275	2821	1275	2473	0.0	0.5155681358673676
chr10	SLC39A12	17993183	17993291	0	109	1275	2821	1275	2712	0.0	0.47013274336283184
chr10	CACNB2	18514235	18514369	0	135	104	11186	104	11051	0.0	0.009410913039543932
chr10	CACNB2	18536100	18536196	0	97	104	11186	104	11089	0.0	0.009378663540445486
chr10	CACNB2	18514979	18515041	0	63	104	11186	104	11123	0.0	0.009349995504809853
chr10	CACNB2	18506470	18506547	0	78	104	11186	104	11108	0.0	0.009362621534029529
chr10	CACNB2	18514510	18514530	0	21	104	11186	104	11165	0.0	0.009314823107926556
chr10	CACNB2	18522184	18522238	0	55	104	11186	104	11131	0.0	0.009343275536789148
chr10	MALRD1	19389182	19389362	0	181	0	7797	0	7616	0.0	0.0
chr10	PLXDC2	20046868	20047015	0	148	561	12582	561	12434	0.0	0.0451182242239022
chr10	MLLT10	21586293	21586348	0	56	306	8958	306	8902	0.0	0.03437429791058189
chr10	MLLT10	21534644	21534804	0	161	306	8958	306	8797	0.0	0.0347845856542003
chr10	MLLT10	21538832	21538912	0	81	306	8958	306	8877	0.0	0.03447110510307536
chr10	MLLT10	21682224	21682257	0	34	306	8958	306	8924	0.0	0.03428955625280143
chr10	MLLT10	21557620	21557824	0	205	306	8958	306	8753	0.0	0.034959442476865075
chr10	MLLT10	21668916	21669052	0	137	306	8958	306	8821	0.0	0.03468994445074255
chr10	MLLT10	21688490	21688538	0	49	306	8958	306	8909	0.0	0.03434728925805365
chr10	MLLT10	21551815	21551921	0	107	306	8958	306	8851	0.0	0.03457236470455316
chr10	MLLT10	21708587	21708657	0	71	306	8958	306	8887	0.0	0.034432316867334306
chr10	MLLT10	21571974	21572026	0	53	306	8958	306	8905	0.0	0.034362717574396406
chr10	MLLT10	21541262	21541361	0	100	306	8958	306	8858	0.0	0.03454504402799729
chr10	COMMD3	22317883	22317995	0	113	0	1905	0	1792	0.0	0.0
chr10	COMMD3	22318271	22318306	0	36	0	1905	0	1869	0.0	0.0
chr10	COMMD3	22318958	22319018	0	61	0	1905	0	1844	0.0	0.0
chr10	COMMD3	22317856	22317995	0	140	0	1905	0	1765	0.0	0.0
chr10	COMMD3	22318104	22318168	0	65	0	1905	0	1840	0.0	0.0
chr10	SPAG6	22412444	22412523	0	80	1248	3848	1248	3768	0.0	0.33121019108280253
chr10	SPAG6	22364852	22365019	0	168	1248	3848	1248	3680	0.0	0.3391304347826087
chr10	SPAG6	22411030	22411176	0	147	1248	3848	1248	3701	0.0	0.33720616049716295
chr10	ARMC3	22955806	22955932	0	127	4207	5988	4207	5861	0.0	0.7177955980208156
chr10	ARMC3	22946143	22946261	0	119	4207	5988	4207	5869	0.0	0.716817174987221
chr10	ARMC3	22961883	22962078	0	196	4207	5988	4207	5792	0.0	0.7263466850828729
chr10	ARMC3	22959398	22959574	0	177	4207	5988	4207	5811	0.0	0.7239717776630529
chr10	MSRB2	23119045	23119134	0	90	0	1985	0	1895	0.0	0.0
chr10	KIAA1217	24494499	24494604	0	106	802	10748	802	10642	0.0	0.07536177410261229
chr10	KIAA1217	24542692	24542770	0	79	802	10748	802	10669	0.0	0.0751710563314275
chr10	KIAA1217	24536773	24536893	0	121	802	10748	802	10627	0.0	0.07546814717229698
chr10	KIAA1217	24542882	24544481	190	1600	802	10748	612	9148	0.11875	0.06689986882378662
chr10	KIAA1217	24367118	24367168	0	51	802	10748	802	10697	0.0	0.07497429185753014
chr10	KIAA1217	24542506	24542542	0	37	802	10748	802	10711	0.0	0.07487629539725515
chr10	LINC00836	25652868	25653042	0	175	0	9665	0	9490	0.0	0.0
chr10	LINC00836	25668215	25668330	0	116	0	9665	0	9549	0.0	0.0
chr10	LINC00836	25686576	25686640	0	65	0	9665	0	9600	0.0	0.0
chr10	LINC00836	25695866	25695953	0	88	0	9665	0	9577	0.0	0.0
chr10	LINC00836	25716744	25716981	0	238	0	9665	0	9427	0.0	0.0
chr10	LINC00836	25682520	25683482	0	963	0	9665	0	8702	0.0	0.0
chr10	MYO3A	26120675	26120802	0	128	255	8475	255	8347	0.0	0.03054989816700611
chr10	MYO3A	26202963	26203107	0	145	255	8475	255	8330	0.0	0.030612244897959183
chr10	FAM238A	26592849	26592966	0	118	51	1095	51	977	0.0	0.052200614124872056
chr10	FAM238B	26648950	26649050	0	101	0	1292	0	1191	0.0	0.0
chr10	PDSS1	26740644	26740817	0	174	0	1927	0	1753	0.0	0.0
chr10	MASTL	27180952	27181066	0	115	0	4672	0	4557	0.0	0.0
chr10	MASTL	27181479	27181581	0	103	0	4672	0	4569	0.0	0.0
chr10	RAB18	27533927	27533994	943	68	13784	6111	12841	6043	13.867647058823529	2.124937944729439
chr10	RAB18	27531528	27531615	0	88	13784	6111	13784	6023	0.0	2.2885605180142785
chr10	WAC	28595732	28596041	0	310	102	10128	102	9818	0.0	0.010389081279282949
chr10	WAC	28534233	28534346	0	114	102	10128	102	10014	0.0	0.01018573996405033
chr10	WAC	28611254	28611481	0	228	102	10128	102	9900	0.0	0.010303030303030303
chr10	LINC01517	28901176	28901314	408	139	122627	8684	122219	8545	2.935251798561151	14.302984201287302
chr10	LINC01517	28907439	28907564	0	126	122627	8684	122627	8558	0.0	14.328931993456415
chr10	LINC01517	28802899	28803046	0	148	122627	8684	122627	8536	0.0	14.365862230552953
chr10	LINC01517	28805107	28805258	184	152	122627	8684	122443	8532	1.2105263157894737	14.351031411157994
chr10	LINC01517	28806931	28807022	22	92	122627	8684	122605	8592	0.2391304347826087	14.269669459962756
chr10	LINC01517	28848215	28848366	0	152	122627	8684	122627	8532	0.0	14.37259728082513
chr10	SVIL-AS1	29418181	29418304	0	124	918	5005	918	4881	0.0	0.1880762138905962
chr10	SVIL-AS1	29458273	29458520	0	248	918	5005	918	4757	0.0	0.19297876813117512
chr10	MAP3K8	30437175	30437406	0	232	0	3527	0	3295	0.0	0.0
chr10	SVIL2P	30698116	30698241	0	126	0	3253	0	3127	0.0	0.0
chr10	LINC02664	31206741	31206864	0	124	1734	1651	1734	1527	0.0	1.1355599214145382
chr10	LINC02664	31248526	31248593	0	68	1734	1651	1734	1583	0.0	1.0953885028427037
chr10	ZEB1	31495775	31495838	0	64	1468	8673	1468	8609	0.0	0.17051922406783598
chr10	ZEB1	31495778	31495838	0	61	1468	8673	1468	8612	0.0	0.1704598235020901
chr10	ZEB1	31461036	31461237	0	202	1468	8673	1468	8471	0.0	0.17329713138944636
chr10	ZEB1	31502347	31502509	0	163	1468	8673	1468	8510	0.0	0.172502937720329
chr10	ZEB1	31387123	31387266	0	144	1468	8673	1468	8529	0.0	0.1721186540039864
chr10	ZEB1	31373017	31373173	0	157	1468	8673	1468	8516	0.0	0.17238139971817754
chr10	AL161935.1	31604255	31604414	580	160	72846	2434	72266	2274	3.625	31.7792436235708
chr10	CCDC7	32471063	32471230	0	168	9680	8667	9680	8499	0.0	1.138957524414637
chr10	CCDC7	32571858	32571893	0	36	9680	8667	9680	8631	0.0	1.121538639786815
chr10	CCDC7	32491921	32491997	0	77	9680	8667	9680	8590	0.0	1.1268917345750873
chr10	CCDC7	32694878	32694992	0	115	9680	8667	9680	8552	0.0	1.1318989710009355
chr10	CCDC7	32778976	32779084	135	109	9680	8667	9545	8558	1.238532110091743	1.115330684739425
chr10	CCDC7	32845242	32845326	0	85	9680	8667	9680	8582	0.0	1.127942204614309
chr10	CCDC7	32574428	32574526	714	99	9680	8667	8966	8568	7.212121212121212	1.046451914098973
chr10	ITGB1-DT	32960969	32961062	0	94	5245	3238	5245	3144	0.0	1.6682569974554708
chr10	AL450313.1	33687039	33687151	0	113	0	1990	0	1877	0.0	0.0
chr10	CREM	35137781	35137879	0	99	170	5551	170	5452	0.0	0.031181217901687455
chr10	CREM	35175852	35175999	0	148	170	5551	170	5403	0.0	0.03146400148065889
chr10	CREM	35148367	35148491	0	125	170	5551	170	5426	0.0	0.03133063029856248
chr10	CREM	35188199	35188388	0	190	170	5551	170	5361	0.0	0.031710501772057455
chr10	CREM	35201450	35201486	0	37	170	5551	170	5514	0.0	0.030830612985128764
chr10	CREM	35179133	35179276	51	144	170	5551	119	5407	0.3541666666666667	0.022008507490290364
chr10	CREM	35178888	35178986	0	99	170	5551	170	5452	0.0	0.031181217901687455
chr10	CREM	35178871	35178986	0	116	170	5551	170	5435	0.0	0.031278748850046
chr10	CCNY	35529972	35530030	21	59	4057	6127	4036	6068	0.3559322033898305	0.6651285431773236
chr10	CCNY	35455356	35455463	0	108	4057	6127	4057	6019	0.0	0.6740322312676524
chr10	CCNY	35483403	35483478	0	76	4057	6127	4057	6051	0.0	0.6704676912906957
chr10	CCNY	35394815	35394878	0	64	4057	6127	4057	6063	0.0	0.669140689427676
chr10	ZNF33A	38015966	38016045	2	80	4490	7554	4488	7474	0.025	0.6004816697886005
chr10	ZNF33A	38012297	38012350	0	54	4490	7554	4490	7500	0.0	0.5986666666666667
chr10	ZNF37A	38094930	38095224	0	295	124847	13019	124847	12724	0.0	9.81193021062559
chr10	AL117339.4	38267279	38267400	0	122	4795	3973	4795	3851	0.0	1.2451311347701897
chr10	CCNYL4	38197499	38197551	0	53	0	1546	0	1493	0.0	0.0
chr10	HSD17B7P2	38369123	38369228	3091	106	3703	1515	612	1409	29.160377358490567	0.43435060326472674
chr10	AL133216.2	38415543	38415602	0	60	28530	7231	28530	7171	0.0	3.9785246130246827
chr10	LINC00839	42492079	42492342	0	264	94	8183	94	7919	0.0	0.011870185629498674
chr10	RET	43111206	43111465	564	260	20575	6854	20011	6594	2.169230769230769	3.0347285410979676
chr10	FXYD4	43373514	43373783	0	270	0	842	0	572	0.0	0.0
chr10	FXYD4	43375498	43375573	0	76	0	842	0	766	0.0	0.0
chr10	ZNF487	43476106	43476202	0	97	0	3028	0	2931	0.0	0.0
chr10	LINC00840	43859526	43860123	51	598	28801	7297	28750	6699	0.08528428093645485	4.291685326168085
chr10	LINC00840	43845532	43845602	0	71	28801	7297	28801	7226	0.0	3.9857459175200662
chr10	LINC00840	43849673	43849998	0	326	28801	7297	28801	6971	0.0	4.131544972026969
chr10	LINC00840	43867156	43867339	0	184	28801	7297	28801	7113	0.0	4.049065092084915
chr10	LINC00840	43874189	43874412	0	224	28801	7297	28801	7073	0.0	4.071963806022904
chr10	LINC00841	43909854	43909935	37	82	5090	4991	5053	4909	0.45121951219512196	1.0293338765532696
chr10	TMEM72	44927920	44927987	0	68	51	3054	51	2986	0.0	0.01707970529135968
chr10	RASSF4	44984021	44984113	0	93	4018	8681	4018	8588	0.0	0.467862133209129
chr10	RASSF4	44980891	44980927	0	37	4018	8681	4018	8644	0.0	0.464831096714484
chr10	ALOX5	45444115	45444286	0	172	510	3570	510	3398	0.0	0.15008828722778106
chr10	WASHC2C	45751481	45751553	0	73	0	5493	0	5420	0.0	0.0
chr10	WASHC2C	45777272	45777425	0	154	0	5493	0	5339	0.0	0.0
chr10	WASHC2C	45785508	45785631	0	124	0	5493	0	5369	0.0	0.0
chr10	WASHC2C	45728861	45729026	0	166	0	5493	0	5327	0.0	0.0
chr10	WASHC2C	45786611	45786674	0	64	0	5493	0	5429	0.0	0.0
chr10	ANTXRL	46306802	46306872	0	71	867	2961	867	2890	0.0	0.3
chr10	ANTXRL	46309112	46309202	0	91	867	2961	867	2870	0.0	0.30209059233449476
chr10	ANTXRL	46308457	46308666	51	210	867	2961	816	2751	0.24285714285714285	0.2966194111232279
chr10	ANXA8L1	46385711	46385807	0	97	992	2872	992	2775	0.0	0.3574774774774775
chr10	SYT15	46580893	46581036	0	144	0	4472	0	4328	0.0	0.0
chr10	SYT15	46580163	46580368	0	206	0	4472	0	4266	0.0	0.0
chr10	AL356056.1	46609091	46609255	0	165	0	1973	0	1808	0.0	0.0
chr10	AL356056.1	46607726	46607769	0	44	0	1973	0	1929	0.0	0.0
chr10	AL356056.1	46607375	46607769	0	395	0	1973	0	1578	0.0	0.0
chr10	BMS1P1	46797131	46797319	0	189	132	4572	132	4383	0.0	0.030116358658453114
chr10	PTPN20	46943917	46944015	0	99	20415	4523	20415	4424	0.0	4.614602169981917
chr10	PTPN20	46967956	46968047	621	92	20415	4523	19794	4431	6.75	4.467163168584969
chr10	PTPN20	46932376	46932533	0	158	20415	4523	20415	4365	0.0	4.676975945017182
chr10	PTPN20	46940622	46940717	0	96	20415	4523	20415	4427	0.0	4.611475039530156
chr10	PTPN20	46964985	46965137	14221	153	20415	4523	6194	4370	92.94771241830065	1.4173913043478261
chr10	PTPN20	46940581	46940717	0	137	20415	4523	20415	4386	0.0	4.654582763337893
chr10	PTPN20	46984229	46984564	0	336	20415	4523	20415	4187	0.0	4.875806066395987
chr10	PTPN20	46987339	46987555	0	217	20415	4523	20415	4306	0.0	4.741058987459359
chr10	PTPN20	46947840	46947955	0	116	20415	4523	20415	4407	0.0	4.6324029952348535
chr10	PTPN20	46955095	46955203	1129	109	20415	4523	19286	4414	10.357798165137615	4.369279565020389
chr10	NPY4R2	47920737	47920893	0	157	21006	1959	21006	1802	0.0	11.657047724750278
chr10	MAPK8	48404851	48404981	0	131	408	8831	408	8700	0.0	0.04689655172413793
chr10	MAPK8	48325896	48325965	0	70	408	8831	408	8761	0.0	0.04657002625271088
chr10	MAPK8	48364611	48364656	0	46	408	8831	408	8785	0.0	0.046442800227660785
chr10	FAM170B-AS1	49135655	49136081	0	427	0	2297	0	1870	0.0	0.0
chr10	FAM170B-AS1	49148606	49148663	0	58	0	2297	0	2239	0.0	0.0
chr10	FAM170B-AS1	49135876	49136081	0	206	0	2297	0	2091	0.0	0.0
chr10	CHAT	49614303	49614475	0	173	4711	6610	4711	6437	0.0	0.7318626689451608
chr10	CHAT	49616022	49616092	18	71	4711	6610	4693	6539	0.2535211267605634	0.7176938369781312
chr10	TIMM23B	49943234	49943358	0	125	0	3049	0	2924	0.0	0.0
chr10	TIMM23B	49945031	49945090	0	60	0	3049	0	2989	0.0	0.0
chr10	AGAP6	49988750	49988938	0	189	0	3178	0	2989	0.0	0.0
chr10	AGAP6	49989307	49989376	0	70	0	3178	0	3108	0.0	0.0
chr10	AGAP6	49994394	49994429	0	36	0	3178	0	3142	0.0	0.0
chr10	WASHC2A	50084071	50084165	0	95	51	5107	51	5012	0.0	0.010175578611332801
chr10	WASHC2A	50126056	50126179	0	124	51	5107	51	4983	0.0	0.010234798314268514
chr10	WASHC2A	50092161	50092233	0	73	51	5107	51	5034	0.0	0.010131108462455305
chr10	WASHC2A	50117905	50118058	0	154	51	5107	51	4953	0.0	0.01029678982434888
chr10	WASHC2A	50127159	50127222	0	64	51	5107	51	5043	0.0	0.010113027959547887
chr10	ASAH2B	50745127	50745274	0	148	2104	5888	2104	5740	0.0	0.36655052264808363
chr10	ASAH2B	50744696	50744732	0	37	2104	5888	2104	5851	0.0	0.3595966501452743
chr10	ASAH2B	50745201	50745274	0	74	2104	5888	2104	5814	0.0	0.36188510491916065
chr10	ASAH2B	50743672	50743741	0	70	2104	5888	2104	5818	0.0	0.3616363011344105
chr10	PRKG1	52288930	52288993	0	64	1714	11773	1714	11709	0.0	0.14638312409257836
chr10	UBE2D1	58361494	58361526	0	33	0	2975	0	2942	0.0	0.0
chr10	TFAM	58390764	58390860	0	97	0	5290	0	5193	0.0	0.0
chr10	LINC00844	59022568	59022642	0	75	0	6009	0	5934	0.0	0.0
chr10	LINC00844	59000345	59000512	0	168	0	6009	0	5841	0.0	0.0
chr10	LINC00844	59000345	59000503	0	159	0	6009	0	5850	0.0	0.0
chr10	LINC00844	59001228	59001349	0	122	0	6009	0	5887	0.0	0.0
chr10	LINC00844	59013681	59013771	0	91	0	6009	0	5918	0.0	0.0
chr10	LINC00844	59000133	59000245	0	113	0	6009	0	5896	0.0	0.0
chr10	PHYHIPL	59206753	59206844	0	92	120	4047	120	3955	0.0	0.03034134007585335
chr10	CDK1	60788059	60788230	0	172	0	3548	0	3376	0.0	0.0
chr10	ZNF365	62376180	62376936	0	757	255	4968	255	4211	0.0	0.06055568748515792
chr10	AC067752.1	62666128	62666202	0	75	714	3973	714	3898	0.0	0.1831708568496665
chr10	AC067752.1	62655366	62655631	0	266	714	3973	714	3707	0.0	0.1926085783652549
chr10	NRBF2	63146208	63146293	0	86	0	1905	0	1819	0.0	0.0
chr10	REEP3	63599669	63599712	0	44	0	5224	0	5180	0.0	0.0
chr10	AC013287.1	64316497	64316594	0	98	51	2952	51	2854	0.0	0.017869656622284513
chr10	LINC01515	65571424	65571579	11	156	419	17753	408	17597	0.07051282051282051	0.023185770301755983
chr10	LINC01515	65585664	65585802	0	139	419	17753	419	17614	0.0	0.023787895991824685
chr10	LINC01515	65689502	65689611	0	110	419	17753	419	17643	0.0	0.023748795556311285
chr10	LINC01515	65679351	65679412	0	62	419	17753	419	17691	0.0	0.0236843592787293
chr10	LINC01515	65579882	65579948	0	67	419	17753	419	17686	0.0	0.02369105507180821
chr10	LINC01515	65637869	65638050	0	182	419	17753	419	17571	0.0	0.02384611006772523
chr10	LINC01515	65581611	65581673	0	63	419	17753	419	17690	0.0	0.023685698134539288
chr10	LINC01515	65689507	65689611	0	105	419	17753	419	17648	0.0	0.023742067089755212
chr10	LINC01515	65766555	65766623	0	69	419	17753	419	17684	0.0	0.023693734449219635
chr10	SIRT1	67888881	67889123	51	243	51	4575	0	4332	0.20987654320987653	0.0
chr10	SIRT1	67906162	67906287	0	126	51	4575	51	4449	0.0	0.011463250168577209
chr10	MYPN	68114232	68114296	0	65	107	6890	107	6825	0.0	0.015677655677655677
chr10	HNRNPH3	68337857	68337996	0	140	0	3045	0	2905	0.0	0.0
chr10	CCAR1	68737844	68737889	0	46	80	6086	80	6040	0.0	0.013245033112582781
chr10	CCAR1	68722454	68722577	0	124	80	6086	80	5962	0.0	0.01341831600134183
chr10	CCAR1	68771205	68771445	0	241	80	6086	80	5845	0.0	0.013686911890504704
chr10	CCAR1	68740628	68740661	0	34	80	6086	80	6052	0.0	0.013218770654329148
chr10	CCAR1	68756272	68756483	51	212	80	6086	29	5874	0.24056603773584906	0.004937010554988083
chr10	CCAR1	68756525	68756632	0	108	80	6086	80	5978	0.0	0.013382402141184342
chr10	STOX1	68884259	68886618	153	2360	153	3919	0	1559	0.06483050847457628	0.0
chr10	STOX1	68884259	68884459	0	201	153	3919	153	3718	0.0	0.04115115653577192
chr10	DDX50	68906283	68906337	0	55	459	2690	459	2635	0.0	0.17419354838709677
chr10	DDX50	68934198	68934360	0	163	459	2690	459	2527	0.0	0.18163830629204591
chr10	DDX50	68906225	68906337	0	113	459	2690	459	2577	0.0	0.1781140861466822
chr10	KIFBP	69000423	69000522	0	100	0	6370	0	6270	0.0	0.0
chr10	KIFBP	69007626	69007751	0	126	0	6370	0	6244	0.0	0.0
chr10	KIFBP	69010899	69011015	0	117	0	6370	0	6253	0.0	0.0
chr10	KIFBP	68989716	68989859	0	144	0	6370	0	6226	0.0	0.0
chr10	KIFBP	68989716	68989742	0	27	0	6370	0	6343	0.0	0.0
chr10	KIFBP	68999714	68999814	0	101	0	6370	0	6269	0.0	0.0
chr10	KIFBP	69006841	69006929	0	89	0	6370	0	6281	0.0	0.0
chr10	KIFBP	69015357	69015436	0	80	0	6370	0	6290	0.0	0.0
chr10	KIFBP	68995203	68995278	0	76	0	6370	0	6294	0.0	0.0
chr10	SRGN	69097083	69097231	0	149	0	1220	0	1071	0.0	0.0
chr10	VPS26A	69132897	69133047	0	151	55	5127	55	4976	0.0	0.011053054662379422
chr10	VPS26A	69155811	69155887	0	77	55	5127	55	5050	0.0	0.01089108910891089
chr10	VPS26A	69158046	69158211	0	166	55	5127	55	4961	0.0	0.011086474501108648
chr10	VPS26A	69168488	69168631	0	144	55	5127	55	4983	0.0	0.011037527593818985
chr10	VPS26A	69157006	69157163	0	158	55	5127	55	4969	0.0	0.011068625477963372
chr10	HK1	69398594	69398828	0	235	31	6322	31	6087	0.0	0.00509282076556596
chr10	HK1	69300768	69300861	0	94	31	6322	31	6228	0.0	0.00497752087347463
chr10	HK1	69278523	69278785	0	263	31	6322	31	6059	0.0	0.005116355834296088
chr10	HK1	69271006	69271096	0	91	31	6322	31	6231	0.0	0.004975124378109453
chr10	HK1	69292257	69292350	0	94	31	6322	31	6228	0.0	0.00497752087347463
chr10	COL13A1	69880502	69880553	0	52	32571	9922	32571	9870	0.0	3.3
chr10	COL13A1	69919664	69919727	0	64	32571	9922	32571	9858	0.0	3.304017041996348
chr10	COL13A1	69940987	69941023	0	37	32571	9922	32571	9885	0.0	3.294992412746586
chr10	COL13A1	69945670	69945724	0	55	32571	9922	32571	9867	0.0	3.301003344481605
chr10	COL13A1	69953947	69954025	0	79	32571	9922	32571	9843	0.0	3.3090521182566293
chr10	COL13A1	69897474	69897531	0	58	32571	9922	32571	9864	0.0	3.302007299270073
chr10	COL13A1	69898696	69898762	0	67	32571	9922	32571	9855	0.0	3.3050228310502283
chr10	COL13A1	69932559	69932604	0	46	32571	9922	32571	9876	0.0	3.297995139732685
chr10	COL13A1	69935349	69935391	110	43	32571	9922	32461	9879	2.558139534883721	3.2858588926004657
chr10	COL13A1	69952881	69952968	0	88	32571	9922	32571	9834	0.0	3.3120805369127515
chr10	COL13A1	69875127	69875163	0	37	32571	9922	32571	9885	0.0	3.294992412746586
chr10	COL13A1	69878038	69878065	0	28	32571	9922	32571	9894	0.0	3.2919951485748937
chr10	COL13A1	69931159	69931256	0	98	32571	9922	32571	9824	0.0	3.315451954397394
chr10	COL13A1	69872183	69872210	0	28	32571	9922	32571	9894	0.0	3.2919951485748937
chr10	COL13A1	69880413	69880553	0	141	32571	9922	32571	9781	0.0	3.330027604539413
chr10	COL13A1	69919664	69919701	0	38	32571	9922	32571	9884	0.0	3.295325779036827
chr10	COL13A1	69941235	69941347	51	113	32571	9922	32520	9809	0.45132743362831856	3.315322662860638
chr10	MACROH2A2	70100207	70100297	2587	91	1089514	11836	1086927	11745	28.428571428571427	92.54380587484036
chr10	MACROH2A2	70109032	70109207	1577	176	1089514	11836	1087937	11660	8.960227272727273	93.30506003430531
chr10	MACROH2A2	70091756	70091954	24842	199	1089514	11836	1064672	11637	124.83417085427136	91.49024662713758
chr10	MACROH2A2	70093734	70093845	8594	112	1089514	11836	1080920	11724	76.73214285714286	92.1972023200273
chr10	MACROH2A2	70055066	70055177	0	112	1089514	11836	1089514	11724	0.0	92.9302285909246
chr10	MACROH2A2	70065053	70065189	0	137	1089514	11836	1089514	11699	0.0	93.12881442858364
chr10	MACROH2A2	70083004	70083179	0	176	1089514	11836	1089514	11660	0.0	93.44030874785592
chr10	MACROH2A2	70083004	70083070	0	67	1089514	11836	1089514	11769	0.0	92.57490016144108
chr10	MACROH2A2	70095653	70095753	8346	101	1089514	11836	1081168	11735	82.63366336633663	92.13191308052834
chr10	MACROH2A2	70091756	70091841	416	86	1089514	11836	1089098	11750	4.837209302325581	92.6891914893617
chr10	MACROH2A2	70093019	70093507	38636	489	1089514	11836	1050878	11347	79.01022494887526	92.61284921124526
chr10	MACROH2A2	70092336	70092642	8398	307	1089514	11836	1081116	11529	27.355048859934854	93.7736143637783
chr10	MACROH2A2	70093222	70093507	24229	286	1089514	11836	1065285	11550	84.71678321678321	92.23246753246754
chr10	MACROH2A2	70094938	70095060	5719	123	1089514	11836	1083795	11713	46.49593495934959	92.52924101425766
chr10	MACROH2A2	70099484	70099641	554	158	1089514	11836	1088960	11678	3.5063291139240507	93.24884398013359
chr10	MACROH2A2	70105951	70106250	1741	300	1089514	11836	1087773	11536	5.803333333333334	94.29377600554785
chr10	MACROH2A2	70108545	70108631	78	87	1089514	11836	1089436	11749	0.896551724137931	92.72584900842625
chr10	UNC5B	71288957	71288990	0	34	51	6858	51	6824	0.0	0.007473622508792497
chr10	SLC29A3	71344208	71344291	0	84	408	5448	408	5364	0.0	0.07606263982102908
chr10	SLC29A3	71351561	71351788	0	228	408	5448	408	5220	0.0	0.07816091954022988
chr10	SLC29A3	71352566	71352818	0	253	408	5448	408	5195	0.0	0.07853705486044274
chr10	CDH23	71643860	71643866	0	7	6345	16489	6345	16482	0.0	0.3849654168183473
chr10	CDH23	71725371	71725520	0	150	6345	16489	6345	16339	0.0	0.3883346594038803
chr10	CDH23	71734655	71734658	0	4	6345	16489	6345	16485	0.0	0.3848953594176524
chr10	CDH23	71813243	71813348	0	106	6345	16489	6345	16383	0.0	0.38729170481596775
chr10	CDH23	71635237	71635297	0	61	6345	16489	6345	16428	0.0	0.38623082542001463
chr10	ANAPC16	72220053	72220379	0	327	985	4329	985	4002	0.0	0.24612693653173412
chr10	ANAPC16	72230365	72230440	220	76	985	4329	765	4253	2.8947368421052633	0.179873030801787
chr10	MCU	72715110	72715226	0	117	51	4536	51	4419	0.0	0.011541072640868975
chr10	MCU	72736484	72736571	0	88	51	4536	51	4448	0.0	0.011465827338129496
chr10	MCU	72760550	72760672	0	123	51	4536	51	4413	0.0	0.011556764106050306
chr10	MCU	72708282	72708356	0	75	51	4536	51	4461	0.0	0.011432414256893073
chr10	OIT3	72924228	72924644	0	417	0	2374	0	1957	0.0	0.0
chr10	NUDT13	73124213	73124320	0	108	2150	2532	2150	2424	0.0	0.886963696369637
chr10	NUDT13	73119450	73119522	0	73	2150	2532	2150	2459	0.0	0.8743391622610818
chr10	NUDT13	73125397	73125509	0	113	2150	2532	2150	2419	0.0	0.888797023563456
chr10	NUDT13	73126672	73126827	0	156	2150	2532	2150	2376	0.0	0.9048821548821548
chr10	FAM149B1	73235192	73235318	0	127	0	6573	0	6446	0.0	0.0
chr10	PPP3CB-AS1	73498297	73498867	0	571	459	5347	459	4776	0.0	0.09610552763819095
chr10	PPP3CB-AS1	73498732	73498867	0	136	459	5347	459	5211	0.0	0.08808290155440414
chr10	PPP3CB-AS1	73515827	73515925	0	99	459	5347	459	5248	0.0	0.08746189024390244
chr10	PPP3CB-AS1	73518743	73518864	0	122	459	5347	459	5225	0.0	0.0878468899521531
chr10	PPP3CB-AS1	73498649	73498867	0	219	459	5347	459	5128	0.0	0.08950858034321373
chr10	AC073389.2	73668274	73668361	0	88	102	1844	102	1756	0.0	0.05808656036446469
chr10	SEC24C	73751107	73751243	0	137	320641	5320	320641	5183	0.0	61.86397839089331
chr10	SEC24C	73746629	73746716	510	88	320641	5320	320131	5232	5.795454545454546	61.18711773700306
chr10	SEC24C	73762097	73762166	0	70	320641	5320	320641	5250	0.0	61.07447619047619
chr10	PLAU	73912040	73912068	0	29	5488	2962	5488	2933	0.0	1.8711217183770883
chr10	VCL	74111908	74112112	357	205	82781	9895	82424	9690	1.7414634146341463	8.50608875128999
chr10	VCL	74043082	74043153	0	72	82781	9895	82781	9823	0.0	8.427262547083377
chr10	ADK	74224537	74224591	0	55	2091	4677	2091	4622	0.0	0.45240155776720037
chr10	ADK	74600378	74600493	0	116	2091	4677	2091	4561	0.0	0.4584520938390704
chr10	ADK	74525255	74525426	357	172	2091	4677	1734	4505	2.0755813953488373	0.3849056603773585
chr10	ADK	74680411	74680514	0	104	2091	4677	2091	4573	0.0	0.45724907063197023
chr10	ADK	74174415	74174618	0	204	2091	4677	2091	4473	0.0	0.4674714956405097
chr10	ADK	74670182	74670269	0	88	2091	4677	2091	4589	0.0	0.45565482675964264
chr10	ADK	74527759	74528093	1326	335	2091	4677	765	4342	3.9582089552238804	0.17618608935974206
chr10	ADK	74339144	74339240	0	97	2091	4677	2091	4580	0.0	0.4565502183406114
chr10	ADK	74242737	74243033	357	297	2091	4677	1734	4380	1.202020202020202	0.3958904109589041
chr10	ADK	74686698	74686820	0	123	2091	4677	2091	4554	0.0	0.45915678524374176
chr10	KAT6B	74970019	74970101	4796	83	113903	24867	109107	24784	57.78313253012048	4.402316010329245
chr10	KAT6B	74979223	74979339	1006	117	113903	24867	112897	24750	8.598290598290598	4.56149494949495
chr10	KAT6B	74985079	74985241	153	163	113903	24867	113750	24704	0.9386503067484663	4.604517487046632
chr10	KAT6B	74989018	74989112	779	95	113903	24867	113124	24772	8.2	4.566607460035524
chr10	KAT6B	74838682	74838752	0	71	113903	24867	113903	24796	0.0	4.593603807065656
chr10	KAT6B	74838682	74838783	0	102	113903	24867	113903	24765	0.0	4.599353926912982
chr10	SAMD8	75173731	75173763	0	33	420735	7145	420735	7112	0.0	59.15846456692913
chr10	VDAC2	75211481	75211659	0	179	77151	2840	77151	2661	0.0	28.99323562570462
chr10	ZNF503-AS1	75358938	75359049	0	112	19920	5296	19920	5184	0.0	3.8425925925925926
chr10	ZNF503-AS1	75358275	75358346	0	72	19920	5296	19920	5224	0.0	3.8131699846860645
chr10	ZNF503-AS1	75285450	75285596	0	147	19920	5296	19920	5149	0.0	3.8687123713342397
chr10	ZNF503-AS1	75343223	75343340	0	118	19920	5296	19920	5178	0.0	3.847045191193511
chr10	ZNF503-AS1	75298951	75299074	0	124	19920	5296	19920	5172	0.0	3.851508120649652
chr10	ZNF503-AS1	75343223	75343330	0	108	19920	5296	19920	5188	0.0	3.8396299151888975
chr10	ZNF503-AS1	75350351	75350470	0	120	19920	5296	19920	5176	0.0	3.848531684698609
chr10	ZNF503-AS1	75355772	75355868	0	97	19920	5296	19920	5199	0.0	3.8315060588574728
chr10	KCNMA1-AS1	76889533	76889768	0	236	119599	4191	119599	3955	0.0	30.239949431099873
chr10	KCNMA1-AS1	76904726	76904875	0	150	119599	4191	119599	4041	0.0	29.596387032912645
chr10	KCNMA1-AS1	76975280	76975400	293	121	119599	4191	119306	4070	2.4214876033057853	29.313513513513513
chr10	RPS24	78040200	78040225	0	26	0	7223	0	7197	0.0	0.0
chr10	RPS24	78037964	78037982	0	19	0	7223	0	7204	0.0	0.0
chr10	RPS24	78037438	78037441	0	4	0	7223	0	7219	0.0	0.0
chr10	RPS24	78040203	78040225	0	23	0	7223	0	7200	0.0	0.0
chr10	RPS24	78048980	78049225	0	246	0	7223	0	6977	0.0	0.0
chr10	RPS24	78037964	78037993	0	30	0	7223	0	7193	0.0	0.0
chr10	AC012560.1	78465993	78466178	0	186	53226	1379	53226	1193	0.0	44.615255658005026
chr10	LINC00595	78527292	78527587	0	296	36	10323	36	10027	0.0	0.0035903061733320034
chr10	LINC00595	78210844	78210998	0	155	36	10323	36	10168	0.0	0.0035405192761605035
chr10	LINC00595	78386992	78387115	0	124	36	10323	36	10199	0.0	0.0035297578193940584
chr10	ZMIZ1	79290744	79290796	0	53	4953	6896	4953	6843	0.0	0.7238053485313459
chr10	SFTPA1	79611318	79611389	124	72	74754	2454	74630	2382	1.7222222222222223	31.330814441645675
chr10	SFTPA1	79611581	79611641	0	61	74754	2454	74754	2393	0.0	31.23861262014208
chr10	AL512662.1	79941436	79941535	0	100	10	2086	10	1986	0.0	0.005035246727089627
chr10	TMEM254	80086230	80086258	0	29	102	3006	102	2977	0.0	0.03426268055089016
chr10	TMEM254	80081639	80081734	0	96	102	3006	102	2910	0.0	0.03505154639175258
chr10	TMEM254	80090379	80090431	0	53	102	3006	102	2953	0.0	0.03454114459871317
chr10	PLAC9	80144222	80144343	0	122	0	1245	0	1123	0.0	0.0
chr10	DYDC2	80356296	80356596	0	301	51	2473	51	2172	0.0	0.023480662983425413
chr10	DYDC2	80357892	80358045	0	154	51	2473	51	2319	0.0	0.02199223803363519
chr10	TSPAN14	80504727	80504778	0	52	51	17902	51	17850	0.0	0.002857142857142857
chr10	TSPAN14	80509300	80509471	0	172	51	17902	51	17730	0.0	0.002876480541455161
chr10	TSPAN14	80466440	80466538	0	99	51	17902	51	17803	0.0	0.002864685727124642
chr10	SH2D4B	80634284	80634505	0	222	0	4595	0	4373	0.0	0.0
chr10	NRG3	82984782	82984854	0	73	51	5209	51	5136	0.0	0.009929906542056074
chr10	NRG3	82166726	82166826	0	101	51	5209	51	5108	0.0	0.009984338292873924
chr10	NRG3	82955190	82955233	0	44	51	5209	51	5165	0.0	0.009874152952565343
chr10	NRG3	82232741	82232819	0	79	51	5209	51	5130	0.0	0.009941520467836258
chr10	CDHR1	84211000	84211165	0	166	51	7747	51	7581	0.0	0.006727344677483181
chr10	RGR	84257892	84258006	0	115	0	4954	0	4839	0.0	0.0
chr10	RGR	84246884	84246970	0	87	0	4954	0	4867	0.0	0.0
chr10	RGR	84255136	84255394	0	259	0	4954	0	4695	0.0	0.0
chr10	RGR	84247590	84247747	0	158	0	4954	0	4796	0.0	0.0
chr10	RGR	84247497	84247747	0	251	0	4954	0	4703	0.0	0.0
chr10	RGR	84247640	84247747	0	108	0	4954	0	4846	0.0	0.0
chr10	RGR	84254696	84254737	0	42	0	4954	0	4912	0.0	0.0
chr10	CCSER2	84438511	84438707	0	197	0	8441	0	8244	0.0	0.0
chr10	CCSER2	84499874	84499959	0	86	0	8441	0	8355	0.0	0.0
chr10	CCSER2	84473031	84473146	0	116	0	8441	0	8325	0.0	0.0
chr10	LINC01520	85461595	85461697	0	103	0	1531	0	1428	0.0	0.0
chr10	GRID1-AS1	85579490	85579603	0	114	102	1726	102	1612	0.0	0.06327543424317618
chr10	OPN4	86657194	86657227	0	34	0	2483	0	2449	0.0	0.0
chr10	LDB3	86687068	86687272	153	205	357	6639	204	6434	0.7463414634146341	0.03170655890581287
chr10	LDB3	86706530	86706719	0	190	357	6639	357	6449	0.0	0.055357419755000775
chr10	LDB3	86681435	86681803	0	369	357	6639	357	6270	0.0	0.056937799043062204
chr10	LDB3	86685677	86685700	0	24	357	6639	357	6615	0.0	0.05396825396825397
chr10	BMPR1A	86843405	86843510	0	106	0	9534	0	9428	0.0	0.0
chr10	ADIRF	86970199	86970262	0	64	0	762	0	698	0.0	0.0
chr10	AGAP11	86998377	86998561	0	185	0	3090	0	2905	0.0	0.0
chr10	AGAP11	87003087	87003421	0	335	0	3090	0	2755	0.0	0.0
chr10	SHLD2	87175888	87176095	0	208	51	4250	51	4042	0.0	0.012617516081147946
chr10	PAPSS2	87721755	87721770	0	16	0	4098	0	4082	0.0	0.0
chr10	LIPJ	88590584	88590696	0	113	66	2082	66	1969	0.0	0.0335195530726257
chr10	LIPJ	88596789	88596936	0	148	66	2082	66	1934	0.0	0.03412616339193381
chr10	LIPF	88665478	88665559	0	82	255	2359	255	2277	0.0	0.11198945981554677
chr10	FAS	89008888	89008997	0	110	19534	5421	19534	5311	0.0	3.6780267369610242
chr10	FAS	89010752	89010815	0	64	19534	5421	19534	5357	0.0	3.6464439051708046
chr10	FAS	89012198	89012335	0	138	19534	5421	19534	5283	0.0	3.6975203482869583
chr10	FAS	89011998	89012081	362	84	19534	5421	19172	5337	4.309523809523809	3.592280307288739
chr10	FAS	89013342	89013367	0	26	19534	5421	19534	5395	0.0	3.6207599629286378
chr10	FAS	89007699	89007837	0	139	19534	5421	19534	5282	0.0	3.6982203710715638
chr10	AL353751.1	89285035	89285264	0	230	153	2464	153	2234	0.0	0.0684870188003581
chr10	IFIT1	89393106	89393341	0	236	102	4617	102	4381	0.0	0.023282355626569277
chr10	SLC16A12-AS1	89462866	89463078	0	213	0	694	0	481	0.0	0.0
chr10	LINC00865	89829969	89830304	0	336	0	5664	0	5328	0.0	0.0
chr10	RPP30	90895453	90895483	0	31	51	4432	51	4401	0.0	0.011588275391956374
chr10	HECTD2	91484333	91484345	0	13	16569	8950	16569	8937	0.0	1.8539778449144009
chr10	KIF11	92632190	92632310	0	121	117983	5347	117983	5226	0.0	22.5761576731726
chr10	EXOC6	92919981	92920050	0	70	0	6513	0	6443	0.0	0.0
chr10	EXOC6	92999249	92999387	0	139	0	6513	0	6374	0.0	0.0
chr10	FFAR4	93579158	93579206	0	49	636528	4065	636528	4016	0.0	158.4980079681275
chr10	PDE6C	93663027	93663178	0	152	3583	3383	3583	3231	0.0	1.1089445991952955
chr10	LGI1	93791687	93791739	0	53	50608	8705	50608	8652	0.0	5.849283402681461
chr10	LGI1	93758759	93758831	162	73	50608	8705	50446	8632	2.219178082191781	5.844068582020389
chr10	LGI1	93793893	93794161	0	269	50608	8705	50608	8436	0.0	5.999051683262209
chr10	LGI1	93782742	93783043	0	302	50608	8705	50608	8403	0.0	6.022610972271807
chr10	LGI1	93758759	93759291	1022	533	50608	8705	49586	8172	1.9174484052532832	6.06779246206559
chr10	LGI1	93780281	93780332	0	52	50608	8705	50608	8653	0.0	5.848607419392119
chr10	PLCE1	94262493	94262732	51	240	14181	13715	14130	13475	0.2125	1.04860853432282
chr10	PLCE1	94253940	94254096	0	157	14181	13715	14181	13558	0.0	1.0459507301961941
chr10	PLCE1	94282790	94282832	0	43	14181	13715	14181	13672	0.0	1.037229373902867
chr10	PLCE1	94282790	94282940	0	151	14181	13715	14181	13564	0.0	1.0454880566204658
chr10	PLCE1	94282793	94282832	0	40	14181	13715	14181	13675	0.0	1.037001828153565
chr10	HELLS	94562811	94562876	0	66	574	8582	574	8516	0.0	0.0674025364020667
chr10	HELLS	94583987	94584125	0	139	574	8582	574	8443	0.0	0.06798531327727111
chr10	CYP2C18	94706783	94706960	0	178	2757	2319	2757	2141	0.0	1.2877160205511444
chr10	CYP2C19	94820495	94820637	0	143	2142	6272	2142	6129	0.0	0.34948604992657856
chr10	CYP2C9	94972103	94972245	0	143	0	4067	0	3924	0.0	0.0
chr10	ACSM6	95214851	95214975	1071	125	42573	2819	41502	2694	8.568	15.405345211581292
chr10	ACSM6	95201440	95201521	0	82	42573	2819	42573	2737	0.0	15.554621848739496
chr10	ENTPD1	95842343	95842494	0	152	161	13872	161	13720	0.0	0.01173469387755102
chr10	ENTPD1	95823236	95823364	0	129	161	13872	161	13743	0.0	0.011715054937058867
chr10	ENTPD1	95839690	95839808	0	119	161	13872	161	13753	0.0	0.011706536755616956
chr10	CC2D2B	95913381	95913437	0	57	3179	7596	3179	7539	0.0	0.4216739620639342
chr10	CC2D2B	95988249	95988342	0	94	3179	7596	3179	7502	0.0	0.4237536656891496
chr10	CC2D2B	96009824	96009923	0	100	3179	7596	3179	7496	0.0	0.42409284951974385
chr10	CC2D2B	96012184	96012367	216	184	3179	7596	2963	7412	1.173913043478261	0.3997571505666487
chr10	CC2D2B	95952322	95952425	0	104	3179	7596	3179	7492	0.0	0.4243192738921516
chr10	CC2D2B	95984596	95984695	0	100	3179	7596	3179	7496	0.0	0.42409284951974385
chr10	CC2D2B	95993008	95993112	0	105	3179	7596	3179	7491	0.0	0.4243759177679883
chr10	CC2D2B	96000794	96000827	0	34	3179	7596	3179	7562	0.0	0.4203914308384025
chr10	ZNF518A	96151415	96151566	0	152	10443	10378	10443	10226	0.0	1.021220418540974
chr10	ZNF518A	96155325	96155398	0	74	10443	10378	10443	10304	0.0	1.0134899068322982
chr10	LCOR	96833405	96833479	0	75	913	26377	913	26302	0.0	0.034712189187134056
chr10	LCOR	96944112	96944245	0	134	913	26377	913	26243	0.0	0.0347902297755592
chr10	LCOR	96833776	96833841	0	66	913	26377	913	26311	0.0	0.03470031545741325
chr10	LCOR	96951035	96951065	0	31	913	26377	913	26346	0.0	0.034654216958931144
chr10	LCOR	96944101	96944245	0	145	913	26377	913	26232	0.0	0.034804818542238485
chr10	LCOR	96954952	96955834	0	883	913	26377	913	25494	0.0	0.035812348003451795
chr10	LCOR	96954952	96955454	0	503	913	26377	913	25874	0.0	0.03528638787972482
chr10	LCOR	96954952	96955957	0	1006	913	26377	913	25371	0.0	0.03598596823144535
chr10	LCOR	96954952	96955671	0	720	913	26377	913	25657	0.0	0.03558483065050474
chr10	LCOR	96858291	96858416	0	126	913	26377	913	26251	0.0	0.03477962744276408
chr10	ZDHHC16	97452089	97452284	2108	196	75100	2995	72992	2799	10.755102040816327	26.0778849589139
chr10	ZDHHC16	97453798	97453846	0	49	75100	2995	75100	2946	0.0	25.492192803801764
chr10	ZDHHC16	97450356	97450536	7197	181	75100	2995	67903	2814	39.76243093922652	24.13041933191187
chr10	ZDHHC16	97448189	97448350	2685	162	75100	2995	72415	2833	16.574074074074073	25.561242499117544
chr10	ZDHHC16	97451670	97451918	3592	249	75100	2995	71508	2746	14.42570281124498	26.040786598689003
chr10	ANKRD2	97582314	97582413	0	100	0	1460	0	1360	0.0	0.0
chr10	ZFYVE27	97738476	97738649	0	174	357	3913	357	3739	0.0	0.09548007488633324
chr10	ZFYVE27	97748268	97748364	0	97	357	3913	357	3816	0.0	0.09355345911949685
chr10	ZFYVE27	97752856	97752877	0	22	357	3913	357	3891	0.0	0.09175019275250579
chr10	R3HCC1L	98186466	98186563	0	98	0	3583	0	3485	0.0	0.0
chr10	R3HCC1L	98208100	98209899	0	1800	0	3583	0	1783	0.0	0.0
chr10	R3HCC1L	98211306	98211348	0	43	0	3583	0	3540	0.0	0.0
chr10	AL391684.1	99434638	99434759	28991	122	186005	7133	157014	7011	237.63114754098362	22.395378690629013
chr10	CUTC	99750368	99750396	0	29	0	1803	0	1774	0.0	0.0
chr10	ABCC2	99796362	99796853	0	492	397	7721	397	7229	0.0	0.054917692626919354
chr10	ABCC2	99796390	99796853	0	464	397	7721	397	7257	0.0	0.05470580129530109
chr10	ABCC2	99849723	99849905	0	183	397	7721	397	7538	0.0	0.05266648978508888
chr10	DNMBP-AS1	99956481	99956591	0	111	0	3011	0	2900	0.0	0.0
chr10	DNMBP-AS1	99955673	99955832	0	160	0	3011	0	2851	0.0	0.0
chr10	AL138921.1	100231245	100231660	0	416	0	1287	0	871	0.0	0.0
chr10	OLMALINC	100380982	100381109	0	128	0	12654	0	12526	0.0	0.0
chr10	OLMALINC	100394497	100394622	0	126	0	12654	0	12528	0.0	0.0
chr10	OLMALINC	100380894	100381109	0	216	0	12654	0	12438	0.0	0.0
chr10	OLMALINC	100394285	100394377	0	93	0	12654	0	12561	0.0	0.0
chr10	PAX2	100824901	100824984	0	84	306	6389	306	6305	0.0	0.04853291038858049
chr10	PAX2	100786942	100787011	0	70	306	6389	306	6319	0.0	0.04842538376325368
chr10	SLF2	100925404	100925481	0	78	51	8833	51	8755	0.0	0.005825242718446602
chr10	SEMA4G	100978848	100979018	0	171	51	4726	51	4555	0.0	0.01119648737650933
chr10	SEMA4G	100983304	100984357	0	1054	51	4726	51	3672	0.0	0.013888888888888888
chr10	SEMA4G	100969691	100969924	43	234	51	4726	8	4492	0.18376068376068377	0.0017809439002671415
chr10	KAZALD1	101062985	101063103	0	119	0	2983	0	2864	0.0	0.0
chr10	LINC01514	101186048	101186164	0	117	24098	1767	24098	1650	0.0	14.604848484848485
chr10	LINC01514	101176988	101177102	51	115	24098	1767	24047	1652	0.4434782608695652	14.556295399515738
chr10	BTRC	101430344	101430452	0	109	6309	6630	6309	6521	0.0	0.967489648826867
chr10	BTRC	101461980	101462058	0	79	6309	6630	6309	6551	0.0	0.9630590749503892
chr10	DPCD	101605139	101605212	0	74	78	1670	78	1596	0.0	0.04887218045112782
chr10	DPCD	101608834	101608937	0	104	78	1670	78	1566	0.0	0.04980842911877394
chr10	NOLC1	102157018	102157074	0	57	116	3983	116	3926	0.0	0.029546612328069283
chr10	NOLC1	102160232	102160343	14	112	116	3983	102	3871	0.125	0.02634978041849651
chr10	NOLC1	102158048	102158214	0	167	116	3983	116	3816	0.0	0.03039832285115304
chr10	GBF1	102344050	102344182	0	133	12004	19267	12004	19134	0.0	0.6273649001776942
chr10	GBF1	102352457	102352518	0	62	12004	19267	12004	19205	0.0	0.6250455610518094
chr10	GBF1	102359269	102359435	0	167	12004	19267	12004	19100	0.0	0.6284816753926702
chr10	GBF1	102360183	102360395	0	213	12004	19267	12004	19054	0.0	0.6299989503516322
chr10	GBF1	102361021	102361120	0	100	12004	19267	12004	19167	0.0	0.6262847602650389
chr10	GBF1	102363255	102363396	0	142	12004	19267	12004	19125	0.0	0.6276601307189542
chr10	GBF1	102363709	102363798	0	90	12004	19267	12004	19177	0.0	0.625958179068676
chr10	GBF1	102367477	102367560	0	84	12004	19267	12004	19183	0.0	0.6257623937861648
chr10	GBF1	102368217	102368454	0	238	12004	19267	12004	19029	0.0	0.6308266330337905
chr10	GBF1	102368738	102368832	0	95	12004	19267	12004	19172	0.0	0.62612142708116
chr10	GBF1	102369210	102369387	0	178	12004	19267	12004	19089	0.0	0.6288438367646288
chr10	GBF1	102369860	102369984	0	125	12004	19267	12004	19142	0.0	0.6271027060913176
chr10	GBF1	102375358	102375584	0	227	12004	19267	12004	19040	0.0	0.6304621848739496
chr10	GBF1	102376271	102376432	0	162	12004	19267	12004	19105	0.0	0.6283171944517142
chr10	GBF1	102380248	102380362	0	115	12004	19267	12004	19152	0.0	0.6267752715121137
chr10	GBF1	102381126	102381255	0	130	12004	19267	12004	19137	0.0	0.627266551706119
chr10	GBF1	102258928	102259034	1100	107	12004	19267	10904	19160	10.280373831775702	0.5691022964509395
chr10	GBF1	102256614	102256729	0	116	12004	19267	12004	19151	0.0	0.6268079995822673
chr10	GBF1	102359266	102359435	0	170	12004	19267	12004	19097	0.0	0.6285804052992616
chr10	GBF1	102380332	102380362	0	31	12004	19267	12004	19236	0.0	0.6240382615928467
chr10	GBF1	102368297	102368454	0	158	12004	19267	12004	19109	0.0	0.6281856716730336
chr10	GBF1	102354369	102354468	0	100	12004	19267	12004	19167	0.0	0.6262847602650389
chr10	GBF1	102354369	102354444	0	76	12004	19267	12004	19191	0.0	0.6255015371788859
chr10	GBF1	102284952	102285070	7339	119	12004	19267	4665	19148	61.67226890756302	0.24362857739711719
chr10	GBF1	102335562	102335743	0	182	12004	19267	12004	19085	0.0	0.628975635315693
chr10	GBF1	102332407	102332526	0	120	12004	19267	12004	19147	0.0	0.6269389460489894
chr10	GBF1	102328810	102328952	51	143	12004	19267	11953	19124	0.35664335664335667	0.6250261451579168
chr10	GBF1	102326359	102326420	0	62	12004	19267	12004	19205	0.0	0.6250455610518094
chr10	GBF1	102314330	102314424	22	95	12004	19267	11982	19172	0.23157894736842105	0.6249739203004382
chr10	GBF1	102314807	102314860	912	54	12004	19267	11092	19213	16.88888888888889	0.5773174413157758
chr10	GBF1	102314810	102314860	849	51	12004	19267	11155	19216	16.647058823529413	0.5805058284762697
chr10	GBF1	102346367	102346492	0	126	12004	19267	12004	19141	0.0	0.627135468366334
chr10	GBF1	102363226	102363396	0	171	12004	19267	12004	19096	0.0	0.6286133221617093
chr10	GBF1	102364894	102364972	0	79	12004	19267	12004	19188	0.0	0.6255993329164061
chr10	GBF1	102368818	102368832	0	15	12004	19267	12004	19252	0.0	0.6235196343237066
chr10	GBF1	102376934	102377140	0	207	12004	19267	12004	19060	0.0	0.629800629590766
chr10	GBF1	102376309	102376432	0	124	12004	19267	12004	19143	0.0	0.6270699472391997
chr10	GBF1	102380345	102380362	0	18	12004	19267	12004	19249	0.0	0.6236168112629228
chr10	RPARP-AS1	102451398	102452187	0	790	0	4289	0	3499	0.0	0.0
chr10	MFSD13A	102470664	102471117	0	454	13	3539	13	3085	0.0	0.004213938411669368
chr10	TRIM8	102654652	102654748	0	97	255	4655	255	4558	0.0	0.055945590171127685
chr10	SFXN2	102716613	102716711	0	99	236054	7940	236054	7841	0.0	30.105088636653488
chr10	SFXN2	102716588	102716711	0	124	236054	7940	236054	7816	0.0	30.20138178096213
chr10	SFXN2	102727674	102727791	255	118	236054	7940	235799	7822	2.1610169491525424	30.145614932242392
chr10	SFXN2	102717702	102717780	15	79	236054	7940	236039	7861	0.189873417721519	30.026586948225418
chr10	SFXN2	102716233	102716329	5511	97	236054	7940	230543	7843	56.81443298969072	29.394746908070893
chr10	SFXN2	102715222	102715328	161	107	236054	7940	235893	7833	1.5046728971962617	30.115281501340483
chr10	SFXN2	102724935	102724996	0	62	236054	7940	236054	7878	0.0	29.963696369636963
chr10	SFXN2	102729722	102729808	0	87	236054	7940	236054	7853	0.0	30.059085699732588
chr10	SFXN2	102729318	102729394	0	77	236054	7940	236054	7863	0.0	30.02085717919369
chr10	CNNM2	103071773	103071839	0	67	153	16333	153	16266	0.0	0.009406123201770564
chr10	PDCD11	103399646	103399830	331	185	26432	7709	26101	7524	1.7891891891891891	3.4690324295587454
chr10	SLK	104010815	104010908	0	94	10931	8127	10931	8033	0.0	1.3607618573384788
chr10	SLK	104013631	104013703	0	73	10931	8127	10931	8054	0.0	1.3572138068040724
chr10	GSTO1	104262978	104263077	0	100	1016	1700	1016	1600	0.0	0.635
chr10	GSTO2	104275225	104275334	0	110	19568	9938	19568	9828	0.0	1.991045991045991
chr10	GSTO2	104279369	104279471	0	103	19568	9938	19568	9835	0.0	1.9896288764616166
chr10	ADD3	110116258	110116410	0	153	102	6311	102	6158	0.0	0.016563819421890225
chr10	ADD3	110100624	110100848	0	225	102	6311	102	6086	0.0	0.01675977653631285
chr10	ADD3	110132304	110132400	0	97	102	6311	102	6214	0.0	0.016414547795300934
chr10	MXI1	110244827	110244857	0	31	129	5912	129	5881	0.0	0.021935045060363884
chr10	MXI1	110244827	110244873	0	47	129	5912	129	5865	0.0	0.021994884910485932
chr10	MXI1	110260998	110261145	0	148	129	5912	129	5764	0.0	0.02238029146426093
chr10	MXI1	110245742	110245818	0	77	129	5912	129	5835	0.0	0.02210796915167095
chr10	MXI1	110279489	110279683	0	195	129	5912	129	5717	0.0	0.022564281966066118
chr10	PDCD4	110876669	110876753	0	85	0	4079	0	3994	0.0	0.0
chr10	PDCD4	110894090	110894198	0	109	0	4079	0	3970	0.0	0.0
chr10	PDCD4	110894411	110894522	0	112	0	4079	0	3967	0.0	0.0
chr10	PDCD4	110875965	110876070	0	106	0	4079	0	3973	0.0	0.0
chr10	SHOC2	110985627	110985765	32	139	32	4393	0	4254	0.2302158273381295	0.0
chr10	ACSL5	112411455	112411529	0	75	0	4259	0	4184	0.0	0.0
chr10	ACSL5	112426787	112426859	0	73	0	4259	0	4186	0.0	0.0
chr10	TCF7L2	112964555	112964624	0	70	0	6478	0	6408	0.0	0.0
chr10	TCF7L2	113160618	113160691	0	74	0	6478	0	6404	0.0	0.0
chr10	TCF7L2	113158666	113158717	0	52	0	6478	0	6426	0.0	0.0
chr10	TCF7L2	113159919	113159992	0	74	0	6478	0	6404	0.0	0.0
chr10	TCF7L2	113040024	113040126	0	103	0	6478	0	6375	0.0	0.0
chr10	TCF7L2	113089396	113089540	0	145	0	6478	0	6333	0.0	0.0
chr10	TCF7L2	113089399	113089540	0	142	0	6478	0	6336	0.0	0.0
chr10	TCF7L2	113161578	113161603	0	26	0	6478	0	6452	0.0	0.0
chr10	CASP7	113691996	113692070	0	75	0	3624	0	3549	0.0	0.0
chr10	CASP7	113691963	113692070	0	108	0	3624	0	3516	0.0	0.0
chr10	PLEKHS1	113755258	113755305	0	48	0	5610	0	5562	0.0	0.0
chr10	PLEKHS1	113755258	113755405	0	148	0	5610	0	5462	0.0	0.0
chr10	PLEKHS1	113777123	113777259	0	137	0	5610	0	5473	0.0	0.0
chr10	TDRD1	114227071	114227299	0	229	9388	5283	9388	5054	0.0	1.8575385833003561
chr10	VWA2	114254914	114255048	0	135	364	6367	364	6232	0.0	0.05840821566110398
chr10	AL137025.1	114769042	114769120	153	79	153	2927	0	2848	1.9367088607594938	0.0
chr10	ATRNL1	115096644	115096839	0	196	495	9992	495	9796	0.0	0.05053082890975909
chr10	ATRNL1	115128406	115128508	0	103	495	9992	495	9889	0.0	0.05005561735261402
chr10	ATRNL1	115165557	115165645	0	89	495	9992	495	9903	0.0	0.04998485307482581
chr10	ATRNL1	115334281	115334419	0	139	495	9992	495	9853	0.0	0.05023850603876992
chr10	ATRNL1	115931527	115931653	0	127	495	9992	495	9865	0.0	0.050177394830207805
chr10	PNLIPRP1	116594729	116594864	0	136	23701	4644	23701	4508	0.0	5.2575421472937
chr10	PNLIPRP1	116600046	116600165	0	120	23701	4644	23701	4524	0.0	5.23894783377542
chr10	PNLIPRP1	116594315	116594864	0	550	23701	4644	23701	4094	0.0	5.789203712750367
chr10	ENO4	116874075	116874201	0	127	6745	3194	6745	3067	0.0	2.199217476361265
chr10	ENO4	116849928	116849931	0	4	6745	3194	6745	3190	0.0	2.114420062695925
chr10	ENO4	116864345	116864351	0	7	6745	3194	6745	3187	0.0	2.116410417320364
chr10	EMX2	117545631	117545816	0	186	0	3265	0	3079	0.0	0.0
chr10	LINC02674	117747699	117747891	0	193	0	1050	0	857	0.0	0.0
chr10	AC022395.1	118043440	118043565	0	126	0	2089	0	1963	0.0	0.0
chr10	CASC2	118052130	118052196	0	67	102	14207	102	14140	0.0	0.0072135785007072135
chr10	CASC2	118206521	118206621	0	101	102	14207	102	14106	0.0	0.007230965546575925
chr10	AL354863.1	118241782	118241886	0	105	428	3474	428	3369	0.0	0.12704066488572277
chr10	AL354863.1	118245545	118245633	0	89	428	3474	428	3385	0.0	0.12644017725258494
chr10	AL354863.1	118241782	118242093	0	312	428	3474	428	3162	0.0	0.13535736875395318
chr10	DENND10	119111848	119111928	0	81	8052	5796	8052	5715	0.0	1.4089238845144356
chr10	DENND10	119110192	119110314	0	123	8052	5796	8052	5673	0.0	1.4193548387096775
chr10	INPP5F	119727432	119727469	0	38	6573	7441	6573	7403	0.0	0.887883290557882
chr10	INPP5F	119791516	119791645	0	130	6573	7441	6573	7311	0.0	0.8990562166598277
chr10	INPP5F	119792156	119792213	0	58	6573	7441	6573	7383	0.0	0.8902885006095084
chr10	INPP5F	119823814	119823902	0	89	6573	7441	6573	7352	0.0	0.8940424374319913
chr10	INPP5F	119781060	119781242	0	183	6573	7441	6573	7258	0.0	0.9056213833011849
chr10	INPP5F	119792156	119792211	0	56	6573	7441	6573	7385	0.0	0.8900473933649289
chr10	INPP5F	119757894	119757977	0	84	6573	7441	6573	7357	0.0	0.8934348239771646
chr10	INPP5F	119759856	119760068	0	213	6573	7441	6573	7228	0.0	0.9093801881571666
chr10	INPP5F	119781634	119781771	290	138	6573	7441	6283	7303	2.101449275362319	0.8603313706695879
chr10	INPP5F	119825951	119826018	0	68	6573	7441	6573	7373	0.0	0.89149599891496
chr10	INPP5F	119819766	119819834	0	69	6573	7441	6573	7372	0.0	0.8916169289202387
chr10	SEC23IP	119909040	119909130	0	91	102	6408	102	6317	0.0	0.016146905176507836
chr10	SEC23IP	119930328	119930431	0	104	102	6408	102	6304	0.0	0.01618020304568528
chr10	AC023282.1	120815643	120815715	0	73	220573	6283	220573	6210	0.0	35.519001610305956
chr10	AC023282.1	120812030	120812110	200	81	220573	6283	220373	6202	2.4691358024691357	35.532570138664944
chr10	AC023282.1	120814540	120814644	0	105	220573	6283	220573	6178	0.0	35.70297831013273
chr10	WDR11	120890715	120890887	0	173	11519	7675	11519	7502	0.0	1.5354572114102907
chr10	WDR11	120860108	120860282	0	175	11519	7675	11519	7500	0.0	1.5358666666666667
chr10	WDR11	120867065	120867169	0	105	11519	7675	11519	7570	0.0	1.521664464993395
chr10	WDR11	120856081	120856130	0	50	11519	7675	11519	7625	0.0	1.510688524590164
chr10	TACC2	122143571	122143706	0	136	9656	18193	9656	18057	0.0	0.5347510660685607
chr10	TACC2	122230350	122230440	0	91	9656	18193	9656	18102	0.0	0.5334217213567561
chr10	TACC2	122033093	122033153	0	61	9656	18193	9656	18132	0.0	0.5325391572909772
chr10	TACC2	122209873	122209969	0	97	9656	18193	9656	18096	0.0	0.5335985853227233
chr10	TACC2	122229345	122229486	0	142	9656	18193	9656	18051	0.0	0.5349288128081546
chr10	TACC2	122213341	122213377	0	37	9656	18193	9656	18156	0.0	0.5318352059925093
chr10	TACC2	122245064	122245073	0	10	9656	18193	9656	18183	0.0	0.5310454820436672
chr10	PLEKHA1	122428275	122428316	0	42	0	22851	0	22809	0.0	0.0
chr10	PLEKHA1	122428275	122428420	0	146	0	22851	0	22705	0.0	0.0
chr10	DMBT1	122597024	122597054	0	31	30598	9431	30598	9400	0.0	3.2551063829787235
chr10	DMBT1	122600063	122600093	0	31	30598	9431	30598	9400	0.0	3.2551063829787235
chr10	DMBT1	122629839	122629993	0	155	30598	9431	30598	9276	0.0	3.2986200948684776
chr10	DMBT1	122584321	122584351	0	31	30598	9431	30598	9400	0.0	3.2551063829787235
chr10	DMBT1L1	122779285	122779315	0	31	191	8183	191	8152	0.0	0.02342983316977429
chr10	DMBT1L1	122785035	122785405	0	371	191	8183	191	7812	0.0	0.024449564772145417
chr10	DMBT1L1	122794530	122794747	191	218	191	8183	0	7965	0.8761467889908257	0.0
chr10	PSTK	122986868	122986962	0	95	39	6128	39	6033	0.0	0.006464445549477871
chr10	PSTK	122982732	122983024	0	293	39	6128	39	5835	0.0	0.006683804627249357
chr10	PSTK	122987333	122987504	0	172	39	6128	39	5956	0.0	0.006548018804566823
chr10	ACADSB	123037746	123037847	0	102	0	6246	0	6144	0.0	0.0
chr10	LINC02641	123361888	123362147	791	260	1377	5335	586	5075	3.042307692307692	0.1154679802955665
chr10	LINC02641	123360907	123361019	0	113	1377	5335	1377	5222	0.0	0.26369207200306394
chr10	LINC02641	123360283	123360502	0	220	1377	5335	1377	5115	0.0	0.26920821114369503
chr10	LHPP	124517179	124517271	0	93	19695	4088	19695	3995	0.0	4.92991239048811
chr10	FAM53B-AS1	124707850	124707990	0	141	8328	1764	8328	1623	0.0	5.131238447319778
chr10	TEX36-AS1	125575024	125575139	0	116	0	754	0	638	0.0	0.0
chr10	TEX36-AS1	125576254	125576352	0	99	0	754	0	655	0.0	0.0
chr10	AL158835.1	125700512	125700620	0	109	153	4566	153	4457	0.0	0.03432802333408122
chr10	EDRF1	125729002	125729104	0	103	0	7630	0	7527	0.0	0.0
chr10	EDRF1	125742219	125742345	0	127	0	7630	0	7503	0.0	0.0
chr10	EDRF1	125752798	125752914	0	117	0	7630	0	7513	0.0	0.0
chr10	EDRF1	125731864	125731925	0	62	0	7630	0	7568	0.0	0.0
chr10	EDRF1	125761227	125761314	0	88	0	7630	0	7542	0.0	0.0
chr10	BCCIP	125830561	125830651	0	91	102	4505	102	4414	0.0	0.023108291798821932
chr10	FANK1	125997419	125997485	0	67	51	3163	51	3096	0.0	0.016472868217054265
chr10	FANK1	125989429	125989447	0	19	51	3163	51	3144	0.0	0.016221374045801526
chr10	PTPRE	128060938	128061015	0	78	36915	9038	36915	8960	0.0	4.119977678571429
chr10	PTPRE	127964827	127964998	0	172	36915	9038	36915	8866	0.0	4.163658921723438
chr10	PPP2R2D	131934893	131935006	0	114	270342	7403	270342	7289	0.0	37.08903827685553
chr10	PPP2R2D	131911561	131912598	2807	1038	270342	7403	267535	6365	2.704238921001927	42.03220738413197
chr10	PPP2R2D	131943967	131943997	0	31	270342	7403	270342	7372	0.0	36.671459576776996
chr10	JAKMIP3	132133311	132133527	0	217	97	12408	97	12191	0.0	0.00795668936100402
chr10	JAKMIP3	132152957	132153023	0	67	97	12408	97	12341	0.0	0.007859978932015234
chr10	JAKMIP3	132104671	132104943	0	273	97	12408	97	12135	0.0	0.007993407498969922
chr10	JAKMIP3	132166982	132167055	0	74	97	12408	97	12334	0.0	0.007864439760012972
chr10	JAKMIP3	132169909	132171255	0	1347	97	12408	97	11061	0.0	0.008769550673537655
chr10	JAKMIP3	132169716	132169932	0	217	97	12408	97	12191	0.0	0.00795668936100402
chr10	JAKMIP3	132169855	132170252	0	398	97	12408	97	12010	0.0	0.008076602830974187
chr10	JAKMIP3	132169716	132171255	0	1540	97	12408	97	10868	0.0	0.008925285241074716
chr10	JAKMIP3	132169716	132170915	0	1200	97	12408	97	11208	0.0	0.008654532476802285
chr10	DPYSL4	132198414	132198483	0	70	0	3126	0	3056	0.0	0.0
chr10	DPYSL4	132202645	132202825	0	181	0	3126	0	2945	0.0	0.0
chr10	LRRC27	132342212	132342271	0	60	0	11495	0	11435	0.0	0.0
chr10	LRRC27	132348962	132349057	0	96	0	11495	0	11399	0.0	0.0
chr10	LRRC27	132355789	132355886	0	98	0	11495	0	11397	0.0	0.0
chr10	LINC01168	132967344	132967485	0	142	0	6002	0	5860	0.0	0.0
chr10	ZNF511	133309775	133309977	0	203	0	1349	0	1146	0.0	0.0
chr10	PAOX	133379998	133380485	51	488	51	2260	0	1772	0.10450819672131148	0.0
chr10	PAOX	133383959	133384212	0	254	51	2260	51	2006	0.0	0.025423728813559324
chr10	PAOX	133389589	133389747	0	159	51	2260	51	2101	0.0	0.02427415516420752
chr10	PAOX	133382851	133382939	0	89	51	2260	51	2171	0.0	0.02349147858129894
chr10	SCART1	133464605	133464911	0	307	0	7075	0	6768	0.0	0.0
chr10	CYP2E1	133528480	133528640	0	161	183	8835	183	8674	0.0	0.021097532856813466
chr10	CYP2E1	133532123	133532284	0	162	183	8835	183	8673	0.0	0.02109996540989277
chr10	CYP2E1	133533755	133533897	0	143	183	8835	183	8692	0.0	0.02105384261389784
chr10	CYP2E1	133531584	133531734	0	151	183	8835	183	8684	0.0	0.0210732381391064
chr10	AL731769.2	133574493	133574577	0	85	0	5667	0	5582	0.0	0.0
chr10	AL731769.2	133608143	133608388	0	246	0	5667	0	5421	0.0	0.0
chr11	ODF3	199368	199509	0	142	1887	1543	1887	1401	0.0	1.3468950749464668
chr11	RIC8A	210406	210445	0	40	1099364	4543	1099364	4503	0.0	244.140350877193
chr11	PSMD13	238997	239076	89863	80	941344	2848	851481	2768	1123.2875	307.6159682080925
chr11	PSMD13	244040	244075	34266	36	941344	2848	907078	2812	951.8333333333334	322.57396870554766
chr11	PSMD13	251545	251626	42730	82	941344	2848	898614	2766	521.0975609756098	324.87852494577004
chr11	PSMD13	251819	251936	89317	118	941344	2848	852027	2730	756.9237288135594	312.0978021978022
chr11	IFITM2	308754	308889	105	136	92679	1548	92574	1412	0.7720588235294118	65.56232294617564
chr11	PTDSS2	473894	473977	22654	84	505397	5471	482743	5387	269.6904761904762	89.61258585483571
chr11	PTDSS2	451384	451493	3018	110	505397	5471	502379	5361	27.436363636363637	93.70994217496735
chr11	PTDSS2	451351	451493	4756	143	505397	5471	500641	5328	33.25874125874126	93.96415165165165
chr11	RASSF7	561761	561892	12133	132	117621	2441	105488	2309	91.91666666666667	45.68557817236899
chr11	RASSF7	563395	563478	2654	84	117621	2441	114967	2357	31.595238095238095	48.776834959694526
chr11	EPS8L2	706676	706801	322	126	52484	4588	52162	4462	2.5555555555555554	11.690273419991035
chr11	EPS8L2	721902	721991	1002	90	52484	4588	51482	4498	11.133333333333333	11.445531347265451
chr11	EPS8L2	722090	722165	1389	76	52484	4588	51095	4512	18.276315789473685	11.32424645390071
chr11	EPS8L2	708574	708643	0	70	52484	4588	52484	4518	0.0	11.616644532979194
chr11	EPS8L2	706673	706801	343	129	52484	4588	52141	4459	2.6589147286821704	11.693429019959632
chr11	EPS8L2	706595	706801	357	207	52484	4588	52127	4381	1.7246376811594204	11.89842501711938
chr11	TALDO1	752263	752473	1726	211	1197190	2916	1195464	2705	8.180094786729859	441.9460258780037
chr11	AP006621.3	778112	778218	1493	107	132283	1492	130790	1385	13.953271028037383	94.4332129963899
chr11	CRACR2B	830865	831032	4578	168	34138	3193	29560	3025	27.25	9.77190082644628
chr11	CD151	833987	834067	2573	81	1920102	3539	1917529	3458	31.765432098765434	554.5196645459804
chr11	CD151	836768	836843	99827	76	1920102	3539	1820275	3463	1313.5131578947369	525.6352873231302
chr11	CD151	834529	834591	85203	63	1920102	3539	1834899	3476	1352.4285714285713	527.876582278481
chr11	CD151	835019	835139	845	121	1920102	3539	1919257	3418	6.983471074380165	561.5146284376829
chr11	CD151	834529	834803	85580	275	1920102	3539	1834522	3264	311.2	562.0471813725491
chr11	CD151	834529	834745	85410	217	1920102	3539	1834692	3322	393.59447004608296	552.2853702588802
chr11	TSPAN4	862549	862741	240868	193	1116795	4889	875927	4696	1248.020725388601	186.52619250425894
chr11	TSPAN4	865512	865614	161436	103	1116795	4889	955359	4786	1567.3398058252428	199.615336397827
chr11	TSPAN4	847200	847300	51239	101	1116795	4889	1065556	4788	507.3168316831683	222.54720133667502
chr11	TSPAN4	850287	850367	53725	81	1116795	4889	1063070	4808	663.2716049382716	221.10440931780366
chr11	AP2A2	1000431	1000598	113884	168	1215669	8274	1101785	8106	677.8809523809524	135.92215642733777
chr11	BRSK2	1444970	1445002	0	33	1980	6414	1980	6381	0.0	0.31029619181946405
chr11	BRSK2	1456954	1457049	0	96	1980	6414	1980	6318	0.0	0.31339031339031337
chr11	BRSK2	1459191	1459239	0	49	1980	6414	1980	6365	0.0	0.3110761979575805
chr11	BRSK2	1447797	1447863	0	67	1980	6414	1980	6347	0.0	0.3119584055459272
chr11	LSP1	1880086	1880224	0	139	0	6021	0	5882	0.0	0.0
chr11	LINC01150	1901715	1901770	0	56	357	1304	357	1248	0.0	0.2860576923076923
chr11	TNNT3	1923554	1923572	0	19	51	2739	51	2720	0.0	0.01875
chr11	TNNT3	1929119	1929143	0	25	51	2739	51	2714	0.0	0.01879145173176124
chr11	TNNT3	1923047	1923061	0	15	51	2739	51	2724	0.0	0.018722466960352423
chr11	TNNT3	1926694	1926709	0	16	51	2739	51	2723	0.0	0.01872934263679765
chr11	TNNT3	1925098	1925116	0	19	51	2739	51	2720	0.0	0.01875
chr11	TNNT3	1921361	1921619	0	259	51	2739	51	2480	0.0	0.02056451612903226
chr11	MRPL23	1955610	1955781	0	172	357	2986	357	2814	0.0	0.12686567164179105
chr11	TSPAN32	2308735	2308810	0	76	0	2972	0	2896	0.0	0.0
chr11	TSPAN32	2317343	2317525	0	183	0	2972	0	2789	0.0	0.0
chr11	TSPAN32	2317345	2317525	0	181	0	2972	0	2791	0.0	0.0
chr11	TSPAN32	2317426	2317525	0	100	0	2972	0	2872	0.0	0.0
chr11	CD81	2376820	2376920	0	101	8536	6256	8536	6155	0.0	1.3868399675060925
chr11	TSSC4	2401975	2402147	0	173	914	2556	914	2383	0.0	0.3835501468736886
chr11	TSSC4	2401838	2401979	0	142	914	2556	914	2414	0.0	0.37862468931234466
chr11	TSSC4	2401838	2402147	0	310	914	2556	914	2246	0.0	0.40694568121104185
chr11	KCNQ1	2585211	2585307	0	97	0	4442	0	4345	0.0	0.0
chr11	KCNQ1	2521478	2521570	0	93	0	4442	0	4349	0.0	0.0
chr11	MRGPRG-AS1	3220226	3220359	0	134	0	2016	0	1882	0.0	0.0
chr11	MRGPRG-AS1	3219699	3219788	0	90	0	2016	0	1926	0.0	0.0
chr11	TSSC2	3397116	3397406	0	291	7071	3680	7071	3389	0.0	2.0864561817645324
chr11	TRPC2	3628722	3628819	0	98	0	3280	0	3182	0.0	0.0
chr11	TRPC2	3635274	3635353	0	80	0	3280	0	3200	0.0	0.0
chr11	PGAP2	3811249	3811424	0	176	2848	3571	2848	3395	0.0	0.838880706921944
chr11	PGAP2	3822908	3822993	0	86	2848	3571	2848	3485	0.0	0.8172166427546629
chr11	PGAP2	3823882	3824135	1510	254	2848	3571	1338	3317	5.94488188976378	0.40337654507084714
chr11	PGAP2	3817431	3817535	195	105	2848	3571	2653	3466	1.8571428571428572	0.7654356607039815
chr11	PGAP2	3823612	3823740	141	129	2848	3571	2707	3442	1.0930232558139534	0.7864613596746078
chr11	PGAP2	3817352	3817535	195	184	2848	3571	2653	3387	1.059782608695652	0.7832890463537053
chr11	PGAP2	3823616	3823740	141	125	2848	3571	2707	3446	1.128	0.78554846198491
chr11	STIM1	4074501	4074679	51	179	25535	6805	25484	6626	0.2849162011173184	3.8460609719287655
chr11	STIM1	4088701	4088738	0	38	25535	6805	25535	6767	0.0	3.773459435495788
chr11	STIM1	3947562	3947667	0	106	25535	6805	25535	6699	0.0	3.811762949693984
chr11	STIM1	4084672	4084765	0	94	25535	6805	25535	6711	0.0	3.8049471017732084
chr11	RRM1	4105605	4105691	64	87	89423	4257	89359	4170	0.735632183908046	21.42901678657074
chr11	RRM1	4101992	4102081	0	90	89423	4257	89423	4167	0.0	21.459803215742742
chr11	RRM1	4106045	4106223	1443	179	89423	4257	87980	4078	8.061452513966481	21.574301128003924
chr11	OR52B5P	5558996	5559049	0	54	0	3523	0	3469	0.0	0.0
chr11	TRIM6	5603245	5603735	0	491	50	3973	50	3482	0.0	0.014359563469270534
chr11	TRIM6	5603607	5603735	0	129	50	3973	50	3844	0.0	0.013007284079084287
chr11	TRIM6	5605336	5605567	0	232	50	3973	50	3741	0.0	0.013365410318096765
chr11	TRIM6	5604533	5604629	0	97	50	3973	50	3876	0.0	0.012899896800825593
chr11	TRIM22	5697247	5697343	8	97	3264	4986	3256	4889	0.08247422680412371	0.665984863980364
chr11	OR56A3	5943329	5943486	0	158	4998	4801	4998	4643	0.0	1.076459185871204
chr11	CCKBR	6269668	6269920	0	253	0	2398	0	2145	0.0	0.0
chr11	CCKBR	6264473	6264633	0	161	0	2398	0	2237	0.0	0.0
chr11	AC068733.3	6323584	6323692	0	109	771	4772	771	4663	0.0	0.1653441990135106
chr11	AC068733.3	6333615	6333708	0	94	771	4772	771	4678	0.0	0.16481402308678922
chr11	SMPD1	6393215	6393387	0	173	44	2455	44	2282	0.0	0.019281332164767746
chr11	TIMM10B	6481756	6481852	0	97	357	2951	357	2854	0.0	0.1250875963559916
chr11	DNHD1	6558901	6559106	143	206	213785	18420	213642	18214	0.6941747572815534	11.729548698803118
chr11	ILK	6608693	6608790	0	98	3335	3225	3335	3127	0.0	1.0665174288455388
chr11	ILK	6609070	6609156	0	87	3335	3225	3335	3138	0.0	1.062778840025494
chr11	ILK	6608045	6608211	0	167	3335	3225	3335	3058	0.0	1.0905820797907129
chr11	ILK	6604852	6604943	0	92	3335	3225	3335	3133	0.0	1.064474944142994
chr11	ZNF215	6943545	6943641	0	97	102	5918	102	5821	0.0	0.01752276241195671
chr11	ZNF215	6943082	6943215	0	134	102	5918	102	5784	0.0	0.017634854771784232
chr11	ZNF215	6927661	6927807	51	147	102	5918	51	5771	0.3469387755102041	0.008837289897764685
chr11	SYT9	7314184	7314337	0	154	0	4785	0	4631	0.0	0.0
chr11	SYT9	7313394	7313941	0	548	0	4785	0	4237	0.0	0.0
chr11	PPFIBP2	7548343	7548499	0	157	0	8897	0	8740	0.0	0.0
chr11	PPFIBP2	7597559	7597673	0	115	0	8897	0	8782	0.0	0.0
chr11	PPFIBP2	7617111	7617294	0	184	0	8897	0	8713	0.0	0.0
chr11	PPFIBP2	7641032	7641065	0	34	0	8897	0	8863	0.0	0.0
chr11	PPFIBP2	7641032	7641083	0	52	0	8897	0	8845	0.0	0.0
chr11	EIF3F	7991780	7991851	0	72	3111	8989	3111	8917	0.0	0.348884153863407
chr11	EIF3F	7991780	7991971	0	192	3111	8989	3111	8797	0.0	0.3536432874843697
chr11	EIF3F	7994102	7994237	0	136	3111	8989	3111	8853	0.0	0.35140630294815317
chr11	RPL27A	8684717	8684892	121	176	38880	3540	38759	3364	0.6875	11.521700356718192
chr11	RPL27A	8684822	8684892	28	71	38880	3540	38852	3469	0.39436619718309857	11.1997693859902
chr11	RPL27A	8684685	8684892	456	208	38880	3540	38424	3332	2.1923076923076925	11.531812725090036
chr11	AC026894.1	8787053	8787286	0	234	408	1261	408	1027	0.0	0.39727361246348586
chr11	AKIP1	8917286	8917367	0	82	4539	2242	4539	2160	0.0	2.1013888888888888
chr11	AKIP1	8912452	8912533	0	82	4539	2242	4539	2160	0.0	2.1013888888888888
chr11	AC079296.1	9060374	9060535	405	162	10219	4344	9814	4182	2.5	2.346724055475849
chr11	AC079296.1	9056497	9057455	0	959	10219	4344	10219	3385	0.0	3.01890694239291
chr11	IPO7	9392197	9392320	0	124	56745	6872	56745	6748	0.0	8.409158269116775
chr11	IPO7	9403289	9403371	0	83	56745	6872	56745	6789	0.0	8.358373840035352
chr11	ZNF143	9472676	9472769	175	94	12634	4244	12459	4150	1.8617021276595744	3.0021686746987952
chr11	ZNF143	9474549	9474633	0	85	12634	4244	12634	4159	0.0	3.0377494590045684
chr11	ZNF143	9474552	9474633	0	82	12634	4244	12634	4162	0.0	3.035559827006247
chr11	ZNF143	9473776	9473849	0	74	12634	4244	12634	4170	0.0	3.029736211031175
chr11	ZNF143	9463770	9463870	2806	101	12634	4244	9828	4143	27.782178217821784	2.3721940622737145
chr11	SWAP70	9713465	9713639	0	175	26628	6787	26628	6612	0.0	4.027223230490018
chr11	SWAP70	9703395	9703448	0	54	26628	6787	26628	6733	0.0	3.9548492499628694
chr11	SBF2-AS1	9779816	9779942	306	127	15880	4738	15574	4611	2.409448818897638	3.3775753632617653
chr11	SBF2-AS1	9780375	9780575	102	201	15880	4738	15778	4537	0.5074626865671642	3.477628388803174
chr11	SBF2-AS1	9784591	9784776	0	186	15880	4738	15880	4552	0.0	3.4885764499121263
chr11	AMPD3	10478525	10478730	0	206	2361	6622	2361	6416	0.0	0.3679862842892768
chr11	IRAG1-AS1	10589011	10589150	0	140	2295	1391	2295	1251	0.0	1.8345323741007193
chr11	IRAG1-AS1	10586026	10586126	0	101	2295	1391	2295	1290	0.0	1.7790697674418605
chr11	IRAG1-AS1	10595720	10595795	0	76	2295	1391	2295	1315	0.0	1.7452471482889733
chr11	CTR9	10761946	10762054	0	109	12748	5798	12748	5689	0.0	2.240815609070135
chr11	ZBED5-AS1	10865260	10865327	0	68	40898	4558	40898	4490	0.0	9.108685968819598
chr11	ZBED5-AS1	10896656	10896838	0	183	40898	4558	40898	4375	0.0	9.348114285714285
chr11	USP47	11880176	11880380	0	205	12572	11959	12572	11754	0.0	1.0695933299302365
chr11	USP47	11873799	11873859	0	61	12572	11959	12572	11898	0.0	1.0566481761640611
chr11	MICAL2	12249183	12249246	0	64	42984	16154	42984	16090	0.0	2.67147296457427
chr11	MICAL2	12153223	12153316	0	94	42984	16154	42984	16060	0.0	2.6764632627646328
chr11	TEAD1	12675408	12675561	0	154	51	10563	51	10409	0.0	0.004899606110097031
chr11	TEAD1	12901939	12902113	0	175	51	10563	51	10388	0.0	0.004909510974201001
chr11	TEAD1	12878888	12878900	0	13	51	10563	51	10550	0.0	0.004834123222748815
chr11	ARNTL	13349944	13350070	0	127	9070	6957	9070	6830	0.0	1.32796486090776
chr11	ARNTL	13326412	13326467	0	56	9070	6957	9070	6901	0.0	1.3143022750326039
chr11	ARNTL	13356738	13356777	0	40	9070	6957	9070	6917	0.0	1.311262107850224
chr11	ARNTL	13309986	13310059	0	74	9070	6957	9070	6883	0.0	1.317739357838152
chr11	ARNTL	13355225	13355296	280	72	9070	6957	8790	6885	3.888888888888889	1.2766884531590414
chr11	ARNTL	13355232	13355296	280	65	9070	6957	8790	6892	4.3076923076923075	1.27539175856065
chr11	ARNTL	13355172	13355296	280	125	9070	6957	8790	6832	2.24	1.286592505854801
chr11	ARNTL	13321820	13321919	0	100	9070	6957	9070	6857	0.0	1.3227358903310487
chr11	ARNTL	13354989	13355010	0	22	9070	6957	9070	6935	0.0	1.307858687815429
chr11	LINC02548	13840654	13840851	0	198	0	2483	0	2285	0.0	0.0
chr11	LINC02548	13844922	13845095	0	174	0	2483	0	2309	0.0	0.0
chr11	LINC02548	13810241	13810346	0	106	0	2483	0	2377	0.0	0.0
chr11	INSC	15200823	15200949	0	127	0	3468	0	3341	0.0	0.0
chr11	INSC	15241566	15241645	0	80	0	3468	0	3388	0.0	0.0
chr11	INSC	15184417	15184522	0	106	0	3468	0	3362	0.0	0.0
chr11	LINC02682	15920115	15920236	0	122	0	3435	0	3313	0.0	0.0
chr11	LINC02682	15917429	15917481	0	53	0	3435	0	3382	0.0	0.0
chr11	LINC02682	15922585	15922655	0	71	0	3435	0	3364	0.0	0.0
chr11	LINC02682	15918301	15918462	0	162	0	3435	0	3273	0.0	0.0
chr11	C11ORF58	16744600	16744684	0	85	796	9224	796	9139	0.0	0.08709924499398183
chr11	C11ORF58	16748096	16748157	0	62	796	9224	796	9162	0.0	0.08688059375682165
chr11	C11ORF58	16753883	16754035	0	153	796	9224	796	9071	0.0	0.0877521772682174
chr11	NUCB2	17276007	17276203	0	197	181799	9053	181799	8856	0.0	20.528342366757002
chr11	NUCB2	17315385	17315475	60	91	181799	9053	181739	8962	0.6593406593406593	20.27884400803392
chr11	NUCB2	17330126	17330297	0	172	181799	9053	181799	8881	0.0	20.47055511766693
chr11	NUCB2	17267587	17267681	18	95	181799	9053	181781	8958	0.18947368421052632	20.29258763116767
chr11	NUCB2	17275612	17275909	0	298	181799	9053	181799	8755	0.0	20.76516276413478
chr11	NUCB2	17286633	17286713	0	81	181799	9053	181799	8972	0.0	20.262929112795362
chr11	NUCB2	17317583	17317706	14178	124	181799	9053	167621	8929	114.33870967741936	18.772650912756188
chr11	NUCB2	17291239	17291365	0	127	181799	9053	181799	8926	0.0	20.367353797893795
chr11	NUCB2	17286633	17286717	0	85	181799	9053	181799	8968	0.0	20.271966993755576
chr11	NUCB2	17283460	17283564	51	105	181799	9053	181748	8948	0.4857142857142857	20.311578006258383
chr11	OTOG	17591449	17591588	0	140	0	10880	0	10740	0.0	0.0
chr11	OTOG	17599670	17599697	0	28	0	10880	0	10852	0.0	0.0
chr11	KCNC1	17781669	17781901	0	233	867	12001	867	11768	0.0	0.0736743711760707
chr11	KCNC1	17779455	17779644	0	190	867	12001	867	11811	0.0	0.07340614681229363
chr11	KCNC1	17773768	17773830	0	63	867	12001	867	11938	0.0	0.07262523035684369
chr11	SAA1	18266382	18266443	0	62	0	714	0	652	0.0	0.0
chr11	GTF2H1	18325946	18326153	0	208	15245	6442	15245	6234	0.0	2.445460378569137
chr11	GTF2H1	18335753	18335946	0	194	15245	6442	15245	6248	0.0	2.4399807938540334
chr11	GTF2H1	18325946	18326019	0	74	15245	6442	15245	6368	0.0	2.394001256281407
chr11	LDHA	18399430	18399548	0	119	969	4566	969	4447	0.0	0.21789970766809086
chr11	LDHA	18400836	18401010	0	175	969	4566	969	4391	0.0	0.2206786608972899
chr11	LDHA	18398797	18398988	51	192	969	4566	918	4374	0.265625	0.20987654320987653
chr11	LDHA	18405448	18405572	0	125	969	4566	969	4441	0.0	0.21819410042783158
chr11	LDHA	18395123	18395273	51	151	969	4566	918	4415	0.33774834437086093	0.20792751981879953
chr11	LDHA	18400629	18400745	0	117	969	4566	969	4449	0.0	0.21780175320296696
chr11	LDHA	18396479	18396610	0	132	969	4566	969	4434	0.0	0.2185385656292287
chr11	LDHC	18415183	18415301	0	119	612	2097	612	1978	0.0	0.30940343781597573
chr11	LDHC	18429736	18429910	612	175	612	2097	0	1922	3.4971428571428573	0.0
chr11	LDHC	18446209	18446333	0	125	612	2097	612	1972	0.0	0.3103448275862069
chr11	LDHC	18434739	18434913	0	175	612	2097	612	1922	0.0	0.3184183142559833
chr11	LDHC	18429778	18429910	612	133	612	2097	0	1964	4.601503759398496	0.0
chr11	LDHC	18438527	18438645	0	119	612	2097	612	1978	0.0	0.30940343781597573
chr11	ZDHHC13	19142977	19143123	0	147	38650	7703	38650	7556	0.0	5.115140285865538
chr11	AC009652.1	19301376	19301483	0	108	0	652	0	544	0.0	0.0
chr11	NAV2	20049835	20049901	0	67	122743	15007	122743	14940	0.0	8.215729585006693
chr11	NAV2	20082591	20082600	266	10	122743	15007	122477	14997	26.6	8.166766686670668
chr11	NAV2	19884293	19884362	0	70	122743	15007	122743	14937	0.0	8.217379661243891
chr11	NAV2	20056529	20056628	0	100	122743	15007	122743	14907	0.0	8.233916951767625
chr11	NAV2	20051288	20051333	0	46	122743	15007	122743	14961	0.0	8.204197580375643
chr11	HTATIP2	20376579	20376717	51	139	51	2801	0	2662	0.3669064748201439	0.0
chr11	PRMT3	20392210	20392260	0	51	6588	5499	6588	5448	0.0	1.2092511013215859
chr11	PRMT3	20393790	20393854	188	65	6588	5499	6400	5434	2.8923076923076922	1.1777695988222303
chr11	PRMT3	20388018	20388154	1479	137	6588	5499	5109	5362	10.795620437956204	0.952816113390526
chr11	SLC6A5	20604285	20604424	30	140	30	6937	0	6797	0.21428571428571427	0.0
chr11	NELL1	21534373	21534514	0	142	42	5341	42	5199	0.0	0.008078476630121177
chr11	NELL1	21560188	21560382	0	195	42	5341	42	5146	0.0	0.008161678973960357
chr11	NELL1	20674488	20674572	0	85	42	5341	42	5256	0.0	0.007990867579908675
chr11	NELL1	20847582	20847753	0	172	42	5341	42	5169	0.0	0.00812536273940801
chr11	GAS2	22731330	22731396	0	67	0	4135	0	4068	0.0	0.0
chr11	LINC02718	23164990	23165093	0	104	0	1360	0	1256	0.0	0.0
chr11	BBOX1	27093167	27093366	51	200	51	2152	0	1952	0.255	0.0
chr11	BDNF-AS	27540019	27540116	0	98	113219	12372	113219	12274	0.0	9.224295258269512
chr11	BDNF-AS	27658240	27658462	0	223	113219	12372	113219	12149	0.0	9.319203226603012
chr11	BDNF-AS	27658237	27658462	0	226	113219	12372	113219	12146	0.0	9.321505022229541
chr11	BDNF-AS	27675576	27676140	1837	565	113219	12372	111382	11807	3.2513274336283184	9.433556364868299
chr11	BDNF-AS	27584268	27584337	0	70	113219	12372	113219	12302	0.0	9.203300276377824
chr11	BDNF-AS	27676981	27677139	23277	159	113219	12372	89942	12213	146.39622641509433	7.364447719643003
chr11	BDNF-AS	27665260	27665392	0	133	113219	12372	113219	12239	0.0	9.250674074679305
chr11	BDNF-AS	27658240	27658544	0	305	113219	12372	113219	12067	0.0	9.382530869313003
chr11	BDNF-AS	27658240	27658620	0	381	113219	12372	113219	11991	0.0	9.441998165290634
chr11	BDNF-AS	27592879	27592981	0	103	113219	12372	113219	12269	0.0	9.228054446165132
chr11	BDNF-AS	27691105	27691140	0	36	113219	12372	113219	12336	0.0	9.177934500648508
chr11	BDNF-AS	27675296	27676140	1990	845	113219	12372	111229	11527	2.3550295857988166	9.64943176889043
chr11	BDNF-AS	27675296	27675496	81	201	113219	12372	113138	12171	0.40298507462686567	9.295702900336867
chr11	METTL15	28211061	28211198	0	138	13791	6379	13791	6241	0.0	2.2097420285210703
chr11	METTL15	28197440	28197549	0	110	13791	6379	13791	6269	0.0	2.1998723879406605
chr11	METTL15	28328094	28328165	0	72	13791	6379	13791	6307	0.0	2.1866180434437927
chr11	METTL15	28296752	28296931	0	180	13791	6379	13791	6199	0.0	2.224713663494112
chr11	METTL15	28122141	28122180	0	40	13791	6379	13791	6339	0.0	2.175579744439186
chr11	LINC02546	29622634	29623076	0	443	0	2969	0	2526	0.0	0.0
chr11	LINC02546	29622754	29623076	0	323	0	2969	0	2646	0.0	0.0
chr11	LINC02546	29622634	29622913	0	280	0	2969	0	2689	0.0	0.0
chr11	LINC02546	29621730	29621905	0	176	0	2969	0	2793	0.0	0.0
chr11	DNAJC24	31407455	31407543	0	89	663	6529	663	6440	0.0	0.1029503105590062
chr11	DNAJC24	31396282	31396394	0	113	663	6529	663	6416	0.0	0.10333541147132169
chr11	DNAJC24	31421971	31422132	0	162	663	6529	663	6367	0.0	0.10413067378671274
chr11	DNAJC24	31374102	31374205	0	104	663	6529	663	6425	0.0	0.10319066147859922
chr11	DNAJC24	31408109	31408330	0	222	663	6529	663	6307	0.0	0.10512129380053908
chr11	DNAJC24	31429482	31429606	0	125	663	6529	663	6404	0.0	0.10352904434728295
chr11	ELP4	31594769	31594901	0	133	15568	23173	15568	23040	0.0	0.6756944444444445
chr11	ELP4	31763410	31763549	0	140	15568	23173	15568	23033	0.0	0.6758997959449485
chr11	ELP4	31541430	31541476	0	47	15568	23173	15568	23126	0.0	0.6731817002507999
chr11	ELP4	31628238	31628419	0	182	15568	23173	15568	22991	0.0	0.677134530903397
chr11	ELP4	31681786	31682075	0	290	15568	23173	15568	22883	0.0	0.6803303762618538
chr11	ELP4	31580682	31580800	0	119	15568	23173	15568	23054	0.0	0.6752841155547844
chr11	ELP4	31573586	31573624	0	39	15568	23173	15568	23134	0.0	0.6729489063715743
chr11	ELP4	31714630	31714779	0	150	15568	23173	15568	23023	0.0	0.6761933718455457
chr11	ELP4	31780678	31780761	0	84	15568	23173	15568	23089	0.0	0.6742604703538482
chr11	ELP4	31687660	31687702	0	43	15568	23173	15568	23130	0.0	0.6730652831820148
chr11	PAUPAR	31829498	31829607	0	110	18536	7661	18536	7551	0.0	2.454774202092438
chr11	RCN1	32103003	32103158	0	156	0	3470	0	3314	0.0	0.0
chr11	WT1-AS	32437069	32437197	111	129	187	5365	76	5236	0.8604651162790697	0.014514896867838044
chr11	EIF3M	32588593	32588732	0	140	151936	7442	151936	7302	0.0	20.80745001369488
chr11	EIF3M	32589011	32589135	0	125	151936	7442	151936	7317	0.0	20.764794314609812
chr11	EIF3M	32587011	32587144	0	134	151936	7442	151936	7308	0.0	20.790366721401202
chr11	EIF3M	32602078	32602114	0	37	151936	7442	151936	7405	0.0	20.518028359216746
chr11	QSER1	32927961	32928123	0	163	46805	10924	46805	10761	0.0	4.349502834309079
chr11	QSER1	32966299	32966437	0	139	46805	10924	46805	10785	0.0	4.339823829392675
chr11	TCP11L1	33040129	33040202	0	74	4875	5147	4875	5073	0.0	0.960969840331165
chr11	TCP11L1	33056587	33056723	0	137	4875	5147	4875	5010	0.0	0.9730538922155688
chr11	CSTF3-DT	33189367	33189557	102	191	1892	4016	1790	3825	0.5340314136125655	0.46797385620915033
chr11	HIPK3	33348165	33348228	0	64	474168	8184	474168	8120	0.0	58.395073891625614
chr11	KIAA1549L	33591236	33591421	0	186	36880	13519	36880	13333	0.0	2.7660691517287934
chr11	CAPRIN1	34052420	34052636	0	217	312523	8803	312523	8586	0.0	36.399138131842534
chr11	CAT	34457775	34457847	0	73	44872	3593	44872	3520	0.0	12.747727272727273
chr11	EHF	34651736	34651805	0	70	153	6633	153	6563	0.0	0.023312509523083957
chr11	PDHX	34931403	34931484	0	82	7826	3735	7826	3653	0.0	2.1423487544483986
chr11	CD44	35180273	35180407	0	135	2905450	9710	2905450	9575	0.0	303.44125326370755
chr11	CD44	35198120	35198246	1464956	127	2905450	9710	1440494	9583	11535.086614173228	150.31764583115935
chr11	CD44	35201670	35201787	0	118	2905450	9710	2905450	9592	0.0	302.9034612176814
chr11	CD44	35206111	35206243	0	133	2905450	9710	2905450	9577	0.0	303.3778845149838
chr11	CD44	35211245	35211449	987465	205	2905450	9710	1917985	9505	4816.90243902439	201.78695423461338
chr11	CD44	35221653	35221732	210	80	2905450	9710	2905240	9630	2.625	301.6863966770509
chr11	CD44	35214851	35214914	64	64	2905450	9710	2905386	9646	1.0	301.2011196350819
chr11	CD44	35196745	35196874	40	130	2905450	9710	2905410	9580	0.3076923076923077	303.2787056367432
chr11	CD44	35208104	35208206	0	103	2905450	9710	2905450	9607	0.0	302.43051941292805
chr11	CD44	35209964	35210054	1602	91	2905450	9710	2903848	9619	17.604395604395606	301.88668260733965
chr11	CD44	35204511	35204640	0	130	2905450	9710	2905450	9580	0.0	303.28288100208766
chr11	CD44	35198147	35198246	1070906	100	2905450	9710	1834544	9610	10709.06	190.89947970863685
chr11	CD44	35206114	35206243	0	130	2905450	9710	2905450	9580	0.0	303.28288100208766
chr11	LDLRAD3	36101914	36102031	0	118	1581	4585	1581	4467	0.0	0.3539288112827401
chr11	LDLRAD3	36227084	36227430	0	347	1581	4585	1581	4238	0.0	0.3730533270410571
chr11	LDLRAD3	36036102	36036249	0	148	1581	4585	1581	4437	0.0	0.3563218390804598
chr11	PRR5L	36419254	36419303	288	50	11609	6635	11321	6585	5.76	1.7192103264996204
chr11	PRR5L	36446299	36446440	0	142	11609	6635	11609	6493	0.0	1.7879254581857384
chr11	PRR5L	36451208	36451335	0	128	11609	6635	11609	6507	0.0	1.7840786844936223
chr11	PRR5L	36393845	36394011	0	167	11609	6635	11609	6468	0.0	1.7948361162646878
chr11	IFTAP	36633283	36633438	0	156	502	10397	502	10241	0.0	0.04901865052240992
chr11	IFTAP	36636050	36636117	51	68	502	10397	451	10329	0.75	0.043663471778487756
chr11	IFTAP	36648015	36648155	0	141	502	10397	502	10256	0.0	0.048946957878315135
chr11	IFTAP	36597643	36597730	33	88	502	10397	469	10309	0.375	0.04549422834416529
chr11	IFTAP	36610080	36610239	0	160	502	10397	502	10237	0.0	0.04903780404415356
chr11	IFTAP	36633285	36633438	0	154	502	10397	502	10243	0.0	0.04900907937127794
chr11	LINC01493	38648423	38648604	0	182	0	2429	0	2247	0.0	0.0
chr11	LINC01493	38648768	38648934	0	167	0	2429	0	2262	0.0	0.0
chr11	LINC01499	41808966	41809083	0	118	0	3065	0	2947	0.0	0.0
chr11	API5	43318420	43318482	0	63	37742	4580	37742	4517	0.0	8.355545716183308
chr11	API5	43326506	43326611	0	106	37742	4580	37742	4474	0.0	8.435851586946804
chr11	API5	43335277	43335354	0	78	37742	4580	37742	4502	0.0	8.383385162150155
chr11	API5	43318639	43318801	0	163	37742	4580	37742	4417	0.0	8.544713606520263
chr11	TTC17	43436163	43436334	22512	172	30484	11324	7972	11152	130.88372093023256	0.7148493543758967
chr11	TTC17	43370078	43370385	0	308	30484	11324	30484	11016	0.0	2.7672476397966594
chr11	TTC17	43486415	43486451	0	37	30484	11324	30484	11287	0.0	2.7008062372641093
chr11	HSD17B12	43798319	43798427	0	109	0	4696	0	4587	0.0	0.0
chr11	ALKBH3	43883982	43884017	667	36	30827	2155	30160	2119	18.52777777777778	14.233128834355828
chr11	ALKBH3	43897194	43897354	0	161	30827	2155	30827	1994	0.0	15.45987963891675
chr11	ALKBH3	43892040	43892129	39	90	30827	2155	30788	2065	0.43333333333333335	14.909443099273608
chr11	ALKBH3	43901515	43901725	0	211	30827	2155	30827	1944	0.0	15.857510288065845
chr11	ACCS	44083423	44083577	0	155	25	4458	25	4303	0.0	0.005809900069718801
chr11	EXT2	44104616	44104783	3383	168	10251	11714	6868	11546	20.136904761904763	0.5948380391477568
chr11	EXT2	44197828	44198018	204	191	10251	11714	10047	11523	1.068062827225131	0.8719083571986462
chr11	EXT2	44236292	44236375	0	84	10251	11714	10251	11630	0.0	0.8814273430782459
chr11	EXT2	44103706	44103745	1062	40	10251	11714	9189	11674	26.55	0.7871338016104164
chr11	CD82	44605354	44605429	0	76	3357	3641	3357	3565	0.0	0.9416549789621318
chr11	CD82	44618639	44618723	0	85	3357	3641	3357	3556	0.0	0.9440382452193475
chr11	CD82	44566272	44566330	0	59	3357	3641	3357	3582	0.0	0.9371859296482412
chr11	CD82	44587709	44587886	1173	178	3357	3641	2184	3463	6.589887640449438	0.6306670516892867
chr11	CD82	44585142	44585292	0	151	3357	3641	3357	3490	0.0	0.9618911174785101
chr11	TSPAN18	44909704	44909899	0	196	51	4392	51	4196	0.0	0.01215443279313632
chr11	TSPAN18	44897751	44897828	0	78	51	4392	51	4314	0.0	0.011821974965229486
chr11	LINC02685	44974795	44974893	0	99	0	1608	0	1509	0.0	0.0
chr11	LINC02685	44977308	44977402	0	95	0	1608	0	1513	0.0	0.0
chr11	LINC02685	44974574	44974893	0	320	0	1608	0	1288	0.0	0.0
chr11	PRDM11	45224216	45224843	0	628	49397	13952	49397	13324	0.0	3.707370159111378
chr11	LINC02696	45355878	45355925	40	48	102	5170	62	5122	0.8333333333333334	0.01210464662241312
chr11	AC044839.1	45734540	45734799	0	260	0	6744	0	6484	0.0	0.0
chr11	AC044839.1	45739409	45739542	0	134	0	6744	0	6610	0.0	0.0
chr11	AC044839.1	45740900	45740963	0	64	0	6744	0	6680	0.0	0.0
chr11	AC044839.1	45741544	45741862	0	319	0	6744	0	6425	0.0	0.0
chr11	AC044839.1	45737055	45737085	0	31	0	6744	0	6713	0.0	0.0
chr11	AC044839.1	45741663	45741862	0	200	0	6744	0	6544	0.0	0.0
chr11	AC044839.1	45742423	45742670	0	248	0	6744	0	6496	0.0	0.0
chr11	AC044839.1	45741724	45741862	0	139	0	6744	0	6605	0.0	0.0
chr11	AC044839.1	45734547	45734799	0	253	0	6744	0	6491	0.0	0.0
chr11	CRY2	45860847	45861032	0	186	19319	5264	19319	5078	0.0	3.804450571090981
chr11	CRY2	45862059	45862148	0	90	19319	5264	19319	5174	0.0	3.7338616157711635
chr11	LARGE2	45926038	45926151	15427	114	108068	2871	92641	2757	135.32456140350877	33.602103735944866
chr11	LARGE2	45928176	45928372	422	197	108068	2871	107646	2674	2.1421319796954315	40.2565445026178
chr11	DGKZ	46368004	46368079	0	76	18415	8820	18415	8744	0.0	2.106015553522415
chr11	DGKZ	46369940	46370009	1313	70	18415	8820	17102	8750	18.757142857142856	1.9545142857142856
chr11	DGKZ	46368001	46368079	0	79	18415	8820	18415	8741	0.0	2.10673835945544
chr11	MDK	46382293	46382461	2107	169	16293	2201	14186	2032	12.467455621301776	6.981299212598425
chr11	MDK	46382056	46382133	0	78	16293	2201	16293	2123	0.0	7.674517192651908
chr11	ATG13	46618324	46618375	0	52	7415	5435	7415	5383	0.0	1.3774846739736206
chr11	ATG13	46621059	46621157	714	99	7415	5435	6701	5336	7.212121212121212	1.2558095952023989
chr11	ATG13	46621041	46621157	714	117	7415	5435	6701	5318	6.102564102564102	1.2600601729973675
chr11	ATG13	46630044	46630100	0	57	7415	5435	7415	5378	0.0	1.3787653402751952
chr11	ATG13	46618259	46618375	0	117	7415	5435	7415	5318	0.0	1.3943211733734486
chr11	ATG13	46632322	46632459	0	138	7415	5435	7415	5297	0.0	1.3998489711157258
chr11	ATG13	46664848	46664959	0	112	7415	5435	7415	5323	0.0	1.3930114597031749
chr11	ATG13	46630896	46630991	0	96	7415	5435	7415	5339	0.0	1.3888368608353625
chr11	ATG13	46644278	46644360	0	83	7415	5435	7415	5352	0.0	1.3854633781763828
chr11	ATG13	46663996	46664095	5	100	7415	5435	7410	5335	0.05	1.3889409559512653
chr11	ATG13	46638498	46638610	317	113	7415	5435	7098	5322	2.8053097345132745	1.3337091319052987
chr11	LRP4-AS1	46852851	46852946	0	96	3519	1643	3519	1547	0.0	2.2747252747252746
chr11	C11ORF49	46987207	46987310	1071	104	9217	5413	8146	5309	10.298076923076923	1.5343755886230928
chr11	C11ORF49	47137315	47137560	0	246	9217	5413	9217	5167	0.0	1.7838203986839558
chr11	C11ORF49	47157022	47157218	255	197	9217	5413	8962	5216	1.2944162436548223	1.718174846625767
chr11	C11ORF49	47023338	47023394	26	57	9217	5413	9191	5356	0.45614035087719296	1.7160194174757282
chr11	C11ORF49	47052387	47052518	0	132	9217	5413	9217	5281	0.0	1.7453133876159819
chr11	C11ORF49	47004364	47004456	0	93	9217	5413	9217	5320	0.0	1.7325187969924811
chr11	C11ORF49	46948025	46948164	0	140	9217	5413	9217	5273	0.0	1.7479613123459132
chr11	C11ORF49	46991542	46991647	0	106	9217	5413	9217	5307	0.0	1.7367627661579046
chr11	DDB2	47216857	47217049	0	193	14186	4822	14186	4629	0.0	3.064592784618708
chr11	DDB2	47232813	47232959	0	147	14186	4822	14186	4675	0.0	3.034438502673797
chr11	DDB2	47234756	47234934	0	179	14186	4822	14186	4643	0.0	3.0553521430109845
chr11	DDB2	47233226	47233474	0	249	14186	4822	14186	4573	0.0	3.102121145856112
chr11	DDB2	47237618	47237712	3166	95	14186	4822	11020	4727	33.32631578947368	2.331288343558282
chr11	NR1H3	47260408	47260675	65215	268	337523	4063	272308	3795	243.33955223880596	71.75441370223979
chr11	NR1H3	47261546	47261726	52064	181	337523	4063	285459	3882	287.646408839779	73.53400309119012
chr11	NR1H3	47250465	47250551	1508	87	337523	4063	336015	3976	17.333333333333332	84.51081488933602
chr11	NR1H3	47259790	47259979	617	190	337523	4063	336906	3873	3.2473684210526317	86.98838109992253
chr11	NR1H3	47259179	47259259	2752	81	337523	4063	334771	3982	33.97530864197531	84.07106981416374
chr11	NR1H3	47259360	47259606	61680	247	337523	4063	275843	3816	249.7165991902834	72.28590146750524
chr11	NR1H3	47259100	47259259	8656	160	337523	4063	328867	3903	54.1	84.26005636689726
chr11	NR1H3	47260550	47260675	34318	126	337523	4063	303205	3937	272.36507936507934	77.01422402844806
chr11	MADD	47286432	47286534	0	103	89108	8408	89108	8305	0.0	10.729440096327513
chr11	MADD	47326737	47326807	50	71	89108	8408	89058	8337	0.704225352112676	10.682259805685499
chr11	MADD	47273826	47273976	51	151	89108	8408	89057	8257	0.33774834437086093	10.785636429696016
chr11	MADD	47288967	47289027	15	61	89108	8408	89093	8347	0.2459016393442623	10.67365520546304
chr11	MADD	47292542	47292596	576	55	89108	8408	88532	8353	10.472727272727273	10.598826768825571
chr11	MADD	47308979	47309042	644	64	89108	8408	88464	8344	10.0625	10.602109300095877
chr11	MADD	47326543	47326552	0	10	89108	8408	89108	8398	0.0	10.61062157656585
chr11	SLC39A13	47413399	47413507	0	109	102	3873	102	3764	0.0	0.02709883103081828
chr11	PTPMT1	47569699	47569891	284	193	8735	2574	8451	2381	1.471502590673575	3.54934901301974
chr11	NDUFS3	47579268	47579334	0	67	6233	4322	6233	4255	0.0	1.4648648648648648
chr11	NDUFS3	47579268	47579338	0	71	6233	4322	6233	4251	0.0	1.4662432368854388
chr11	PTPRJ	48112746	48112983	297	238	63377	9648	63080	9410	1.2478991596638656	6.703506907545164
chr11	PTPRJ	48121002	48121266	6	265	63377	9648	63371	9383	0.022641509433962263	6.753810082063306
chr11	OR8K3	56315999	56316057	0	59	213	2418	213	2359	0.0	0.09029249682068673
chr11	LINC02735	56874723	56874843	0	121	0	2905	0	2784	0.0	0.0
chr11	SERPING1	57598248	57598321	0	74	1938	6109	1938	6035	0.0	0.3211267605633803
chr11	SERPING1	57599878	57600377	0	500	1938	6109	1938	5609	0.0	0.34551613478338383
chr11	SERPING1	57606407	57606547	0	141	1938	6109	1938	5968	0.0	0.3247319034852547
chr11	SERPING1	57598008	57598321	0	314	1938	6109	1938	5795	0.0	0.3344262295081967
chr11	SERPING1	57606009	57606213	0	205	1938	6109	1938	5904	0.0	0.3282520325203252
chr11	SERPING1	57605323	57605508	0	186	1938	6109	1938	5923	0.0	0.32719905453317577
chr11	SERPING1	57599863	57600377	0	515	1938	6109	1938	5594	0.0	0.346442617089739
chr11	SERPING1	57606710	57606799	0	90	1938	6109	1938	6019	0.0	0.32198039541452067
chr11	SERPING1	57605602	57606213	51	612	1938	6109	1887	5497	0.08333333333333333	0.3432781517191195
chr11	ZDHHC5	57682421	57682543	0	123	0	5308	0	5185	0.0	0.0
chr11	ZDHHC5	57672020	57673194	0	1175	0	5308	0	4133	0.0	0.0
chr11	TMX2	57737607	57737668	0	62	0	2143	0	2081	0.0	0.0
chr11	CTNND1	57814310	57814373	0	64	1432	9351	1432	9287	0.0	0.1541940346721223
chr11	CTNND1	57794009	57794081	0	73	1432	9351	1432	9278	0.0	0.15434360853632248
chr11	CTNND1	57806460	57806478	0	19	1432	9351	1432	9332	0.0	0.15345049292756108
chr11	TMX2	57737912	57738026	0	115	0	2143	0	2028	0.0	0.0
chr11	TMX2	57738353	57738430	0	78	0	2143	0	2065	0.0	0.0
chr11	TMX2	57738663	57739039	0	377	0	2143	0	1766	0.0	0.0
chr11	TMX2	57737835	57738026	0	192	0	2143	0	1951	0.0	0.0
chr11	TMX2	57737785	57738026	0	242	0	2143	0	1901	0.0	0.0
chr11	CTNND1	57789036	57789155	0	120	1432	9351	1432	9231	0.0	0.15512945509695591
chr11	CTNND1	57815914	57816001	0	88	1432	9351	1432	9263	0.0	0.15459354420813992
chr11	CTNND1	57791384	57791673	0	290	1432	9351	1432	9061	0.0	0.15803995144023839
chr11	CTNND1	57791493	57791673	0	181	1432	9351	1432	9170	0.0	0.15616139585605235
chr11	CTNND1	57762600	57762667	103	68	1432	9351	1329	9283	1.5147058823529411	0.14316492513196166
chr11	GLYATL1	58947045	58947165	0	121	8773	4761	8773	4640	0.0	1.8907327586206897
chr11	GLYATL1	58942539	58942584	0	46	8773	4761	8773	4715	0.0	1.8606574761399788
chr11	GLYATL1	58947045	58947068	0	24	8773	4761	8773	4737	0.0	1.8520160439096474
chr11	FAM111B	59108667	59108712	0	46	0	3869	0	3823	0.0	0.0
chr11	FAM111B	59109539	59109706	0	168	0	3869	0	3701	0.0	0.0
chr11	FAM111A	59143496	59143695	0	200	153	6384	153	6184	0.0	0.024741267787839586
chr11	FAM111A	59145826	59145856	0	31	153	6384	153	6353	0.0	0.024083110341570912
chr11	FAM111A	59144808	59144896	0	89	153	6384	153	6295	0.0	0.024305003971405878
chr11	FAM111A	59144537	59144896	0	360	153	6384	153	6024	0.0	0.025398406374501994
chr11	AP000442.1	59635419	59635536	0	118	1412	1810	1412	1692	0.0	0.83451536643026
chr11	AP000442.1	59635419	59635532	0	114	1412	1810	1412	1696	0.0	0.8325471698113207
chr11	STX3	59787036	59787136	0	101	0	6815	0	6714	0.0	0.0
chr11	STX3	59795371	59795482	0	112	0	6815	0	6703	0.0	0.0
chr11	STX3	59797282	59797396	0	115	0	6815	0	6700	0.0	0.0
chr11	MS4A3	60061145	60061316	0	172	51	2090	51	1918	0.0	0.026590198123044837
chr11	MS4A3	60062467	60062605	0	139	51	2090	51	1951	0.0	0.026140440799589954
chr11	MS4A3	60061489	60061554	0	66	51	2090	51	2024	0.0	0.025197628458498024
chr11	MS4A2	60090335	60090470	0	136	51	4461	51	4325	0.0	0.011791907514450866
chr11	MS4A4A	60302558	60302717	0	160	7	2959	7	2799	0.0	0.002500893176134334
chr11	MS4A4A	60282593	60282739	0	147	7	2959	7	2812	0.0	0.0024893314366998577
chr11	MS4A4A	60296870	60297022	0	153	7	2959	7	2806	0.0	0.0024946543121881683
chr11	MS4A4A	60290048	60290242	0	195	7	2959	7	2764	0.0	0.002532561505065123
chr11	MS4A6E	60335529	60335649	0	121	0	1064	0	943	0.0	0.0
chr11	MS4A7	60386716	60386773	0	58	357	3914	357	3856	0.0	0.09258298755186722
chr11	MS4A7	60392684	60392786	0	103	357	3914	357	3811	0.0	0.09367620047231698
chr11	MS4A7	60385087	60385222	0	136	357	3914	357	3778	0.0	0.09449444150344097
chr11	MS4A14	60405888	60405987	0	100	3	4014	3	3914	0.0	0.0007664793050587634
chr11	MS4A14	60400403	60400454	0	52	3	4014	3	3962	0.0	0.000757193336698637
chr11	MS4A14	60404545	60404666	3	122	3	4014	0	3892	0.02459016393442623	0.0
chr11	MS4A5	60433764	60433917	0	154	0	921	0	767	0.0	0.0
chr11	MS4A5	60433849	60433917	0	69	0	921	0	852	0.0	0.0
chr11	MS4A1	60458048	60458208	0	161	0	4614	0	4453	0.0	0.0
chr11	MS4A1	60461071	60461160	0	90	0	4614	0	4524	0.0	0.0
chr11	MS4A12	60492919	60493032	28	114	51	1846	23	1732	0.24561403508771928	0.013279445727482679
chr11	MS4A12	60501044	60501182	0	139	51	1846	51	1707	0.0	0.029876977152899824
chr11	MS4A13	60525206	60525326	0	121	0	1316	0	1195	0.0	0.0
chr11	MS4A13	60523896	60523953	0	58	0	1316	0	1258	0.0	0.0
chr11	MS4A13	60529364	60529460	0	97	0	1316	0	1219	0.0	0.0
chr11	LINC00301	60657102	60657400	0	299	36453	1989	36453	1690	0.0	21.5698224852071
chr11	LINC00301	60658726	60658870	3523	145	36453	1989	32930	1844	24.29655172413793	17.857917570498916
chr11	LINC00301	60679902	60680023	0	122	36453	1989	36453	1867	0.0	19.524906266738082
chr11	LINC00301	60653688	60653783	0	96	36453	1989	36453	1893	0.0	19.256735340729
chr11	LINC00301	60675138	60675248	0	111	36453	1989	36453	1878	0.0	19.410543130990416
chr11	MS4A8	60701283	60701473	14386	191	54978	2227	40592	2036	75.31937172774869	19.93713163064833
chr11	MS4A15	60767532	60767655	0	124	0	2290	0	2166	0.0	0.0
chr11	MS4A15	60763705	60763958	0	254	0	2290	0	2036	0.0	0.0
chr11	MS4A15	60767566	60767655	0	90	0	2290	0	2200	0.0	0.0
chr11	MS4A15	60771437	60771758	0	322	0	2290	0	1968	0.0	0.0
chr11	ZP1	60869536	60869900	0	365	0	1917	0	1552	0.0	0.0
chr11	TMEM132A	60931983	60932127	0	145	6731	5092	6731	4947	0.0	1.360622599555286
chr11	CD6	61009571	61009874	0	304	0	4331	0	4027	0.0	0.0
chr11	CD6	61013918	61014014	0	97	0	4331	0	4234	0.0	0.0
chr11	CD6	61015712	61015835	0	124	0	4331	0	4207	0.0	0.0
chr11	CD6	61018288	61018393	0	106	0	4331	0	4225	0.0	0.0
chr11	CD6	60982624	60982770	0	147	0	4331	0	4184	0.0	0.0
chr11	CD6	61015732	61015835	0	104	0	4331	0	4227	0.0	0.0
chr11	CD6	61011069	61011135	0	67	0	4331	0	4264	0.0	0.0
chr11	AP003721.2	61061301	61061426	0	126	106398	839	106398	713	0.0	149.2258064516129
chr11	TKFC	61333548	61333650	0	103	0	7716	0	7613	0.0	0.0
chr11	TMEM138	61364432	61364518	0	87	51	4888	51	4801	0.0	0.010622786919391794
chr11	SDHAF2	61436760	61436960	2	201	2	1702	0	1501	0.009950248756218905	0.0
chr11	SDHAF2	61438003	61438113	0	111	2	1702	2	1591	0.0	0.001257071024512885
chr11	AP003108.2	61481781	61481918	0	138	918	7534	918	7396	0.0	0.1241211465657112
chr11	SDHAF2	61437624	61437848	0	225	2	1702	2	1477	0.0	0.0013540961408259986
chr11	AP003108.2	61445940	61446231	0	292	918	7534	918	7242	0.0	0.1267605633802817
chr11	PPP1R32	61486343	61486403	0	61	2839	2415	2839	2354	0.0	1.2060322854715377
chr11	PPP1R32	61486523	61486610	0	88	2839	2415	2839	2327	0.0	1.2200257842715942
chr11	PPP1R32	61489781	61489946	102	166	2839	2415	2737	2249	0.6144578313253012	1.2169853268119164
chr11	AP002754.1	61598184	61598286	191	103	5625	2760	5434	2657	1.854368932038835	2.045163718479488
chr11	AP002754.1	61596892	61596979	25	88	5625	2760	5600	2672	0.2840909090909091	2.095808383233533
chr11	RPLP0P2	61630168	61630288	137	121	4987	3820	4850	3699	1.1322314049586777	1.3111651797783184
chr11	MYRF	61780711	61780792	0	82	4886	9103	4886	9021	0.0	0.5416250969958984
chr11	BEST1	61955342	61955387	0	46	521	5587	521	5541	0.0	0.09402634903447031
chr11	BEST1	61951770	61951958	0	189	521	5587	521	5398	0.0	0.09651722860318636
chr11	INCENP	62141499	62141511	13	13	6496	3753	6483	3740	1.0	1.733422459893048
chr11	ASRGL1	62356324	62356467	257	144	2990518	4595	2990261	4451	1.7847222222222223	671.8177937542125
chr11	TTC9C	62733117	62733199	0	83	0	2634	0	2551	0.0	0.0
chr11	POLR2G	62762541	62762742	0	202	0	1552	0	1350	0.0	0.0
chr11	TMEM179B	62789600	62789679	0	80	0	1365	0	1285	0.0	0.0
chr11	SLC3A2	62870744	62870837	0	94	0	3522	0	3428	0.0	0.0
chr11	SLC3A2	62876783	62876879	0	97	0	3522	0	3425	0.0	0.0
chr11	SLC3A2	62871576	62871669	0	94	0	3522	0	3428	0.0	0.0
chr11	SLC3A2	62876786	62876879	0	94	0	3522	0	3428	0.0	0.0
chr11	SLC3A2	62882666	62882807	0	142	0	3522	0	3380	0.0	0.0
chr11	SLC3A2	62883988	62884112	0	125	0	3522	0	3397	0.0	0.0
chr11	SLC22A9	63373643	63373798	0	156	3059	2376	3059	2220	0.0	1.377927927927928
chr11	LGALS12	63511078	63511105	0	28	2	2311	2	2283	0.0	0.0008760402978537013
chr11	PLAAT4	63539515	63539624	2487	110	12656	1305	10169	1195	22.60909090909091	8.509623430962343
chr11	RTN3	63752506	63752645	0	140	179245	5524	179245	5384	0.0	33.292161961367015
chr11	RTN3	63704850	63704907	0	58	179245	5524	179245	5466	0.0	32.792718624222466
chr11	RTN3	63756111	63756170	19753	60	179245	5524	159492	5464	329.21666666666664	29.1896046852123
chr11	RTN3	63746946	63747024	0	79	179245	5524	179245	5445	0.0	32.91919191919192
chr11	RTN3	63718701	63721032	120065	2332	179245	5524	59180	3192	51.485849056603776	18.540100250626566
chr11	RTN3	63718980	63721032	117311	2053	179245	5524	61934	3471	57.14125669751583	17.843272832036877
chr11	MARK2	63903985	63904147	0	163	9035	8854	9035	8691	0.0	1.039581175929122
chr11	MARK2	63906087	63906114	14	28	9035	8854	9021	8826	0.5	1.022093813732155
chr11	MARK2	63908259	63908304	0	46	9035	8854	9035	8808	0.0	1.025772025431426
chr11	MARK2	63903985	63904354	0	370	9035	8854	9035	8484	0.0	1.064945780292315
chr11	MARK2	63890221	63890295	0	75	9035	8854	9035	8779	0.0	1.0291604966397083
chr11	MARK2	63906087	63907567	1085	1481	9035	8854	7950	7373	0.7326130992572586	1.078258510782585
chr11	NAA40	63946950	63947003	439	54	35523	5285	35084	5231	8.12962962962963	6.706939399732365
chr11	FERMT3	64221015	64221140	0	126	0	2997	0	2871	0.0	0.0
chr11	NUDT22	64227567	64227666	0	100	0	3038	0	2938	0.0	0.0
chr11	NUDT22	64229246	64229344	0	99	0	3038	0	2939	0.0	0.0
chr11	NUDT22	64227400	64227493	0	94	0	3038	0	2944	0.0	0.0
chr11	NUDT22	64229849	64230070	0	222	0	3038	0	2816	0.0	0.0
chr11	DNAJC4	64231031	64231147	0	117	51	2070	51	1953	0.0	0.026113671274961597
chr11	GPR137	64288064	64288214	0	151	51	3606	51	3455	0.0	0.014761215629522432
chr11	GPR137	64287720	64287946	0	227	51	3606	51	3379	0.0	0.015093222846996152
chr11	GPR137	64288602	64288721	0	120	51	3606	51	3486	0.0	0.014629948364888123
chr11	KCNK4	64292941	64293207	0	267	0	2595	0	2328	0.0	0.0
chr11	ESRRA	64307167	64307504	0	338	0	3109	0	2771	0.0	0.0
chr11	ESRRA	64314743	64314911	0	169	0	3109	0	2940	0.0	0.0
chr11	ESRRA	64314740	64314911	0	172	0	3109	0	2937	0.0	0.0
chr11	ESRRA	64315000	64315270	0	271	0	3109	0	2838	0.0	0.0
chr11	PRDX5	64320660	64320792	0	133	51	866	51	733	0.0	0.06957708049113233
chr11	PRDX5	64319733	64319868	0	136	51	866	51	730	0.0	0.06986301369863014
chr11	CCDC88B	64354003	64354170	0	168	102	6744	102	6576	0.0	0.01551094890510949
chr11	CCDC88B	64354003	64354028	0	26	102	6744	102	6718	0.0	0.01518309020541828
chr11	SLC22A11	64559134	64559238	0	105	460777	5168	460777	5063	0.0	91.00869049970373
chr11	SLC22A11	64564307	64564428	13845	122	460777	5168	446932	5046	113.48360655737704	88.57154181529924
chr11	SLC22A11	64568669	64568778	0	110	460777	5168	460777	5058	0.0	91.09865559509687
chr11	SLC22A11	64569651	64569858	266	208	460777	5168	460511	4960	1.2788461538461537	92.84495967741935
chr11	SLC22A11	64569783	64569858	266	76	460777	5168	460511	5092	3.5	90.43813825608798
chr11	SLC22A12	64593404	64593559	0	156	2830	2982	2830	2826	0.0	1.0014154281670204
chr11	SLC22A12	64593634	64593803	0	170	2830	2982	2830	2812	0.0	1.0064011379800855
chr11	SLC22A12	64593404	64593457	0	54	2830	2982	2830	2928	0.0	0.9665300546448088
chr11	ARL2	65020418	65020499	0	82	0	1837	0	1755	0.0	0.0
chr11	SNX15	65032167	65032203	167	37	26853	4844	26686	4807	4.513513513513513	5.551487414187643
chr11	SNX15	65034846	65034962	5817	117	26853	4844	21036	4727	49.717948717948715	4.4501798180664265
chr11	SNX15	65038571	65038829	104	259	26853	4844	26749	4585	0.4015444015444015	5.8340239912759
chr11	SNX15	65032167	65032271	700	105	26853	4844	26153	4739	6.666666666666667	5.5186748259126395
chr11	SAC3D1	65043024	65043164	0	141	1071	1673	1071	1532	0.0	0.6990861618798956
chr11	ZFPL1	65085114	65085226	0	113	32052	2401	32052	2288	0.0	14.008741258741258
chr11	ZFPL1	65085114	65085314	0	201	32052	2401	32052	2200	0.0	14.569090909090908
chr11	VPS51	65096997	65097127	76	131	222656	4595	222580	4464	0.5801526717557252	49.861111111111114
chr11	VPS51	65107580	65107727	158	148	222656	4595	222498	4447	1.0675675675675675	50.033280863503485
chr11	VPS51	65107186	65107372	500	187	222656	4595	222156	4408	2.6737967914438503	50.3983666061706
chr11	VPS51	65111160	65111237	8333	78	222656	4595	214323	4517	106.83333333333333	47.44808501217622
chr11	TM7SF2	65115313	65115394	0	82	161869	2460	161869	2378	0.0	68.06938603868797
chr11	TM7SF2	65112810	65112865	169	56	161869	2460	161700	2404	3.017857142857143	67.26289517470882
chr11	TM7SF2	65113219	65113414	11269	196	161869	2460	150600	2264	57.494897959183675	66.51943462897526
chr11	TM7SF2	65113490	65113594	17068	105	161869	2460	144801	2355	162.55238095238096	61.486624203821655
chr11	TM7SF2	65115475	65115598	0	124	161869	2460	161869	2336	0.0	69.29323630136986
chr11	TM7SF2	65113523	65113594	4293	72	161869	2460	157576	2388	59.625	65.98659966499163
chr11	TM7SF2	65112810	65112894	169	85	161869	2460	161700	2375	1.988235294117647	68.08421052631579
chr11	TM7SF2	65113368	65113414	1173	47	161869	2460	160696	2413	24.95744680851064	66.59593866556155
chr11	TM7SF2	65115774	65115822	0	49	161869	2460	161869	2411	0.0	67.13770219825798
chr11	MRPL49	65124501	65124652	2285	152	4682	2385	2397	2233	15.032894736842104	1.0734437975817286
chr11	CAPN1	65183127	65183197	0	71	117620	5821	117620	5750	0.0	20.455652173913045
chr11	CAPN1	65186169	65186338	0	170	117620	5821	117620	5651	0.0	20.81401521854539
chr11	CAPN1	65182383	65182480	0	98	117620	5821	117620	5723	0.0	20.552157959112353
chr11	SLC22A20P	65220995	65221164	100	170	19902	3995	19802	3825	0.5882352941176471	5.176993464052288
chr11	SLC22A20P	65238661	65239480	0	820	19902	3995	19902	3175	0.0	6.268346456692913
chr11	POLA2	65266581	65266706	195593	126	583817	5587	388224	5461	1552.3253968253969	71.0902765061344
chr11	DPF2	65340384	65340545	26867	162	577934	7024	551067	6862	165.84567901234567	80.30705333721947
chr11	DPF2	65341398	65341562	98114	165	577934	7024	479820	6859	594.630303030303	69.9548039072751
chr11	DPF2	65343990	65344069	569	80	577934	7024	577365	6944	7.1125	83.14588133640552
chr11	DPF2	65346246	65346359	8202	114	577934	7024	569732	6910	71.94736842105263	82.45036179450072
chr11	DPF2	65344579	65344621	43	43	577934	7024	577891	6981	1.0	82.78054719954162
chr11	FRMD8	65389360	65389528	603	169	78563	4080	77960	3911	3.5680473372781063	19.93352083866019
chr11	FRMD8	65393572	65393674	2410	103	78563	4080	76153	3977	23.398058252427184	19.148353029922053
chr11	SCYL1	65538269	65538324	43	56	4220	3914	4177	3858	0.7678571428571429	1.0826853291861067
chr11	ZNRD2	65571390	65571779	0	390	598	1874	598	1484	0.0	0.4029649595687331
chr11	EHBP1L1	65580927	65580963	8	37	34886	5816	34878	5779	0.21621621621621623	6.0353002249524135
chr11	PCNX3	65620338	65620429	2532	92	3220252	8007	3217720	7915	27.52173913043478	406.53442830069486
chr11	SIPA1	65639135	65639251	7959	117	69636	4641	61677	4524	68.02564102564102	13.633289124668435
chr11	KAT5	65713347	65713503	0	157	25	3659	25	3502	0.0	0.007138777841233581
chr11	MUS81	65860674	65860888	0	215	3891	4721	3891	4506	0.0	0.8635153129161118
chr11	CTSW	65882608	65882689	0	82	3177	1700	3177	1618	0.0	1.9635352286773795
chr11	BANF1	66003234	66003373	1347	140	46760	1298	45413	1158	9.621428571428572	39.2167530224525
chr11	BANF1	66002843	66003070	13493	228	46760	1298	33267	1070	59.17982456140351	31.09065420560748
chr11	SF3B2	66055534	66055585	49795	52	828612	9289	778817	9237	957.5961538461538	84.31492908953123
chr11	SF3B2	66055537	66055585	49795	49	828612	9289	778817	9240	1016.2244897959183	84.28755411255412
chr11	PACS1	66242911	66243031	1777	121	102124	8343	100347	8222	14.685950413223141	12.204694721478958
chr11	PACS1	66217505	66217617	0	113	102124	8343	102124	8230	0.0	12.408748481166464
chr11	KLC2	66261741	66261972	0	232	41538	3969	41538	3737	0.0	11.115333154937115
chr11	RAB1B	66272364	66272460	29	97	181902	1956	181873	1859	0.29896907216494845	97.83378160301237
chr11	CNIH2	66281416	66281574	51	159	28071	1769	28020	1610	0.32075471698113206	17.403726708074533
chr11	NPAS4	66423122	66423232	303	111	14707	3436	14404	3325	2.72972972972973	4.33203007518797
chr11	PELI3	66468127	66468280	1027	154	9439	3910	8412	3756	6.6688311688311686	2.2396166134185305
chr11	PELI3	66468832	66468904	160	73	9439	3910	9279	3837	2.191780821917808	2.418295543393276
chr11	DPP3	66482192	66482470	0	279	2455	3901	2455	3622	0.0	0.6778023191606847
chr11	DPP3	66485172	66485262	0	91	2455	3901	2455	3810	0.0	0.6443569553805775
chr11	DPP3	66495364	66495489	0	126	2455	3901	2455	3775	0.0	0.6503311258278146
chr11	DPP3	66482195	66482470	0	276	2455	3901	2455	3625	0.0	0.6772413793103448
chr11	DPP3	66482179	66482470	0	292	2455	3901	2455	3609	0.0	0.6802438348573012
chr11	DPP3	66482288	66482470	0	183	2455	3901	2455	3718	0.0	0.6603012372243141
chr11	BBS1	66511204	66511239	71	36	46904	5850	46833	5814	1.9722222222222223	8.055211558307533
chr11	BBS1	66514405	66514678	224	274	46904	5850	46680	5576	0.8175182481751825	8.371592539454806
chr11	BBS1	66515539	66515586	758	48	46904	5850	46146	5802	15.791666666666666	7.953464322647363
chr11	BBS1	66523171	66523365	326	195	46904	5850	46578	5655	1.6717948717948719	8.23660477453581
chr11	BBS1	66514505	66514678	189	174	46904	5850	46715	5676	1.0862068965517242	8.230267794221282
chr11	CCS	66593641	66593714	0	74	19193	2149	19193	2075	0.0	9.249638554216867
chr11	CCS	66593609	66593714	0	106	19193	2149	19193	2043	0.0	9.394517865883504
chr11	RBM14	66624213	66624324	1229	112	480394	6382	479165	6270	10.973214285714286	76.42185007974481
chr11	RBM4	66643449	66644140	0	692	13881	6217	13881	5525	0.0	2.512398190045249
chr11	RBM14	66623900	66623968	0	69	480394	6382	480394	6313	0.0	76.09599239664185
chr11	RBM4	66639699	66640123	0	425	13881	6217	13881	5792	0.0	2.3965814917127073
chr11	RBM14	66618495	66618561	2299	67	480394	6382	478095	6315	34.3134328358209	75.70783847980998
chr11	C11ORF80	66756352	66756505	0	154	6159	3974	6159	3820	0.0	1.612303664921466
chr11	C11ORF80	66801030	66801102	58	73	6159	3974	6101	3901	0.7945205479452054	1.5639579594975648
chr11	C11ORF80	66788159	66788269	0	111	6159	3974	6159	3863	0.0	1.5943567175770126
chr11	C11ORF80	66796280	66796364	252	85	6159	3974	5907	3889	2.9647058823529413	1.5188994600154282
chr11	C11ORF80	66822563	66822674	0	112	6159	3974	6159	3862	0.0	1.5947695494562404
chr11	C11ORF80	66748378	66748517	0	140	6159	3974	6159	3834	0.0	1.60641627543036
chr11	C11ORF80	66788159	66788273	0	115	6159	3974	6159	3859	0.0	1.5960093288416688
chr11	C11ORF80	66821642	66821764	0	123	6159	3974	6159	3851	0.0	1.599324850688133
chr11	C11ORF80	66801030	66801161	310	132	6159	3974	5849	3842	2.3484848484848486	1.5223841749089015
chr11	C11ORF80	66839131	66839207	1380	77	6159	3974	4779	3897	17.92207792207792	1.2263279445727482
chr11	RCE1	66845499	66845562	0	64	0	2143	0	2079	0.0	0.0
chr11	SYT12	67034644	67034838	755	195	436466	10117	435711	9922	3.871794871794872	43.91362628502318
chr11	KDM2A	67243008	67243092	83	85	873496	10408	873413	10323	0.9764705882352941	84.60844715683426
chr11	KDM2A	67131951	67132073	15117	123	873496	10408	858379	10285	122.90243902439025	83.45930967428293
chr11	GRK2	67282270	67282365	0	96	4984	4814	4984	4718	0.0	1.056379821958457
chr11	GRK2	67283706	67283773	0	68	4984	4814	4984	4746	0.0	1.0501474926253687
chr11	ANKRD13D	67289828	67289965	0	138	333	4350	333	4212	0.0	0.07905982905982906
chr11	SSH3	67307548	67307737	0	190	0	3237	0	3047	0.0	0.0
chr11	SSH3	67309396	67309543	0	148	0	3237	0	3089	0.0	0.0
chr11	SSH3	67304117	67304155	0	39	0	3237	0	3198	0.0	0.0
chr11	RAD9A	67392160	67392231	1440	72	149038	3780	147598	3708	20.0	39.805285868392666
chr11	TBC1D10C	67406826	67407016	0	191	38	4302	38	4111	0.0	0.009243493067380199
chr11	CARNS1	67416175	67416202	0	28	51	5370	51	5342	0.0	0.009546986147510296
chr11	RPS6KB2	67428981	67429022	0	42	452	2864	452	2822	0.0	0.16017009213323885
chr11	RPS6KB2	67432355	67432492	0	138	452	2864	452	2726	0.0	0.16581071166544387
chr11	RPS6KB2	67432736	67432837	442	102	452	2864	10	2762	4.333333333333333	0.003620564808110065
chr11	RPS6KB2	67428912	67429022	0	111	452	2864	452	2753	0.0	0.16418452597166727
chr11	RPS6KB2	67432599	67432657	0	59	452	2864	452	2805	0.0	0.16114081996434937
chr11	RPS6KB2	67431367	67431515	0	149	452	2864	452	2715	0.0	0.16648250460405156
chr11	RPS6KB2	67432352	67432492	0	141	452	2864	452	2723	0.0	0.16599338964377525
chr11	AIP	67489266	67489455	0	190	567	1661	567	1471	0.0	0.38545207341944254
chr11	GSTP1	67584463	67584570	0	108	52	1247	52	1139	0.0	0.0456540825285338
chr11	GSTP1	67586103	67586211	0	109	52	1247	52	1138	0.0	0.04569420035149385
chr11	NDUFV1	67608395	67608478	0	84	408	3785	408	3701	0.0	0.11024047554714941
chr11	NDUFV1	67611896	67611978	0	83	408	3785	408	3702	0.0	0.11021069692058347
chr11	NDUFV1	67608399	67608478	0	80	408	3785	408	3705	0.0	0.11012145748987855
chr11	NDUFV1	67607365	67607496	0	132	408	3785	408	3653	0.0	0.11168902272105119
chr11	NDUFV1	67607298	67607324	0	27	408	3785	408	3758	0.0	0.10856838744012773
chr11	NDUFV1	67608395	67608457	0	63	408	3785	408	3722	0.0	0.10961848468565287
chr11	NDUFV1	67608431	67608478	0	48	408	3785	408	3737	0.0	0.10917848541610918
chr11	ALDH3B1	68018526	68018637	0	112	48986	6638	48986	6526	0.0	7.506282562059455
chr11	ALDH3B1	68019714	68019796	0	83	48986	6638	48986	6555	0.0	7.473073989321129
chr11	NDUFS8	68031532	68031710	0	179	23298	3779	23298	3600	0.0	6.471666666666667
chr11	NDUFS8	68035627	68035788	8167	162	23298	3779	15131	3617	50.41358024691358	4.183301078241636
chr11	TCIRG1	68043370	68043497	3420	128	22032	4293	18612	4165	26.71875	4.468667466986795
chr11	TCIRG1	68050486	68050664	0	179	22032	4293	22032	4114	0.0	5.355371900826446
chr11	TCIRG1	68039791	68039962	2618	172	22032	4293	19414	4121	15.220930232558139	4.710992477553992
chr11	TCIRG1	68046936	68046998	0	63	22032	4293	22032	4230	0.0	5.208510638297873
chr11	AP002992.1	68129080	68130082	0	1003	0	1925	0	922	0.0	0.0
chr11	LRP5	68389880	68390052	0	173	1284	6209	1284	6036	0.0	0.21272365805168986
chr11	LRP5	68404222	68404416	0	195	1284	6209	1284	6014	0.0	0.2135018290655138
chr11	LRP5	68445572	68445686	0	115	1284	6209	1284	6094	0.0	0.2106990482441746
chr11	PPP6R3	68505144	68505249	4149	106	357012	8173	352863	8067	39.14150943396226	43.741539605801414
chr11	PPP6R3	68522493	68522689	193605	197	357012	8173	163407	7976	982.7664974619289	20.487337011033098
chr11	PPP6R3	68505144	68505271	4698	128	357012	8173	352314	8045	36.703125	43.79291485394655
chr11	PPP6R3	68515027	68515166	51	140	357012	8173	356961	8033	0.36428571428571427	44.43682310469314
chr11	PPP6R3	68583042	68583129	51	88	357012	8173	356961	8085	0.5795454545454546	44.15102040816326
chr11	PPP6R3	68519500	68519651	0	152	357012	8173	357012	8021	0.0	44.50966213689066
chr11	PPP6R3	68537658	68537891	153	234	357012	8173	356859	7939	0.6538461538461539	44.950119662426
chr11	PPP6R3	68567013	68567166	0	154	357012	8173	357012	8019	0.0	44.52076318742986
chr11	PPP6R3	68609610	68609628	0	19	357012	8173	357012	8154	0.0	43.783664459161145
chr11	PPP6R3	68566998	68567166	0	169	357012	8173	357012	8004	0.0	44.604197901049474
chr11	PPP6R3	68609472	68609628	0	157	357012	8173	357012	8016	0.0	44.537425149700596
chr11	IGHMBP2	68906068	68906238	0	171	2932	8643	2932	8472	0.0	0.34608120868744097
chr11	IGHMBP2	68933794	68933913	0	120	2932	8643	2932	8523	0.0	0.3440103250029332
chr11	IGHMBP2	68935298	68935422	0	125	2932	8643	2932	8518	0.0	0.34421225639821557
chr11	IGHMBP2	68908533	68908631	0	99	2932	8643	2932	8544	0.0	0.3431647940074906
chr11	IGHMBP2	68911439	68911603	0	165	2932	8643	2932	8478	0.0	0.3458362821420146
chr11	IGHMBP2	68938181	68938354	0	174	2932	8643	2932	8469	0.0	0.346203802101783
chr11	IGHMBP2	68906068	68906242	0	175	2932	8643	2932	8468	0.0	0.34624468587623997
chr11	IGHMBP2	68906068	68906384	0	317	2932	8643	2932	8326	0.0	0.3521498919048763
chr11	IGHMBP2	68930322	68930434	0	113	2932	8643	2932	8530	0.0	0.34372801875732706
chr11	IGHMBP2	68914184	68914350	0	167	2932	8643	2932	8476	0.0	0.3459178857951864
chr11	IGHMBP2	68917160	68917301	0	142	2932	8643	2932	8501	0.0	0.34490059992942007
chr11	IGHMBP2	68917163	68917301	0	139	2932	8643	2932	8504	0.0	0.34477892756349954
chr11	IGHMBP2	68917521	68917552	0	32	2932	8643	2932	8611	0.0	0.3404947160608524
chr11	IGHMBP2	68938657	68938844	0	188	2932	8643	2932	8455	0.0	0.34677705499704314
chr11	IGHMBP2	68928920	68928997	0	78	2932	8643	2932	8565	0.0	0.34232340922358434
chr11	IGHMBP2	68935330	68935422	0	93	2932	8643	2932	8550	0.0	0.34292397660818713
chr11	TPCN2	69079833	69079883	0	51	1262	7280	1262	7229	0.0	0.17457462996265044
chr11	TPCN2	69085209	69085286	0	78	1262	7280	1262	7202	0.0	0.17522910302693695
chr11	LINC01488	69491656	69491799	0	144	40363	4909	40363	4765	0.0	8.470724029380902
chr11	ANO1	70103065	70103164	0	100	11966	6051	11966	5951	0.0	2.0107544950428498
chr11	ANO1	70152449	70152461	0	13	11966	6051	11966	6038	0.0	1.9817820470354421
chr11	ANO1	70155910	70155988	0	79	11966	6051	11966	5972	0.0	2.0036838580040186
chr11	ANO1	70111125	70111191	0	67	11966	6051	11966	5984	0.0	1.9996657754010696
chr11	PPFIA1	70382087	70382158	0	72	17946	10724	17946	10652	0.0	1.6847540368006009
chr11	PPFIA1	70350993	70351023	0	31	17946	10724	17946	10693	0.0	1.6782942111661834
chr11	PPFIA1	70322396	70322554	0	159	17946	10724	17946	10565	0.0	1.698627543776621
chr11	PPFIA1	70333021	70333096	0	76	17946	10724	17946	10648	0.0	1.6853869271224644
chr11	PPFIA1	70374659	70374829	0	171	17946	10724	17946	10553	0.0	1.7005590827252914
chr11	PPFIA1	70343668	70343892	0	225	17946	10724	17946	10499	0.0	1.7093056481569673
chr11	PPFIA1	70349922	70350039	0	118	17946	10724	17946	10606	0.0	1.6920610974919856
chr11	CTTN	70421469	70421580	0	112	67	5771	67	5659	0.0	0.011839547623254992
chr11	NADSYN1	71476032	71477438	0	1407	13864	14232	13864	12825	0.0	1.0810136452241716
chr11	NADSYN1	71477344	71477438	0	95	13864	14232	13864	14137	0.0	0.9806889722006084
chr11	NADSYN1	71480218	71480274	0	57	13864	14232	13864	14175	0.0	0.9780599647266314
chr11	FAM86C1P	71791735	71791819	470	85	50228	3381	49758	3296	5.529411764705882	15.096480582524272
chr11	FAM86C1P	71793379	71793481	0	103	50228	3381	50228	3278	0.0	15.322757779133617
chr11	FAM86C1P	71791738	71791819	449	82	50228	3381	49779	3299	5.475609756097561	15.089117914519552
chr11	RNF121	71957226	71957264	0	39	15373	3262	15373	3223	0.0	4.769779708346261
chr11	RNF121	71982806	71982915	0	110	15373	3262	15373	3152	0.0	4.877220812182741
chr11	RNF121	71978085	71978235	0	151	15373	3262	15373	3111	0.0	4.941497910639666
chr11	RNF121	71987003	71987111	51	109	15373	3262	15322	3153	0.46788990825688076	4.859498889946083
chr11	RNF121	71982760	71982915	0	156	15373	3262	15373	3106	0.0	4.949452672247263
chr11	RNF121	71962151	71962289	153	139	15373	3262	15220	3123	1.1007194244604317	4.873519052193404
chr11	RNF121	71990596	71990717	0	122	15373	3262	15373	3140	0.0	4.895859872611465
chr11	IL18BP	71999258	71999370	171	113	136972	3492	136801	3379	1.5132743362831858	40.48564664101805
chr11	IL18BP	71999227	71999662	1155	436	136972	3492	135817	3056	2.6490825688073394	44.44273560209424
chr11	IL18BP	71999616	71999662	190	47	136972	3492	136782	3445	4.042553191489362	39.70449927431059
chr11	LRTOMT	72093495	72093701	0	207	1479	3353	1479	3146	0.0	0.4701207883026065
chr11	LRTOMT	72089028	72089165	0	138	1479	3353	1479	3215	0.0	0.4600311041990669
chr11	LRTOMT	72088296	72088380	0	85	1479	3353	1479	3268	0.0	0.4525703794369645
chr11	LRTOMT	72089416	72089596	0	181	1479	3353	1479	3172	0.0	0.4662673392181589
chr11	LRTOMT	72085410	72085573	0	164	1479	3353	1479	3189	0.0	0.46378174976481656
chr11	LRTOMT	72088339	72088380	0	42	1479	3353	1479	3311	0.0	0.44669284204167925
chr11	FOLR1	72190575	72190641	0	67	0	1608	0	1541	0.0	0.0
chr11	FOLR2	72218560	72218734	0	175	0	1197	0	1022	0.0	0.0
chr11	FOLR2	72217336	72217423	0	88	0	1197	0	1109	0.0	0.0
chr11	FOLR2	72218572	72218734	0	163	0	1197	0	1034	0.0	0.0
chr11	INPPL1	72229662	72229752	0	91	102	6501	102	6410	0.0	0.01591263650546022
chr11	INPPL1	72238041	72238175	0	135	102	6501	102	6366	0.0	0.016022620169651274
chr11	ATG16L2	72824059	72824122	0	64	4485	7660	4485	7596	0.0	0.5904423380726699
chr11	ATG16L2	72828882	72828984	0	103	4485	7660	4485	7557	0.0	0.593489479952362
chr11	ATG16L2	72823765	72823797	0	33	4485	7660	4485	7627	0.0	0.5880424806608103
chr11	ATG16L2	72823543	72823797	0	255	4485	7660	4485	7405	0.0	0.6056718433490884
chr11	P2RY6	73272339	73272466	0	128	2153	3193	2153	3065	0.0	0.702446982055465
chr11	P2RY6	73295729	73295815	78	87	2153	3193	2075	3106	0.896551724137931	0.6680618158403091
chr11	P2RY6	73272306	73272466	0	161	2153	3193	2153	3032	0.0	0.7100923482849604
chr11	AP000763.3	73406442	73406501	0	60	1874	347	1874	287	0.0	6.529616724738676
chr11	PLEKHB1	73650552	73650705	0	154	8649	3884	8649	3730	0.0	2.3187667560321716
chr11	PLEKHB1	73647388	73647529	0	142	8649	3884	8649	3742	0.0	2.3113308391234635
chr11	PLEKHB1	73655802	73655907	0	106	8649	3884	8649	3778	0.0	2.2893065113816835
chr11	PLEKHB1	73650531	73650705	0	175	8649	3884	8649	3709	0.0	2.3318953895928822
chr11	PLEKHB1	73653369	73653461	0	93	8649	3884	8649	3791	0.0	2.2814560801899235
chr11	PLEKHB1	73648185	73648278	0	94	8649	3884	8649	3790	0.0	2.2820580474934036
chr11	MRPL48	73823012	73823070	0	59	5553	3843	5553	3784	0.0	1.467494714587738
chr11	MRPL48	73859906	73860009	0	104	5553	3843	5553	3739	0.0	1.4851564589462423
chr11	MRPL48	73808312	73808350	0	39	5553	3843	5553	3804	0.0	1.4597791798107256
chr11	MRPL48	73825707	73825796	0	90	5553	3843	5553	3753	0.0	1.4796163069544364
chr11	MRPL48	73817822	73817947	6	126	5553	3843	5547	3717	0.047619047619047616	1.4923325262308313
chr11	MRPL48	73805026	73805079	369	54	5553	3843	5184	3789	6.833333333333333	1.368171021377672
chr11	MRPL48	73843246	73843367	0	122	5553	3843	5553	3721	0.0	1.4923407686105885
chr11	MRPL48	73802080	73802177	0	98	5553	3843	5553	3745	0.0	1.482777036048064
chr11	MRPL48	73789334	73789490	3495	157	5553	3843	2058	3686	22.261146496815286	0.5583288117200217
chr11	PAAF1	73914412	73914504	0	93	6238	5654	6238	5561	0.0	1.1217406941197627
chr11	PAAF1	73886928	73887099	0	172	6238	5654	6238	5482	0.0	1.1379058737686976
chr11	PAAF1	73887039	73887099	0	61	6238	5654	6238	5593	0.0	1.1153227248346147
chr11	PAAF1	73887030	73887099	0	70	6238	5654	6238	5584	0.0	1.1171203438395416
chr11	POLD3	74604691	74604794	38	104	14741	5517	14703	5413	0.36538461538461536	2.7162386846480695
chr11	SPCS2	74963594	74963687	0	94	357	2959	357	2865	0.0	0.12460732984293194
chr11	NEU3	74994508	74994720	199	213	2288	7219	2089	7006	0.9342723004694836	0.29817299457607765
chr11	NEU3	75004304	75004405	0	102	2288	7219	2288	7117	0.0	0.321483771251932
chr11	SLCO2B1	75165786	75165949	651	164	2807	6153	2156	5989	3.9695121951219514	0.35999332108866255
chr11	RPS3	75400693	75400824	0	132	0	4632	0	4500	0.0	0.0
chr11	RPS3	75404019	75404207	0	189	0	4632	0	4443	0.0	0.0
chr11	RPS3	75402351	75402446	0	96	0	4632	0	4536	0.0	0.0
chr11	RPS3	75400693	75400777	0	85	0	4632	0	4547	0.0	0.0
chr11	RPS3	75402303	75402446	0	144	0	4632	0	4488	0.0	0.0
chr11	RPS3	75401639	75401733	0	95	0	4632	0	4537	0.0	0.0
chr11	RPS3	75404053	75404207	0	155	0	4632	0	4477	0.0	0.0
chr11	SERPINH1	75563726	75563770	0	45	6864	5453	6864	5408	0.0	1.2692307692307692
chr11	DGAT2	75784617	75784746	0	130	648	3122	648	2992	0.0	0.21657754010695188
chr11	UVRAG	76012926	76013102	0	177	18250	7369	18250	7192	0.0	2.5375417130144604
chr11	UVRAG	76137193	76137452	0	260	18250	7369	18250	7109	0.0	2.5671683781122523
chr11	EMSY	76454748	76454790	0	43	9430	10232	9430	10189	0.0	0.9255079006772009
chr11	EMSY	76545796	76546297	0	502	9430	10232	9430	9730	0.0	0.9691675231243576
chr11	EMSY	76496214	76496469	2128	256	9430	10232	7302	9976	8.3125	0.7319566960705693
chr11	EMSY	76539598	76539640	13	43	9430	10232	9417	10189	0.3023255813953488	0.9242320149180488
chr11	EMSY	76547027	76547100	0	74	9430	10232	9430	10158	0.0	0.9283323488875763
chr11	ACER3	76958978	76959031	74	54	71423	8264	71349	8210	1.3703703703703705	8.690499390986602
chr11	ACER3	76926556	76926667	0	112	71423	8264	71423	8152	0.0	8.76140824337586
chr11	ACER3	76868119	76868156	0	38	71423	8264	71423	8226	0.0	8.682591782154145
chr11	ACER3	76959076	76959200	0	125	71423	8264	71423	8139	0.0	8.775402383585208
chr11	ACER3	76994155	76994226	0	72	71423	8264	71423	8192	0.0	8.7186279296875
chr11	ACER3	76957464	76957586	0	123	71423	8264	71423	8141	0.0	8.773246529910331
chr11	ACER3	76868119	76868267	0	149	71423	8264	71423	8115	0.0	8.80135551447936
chr11	B3GNT6	77037175	77037298	0	124	532	2629	532	2505	0.0	0.212375249500998
chr11	CAPN5	77116225	77116303	0	79	51	5580	51	5501	0.0	0.009271041628794765
chr11	CAPN5	77072990	77073137	0	148	51	5580	51	5432	0.0	0.00938880706921944
chr11	CAPN5	77071609	77071682	0	74	51	5580	51	5506	0.0	0.009262622593534326
chr11	CAPN5	77087941	77088061	0	121	51	5580	51	5459	0.0	0.0093423703975087
chr11	MYO7A	77139400	77139480	0	81	2747	9808	2747	9727	0.0	0.2824097871902951
chr11	MYO7A	77166938	77166992	0	55	2747	9808	2747	9753	0.0	0.2816569260740285
chr11	AAMDC	77841018	77841060	356	43	15957	1874	15601	1831	8.279069767441861	8.520480611687603
chr11	AAMDC	77869721	77869817	51	97	15957	1874	15906	1777	0.5257731958762887	8.951041080472708
chr11	AAMDC	77878701	77878756	0	56	15957	1874	15957	1818	0.0	8.777227722772277
chr11	AAMDC	77855344	77855482	0	139	15957	1874	15957	1735	0.0	9.197118155619597
chr11	AAMDC	77884779	77884916	11929	138	15957	1874	4028	1736	86.44202898550725	2.3202764976958523
chr11	KCTD21-AS1	78141594	78141702	0	109	6858	4417	6858	4308	0.0	1.5919220055710306
chr11	KCTD21-AS1	78148976	78149093	504	118	6858	4417	6354	4299	4.271186440677966	1.4780181437543616
chr11	USP35	78199594	78199724	0	131	1599	5765	1599	5634	0.0	0.2838125665601704
chr11	USP35	78196235	78196918	0	684	1599	5765	1599	5081	0.0	0.31470183034835664
chr11	DDIAS	82913286	82913386	165	101	18255	5351	18090	5250	1.6336633663366336	3.4457142857142857
chr11	DDIAS	82928776	82928938	0	163	18255	5351	18255	5188	0.0	3.5186969930609098
chr11	DDIAS	82913956	82914170	0	215	18255	5351	18255	5136	0.0	3.554322429906542
chr11	DDIAS	82930156	82930274	0	119	18255	5351	18255	5232	0.0	3.489105504587156
chr11	DDIAS	82913654	82913746	408	93	18255	5351	17847	5258	4.387096774193548	3.3942563712438187
chr11	DDIAS	82913282	82913386	165	105	18255	5351	18090	5246	1.5714285714285714	3.4483415935951203
chr11	RAB30-DT	83073302	83073447	0	146	225	6987	225	6841	0.0	0.03288992837304488
chr11	PCF11	83161326	83161452	0	127	51	9968	51	9841	0.0	0.005182400162585104
chr11	ANKRD42	83245497	83245624	0	128	51	6726	51	6598	0.0	0.007729615034859048
chr11	ANKRD42	83240758	83240934	0	177	51	6726	51	6549	0.0	0.007787448465414567
chr11	DLG2-AS2	83647003	83647090	0	88	0	2124	0	2036	0.0	0.0
chr11	TMEM126B	85631144	85631316	0	173	102	2156	102	1983	0.0	0.05143721633888049
chr11	TMEM126B	85629131	85629262	0	132	102	2156	102	2024	0.0	0.05039525691699605
chr11	TMEM126B	85631686	85631808	0	123	102	2156	102	2033	0.0	0.05017215937038859
chr11	TMEM126B	85629131	85629203	0	73	102	2156	102	2083	0.0	0.04896783485357657
chr11	TMEM126A	85650248	85650341	0	94	625	976	625	882	0.0	0.7086167800453514
chr11	TMEM126A	85650311	85650341	0	31	625	976	625	945	0.0	0.6613756613756614
chr11	CCDC83	85886199	85886367	0	169	0	2371	0	2202	0.0	0.0
chr11	CCDC83	85912648	85912741	0	94	0	2371	0	2277	0.0	0.0
chr11	CCDC83	85882512	85882675	0	164	0	2371	0	2207	0.0	0.0
chr11	EED	86270082	86270157	0	76	0	6220	0	6144	0.0	0.0
chr11	HIKESHI	86306244	86306482	0	239	0	2980	0	2741	0.0	0.0
chr11	HIKESHI	86326512	86326676	0	165	0	2980	0	2815	0.0	0.0
chr11	HIKESHI	86345093	86345198	0	106	0	2980	0	2874	0.0	0.0
chr11	CCDC81	86387515	86387659	0	145	0	4095	0	3950	0.0	0.0
chr11	CCDC81	86397620	86397742	0	123	0	4095	0	3972	0.0	0.0
chr11	CCDC81	86408126	86408270	0	145	0	4095	0	3950	0.0	0.0
chr11	CCDC81	86407613	86407701	0	89	0	4095	0	4006	0.0	0.0
chr11	TMEM135	87071522	87071615	0	94	0	10006	0	9912	0.0	0.0
chr11	TMEM135	87157340	87157406	0	67	0	10006	0	9939	0.0	0.0
chr11	GRM5-AS1	88512063	88512164	0	102	204	4843	204	4741	0.0	0.043028896857203125
chr11	TRIM77	89714191	89714422	0	232	51	1359	51	1127	0.0	0.04525288376220053
chr11	NAALAD2	90158144	90158238	0	95	68	6651	68	6556	0.0	0.010372178157413058
chr11	NAALAD2	90159238	90159337	0	100	68	6651	68	6551	0.0	0.010380094642039383
chr11	DISC1FP1	90361558	90361622	0	65	1152	3223	1152	3158	0.0	0.3647878404053198
chr11	DISC1FP1	90849383	90849540	1152	158	1152	3223	0	3065	7.291139240506329	0.0
chr11	DISC1FP1	90602804	90602908	0	105	1152	3223	1152	3118	0.0	0.3694676074406671
chr11	DISC1FP1	90716396	90716440	0	45	1152	3223	1152	3178	0.0	0.36249213341724357
chr11	LINC02756	91803291	91803492	0	202	0	2679	0	2477	0.0	0.0
chr11	MTNR1B	92972460	92972591	0	132	0	2029	0	1897	0.0	0.0
chr11	DEUP1	93352302	93352408	0	107	4174	4161	4174	4054	0.0	1.029600394671929
chr11	CEP295	93691926	93692030	0	105	722	8943	722	8838	0.0	0.08169269065399412
chr11	CEP295	93702775	93702919	0	145	722	8943	722	8798	0.0	0.08206410547851785
chr11	CEP295	93721953	93722050	0	98	722	8943	722	8845	0.0	0.08162803843979649
chr11	C11ORF54	93747296	93747448	0	153	51	5944	51	5791	0.0	0.00880676912450354
chr11	C11ORF54	93750345	93750444	0	100	51	5944	51	5844	0.0	0.008726899383983572
chr11	C11ORF54	93755209	93755386	0	178	51	5944	51	5766	0.0	0.008844953173777315
chr11	C11ORF54	93757315	93757465	0	151	51	5944	51	5793	0.0	0.008803728638011392
chr11	C11ORF54	93747301	93747448	0	148	51	5944	51	5796	0.0	0.008799171842650104
chr11	C11ORF54	93741962	93742066	0	105	51	5944	51	5839	0.0	0.008734372324028086
chr11	C11ORF54	93741962	93742094	0	133	51	5944	51	5811	0.0	0.008776458440887971
chr11	MED17	93788000	93788167	0	168	0	8731	0	8563	0.0	0.0
chr11	MED17	93794907	93795060	0	154	0	8731	0	8577	0.0	0.0
chr11	MED17	93797534	93797719	0	186	0	8731	0	8545	0.0	0.0
chr11	MED17	93801834	93801972	0	139	0	8731	0	8592	0.0	0.0
chr11	MED17	93807517	93807635	0	119	0	8731	0	8612	0.0	0.0
chr11	MED17	93809716	93809876	0	161	0	8731	0	8570	0.0	0.0
chr11	C11ORF54	93741962	93742141	0	180	51	5944	51	5764	0.0	0.008848022206800832
chr11	MED17	93794249	93794439	0	191	0	8731	0	8540	0.0	0.0
chr11	MED17	93807500	93807635	0	136	0	8731	0	8595	0.0	0.0
chr11	MED17	93790259	93790343	0	85	0	8731	0	8646	0.0	0.0
chr11	MED17	93790573	93790793	0	221	0	8731	0	8510	0.0	0.0
chr11	AP002784.1	94276956	94277109	828	154	118269	5352	117441	5198	5.376623376623376	22.59349749903809
chr11	ANKRD49	94497901	94497964	0	64	0	3004	0	2940	0.0	0.0
chr11	PIWIL4	94608184	94608686	142242	503	207424	4521	65182	4018	282.7872763419483	16.2224987555998
chr11	PIWIL4	94603983	94604056	16071	74	207424	4521	191353	4447	217.17567567567568	43.02968293231392
chr11	PIWIL4	94608582	94608686	39530	105	207424	4521	167894	4416	376.4761904761905	38.01947463768116
chr11	LINC02700	94639561	94639735	0	175	2800	3099	2800	2924	0.0	0.957592339261286
chr11	LINC02700	94648016	94648108	0	93	2800	3099	2800	3006	0.0	0.9314703925482368
chr11	LINC02700	94648016	94648102	0	87	2800	3099	2800	3012	0.0	0.9296148738379814
chr11	AMOTL1	94795010	94795160	0	151	18044	10047	18044	9896	0.0	1.8233629749393694
chr11	KDM4D	94975653	94975748	0	96	0	2805	0	2709	0.0	0.0
chr11	AP000787.1	95204805	95204912	0	108	0	6723	0	6615	0.0	0.0
chr11	AP000787.1	95232879	95232919	0	41	0	6723	0	6682	0.0	0.0
chr11	CEP57	95822498	95822576	0	79	32204	6568	32204	6489	0.0	4.962860224996147
chr11	CEP57	95799231	95799388	0	158	32204	6568	32204	6410	0.0	5.02402496099844
chr11	CEP57	95821870	95821978	0	109	32204	6568	32204	6459	0.0	4.985911131754142
chr11	CEP57	95794220	95794359	0	140	32204	6568	32204	6428	0.0	5.009956440572496
chr11	CEP57	95795515	95795559	0	45	32204	6568	32204	6523	0.0	4.936992181511575
chr11	CEP57	95799236	95799388	0	153	32204	6568	32204	6415	0.0	5.020109119251754
chr11	CNTN5	99325345	99325484	0	140	51	9136	51	8996	0.0	0.005669186305024455
chr11	CNTN5	99819543	99819765	0	223	51	9136	51	8913	0.0	0.00572197913160552
chr11	CNTN5	100224691	100224812	0	122	51	9136	51	9014	0.0	0.005657865542489461
chr11	ARHGAP42	100913451	100913553	0	103	4524	6134	4524	6031	0.0	0.7501243574863207
chr11	ARHGAP42	100986073	100986352	0	280	4524	6134	4524	5854	0.0	0.7728049197130168
chr11	CEP126	101986831	101987041	0	211	14308	8212	14308	8001	0.0	1.7882764654418197
chr11	CEP126	101956261	101956943	5826	683	14308	8212	8482	7529	8.530014641288433	1.1265772346925222
chr11	CEP126	101956867	101956943	0	77	14308	8212	14308	8135	0.0	1.758819913952059
chr11	CEP126	101955791	101956943	7140	1153	14308	8212	7168	7059	6.19254119687771	1.015441280634651
chr11	CFAP300	102066484	102066651	1765	168	14605	2653	12840	2485	10.505952380952381	5.167002012072435
chr11	YAP1	102186017	102186131	0	115	7041	6322	7041	6207	0.0	1.1343644272595457
chr11	YAP1	102209516	102209564	140	49	7041	6322	6901	6273	2.857142857142857	1.1001115893511877
chr11	BIRC3	102319876	102320006	0	131	144378	7530	144378	7399	0.0	19.51317745641303
chr11	BIRC3	102321836	102325362	136774	3527	144378	7530	7604	4003	38.779132407144886	1.8995753185111166
chr11	BIRC3	102326728	102326851	1785	124	144378	7530	142593	7406	14.39516129032258	19.253713205509047
chr11	BIRC2	102350843	102350943	0	101	153	3556	153	3455	0.0	0.04428364688856729
chr11	BIRC2	102348597	102348764	0	168	153	3556	153	3388	0.0	0.04515938606847698
chr11	DYNC2H1	103399662	103399872	0	211	1780	15101	1780	14890	0.0	0.11954331766286098
chr11	DYNC2H1	103241526	103241547	0	22	1780	15101	1780	15079	0.0	0.11804496319384575
chr11	GRIA4	105965946	105966061	344	116	2307	10106	1963	9990	2.9655172413793105	0.1964964964964965
chr11	GRIA4	105971913	105972028	0	116	2307	10106	2307	9990	0.0	0.23093093093093092
chr11	AASDHPPT	106090556	106090678	0	123	0	6010	0	5887	0.0	0.0
chr11	ELMOD1	107625396	107625532	0	137	4722	5874	4722	5737	0.0	0.8230782639009936
chr11	ELMOD1	107650884	107650908	0	25	4722	5874	4722	5849	0.0	0.8073174901692597
chr11	CUL5	108046269	108046369	0	101	31077	5279	31077	5178	0.0	6.001738122827346
chr11	CUL5	108049889	108050066	28	178	31077	5279	31049	5101	0.15730337078651685	6.086845716526171
chr11	ACAT1	108135141	108135242	0	102	5056	5827	5056	5725	0.0	0.8831441048034935
chr11	ACAT1	108140064	108140215	484	152	5056	5827	4572	5675	3.1842105263157894	0.8056387665198238
chr11	ACAT1	108143982	108144047	0	66	5056	5827	5056	5761	0.0	0.8776254122548168
chr11	ACAT1	108127885	108127979	0	95	5056	5827	5056	5732	0.0	0.8820655966503839
chr11	ACAT1	108131906	108131954	0	49	5056	5827	5056	5778	0.0	0.8750432675666321
chr11	ATM	108235669	108235834	737	166	102736	19441	101999	19275	4.4397590361445785	5.29177691309987
chr11	ATM	108271063	108271146	0	84	102736	19441	102736	19357	0.0	5.307434003202975
chr11	ATM	108294926	108295059	0	134	102736	19441	102736	19307	0.0	5.321178847050293
chr11	ATM	108307896	108307984	0	89	102736	19441	102736	19352	0.0	5.308805291442745
chr11	ATM	108293312	108293477	0	166	102736	19441	102736	19275	0.0	5.330012970168612
chr11	ATM	108320709	108320780	0	72	102736	19441	102736	19369	0.0	5.304145799989675
chr11	ATM	108225500	108225574	3189	75	102736	19441	99547	19366	42.52	5.140297428482908
chr11	ATM	108224783	108224871	0	89	102736	19441	102736	19352	0.0	5.308805291442745
chr11	ATM	108226163	108226247	0	85	102736	19441	102736	19356	0.0	5.307708204174416
chr11	LINC02732	110366360	110366534	0	175	0	2329	0	2154	0.0	0.0
chr11	LINC02732	110381925	110382021	0	97	0	2329	0	2232	0.0	0.0
chr11	C11ORF53	111281397	111281440	0	44	0	1348	0	1304	0.0	0.0
chr11	COLCA2	111299785	111299890	0	106	0	2014	0	1908	0.0	0.0
chr11	COLCA2	111299785	111300017	0	233	0	2014	0	1781	0.0	0.0
chr11	AP002008.2	111452408	111452588	0	181	11992	5357	11992	5176	0.0	2.3168469860896446
chr11	AP002008.2	111455384	111455620	0	237	11992	5357	11992	5120	0.0	2.3421875
chr11	HOATZ	111524882	111524963	0	82	46	983	46	901	0.0	0.051054384017758046
chr11	HOATZ	111519008	111519188	0	181	46	983	46	802	0.0	0.057356608478802994
chr11	LAYN	111549617	111549775	0	159	4454	3154	4454	2995	0.0	1.4871452420701168
chr11	LAYN	111541561	111541585	3	25	4454	3154	4451	3129	0.12	1.422499201022691
chr11	C11ORF1	111883135	111883202	0	68	3111	3520	3111	3452	0.0	0.9012166859791425
chr11	C11ORF1	111881484	111881615	25	132	3111	3520	3086	3388	0.1893939393939394	0.91086186540732
chr11	HSPB2-C11ORF52	111913440	111913971	1351	532	1420	2064	69	1532	2.539473684210526	0.04503916449086162
chr11	NKAPD1	112078214	112078315	0	102	204	4338	204	4236	0.0	0.04815864022662889
chr11	NKAPD1	112074886	112074916	0	31	204	4338	204	4307	0.0	0.04736475504991874
chr11	SDHD	112088244	112088535	280	292	3181	2799	2901	2507	0.958904109589041	1.1571599521340248
chr11	SDHD	112087856	112087973	0	118	3181	2799	3181	2681	0.0	1.1864975755315181
chr11	SDHD	112088866	112089004	324	139	3181	2799	2857	2660	2.3309352517985613	1.07406015037594
chr11	SDHD	112088866	112089011	331	146	3181	2799	2850	2653	2.267123287671233	1.0742555597436865
chr11	SDHD	112093079	112093209	0	131	3181	2799	3181	2668	0.0	1.1922788605697152
chr11	AP002884.2	112170622	112170674	0	53	1181	1027	1181	974	0.0	1.2125256673511293
chr11	SDHD	112091078	112091132	0	55	3181	2799	3181	2744	0.0	1.159256559766764
chr11	BCO2	112179277	112179482	0	206	102	6492	102	6286	0.0	0.016226535157492842
chr11	BCO2	112179277	112179569	0	293	102	6492	102	6199	0.0	0.016454266817228586
chr11	PTS	112230625	112230682	10	58	102	3138	92	3080	0.1724137931034483	0.02987012987012987
chr11	PTS	112230207	112230230	0	24	102	3138	102	3114	0.0	0.03275529865125241
chr11	AP003100.2	112639681	112639751	0	71	0	5543	0	5472	0.0	0.0
chr11	NCAM1	113221295	113221325	0	31	10388	12494	10388	12463	0.0	0.8335071812565193
chr11	NCAM1	113231195	113231273	672	79	10388	12494	9716	12415	8.50632911392405	0.782601691502215
chr11	NCAM1	113246367	113246370	0	4	10388	12494	10388	12490	0.0	0.8317053642914332
chr11	NCAM1	113242804	113242846	0	43	10388	12494	10388	12451	0.0	0.8343104971488234
chr11	NCAM1	113272932	113273048	0	117	10388	12494	10388	12377	0.0	0.8392986992001292
chr11	NCAM1	113236300	113236315	17	16	10388	12494	10371	12478	1.0625	0.8311428113479724
chr11	NCAM1	113243551	113243790	51	240	10388	12494	10337	12254	0.2125	0.8435612861106577
chr11	NCAM1	113272932	113273748	0	817	10388	12494	10388	11677	0.0	0.8896120578915817
chr11	TTC12	113315950	113316315	0	366	46	4931	46	4565	0.0	0.010076670317634174
chr11	TTC12	113315950	113316053	0	104	46	4931	46	4827	0.0	0.009529728609902631
chr11	TTC12	113329919	113329979	0	61	46	4931	46	4870	0.0	0.00944558521560575
chr11	TTC12	113316242	113316315	0	74	46	4931	46	4857	0.0	0.009470866790199713
chr11	TTC12	113334965	113335037	0	73	46	4931	46	4858	0.0	0.009468917249897077
chr11	TTC12	113329641	113329808	0	168	46	4931	46	4763	0.0	0.009657778710896493
chr11	TTC12	113364834	113365060	0	227	46	4931	46	4704	0.0	0.00977891156462585
chr11	ANKK1	113394727	113394782	0	56	0	2617	0	2561	0.0	0.0
chr11	HTR3B	113942981	113943192	0	212	78	4836	78	4624	0.0	0.016868512110726645
chr11	HTR3A	113986014	113986175	0	162	0	2686	0	2524	0.0	0.0
chr11	ZBTB16	114061370	114061561	0	192	20906	11948	20906	11756	0.0	1.7783259612112963
chr11	ZBTB16	114121817	114121914	0	98	20906	11948	20906	11850	0.0	1.7642194092827004
chr11	RBM7	114401697	114401860	0	164	6528	6246	6528	6082	0.0	1.0733311410720159
chr11	RBM7	114402827	114402915	0	89	6528	6246	6528	6157	0.0	1.0602566184830275
chr11	REXO2	114440655	114440739	0	85	3876	3443	3876	3358	0.0	1.1542584871947588
chr11	REXO2	114444540	114444652	0	113	3876	3443	3876	3330	0.0	1.163963963963964
chr11	REXO2	114444585	114444652	0	68	3876	3443	3876	3375	0.0	1.1484444444444444
chr11	REXO2	114443855	114443933	0	79	3876	3443	3876	3364	0.0	1.1521997621878717
chr11	LINC02703	115942252	115942387	0	136	0	1379	0	1243	0.0	0.0
chr11	LINC02702	116655034	116655190	58742	157	178561	1108	119819	951	374.1528662420382	125.99263932702418
chr11	APOA1-AS	116853869	116854022	0	154	0	1008	0	854	0.0	0.0
chr11	PAFAH1B2	117171621	117171746	153	126	357153	6079	357000	5953	1.2142857142857142	59.96976314463296
chr11	SIDT2	117182059	117182105	308	47	31773	6733	31465	6686	6.553191489361702	4.706102303320371
chr11	SIDT2	117189951	117190025	658	75	31773	6733	31115	6658	8.773333333333333	4.673325322919796
chr11	SIDT2	117193852	117193963	195	112	31773	6733	31578	6621	1.7410714285714286	4.769370185772542
chr11	SIDT2	117187891	117187954	525	64	31773	6733	31248	6669	8.203125	4.685560053981106
chr11	SIDT2	117186989	117187001	39	13	31773	6733	31734	6720	3.0	4.722321428571429
chr11	TAGLN	117199632	117199829	286	198	36934	4328	36648	4130	1.4444444444444444	8.87360774818402
chr11	RNF214	117282745	117282850	11262	106	76777	4317	65515	4211	106.24528301886792	15.558062218000474
chr11	CEP164	117338565	117338668	0	104	102	12616	102	12512	0.0	0.008152173913043478
chr11	CEP164	117382795	117382942	0	148	102	12616	102	12468	0.0	0.008180943214629451
chr11	CEP164	117335604	117335680	0	77	102	12616	102	12539	0.0	0.008134619985644789
chr11	CEP164	117354931	117356617	51	1687	102	12616	51	10929	0.03023117960877297	0.004666483667307164
chr11	IL10RA	117989441	117989620	0	180	204	8065	204	7885	0.0	0.025871908687381102
chr11	IL10RA	117986683	117986813	0	131	204	8065	204	7934	0.0	0.025712125031509957
chr11	IL10RA	117986606	117986813	0	208	204	8065	204	7857	0.0	0.025964108438335243
chr11	TMPRSS4	118115137	118115280	0	144	51	7122	51	6978	0.0	0.007308684436801376
chr11	TMPRSS4	118098984	118099098	0	115	51	7122	51	7007	0.0	0.007278435849864422
chr11	TMPRSS4	118103100	118103253	0	154	51	7122	51	6968	0.0	0.007319173363949483
chr11	TMPRSS4	118098984	118099034	0	51	51	7122	51	7071	0.0	0.007212558336868901
chr11	CD3E	118312152	118312170	0	19	3838	2293	3838	2274	0.0	1.6877748460861917
chr11	CD3G	118350551	118350683	29	133	14626	3315	14597	3182	0.21804511278195488	4.587366436203646
chr11	CD3G	118349263	118349322	0	60	14626	3315	14626	3255	0.0	4.493394777265745
chr11	ATP5MG	118405656	118405709	5783	54	48072	2122	42289	2068	107.0925925925926	20.449226305609283
chr11	KMT2A	118482421	118482495	0	75	412881	22794	412881	22719	0.0	18.173379109996038
chr11	KMT2A	118484861	118484975	0	115	412881	22794	412881	22679	0.0	18.20543233828652
chr11	KMT2A	118439023	118439122	0	100	412881	22794	412881	22694	0.0	18.193399136335596
chr11	KMT2A	118471661	118471985	108315	325	412881	22794	304566	22469	333.2769230769231	13.554942365036272
chr11	TTC36	118527921	118528056	19935	136	46975	1013	27040	877	146.5808823529412	30.832383124287343
chr11	TMEM25	118532149	118532461	0	313	51	4816	51	4503	0.0	0.011325782811459028
chr11	TMEM25	118532916	118533207	0	292	51	4816	51	4524	0.0	0.011273209549071617
chr11	TMEM25	118532096	118532461	0	366	51	4816	51	4450	0.0	0.01146067415730337
chr11	TMEM25	118532409	118532461	0	53	51	4816	51	4763	0.0	0.01070753726642872
chr11	TMEM25	118533419	118533551	0	133	51	4816	51	4683	0.0	0.010890454836643177
chr11	TMEM25	118532245	118532461	0	217	51	4816	51	4599	0.0	0.011089367253750815
chr11	TMEM25	118531774	118531871	0	98	51	4816	51	4718	0.0	0.010809665112335736
chr11	ARCN1	118581245	118581509	0	265	327	3861	327	3596	0.0	0.09093437152391547
chr11	ARCN1	118573619	118573783	0	165	327	3861	327	3696	0.0	0.08847402597402597
chr11	PHLDB1	118632158	118632296	429	139	202332	19655	201903	19516	3.0863309352517985	10.34551137528182
chr11	PHLDB1	118642253	118642394	0	142	202332	19655	202332	19513	0.0	10.3690872751499
chr11	PHLDB1	118655859	118655892	57	34	202332	19655	202275	19621	1.6764705882352942	10.30910758880791
chr11	PHLDB1	118613293	118613450	0	158	202332	19655	202332	19497	0.0	10.377596553315895
chr11	PHLDB1	118624791	118624845	24	55	202332	19655	202308	19600	0.43636363636363634	10.321836734693878
chr11	PHLDB1	118644646	118644691	0	46	202332	19655	202332	19609	0.0	10.318323218930082
chr11	PHLDB1	118634922	118635051	105	130	202332	19655	202227	19525	0.8076923076923077	10.357336747759282
chr11	FOXR1	118979441	118979668	509	228	58117	1235	57608	1007	2.232456140350877	57.20754716981132
chr11	CENATAC	119013231	119013262	0	32	15981	4795	15981	4763	0.0	3.355238295192106
chr11	CENATAC	119001612	119001825	11723	214	15981	4795	4258	4581	54.7803738317757	0.9294913774285091
chr11	TRAPPC4	119020149	119020253	0	105	4219	4642	4219	4537	0.0	0.9299096319153626
chr11	TRAPPC4	119019142	119019317	0	176	4219	4642	4219	4466	0.0	0.9446932377966861
chr11	VPS11	119069441	119069577	0	137	1016	4315	1016	4178	0.0	0.24317855433221638
chr11	VPS11	119081091	119081314	158	224	1016	4315	858	4091	0.7053571428571429	0.2097286726961623
chr11	HMBS	119088254	119088308	0	55	730	3568	730	3513	0.0	0.20779960148021634
chr11	HMBS	119089081	119089131	0	51	730	3568	730	3517	0.0	0.20756326414557863
chr11	HMBS	119089682	119089760	0	79	730	3568	730	3489	0.0	0.20922900544568646
chr11	HMBS	119092124	119092163	0	40	730	3568	730	3528	0.0	0.20691609977324263
chr11	HMBS	119092403	119092523	0	121	730	3568	730	3447	0.0	0.2117783579924572
chr11	HMBS	119089099	119089131	0	33	730	3568	730	3535	0.0	0.2065063649222065
chr11	HMBS	119085810	119085893	264	84	730	3568	466	3484	3.142857142857143	0.13375430539609645
chr11	HINFP	119126934	119127125	0	192	2164	5658	2164	5466	0.0	0.39590193926088546
chr11	HINFP	119121782	119122013	91	232	2164	5658	2073	5426	0.3922413793103448	0.38204939181717656
chr11	NLRX1	119172355	119172425	8388	71	688243	4706	679855	4635	118.14084507042253	146.67853290183388
chr11	PDZD3	119187269	119187459	154	191	78752	3455	78598	3264	0.806282722513089	24.08026960784314
chr11	CBL	119284968	119285100	0	133	144484	6239	144484	6106	0.0	23.662626924336717
chr11	USP2-AS1	119469808	119469975	0	168	163	9657	163	9489	0.0	0.017177784803456633
chr11	USP2-AS1	119395541	119395663	102	123	163	9657	61	9534	0.8292682926829268	0.006398153975246486
chr11	USP2-AS1	119394980	119395154	0	175	163	9657	163	9482	0.0	0.01719046614638262
chr11	AP003393.1	119656950	119657098	0	149	0	6121	0	5972	0.0	0.0
chr11	POU2F3	120309424	120309586	0	163	30143	5379	30143	5216	0.0	5.778949386503068
chr11	POU2F3	120301042	120301089	0	48	30143	5379	30143	5331	0.0	5.6542862502344775
chr11	TLCD5	120327121	120327640	0	520	2114	4308	2114	3788	0.0	0.558078141499472
chr11	TLCD5	120327440	120327640	0	201	2114	4308	2114	4107	0.0	0.5147309471633796
chr11	ARHGEF12	120409393	120409450	0	58	102	19664	102	19606	0.0	0.005202489033969193
chr11	GRIK4	120653684	120653792	0	109	10427	7503	10427	7394	0.0	1.4101974573978902
chr11	TBCEL	121055051	121055308	0	258	54	6539	54	6281	0.0	0.008597357108740647
chr11	TBCEL	121036504	121036612	0	109	54	6539	54	6430	0.0	0.008398133748055987
chr11	TBCEL	121035732	121035944	0	213	54	6539	54	6326	0.0	0.00853619981030667
chr11	TBCEL	121053629	121053732	0	104	54	6539	54	6435	0.0	0.008391608391608392
chr11	TBCEL	121057507	121057614	0	108	54	6539	54	6431	0.0	0.008396827865028766
chr11	GRAMD1B	123432017	123432126	0	110	50106	14786	50106	14676	0.0	3.4141455437448895
chr11	GRAMD1B	123618344	123618356	0	13	50106	14786	50106	14773	0.0	3.391728152711027
chr11	GRAMD1B	123578409	123578430	0	22	50106	14786	50106	14764	0.0	3.393795719317258
chr11	OR10G4	124014918	124015240	0	323	0	3599	0	3276	0.0	0.0
chr11	VWA5A	124116565	124116680	0	116	153	6379	153	6263	0.0	0.024429187290435892
chr11	OR8G3P	124214571	124214660	0	90	0	1347	0	1257	0.0	0.0
chr11	TBRG1	124625670	124625903	969	234	15696	5659	14727	5425	4.141025641025641	2.7146543778801844
chr11	TBRG1	124626472	124626609	204	138	15696	5659	15492	5521	1.4782608695652173	2.8060134033689548
chr11	TBRG1	124624930	124625001	0	72	15696	5659	15696	5587	0.0	2.80937891533918
chr11	ROBO3	124877266	124877309	0	44	20590	6444	20590	6400	0.0	3.2171875
chr11	ROBO3	124877936	124878131	0	196	20590	6444	20590	6248	0.0	3.2954545454545454
chr11	ROBO3	124878297	124878436	0	140	20590	6444	20590	6304	0.0	3.2661802030456855
chr11	ROBO3	124877160	124877184	0	25	20590	6444	20590	6419	0.0	3.207664745287428
chr11	ROBO3	124878583	124878796	0	214	20590	6444	20590	6230	0.0	3.304975922953451
chr11	ROBO3	124877284	124877309	0	26	20590	6444	20590	6418	0.0	3.208164537239015
chr11	SLC37A2	125084233	125084319	0	87	0	6174	0	6087	0.0	0.0
chr11	SLC37A2	125086203	125086260	0	58	0	6174	0	6116	0.0	0.0
chr11	PKNOX2	125235044	125235115	0	72	226	5946	226	5874	0.0	0.03847463398025196
chr11	PKNOX2	125385550	125385722	0	173	226	5946	226	5773	0.0	0.03914775679889139
chr11	PKNOX2	125331818	125331925	0	108	226	5946	226	5838	0.0	0.03871188763275094
chr11	PKNOX2	125351283	125351392	0	110	226	5946	226	5836	0.0	0.0387251542152159
chr11	PKNOX2	125239615	125239728	0	114	226	5946	226	5832	0.0	0.0387517146776406
chr11	PKNOX2	125332615	125332688	0	74	226	5946	226	5872	0.0	0.03848773841961853
chr11	PKNOX2	125367845	125367985	22	141	226	5946	204	5805	0.15602836879432624	0.0351421188630491
chr11	EI24	125570103	125570190	0	88	545	3327	545	3239	0.0	0.16826180920037048
chr11	EI24	125575802	125575931	0	130	545	3327	545	3197	0.0	0.17047231779793556
chr11	EI24	125581210	125581322	0	113	545	3327	545	3214	0.0	0.16957062850031113
chr11	EI24	125575304	125575408	0	105	545	3327	545	3222	0.0	0.1691495965238982
chr11	EI24	125575250	125575408	0	159	545	3327	545	3168	0.0	0.1720328282828283
chr11	EI24	125575262	125575408	0	147	545	3327	545	3180	0.0	0.17138364779874213
chr11	EI24	125575308	125575408	0	101	545	3327	545	3226	0.0	0.1689398636081835
chr11	EI24	125577735	125577906	0	172	545	3327	545	3155	0.0	0.17274167987321712
chr11	STT3A	125595880	125596003	0	124	1079	7052	1079	6928	0.0	0.15574480369515012
chr11	STT3A	125593637	125593725	0	89	1079	7052	1079	6963	0.0	0.1549619416917995
chr11	STT3A	125611427	125611519	0	93	1079	7052	1079	6959	0.0	0.15505101307659147
chr11	STT3A	125594049	125594097	0	49	1079	7052	1079	7003	0.0	0.15407682421819222
chr11	CHEK1	125627606	125627830	0	225	94	4401	94	4176	0.0	0.022509578544061302
chr11	CHEK1	125653745	125653847	51	103	94	4401	43	4298	0.49514563106796117	0.010004653327128897
chr11	CHEK1	125626416	125626575	0	160	94	4401	94	4241	0.0	0.022164583824569678
chr11	CHEK1	125656205	125656335	0	131	94	4401	94	4270	0.0	0.022014051522248244
chr11	PATE1	125747375	125747411	0	37	1122	2073	1122	2036	0.0	0.5510805500982319
chr11	PATE4	125837867	125837984	0	118	0	2889	0	2771	0.0	0.0
chr11	HYLS1	125899103	125899158	0	56	1934	2395	1934	2339	0.0	0.8268490808037623
chr11	DDX25	125905211	125905278	0	68	46	10966	46	10898	0.0	0.0042209579739401724
chr11	DDX25	125922099	125922305	0	207	46	10966	46	10759	0.0	0.004275490287201413
chr11	VSIG10L2	125953399	125953690	0	292	153	5122	153	4830	0.0	0.031677018633540374
chr11	VSIG10L2	125954086	125954211	0	126	153	5122	153	4996	0.0	0.030624499599679743
chr11	FAM118B	126229224	126229293	0	70	5794	3544	5794	3474	0.0	1.667818077144502
chr11	FAM118B	126234994	126235087	0	94	5794	3544	5794	3450	0.0	1.6794202898550725
chr11	FAM118B	126250505	126250733	0	229	5794	3544	5794	3315	0.0	1.7478129713423831
chr11	FAM118B	126233585	126233721	8	137	5794	3544	5786	3407	0.058394160583941604	1.69826827120634
chr11	FAM118B	126229224	126229336	0	113	5794	3544	5794	3431	0.0	1.6887204896531622
chr11	FOXRED1	126274930	126275021	40	92	99240	4405	99200	4313	0.43478260869565216	23.00023185717598
chr11	FOXRED1	126271436	126271657	0	222	99240	4405	99240	4183	0.0	23.724599569686827
chr11	FOXRED1	126274926	126275021	40	96	99240	4405	99200	4309	0.4166666666666667	23.02158273381295
chr11	TIRAP	126289664	126289833	0	170	945	3600	945	3430	0.0	0.2755102040816326
chr11	TIRAP	126291424	126291569	0	146	945	3600	945	3454	0.0	0.2735958309206717
chr11	TIRAP	126290461	126290585	0	125	945	3600	945	3475	0.0	0.2719424460431655
chr11	TIRAP	126289664	126289817	0	154	945	3600	945	3446	0.0	0.2742309924550203
chr11	DCPS	126338285	126338399	0	115	1477	7888	1477	7773	0.0	0.19001672455937219
chr11	ST3GAL4	126358414	126358511	0	98	231	5834	231	5736	0.0	0.040271966527196654
chr11	ST3GAL4	126407573	126407634	0	62	231	5834	231	5772	0.0	0.04002079002079002
chr11	ST3GAL4	126408098	126408194	0	97	231	5834	231	5737	0.0	0.04026494683632561
chr11	ST3GAL4	126408306	126408496	0	191	231	5834	231	5643	0.0	0.04093567251461988
chr11	ST3GAL4	126358197	126358348	0	152	231	5834	231	5682	0.0	0.04065469904963041
chr11	AP001993.1	127053337	127053688	0	352	0	9479	0	9127	0.0	0.0
chr11	AP001993.1	127075982	127076078	0	97	0	9479	0	9382	0.0	0.0
chr11	AP001993.1	127078927	127079031	0	105	0	9479	0	9374	0.0	0.0
chr11	AP001993.1	127023971	127024163	0	193	0	9479	0	9286	0.0	0.0
chr11	AP001993.1	127072988	127073268	0	281	0	9479	0	9198	0.0	0.0
chr11	AP001993.1	127072988	127073296	0	309	0	9479	0	9170	0.0	0.0
chr11	AP001993.1	127048692	127048812	0	121	0	9479	0	9358	0.0	0.0
chr11	AP001993.1	127080433	127080567	0	135	0	9479	0	9344	0.0	0.0
chr11	LINC02725	128100725	128100750	0	26	0	2534	0	2508	0.0	0.0
chr11	LINC02725	128167171	128167271	0	101	0	2534	0	2433	0.0	0.0
chr11	LINC02725	128168182	128168371	0	190	0	2534	0	2344	0.0	0.0
chr11	LINC02098	128210536	128210716	0	181	0	991	0	810	0.0	0.0
chr11	LINC02098	128211386	128211719	0	334	0	991	0	657	0.0	0.0
chr11	LINC02098	128211637	128211719	0	83	0	991	0	908	0.0	0.0
chr11	FLI1	128764650	128764821	0	172	714	6548	714	6376	0.0	0.11198243412797992
chr11	FLI1	128748236	128748290	0	55	714	6548	714	6493	0.0	0.10996457723702449
chr11	KCNJ5	128909851	128909940	0	90	102	6241	102	6151	0.0	0.016582669484636645
chr11	APLP2	130109428	130109602	0	175	23145	7164	23145	6989	0.0	3.3116325654600085
chr11	APLP2	130123611	130123779	0	169	23145	7164	23145	6995	0.0	3.3087919942816297
chr11	APLP2	130137255	130137291	0	37	23145	7164	23145	7127	0.0	3.247509471025677
chr11	APLP2	130100269	130100425	2193	157	23145	7164	20952	7007	13.968152866242038	2.990152704438419
chr11	APLP2	130101925	130102000	3811	76	23145	7164	19334	7088	50.14473684210526	2.7277088036117383
chr11	APLP2	130110537	130110661	0	125	23145	7164	23145	7039	0.0	3.28810910640716
chr11	NTM	132146281	132146514	0	234	51	6509	51	6275	0.0	0.008127490039840637
chr11	NTM	131660928	131661048	0	121	51	6509	51	6388	0.0	0.007983719474013776
chr11	NTM	132330152	132330185	0	34	51	6509	51	6475	0.0	0.007876447876447876
chr11	NTM	132317654	132317690	0	37	51	6509	51	6472	0.0	0.00788009888751545
chr11	LINC02731	134037511	134037641	224	131	25043	5070	24819	4939	1.7099236641221374	5.025106296821219
chr11	JAM3	134070171	134070278	0	108	3091	5317	3091	5209	0.0	0.5933960453062008
chr11	JAM3	134144240	134144393	0	154	3091	5317	3091	5163	0.0	0.5986829362773581
chr11	VPS26B	134234896	134235053	0	158	33481	6455	33481	6297	0.0	5.316976337938701
chr11	VPS26B	134236341	134236746	1354	406	33481	6455	32127	6049	3.334975369458128	5.3111258059183335
chr11	ACAD8	134257087	134257257	0	171	0	6406	0	6235	0.0	0.0
chr11	ACAD8	134258514	134258624	0	111	0	6406	0	6295	0.0	0.0
chr11	ACAD8	134256547	134256648	0	102	0	6406	0	6304	0.0	0.0
chr11	GLB1L3	134313395	134313474	0	80	88	8157	88	8077	0.0	0.01089513433205398
chr11	B3GAT1-DT	134467864	134467987	0	124	0	7092	0	6968	0.0	0.0
chr11	B3GAT1-DT	134469486	134469601	0	116	0	7092	0	6976	0.0	0.0
chr11	LINC02706	134714719	134714780	0	62	0	2836	0	2774	0.0	0.0
chr11	LINC01001	135174	135860	8303	687	93793	3834	85490	3147	12.085880640465794	27.165554496345727
chr11	BET1L	205610	205667	12040	58	150275	1695	138235	1637	207.58620689655172	84.44410507025046
chr11	SIRT3	224077	224239	19410	163	344499	5564	325089	5401	119.079754601227	60.19052027402333
chr11	SIRT3	230451	230552	15293	102	344499	5564	329206	5462	149.9313725490196	60.27206151592823
chr11	SIRT3	233342	233534	29645	193	344499	5564	314854	5371	153.60103626943004	58.621113386706384
chr11	SIRT3	233342	233437	18420	96	344499	5564	326079	5468	191.875	59.63405267008047
chr11	SIRT3	230451	230641	15971	191	344499	5564	328528	5373	83.61780104712042	61.144239717104035
chr11	SIRT3	233910	234004	4490	95	344499	5564	340009	5469	47.26315789473684	62.17023221795575
chr11	SIRT3	233342	233486	24370	145	344499	5564	320129	5419	168.06896551724137	59.07529064403026
chr11	IFITM3	320112	320248	3143	137	1127627	1156	1124484	1019	22.94160583941606	1103.5171736997056
chr11	SIGIRR	406842	406993	15891	152	145538	2873	129647	2721	104.54605263157895	47.6468210216832
chr11	SIGIRR	408072	408206	0	135	145538	2873	145538	2738	0.0	53.15485756026297
chr11	SIGIRR	408694	408893	0	200	145538	2873	145538	2673	0.0	54.447437336326225
chr11	SIGIRR	409867	410027	0	161	145538	2873	145538	2712	0.0	53.66445427728613
chr11	SIGIRR	409216	409308	0	93	145538	2873	145538	2780	0.0	52.35179856115108
chr11	RNH1	504823	504996	57293	174	1056857	5394	999564	5220	329.2701149425287	191.4873563218391
chr11	RNH1	504823	504888	21303	66	1056857	5394	1035554	5328	322.77272727272725	194.36073573573574
chr11	RNH1	505377	505461	3664	85	1056857	5394	1053193	5309	43.10588235294118	198.37879073271802
chr11	HRAS	533276	533358	12260	83	300430	1889	288170	1806	147.710843373494	159.56256921373202
chr11	LMNTD2	559346	559498	2797	153	24885	2775	22088	2622	18.281045751633986	8.424103737604883
chr11	IRF7	613950	614037	1308	88	121981	2356	120673	2268	14.863636363636363	53.20679012345679
chr11	IRF7	614173	614399	5051	227	121981	2356	116930	2129	22.251101321585903	54.92249882573979
chr11	CDHR5	618598	619162	255	565	3232	3877	2977	3312	0.45132743362831856	0.898852657004831
chr11	CDHR5	621811	621904	72	94	3232	3877	3160	3783	0.7659574468085106	0.8353158868622786
chr11	CDHR5	618598	619180	255	583	3232	3877	2977	3294	0.43739279588336194	0.9037644201578627
chr11	CDHR5	621811	621835	18	25	3232	3877	3214	3852	0.72	0.8343717549325026
chr11	DEAF1	651161	651407	1030	247	296301	4162	295271	3915	4.17004048582996	75.42043422733077
chr11	DEAF1	678693	678822	25060	130	296301	4162	271241	4032	192.76923076923077	67.27207341269842
chr11	GATD1	770992	771104	33725	113	580940	5390	547215	5277	298.4513274336283	103.69812393405344
chr11	GATD1	773521	773629	40547	109	580940	5390	540393	5281	371.9908256880734	102.32777882976708
chr11	GATD1	770313	770398	32435	86	580940	5390	548505	5304	377.1511627906977	103.41346153846153
chr11	GATD1	775065	775142	25225	78	580940	5390	555715	5312	323.3974358974359	104.61502259036145
chr11	GATD1	770678	770903	22283	226	580940	5390	558657	5164	98.59734513274336	108.18299767621998
chr11	GATD1	773427	773629	41391	203	580940	5390	539549	5187	203.89655172413794	104.01947175631386
chr11	SLC25A22	796042	796367	2301	326	193737	4564	191436	4238	7.058282208588957	45.17130722038697
chr11	CHID1	884067	884169	56331	103	713739	4078	657408	3975	546.9029126213592	165.38566037735848
chr11	CHID1	893426	893519	51238	94	713739	4078	662501	3984	545.0851063829788	166.29041164658634
chr11	CHID1	903703	903778	51	76	713739	4078	713688	4002	0.6710526315789473	178.33283358320838
chr11	CHID1	869213	869345	1665	133	713739	4078	712074	3945	12.518796992481203	180.5003802281369
chr11	CHID1	908541	908645	8718	105	713739	4078	705021	3973	83.02857142857142	177.45305814246163
chr11	CHID1	903655	903753	32	99	713739	4078	713707	3979	0.32323232323232326	179.36843427996985
chr11	CHID1	908214	908296	0	83	713739	4078	713739	3995	0.0	178.6580725907384
chr11	TOLLIP	1290226	1290409	204	184	116792	5727	116588	5543	1.108695652173913	21.03337542846834
chr11	TOLLIP	1295644	1295794	20446	151	116792	5727	96346	5576	135.40397350993376	17.278694404591104
chr11	TOLLIP	1283282	1283597	0	316	116792	5727	116792	5411	0.0	21.58418037331362
chr11	IFITM10	1747666	1748119	0	454	51	4795	51	4341	0.0	0.011748445058742226
chr11	CTSD	1753532	1753670	155	139	1673	3467	1518	3328	1.1151079136690647	0.4561298076923077
chr11	H19	1995875	1995941	84	67	937	2821	853	2754	1.2537313432835822	0.30973129992737836
chr11	H19	1995875	1995998	102	124	937	2821	835	2697	0.8225806451612904	0.3096032628846867
chr11	IGF2	2140134	2140299	0	166	357	6266	357	6100	0.0	0.05852459016393442
chr11	TH	2166886	2167032	0	147	0	3044	0	2897	0.0	0.0
chr11	TH	2170689	2170770	0	82	0	3044	0	2962	0.0	0.0
chr11	TH	2166632	2166768	0	137	0	3044	0	2907	0.0	0.0
chr11	C11ORF21	2300519	2300613	0	95	0	4079	0	3984	0.0	0.0
chr11	C11ORF21	2300683	2300768	0	86	0	4079	0	3993	0.0	0.0
chr11	SLC22A18AS	2899395	2899790	264	396	366	2058	102	1662	0.6666666666666666	0.061371841155234655
chr11	NAP1L4	2979206	2979237	214	32	14900	5136	14686	5104	6.6875	2.8773510971786833
chr11	NAP1L4	2949226	2949264	0	39	14900	5136	14900	5097	0.0	2.9232882087502454
chr11	NAP1L4	2989128	2989271	0	144	14900	5136	14900	4992	0.0	2.984775641025641
chr11	NAP1L4	2954300	2954410	79	111	14900	5136	14821	5025	0.7117117117117117	2.949452736318408
chr11	NAP1L4	2988076	2988126	0	51	14900	5136	14900	5085	0.0	2.9301868239921336
chr11	NAP1L4	2983745	2983813	120	69	14900	5136	14780	5067	1.7391304347826086	2.9169133609630946
chr11	NAP1L4	2981701	2981799	0	99	14900	5136	14900	5037	0.0	2.958109986102839
chr11	NAP1L4	2990908	2990992	0	85	14900	5136	14900	5051	0.0	2.9499109087309443
chr11	CARS1	3002540	3002600	0	61	77499	7131	77499	7070	0.0	10.961669024045262
chr11	CARS1	3047752	3048001	14448	250	77499	7131	63051	6881	57.792	9.163057695102456
chr11	CARS1	3054876	3055039	0	164	77499	7131	77499	6967	0.0	11.123726137505383
chr11	CARS1	3040447	3040581	8486	135	77499	7131	69013	6996	62.85925925925926	9.864636935391653
chr11	OSBPL5	3120420	3120624	51	205	14893	7227	14842	7022	0.24878048780487805	2.113642836798633
chr11	OSBPL5	3120543	3120624	0	82	14893	7227	14893	7145	0.0	2.0843946815955214
chr11	ZNF195	3360719	3360788	0	70	2796	7243	2796	7173	0.0	0.38979506482643245
chr11	ZNF195	3361742	3361889	0	148	2796	7243	2796	7095	0.0	0.3940803382663848
chr11	ZNF195	3373576	3373675	68	100	2796	7243	2728	7143	0.68	0.38191236175276494
chr11	ZNF195	3373576	3373656	0	81	2796	7243	2796	7162	0.0	0.3903937447640324
chr11	ZNF195	3377616	3377900	204	285	2796	7243	2592	6958	0.7157894736842105	0.37252083932164415
chr11	ZNF195	3362545	3362602	0	58	2796	7243	2796	7185	0.0	0.38914405010438413
chr11	ZNF195	3361975	3362032	0	58	2796	7243	2796	7185	0.0	0.38914405010438413
chr11	ZNF195	3361975	3362073	0	99	2796	7243	2796	7144	0.0	0.39137737961926095
chr11	ZNF195	3377616	3377802	194	187	2796	7243	2602	7056	1.0374331550802138	0.3687641723356009
chr11	ZNF195	3369356	3369502	493	147	2796	7243	2303	7096	3.3537414965986394	0.32454904171364146
chr11	NUP98	3685972	3686194	0	223	172072	9424	172072	9201	0.0	18.701445495054884
chr11	NUP98	3700609	3700839	5791	231	172072	9424	166281	9193	25.06926406926407	18.08778418361797
chr11	NUP98	3744508	3744649	52524	142	172072	9424	119548	9282	369.88732394366195	12.879551820728292
chr11	NUP98	3696684	3696800	9383	117	172072	9424	162689	9307	80.19658119658119	17.480283657462124
chr11	NUP98	3686063	3686194	0	132	172072	9424	172072	9292	0.0	18.51829530779165
chr11	TRIM68	4603244	4603340	0	97	0	3796	0	3699	0.0	0.0
chr11	TRIM68	4605078	4605561	0	484	0	3796	0	3312	0.0	0.0
chr11	OR51E2	4685777	4685856	0	80	0	2911	0	2831	0.0	0.0
chr11	HBD	5233990	5234213	0	224	0	1158	0	934	0.0	0.0
chr11	AC104389.6	5253342	5253405	0	64	0	655	0	591	0.0	0.0
chr11	AC104389.5	5626600	5626854	1090	255	1213	5285	123	5030	4.2745098039215685	0.02445328031809145
chr11	TRIM5	5665980	5666081	0	102	19046	4811	19046	4709	0.0	4.044595455510724
chr11	TRIM5	5667688	5667711	0	24	19046	4811	19046	4787	0.0	3.978692291623146
chr11	TRIM5	5665168	5665395	0	228	19046	4811	19046	4583	0.0	4.1557931485926245
chr11	TRIM5	5683985	5684139	0	155	19046	4811	19046	4656	0.0	4.090635738831615
chr11	OR56A4	6006248	6006403	0	156	0	3937	0	3781	0.0	0.0
chr11	CAVIN3	6319656	6319752	0	97	0	1559	0	1462	0.0	0.0
chr11	APBB1	6404744	6404784	0	41	5158	5258	5158	5217	0.0	0.9886908184780525
chr11	APBB1	6410626	6411361	2180	736	5158	5258	2978	4522	2.9619565217391304	0.6585581601061478
chr11	APBB1	6401976	6401982	0	7	5158	5258	5158	5251	0.0	0.9822890877928013
chr11	APBB1	6403646	6403822	0	177	5158	5258	5158	5081	0.0	1.015154497146231
chr11	APBB1	6403937	6404058	0	122	5158	5258	5158	5136	0.0	1.0042834890965733
chr11	TRIM3	6465564	6465732	1358	169	10824	6639	9466	6470	8.035502958579881	1.4630602782071098
chr11	TRIM3	6473083	6473248	98	166	10824	6639	10726	6473	0.5903614457831325	1.6570369226015758
chr11	ARFIP2	6479139	6479357	3886	219	47035	5066	43149	4847	17.744292237442924	8.902207551062514
chr11	ARFIP2	6480322	6480463	126	142	47035	5066	46909	4924	0.8873239436619719	9.526604386677498
chr11	ARFIP2	6479139	6479258	0	120	47035	5066	47035	4946	0.0	9.509704811969268
chr11	ARFIP2	6480322	6480423	6	102	47035	5066	47029	4964	0.058823529411764705	9.474012892828364
chr11	ARFIP2	6478578	6478652	7010	75	47035	5066	40025	4991	93.46666666666667	8.019434982969345
chr11	TPP1	6616314	6616503	714	190	33334	5275	32620	5085	3.7578947368421054	6.414945919370698
chr11	TPP1	6618775	6618915	1195	141	33334	5275	32139	5134	8.47517730496454	6.260031164783794
chr11	TPP1	6615764	6615848	89	85	33334	5275	33245	5190	1.0470588235294118	6.405587668593449
chr11	MRPL17	6682746	6682815	0	70	0	902	0	832	0.0	0.0
chr11	AC107884.1	7440126	7441719	0	1594	0	5841	0	4247	0.0	0.0
chr11	AC107884.1	7457795	7457943	0	149	0	5841	0	5692	0.0	0.0
chr11	AC107884.1	7457795	7457959	0	165	0	5841	0	5676	0.0	0.0
chr11	AC107884.1	7451812	7451963	0	152	0	5841	0	5689	0.0	0.0
chr11	AC107884.1	7456817	7456849	0	33	0	5841	0	5808	0.0	0.0
chr11	CYB5R2	7665826	7665939	0	114	0	5718	0	5604	0.0	0.0
chr11	CYB5R2	7666450	7666550	0	101	0	5718	0	5617	0.0	0.0
chr11	RIC3	8126658	8126804	9804	147	12964	2602	3160	2455	66.6938775510204	1.2871690427698574
chr11	RIC3	8153374	8153423	0	50	12964	2602	12964	2552	0.0	5.079937304075235
chr11	STK33	8413494	8413692	204	199	306	7588	102	7389	1.0251256281407035	0.013804303694681283
chr11	STK33	8440677	8440753	0	77	306	7588	306	7511	0.0	0.040740247636799364
chr11	STK33	8464708	8464822	0	115	306	7588	306	7473	0.0	0.040947410678442396
chr11	STK33	8533347	8533496	0	150	306	7588	306	7438	0.0	0.04114009142242538
chr11	STK33	8476686	8476751	0	66	306	7588	306	7522	0.0	0.040680670034565276
chr11	TRIM66	8678133	8678169	37	37	23427	11781	23390	11744	1.0	1.9916553133514987
chr11	DENND2B	8702571	8702720	765	150	290490	10617	289725	10467	5.1	27.679850960160504
chr11	DENND2B	8713997	8714042	240	46	290490	10617	290250	10571	5.217391304347826	27.457194210576105
chr11	DENND2B	8750620	8750725	0	106	290490	10617	290490	10511	0.0	27.63676148796499
chr11	DENND2B	8729949	8731209	7599	1261	290490	10617	282891	9356	6.026169706582078	30.23631893971783
chr11	DENND2B	8811246	8811335	0	90	290490	10617	290490	10527	0.0	27.594756340837847
chr11	DENND2B	8699856	8700012	153	157	290490	10617	290337	10460	0.9745222929936306	27.756883365200764
chr11	DENND2B	8711903	8712036	51	134	290490	10617	290439	10483	0.3805970149253731	27.70571401316417
chr11	DENND2B	8831555	8831688	0	134	290490	10617	290490	10483	0.0	27.710579032719643
chr11	DENND2B	8839309	8839350	0	42	290490	10617	290490	10575	0.0	27.46950354609929
chr11	DENND2B	8870953	8871088	0	136	290490	10617	290490	10481	0.0	27.715866806602424
chr11	DENND2B	8857342	8857436	0	95	290490	10617	290490	10522	0.0	27.607869226382817
chr11	C11ORF16	8921293	8921515	0	223	2560	2139	2560	1916	0.0	1.336116910229645
chr11	C11ORF16	8927502	8927682	0	181	2560	2139	2560	1958	0.0	1.3074565883554647
chr11	TMEM9B	8962091	8962183	0	93	94	2833	94	2740	0.0	0.034306569343065696
chr11	NRIP3	8985710	8985850	15025	141	40871	2146	25846	2005	106.56028368794327	12.89077306733167
chr11	SCUBE2	9027363	9027561	0	199	2717	7780	2717	7581	0.0	0.3583959899749373
chr11	SCUBE2	9033625	9033796	0	172	2717	7780	2717	7608	0.0	0.357124079915878
chr11	SCUBE2	9052745	9052832	0	88	2717	7780	2717	7692	0.0	0.3532241289651586
chr11	SCUBE2	9053636	9053759	0	124	2717	7780	2717	7656	0.0	0.35488505747126436
chr11	DENND5A	9143402	9143485	0	84	163642	7876	163642	7792	0.0	21.001283367556468
chr11	DENND5A	9147029	9147151	0	123	163642	7876	163642	7753	0.0	21.1069263510899
chr11	DENND5A	9152357	9152442	0	86	163642	7876	163642	7790	0.0	21.006675224646983
chr11	DENND5A	9207560	9207632	0	73	163642	7876	163642	7803	0.0	20.971677559912855
chr11	DENND5A	9142721	9142845	112	125	163642	7876	163530	7751	0.896	21.097922848664687
chr11	DENND5A	9140188	9140248	0	61	163642	7876	163642	7815	0.0	20.939475367882277
chr11	DENND5A	9176771	9176902	0	132	163642	7876	163642	7744	0.0	21.131456611570247
chr11	DENND5A	9207172	9207208	0	37	163642	7876	163642	7839	0.0	20.87536675596377
chr11	TMEM41B	9286454	9286593	2127	140	8596	4285	6469	4145	15.192857142857143	1.5606755126658625
chr11	SBF2	9992414	9992543	35	130	29801	15076	29766	14946	0.2692307692307692	1.9915696507426737
chr11	SBF2	9998265	9998379	0	115	29801	15076	29801	14961	0.0	1.991912305327184
chr11	SBF2	9828595	9828632	0	38	29801	15076	29801	15038	0.0	1.9817129937491689
chr11	SBF2	9819228	9819303	0	76	29801	15076	29801	15000	0.0	1.9867333333333332
chr11	SBF2	9828125	9828221	111	97	29801	15076	29690	14979	1.1443298969072164	1.9821082849322385
chr11	RNF141	10531826	10532015	0	190	24036	7833	24036	7643	0.0	3.144838414235248
chr11	IRAG1	10594145	10594195	0	51	106	7711	106	7660	0.0	0.013838120104438642
chr11	IRAG1	10625965	10626583	0	619	106	7711	106	7092	0.0	0.014946418499717992
chr11	IRAG1	10627972	10628025	0	54	106	7711	106	7657	0.0	0.0138435418571242
chr11	IRAG1	10633967	10634071	0	105	106	7711	106	7606	0.0	0.013936366026820931
chr11	IRAG1	10652024	10652182	4	159	106	7711	102	7552	0.025157232704402517	0.01350635593220339
chr11	IRAG1	10690264	10690369	0	106	106	7711	106	7605	0.0	0.01393819855358317
chr11	IRAG1	10633967	10634074	0	108	106	7711	106	7603	0.0	0.013941865053268446
chr11	IRAG1	10658383	10658579	0	197	106	7711	106	7514	0.0	0.014107000266169817
chr11	IRAG1	10687508	10687777	0	270	106	7711	106	7441	0.0	0.014245397124042467
chr11	EIF4G2	10801660	10801774	0	115	51732	7294	51732	7179	0.0	7.206017551190974
chr11	EIF4G2	10804912	10805015	0	104	51732	7294	51732	7190	0.0	7.194993045897079
chr11	EIF4G2	10806819	10806885	0	67	51732	7294	51732	7227	0.0	7.158156911581569
chr11	EIF4G2	10807254	10807381	0	128	51732	7294	51732	7166	0.0	7.2190901479207366
chr11	EIF4G2	10808276	10808508	0	233	51732	7294	51732	7061	0.0	7.326441014020677
chr11	EIF4G2	10807254	10807319	0	66	51732	7294	51732	7228	0.0	7.157166574432761
chr11	DKK3	11998695	11998779	0	85	45069	4948	45069	4863	0.0	9.267735965453424
chr11	DKK3	12008369	12008608	0	240	45069	4948	45069	4708	0.0	9.57285471537808
chr11	LINC00958	12988401	12988466	0	66	119200	5127	119200	5061	0.0	23.552657577553845
chr11	LINC00958	12984225	12984338	0	114	119200	5127	119200	5013	0.0	23.778176740474766
chr11	LINC00958	12986039	12986144	0	106	119200	5127	119200	5021	0.0	23.740290778729335
chr11	LINC00958	12984225	12984325	0	101	119200	5127	119200	5026	0.0	23.716673298846
chr11	LINC00958	12984229	12984338	0	110	119200	5127	119200	5017	0.0	23.75921865656767
chr11	BTBD10	13445023	13445181	561	159	4389	3285	3828	3126	3.5283018867924527	1.2245681381957774
chr11	BTBD10	13462621	13462797	0	177	4389	3285	4389	3108	0.0	1.412162162162162
chr11	RRAS2	14356685	14356769	51	85	1673	3469	1622	3384	0.6	0.4793144208037825
chr11	RRAS2	14308206	14308317	1316	112	1673	3469	357	3357	11.75	0.1063449508489723
chr11	PSMA1	14507655	14507766	0	112	10106	2912	10106	2800	0.0	3.6092857142857144
chr11	PSMA1	14513569	14513699	0	131	10106	2912	10106	2781	0.0	3.633944624235886
chr11	PSMA1	14519904	14520211	0	308	10106	2912	10106	2604	0.0	3.880952380952381
chr11	CYP2R1	14880135	14880768	1326	634	3682	4037	2356	3403	2.091482649842271	0.6923302967969439
chr11	CYP2R1	14890431	14890469	0	39	3682	4037	3682	3998	0.0	0.92096048024012
chr11	CALCA	14968825	14968997	0	173	0	2106	0	1933	0.0	0.0
chr11	AC073172.1	15589080	15589250	0	171	0	900	0	729	0.0	0.0
chr11	AC087379.1	15725679	15725791	0	113	0	1813	0	1700	0.0	0.0
chr11	AC087379.1	15703750	15703809	0	60	0	1813	0	1753	0.0	0.0
chr11	AC087379.1	15710961	15711020	0	60	0	1813	0	1753	0.0	0.0
chr11	SOX6	16095995	16096118	0	124	530	19677	530	19553	0.0	0.027105814964455584
chr11	PLEKHA7	16780941	16781052	50	112	70735	10535	70685	10423	0.44642857142857145	6.781636764846973
chr11	PLEKHA7	16815174	16815294	0	121	70735	10535	70735	10414	0.0	6.792298828500096
chr11	PLEKHA7	16807143	16807224	0	82	70735	10535	70735	10453	0.0	6.766956854491534
chr11	RPS13	17076442	17076547	0	106	0	1798	0	1692	0.0	0.0
chr11	PIK3C2A	17094260	17094385	0	126	903014	9241	903014	9115	0.0	99.06900713110258
chr11	PIK3C2A	17194388	17194414	0	27	903014	9241	903014	9214	0.0	98.00455828087692
chr11	ABCC8	17393696	17393759	3240	64	76870	9821	73630	9757	50.625	7.546376960131188
chr11	ABCC8	17395171	17395275	4640	105	76870	9821	72230	9716	44.19047619047619	7.434129271305064
chr11	ABCC8	17397683	17397797	2358	115	76870	9821	74512	9706	20.504347826086956	7.676900886049866
chr11	ABCC8	17407353	17407453	0	101	76870	9821	76870	9720	0.0	7.908436213991769
chr11	ABCC8	17413393	17413478	0	86	76870	9821	76870	9735	0.0	7.896250642013354
chr11	ABCC8	17430813	17430959	0	147	76870	9821	76870	9674	0.0	7.94604093446351
chr11	ABCC8	17442719	17442882	0	164	76870	9821	76870	9657	0.0	7.960028994511753
chr11	ABCC8	17470100	17470222	0	123	76870	9821	76870	9698	0.0	7.926376572489173
chr11	ABCC8	17474885	17475027	0	143	76870	9821	76870	9678	0.0	7.942756767927258
chr11	ABCC8	17395171	17395470	10465	300	76870	9821	66405	9521	34.88333333333333	6.974582501838042
chr11	ABCC8	17430813	17431032	0	220	76870	9821	76870	9601	0.0	8.006457660660347
chr11	ABCC8	17428564	17428702	0	139	76870	9821	76870	9682	0.0	7.9394753150175585
chr11	ABCC8	17428564	17428670	0	107	76870	9821	76870	9714	0.0	7.913320980028824
chr11	ABCC8	17432203	17432244	0	42	76870	9821	76870	9779	0.0	7.860721955210145
chr11	ABCC8	17465397	17465577	0	181	76870	9821	76870	9640	0.0	7.974066390041494
chr11	ABCC8	17408199	17408302	0	104	76870	9821	76870	9717	0.0	7.910877842955645
chr11	ABCC8	17443177	17443312	0	136	76870	9821	76870	9685	0.0	7.937016004130098
chr11	ABCC8	17412873	17412977	0	105	76870	9821	76870	9716	0.0	7.9116920543433515
chr11	ABCC8	17432203	17432346	0	144	76870	9821	76870	9677	0.0	7.943577555027384
chr11	ABCC8	17399006	17399101	2925	96	76870	9821	73945	9725	30.46875	7.603598971722365
chr11	ABCC8	17443163	17443312	0	150	76870	9821	76870	9671	0.0	7.948505842208665
chr11	ABCC8	17444281	17444401	0	121	76870	9821	76870	9700	0.0	7.924742268041237
chr11	USH1C	17523210	17523267	0	58	9	4935	9	4877	0.0	0.0018453967603034652
chr11	USH1C	17517400	17517474	9	75	9	4935	0	4860	0.12	0.0
chr11	USH1C	17495568	17495677	0	110	9	4935	9	4825	0.0	0.0018652849740932642
chr11	LINC02729	17696542	17696626	0	85	0	762	0	677	0.0	0.0
chr11	SERGEF	17988596	17988755	0	160	8276	3044	8276	2884	0.0	2.869625520110957
chr11	SERGEF	17999493	17999572	0	80	8276	3044	8276	2964	0.0	2.7921727395411606
chr11	SERGEF	18004440	18004535	0	96	8276	3044	8276	2948	0.0	2.8073270013568523
chr11	SERGEF	17918694	17918779	0	86	8276	3044	8276	2958	0.0	2.7978363759296823
chr11	SERGEF	17959469	17959636	0	168	8276	3044	8276	2876	0.0	2.877607788595271
chr11	SERGEF	17846584	17846761	0	178	8276	3044	8276	2866	0.0	2.8876482903000698
chr11	SERGEF	17926737	17926846	0	110	8276	3044	8276	2934	0.0	2.8207225630538515
chr11	SERGEF	17992930	17992993	0	64	8276	3044	8276	2980	0.0	2.7771812080536913
chr11	SERGEF	18010070	18010139	30	70	8276	3044	8246	2974	0.42857142857142855	2.772696704774714
chr11	SERGEF	18010074	18010139	26	66	8276	3044	8250	2978	0.3939393939393939	2.7703156480859636
chr11	SERGEF	18001945	18002058	0	114	8276	3044	8276	2930	0.0	2.8245733788395904
chr11	TPH1	18029164	18029361	0	198	4429	5637	4429	5439	0.0	0.8143041000183857
chr11	SAAL1	18083534	18083731	0	198	3173	2752	3173	2554	0.0	1.2423649177760376
chr11	SAAL1	18083534	18083728	0	195	3173	2752	3173	2557	0.0	1.240907313257724
chr11	SAAL1	18083534	18083709	0	176	3173	2752	3173	2576	0.0	1.2317546583850931
chr11	SAAL1	18086865	18087054	459	190	3173	2752	2714	2562	2.4157894736842107	1.059328649492584
chr11	SAA2	18248455	18248516	0	62	0	2249	0	2187	0.0	0.0
chr11	HPS5	18285345	18285459	0	115	18293	6458	18293	6343	0.0	2.8839665773293395
chr11	HPS5	18291441	18292019	31	579	18293	6458	18262	5879	0.0535405872193437	3.106310597040313
chr11	HPS5	18292898	18292976	0	79	18293	6458	18293	6379	0.0	2.8676908606364635
chr11	HPS5	18317750	18317907	969	158	18293	6458	17324	6300	6.132911392405063	2.7498412698412698
chr11	HPS5	18280508	18280642	0	135	18293	6458	18293	6323	0.0	2.893088723707101
chr11	TSG101	18514677	18514841	42	165	405	3400	363	3235	0.2545454545454545	0.11221020092735703
chr11	TSG101	18519518	18519603	0	86	405	3400	405	3314	0.0	0.12220881110440555
chr11	TSG101	18480484	18480635	0	152	405	3400	405	3248	0.0	0.12469211822660098
chr11	TSG101	18516098	18516164	0	67	405	3400	405	3333	0.0	0.12151215121512152
chr11	UEVLD	18534329	18534453	51	125	68454	5531	68403	5406	0.408	12.653163152053274
chr11	UEVLD	18546879	18547050	0	172	68454	5531	68454	5359	0.0	12.773651800709088
chr11	UEVLD	18570213	18570377	42	165	68454	5531	68412	5366	0.2545454545454545	12.749161386507641
chr11	UEVLD	18575346	18575412	0	67	68454	5531	68454	5464	0.0	12.52818448023426
chr11	UEVLD	18578723	18578808	0	86	68454	5531	68454	5445	0.0	12.571900826446281
chr11	UEVLD	18536405	18536469	0	65	68454	5531	68454	5466	0.0	12.523600439077937
chr11	UEVLD	18566346	18566482	0	137	68454	5531	68454	5394	0.0	12.690767519466073
chr11	IGSF22	18708206	18708295	0	90	330	4857	330	4767	0.0	0.06922592825676527
chr11	IGSF22	18712081	18712384	0	304	330	4857	330	4553	0.0	0.07247968372501647
chr11	PTPN5	18771938	18772071	0	134	1428	5512	1428	5378	0.0	0.2655262179248791
chr11	PTPN5	18771938	18772026	0	89	1428	5512	1428	5423	0.0	0.26332288401253917
chr11	CSRP3	19186215	19186348	1220	134	5004	1641	3784	1507	9.104477611940299	2.510948905109489
chr11	CSRP3	19188135	19188304	1248	170	5004	1641	3756	1471	7.341176470588235	2.5533650577838207
chr11	CSRP3	19201478	19201647	0	170	5004	1641	5004	1471	0.0	3.4017675050985723
chr11	LINC01495	22447113	22447476	0	364	0	858	0	494	0.0	0.0
chr11	LINC01495	22467846	22467945	0	100	0	858	0	758	0.0	0.0
chr11	MUC15	26563115	26563265	0	151	51	3593	51	3442	0.0	0.014816966879721092
chr11	MUC15	26567051	26567139	0	89	51	3593	51	3504	0.0	0.014554794520547944
chr11	SLC5A12	26716272	26716354	0	83	0	7588	0	7505	0.0	0.0
chr11	LGR4	27412788	27412860	0	73	63148	6373	63148	6300	0.0	10.023492063492064
chr11	LIN7C	27501494	27501566	0	73	2295	4847	2295	4774	0.0	0.48072894847088393
chr11	BDNF	27658819	27658926	0	108	87154	7518	87154	7410	0.0	11.761673414304994
chr11	BDNF	27674059	27674342	0	284	87154	7518	87154	7234	0.0	12.047829693115842
chr11	BDNF	27660155	27660272	0	118	87154	7518	87154	7400	0.0	11.777567567567568
chr11	LINC02755	29520123	29520216	0	94	102	1133	102	1039	0.0	0.09817131857555342
chr11	MPPED2	30504735	30504833	0	99	0	8211	0	8112	0.0	0.0
chr11	DCDC1	30882042	30883518	0	1477	51	12605	51	11128	0.0	0.004583033788641265
chr11	DCDC1	31290646	31290852	0	207	51	12605	51	12398	0.0	0.004113566704307146
chr11	DCDC1	31215169	31215263	0	95	51	12605	51	12510	0.0	0.00407673860911271
chr11	IMMP1L	31437075	31437154	0	80	19280	3848	19280	3768	0.0	5.116772823779193
chr11	IMMP1L	31463171	31463305	0	135	19280	3848	19280	3713	0.0	5.1925666576892
chr11	IMMP1L	31477500	31477759	1275	260	19280	3848	18005	3588	4.903846153846154	5.018115942028985
chr11	IMMP1L	31460625	31460714	59	90	19280	3848	19221	3758	0.6555555555555556	5.114688664183076
chr11	IMMP1L	31473723	31473786	0	64	19280	3848	19280	3784	0.0	5.0951374207188165
chr11	IMMP1L	31447982	31449091	4329	1110	19280	3848	14951	2738	3.9	5.460555149744339
chr11	IMMP1L	31469739	31469797	0	59	19280	3848	19280	3789	0.0	5.088413829506466
chr11	IMMP1L	31469757	31469797	0	41	19280	3848	19280	3807	0.0	5.064355135277121
chr11	AC131571.1	31635542	31635640	0	99	51	6618	51	6519	0.0	0.007823285780027611
chr11	AC131571.1	31727786	31727895	0	110	51	6618	51	6508	0.0	0.007836508912108174
chr11	AC131571.1	31655933	31656969	0	1037	51	6618	51	5581	0.0	0.009138147285432718
chr11	PAX6	31790709	31790860	0	152	77755	17695	77755	17543	0.0	4.432252180356837
chr11	PAX6	31801870	31801912	0	43	77755	17695	77755	17652	0.0	4.404883299342851
chr11	PAX6	31802703	31802834	228	132	77755	17695	77527	17563	1.7272727272727273	4.414223082616865
chr11	PAX6	31810827	31811015	11829	189	77755	17695	65926	17506	62.58730158730159	3.7659088312578546
chr11	PAX6	31803583	31803726	0	144	77755	17695	77755	17551	0.0	4.430231895618483
chr11	PAX6	31801229	31801326	0	98	77755	17695	77755	17597	0.0	4.418650906404501
chr11	PAX6	31803397	31803471	306	75	77755	17695	77449	17620	4.08	4.395516458569807
chr11	PAX6	31812148	31812277	1058	130	77755	17695	76697	17565	8.138461538461538	4.366467406774836
chr11	WT1	32392665	32392755	0	91	67	6874	67	6783	0.0	0.009877635264632168
chr11	WT1	32396256	32396407	0	152	67	6874	67	6722	0.0	0.009967271645343648
chr11	WT1	32416489	32416540	0	52	67	6874	67	6822	0.0	0.009821166813251247
chr11	CSTF3	33156707	33156803	0	97	25375	4539	25375	4442	0.0	5.712516884286358
chr11	CSTF3	33144869	33144973	0	105	25375	4539	25375	4434	0.0	5.722823635543527
chr11	AL049629.2	33702667	33702737	0	71	0	958	0	887	0.0	0.0
chr11	CD59	33731423	33731468	178003	46	189225	10567	11222	10521	3869.6304347826085	1.0666286474669708
chr11	CD59	33733494	33733610	0	117	189225	10567	189225	10450	0.0	18.107655502392344
chr11	CD59	33722916	33723029	0	114	189225	10567	189225	10453	0.0	18.102458624318377
chr11	CD59	33716825	33716868	0	44	189225	10567	189225	10523	0.0	17.982039342392852
chr11	CD59	33711383	33711505	0	123	189225	10567	189225	10444	0.0	18.118058215243202
chr11	CD59	33713378	33713469	0	92	189225	10567	189225	10475	0.0	18.064439140811455
chr11	CD59	33733494	33733614	0	121	189225	10567	189225	10446	0.0	18.11458931648478
chr11	FBXO3	33755770	33755975	252	206	16851	5200	16599	4994	1.2233009708737863	3.3237885462555066
chr11	FBXO3	33763205	33763286	4527	82	16851	5200	12324	5118	55.207317073170735	2.4079718640093786
chr11	ELF5	34493478	34493712	8580	235	147897	4922	139317	4687	36.51063829787234	29.724130573927887
chr11	ELF5	34490008	34490059	82	52	147897	4922	147815	4870	1.5769230769230769	30.352156057494867
chr11	APIP	34895009	34895110	0	102	172	5227	172	5125	0.0	0.0335609756097561
chr11	SLC1A2	35280866	35281001	0	136	12847629	13109	12847629	12973	0.0	990.3360055499884
chr11	SLC1A2	35292286	35292520	0	235	12847629	13109	12847629	12874	0.0	997.9516078918751
chr11	SLC1A2	35301518	35301645	0	128	12847629	13109	12847629	12981	0.0	989.7256759879824
chr11	SLC1A2	35260843	35260965	0	123	12847629	13109	12847629	12986	0.0	989.3446018789466
chr11	SLC1A2	35261669	35261740	0	72	12847629	13109	12847629	13037	0.0	985.4743422566542
chr11	SLC1A2	35261669	35261862	0	194	12847629	13109	12847629	12915	0.0	994.7835075493612
chr11	SLC1A2	35380380	35380541	0	162	12847629	13109	12847629	12947	0.0	992.3247856646327
chr11	SLC1A2	35322560	35322679	0	120	12847629	13109	12847629	12989	0.0	989.1160982369697
chr11	SLC1A2	35322764	35323309	0	546	12847629	13109	12847629	12563	0.0	1022.6561330892303
chr11	SLC1A2	35370940	35371096	0	157	12847629	13109	12847629	12952	0.0	991.9417078443483
chr11	SLC1A2	35418949	35419007	39	59	12847629	13109	12847590	13050	0.6610169491525424	984.4896551724138
chr11	SLC1A2	35391539	35391608	0	70	12847629	13109	12847629	13039	0.0	985.323184293274
chr11	PAMR1	35451887	35451938	0	52	51	3879	51	3827	0.0	0.013326365299189966
chr11	PAMR1	35513370	35513477	0	108	51	3879	51	3771	0.0	0.013524264120922832
chr11	COMMD9	36277088	36277123	0	36	0	4778	0	4742	0.0	0.0
chr11	COMMD9	36280711	36280837	0	127	0	4778	0	4651	0.0	0.0
chr11	TRAF6	36501718	36501811	142	94	112551	8138	112409	8044	1.5106382978723405	13.974266534062656
chr11	RAG2	36594806	36595195	0	390	78	3438	78	3048	0.0	0.025590551181102362
chr11	RAG2	36594806	36595001	0	196	78	3438	78	3242	0.0	0.024059222702035782
chr11	LINC02759	38634970	38635095	0	126	0	1928	0	1802	0.0	0.0
chr11	LRRC4C	40241518	40241598	0	81	0	5365	0	5284	0.0	0.0
chr11	LRRC4C	40933634	40933723	0	90	0	5365	0	5275	0.0	0.0
chr11	LRRC4C	40140800	40140853	0	54	0	5365	0	5311	0.0	0.0
chr11	LINC02741	41620347	41620399	0	53	0	2732	0	2679	0.0	0.0
chr11	LINC02741	41591105	41591196	0	92	0	2732	0	2640	0.0	0.0
chr11	LINC02745	42025986	42026062	0	77	0	1565	0	1488	0.0	0.0
chr11	LINC02740	42250270	42250416	0	147	51	2061	51	1914	0.0	0.02664576802507837
chr11	LINC02740	42253058	42253129	0	72	51	2061	51	1989	0.0	0.02564102564102564
chr11	ALKBH3-AS1	43919585	43919662	0	78	6514	2165	6514	2087	0.0	3.1212266411116434
chr11	ALKBH3-AS1	43916668	43916921	1326	254	6514	2165	5188	1911	5.2204724409448815	2.714809000523286
chr11	TP53I11	44937554	44937613	0	60	0	7153	0	7093	0.0	0.0
chr11	TP53I11	44936802	44936899	0	98	0	7153	0	7055	0.0	0.0
chr11	TP53I11	44941002	44941077	0	76	0	7153	0	7077	0.0	0.0
chr11	TP53I11	44939165	44939281	0	117	0	7153	0	7036	0.0	0.0
chr11	TP53I11	44939113	44939190	0	78	0	7153	0	7075	0.0	0.0
chr11	TP53I11	44936879	44936899	0	21	0	7153	0	7132	0.0	0.0
chr11	TP53I11	44936558	44936689	0	132	0	7153	0	7021	0.0	0.0
chr11	AC018716.2	45410991	45411145	0	155	0	3377	0	3222	0.0	0.0
chr11	AC103855.2	45533422	45533532	0	111	51	4073	51	3962	0.0	0.01287228672387683
chr11	AC103855.2	45532648	45532880	0	233	51	4073	51	3840	0.0	0.01328125
chr11	AC103855.2	45541142	45541269	0	128	51	4073	51	3945	0.0	0.012927756653992395
chr11	PEX16	45915467	45915568	0	102	286	2915	286	2813	0.0	0.10167081407749734
chr11	PEX16	45916973	45917141	0	169	286	2915	286	2746	0.0	0.10415149308084487
chr11	PHF21A	45938156	45938312	4421	157	77762	9390	73341	9233	28.159235668789808	7.943355355789017
chr11	PHF21A	45945839	45946003	0	165	77762	9390	77762	9225	0.0	8.429485094850948
chr11	PHF21A	46090454	46090566	0	113	77762	9390	77762	9277	0.0	8.382235636520427
chr11	PHF21A	45946075	45946098	48	24	77762	9390	77714	9366	2.0	8.29745889387145
chr11	PHF21A	46092182	46092223	0	42	77762	9390	77762	9348	0.0	8.318570817287121
chr11	PHF21A	45935120	45935246	731	127	77762	9390	77031	9263	5.755905511811024	8.315988340710353
chr11	PHF21A	45935120	45935157	241	38	77762	9390	77521	9352	6.342105263157895	8.289242942686057
chr11	PHF21A	46049399	46049497	0	99	77762	9390	77762	9291	0.0	8.369604994080293
chr11	PHF21A	46090454	46090581	0	128	77762	9390	77762	9262	0.0	8.395810839991363
chr11	PHF21A	46083554	46083611	0	58	77762	9390	77762	9332	0.0	8.332833261894557
chr11	PHF21A	46117921	46118114	0	194	77762	9390	77762	9196	0.0	8.456067855589387
chr11	PHF21A	46118741	46118800	0	60	77762	9390	77762	9330	0.0	8.334619506966774
chr11	PHF21A	46117921	46118145	0	225	77762	9390	77762	9165	0.0	8.48466993998909
chr11	LINC02710	46216252	46216372	0	121	51	1999	51	1878	0.0	0.027156549520766772
chr11	LINC02710	46216252	46216368	0	117	51	1999	51	1882	0.0	0.02709883103081828
chr11	AMBRA1	46410275	46410368	0	94	114069	7626	114069	7532	0.0	15.144583112055232
chr11	AMBRA1	46508190	46508370	0	181	114069	7626	114069	7445	0.0	15.32155809267965
chr11	AMBRA1	46512726	46512813	0	88	114069	7626	114069	7538	0.0	15.132528522154418
chr11	AMBRA1	46547112	46547296	17	185	114069	7626	114052	7441	0.0918918918918919	15.32750974331407
chr11	AMBRA1	46549019	46549051	0	33	114069	7626	114069	7593	0.0	15.022915843540103
chr11	ARHGAP1	46682050	46682182	0	133	321534	6156	321534	6023	0.0	53.38435995351154
chr11	CKAP5	46754887	46755067	0	181	77702	8584	77702	8403	0.0	9.246935618231584
chr11	CKAP5	46754887	46754983	0	97	77702	8584	77702	8487	0.0	9.15541416283728
chr11	CKAP5	46760351	46760375	0	25	77702	8584	77702	8559	0.0	9.078397008996378
chr11	LRP4	46902782	46902929	0	148	29410	8786	29410	8638	0.0	3.4047233155823107
chr11	ARFGAP2	47175850	47175923	94	74	49923	5269	49829	5195	1.2702702702702702	9.59172281039461
chr11	ARFGAP2	47176515	47176634	1387	120	49923	5269	48536	5149	11.558333333333334	9.42629636822684
chr11	ARFGAP2	47173758	47173840	0	83	49923	5269	49923	5186	0.0	9.626494408021596
chr11	ARFGAP2	47175014	47175098	494	85	49923	5269	49429	5184	5.811764705882353	9.53491512345679
chr11	ARFGAP2	47172280	47172333	43	54	49923	5269	49880	5215	0.7962962962962963	9.564717162032599
chr11	ARFGAP2	47175181	47175313	3280	133	49923	5269	46643	5136	24.661654135338345	9.081580996884735
chr11	ARFGAP2	47173758	47173882	0	125	49923	5269	49923	5144	0.0	9.705093312597201
chr11	ARFGAP2	47172709	47172751	0	43	49923	5269	49923	5226	0.0	9.552812858783009
chr11	ARFGAP2	47173758	47173915	126	158	49923	5269	49797	5111	0.7974683544303798	9.743103110937195
chr11	ARFGAP2	47175871	47175923	94	53	49923	5269	49829	5216	1.7735849056603774	9.55310582822086
chr11	PACSIN3	47178365	47178487	820	123	140232	2765	139412	2642	6.666666666666667	52.76760030280091
chr11	PACSIN3	47182673	47182764	13967	92	140232	2765	126265	2673	151.81521739130434	47.23718668163112
chr11	PACSIN3	47182673	47182809	14721	137	140232	2765	125511	2628	107.45255474452554	47.759132420091326
chr11	PACSIN3	47184319	47184497	51	179	140232	2765	140181	2586	0.2849162011173184	54.207656612529
chr11	ACP2	47245473	47245572	222	100	40319	3486	40097	3386	2.22	11.841996455995275
chr11	ACP2	47248037	47248133	259	97	40319	3486	40060	3389	2.670103092783505	11.820596046031278
chr11	ACP2	47245304	47245422	0	119	40319	3486	40319	3367	0.0	11.974754974754974
chr11	ACP2	47245304	47245427	0	124	40319	3486	40319	3362	0.0	11.992563950029744
chr11	ACP2	47245304	47245394	0	91	40319	3486	40319	3395	0.0	11.8759941089838
chr11	AC090559.1	47395489	47395577	0	89	459	2935	459	2846	0.0	0.1612789880534083
chr11	AC090559.1	47405509	47405547	0	39	459	2935	459	2896	0.0	0.15849447513812154
chr11	PSMC3	47424428	47424491	0	64	46	1859	46	1795	0.0	0.02562674094707521
chr11	PSMC3	47425120	47425246	0	127	46	1859	46	1732	0.0	0.026558891454965358
chr11	RAPSN	47442655	47442814	51	160	236165	1884	236114	1724	0.31875	136.9570765661253
chr11	CELF1	47483452	47483532	0	81	48316	9012	48316	8931	0.0	5.409920501623558
chr11	CELF1	47471997	47472102	0	106	48316	9012	48316	8906	0.0	5.425106669660903
chr11	CELF1	47499452	47499604	7579	153	48316	9012	40737	8859	49.5359477124183	4.598374534371826
chr11	CELF1	47506857	47506897	0	41	48316	9012	48316	8971	0.0	5.385798684650541
chr11	CELF1	47564350	47564469	825	120	48316	9012	47491	8892	6.875	5.340868196131354
chr11	CELF1	47494330	47494443	0	114	48316	9012	48316	8898	0.0	5.42998426612722
chr11	MTCH2	47635544	47635571	0	28	14660	2894	14660	2866	0.0	5.115143056524773
chr11	AGBL2	47677270	47677401	0	132	157052	5082	157052	4950	0.0	31.72767676767677
chr11	AGBL2	47685892	47686049	96	158	157052	5082	156956	4924	0.6075949367088608	31.87571080422421
chr11	AGBL2	47705520	47705634	0	115	157052	5082	157052	4967	0.0	31.619085967384738
chr11	AGBL2	47705863	47705917	0	55	157052	5082	157052	5027	0.0	31.241694847821762
chr11	AGBL2	47710697	47710902	0	206	157052	5082	157052	4876	0.0	32.20918785890074
chr11	FNBP4	47722975	47723316	969	342	140952	6583	139983	6241	2.8333333333333335	22.42957859317417
chr11	FNBP4	47754527	47754664	0	138	140952	6583	140952	6445	0.0	21.869976726144298
chr11	FNBP4	47765269	47765362	0	94	140952	6583	140952	6489	0.0	21.72168284789644
chr11	NUP160	47840377	47840588	1226	212	27381	8120	26155	7908	5.783018867924528	3.3074102175012645
chr11	NUP160	47827074	47827194	1209	121	27381	8120	26172	7999	9.991735537190083	3.271908988623578
chr11	FOLH1	49148638	49148731	0	94	0	5358	0	5264	0.0	0.0
chr11	FOLH1	49185668	49185855	0	188	0	5358	0	5170	0.0	0.0
chr11	FOLH1	49200254	49200441	0	188	0	5358	0	5170	0.0	0.0
chr11	FOLH1	49206777	49206874	0	98	0	5358	0	5260	0.0	0.0
chr11	FOLH1	49206279	49206332	0	54	0	5358	0	5304	0.0	0.0
chr11	FOLH1	49207763	49207901	0	139	0	5358	0	5219	0.0	0.0
chr11	AP002512.3	56466106	56466248	0	143	0	4676	0	4533	0.0	0.0
chr11	SSRP1	57335067	57335240	16264	174	26204	5904	9940	5730	93.47126436781609	1.7347294938917976
chr11	SSRP1	57330732	57330741	0	10	26204	5904	26204	5894	0.0	4.445877163216831
chr11	SLC43A3	57409934	57410121	153	188	33133	4537	32980	4349	0.8138297872340425	7.583352494826397
chr11	SLC43A3	57425540	57425670	0	131	33133	4537	33133	4406	0.0	7.519972764412166
chr11	SLC43A3	57426587	57426652	0	66	33133	4537	33133	4471	0.0	7.4106463878327
chr11	SLC43A3	57425540	57425709	0	170	33133	4537	33133	4367	0.0	7.587130753377605
chr11	SLC43A1	57497752	57497845	78	94	5919	3545	5841	3451	0.8297872340425532	1.6925528832222545
chr11	SLC43A1	57496030	57496164	0	135	5919	3545	5919	3410	0.0	1.7357771260997068
chr11	SLC43A1	57515099	57515201	0	103	5919	3545	5919	3442	0.0	1.7196397443346891
chr11	YPEL4	57646750	57646794	0	45	51	2700	51	2655	0.0	0.0192090395480226
chr11	YPEL4	57647472	57647686	0	215	51	2700	51	2485	0.0	0.020523138832997986
chr11	AP003557.1	58503689	58503816	0	128	0	1007	0	879	0.0	0.0
chr11	LPXN	58553854	58554145	0	292	0	2445	0	2153	0.0	0.0
chr11	LPXN	58564154	58564201	0	48	0	2445	0	2397	0.0	0.0
chr11	GLYATL2	58840693	58840831	0	139	0	1766	0	1627	0.0	0.0
chr11	AP001636.3	59055294	59055446	0	153	0	6599	0	6446	0.0	0.0
chr11	LINC02739	59563813	59563906	1080	94	16334	1663	15254	1569	11.48936170212766	9.722115997450606
chr11	OSBP	59593603	59593724	0	122	229652	5011	229652	4889	0.0	46.97320515442831
chr11	TCN1	59863906	59864086	0	181	0	1509	0	1328	0.0	0.0
chr11	MS4A6A	60179830	60179965	0	136	51	3986	51	3850	0.0	0.013246753246753246
chr11	MS4A6A	60178259	60178316	0	58	51	3986	51	3928	0.0	0.012983706720977596
chr11	MS4A6A	60178793	60178828	0	36	51	3986	51	3950	0.0	0.012911392405063291
chr11	MS4A4E	60212973	60213132	0	160	102	2892	102	2732	0.0	0.03733528550512445
chr11	MS4A4E	60228593	60228627	0	35	102	2892	102	2857	0.0	0.035701785089254465
chr11	MS4A4E	60224964	60225093	0	130	102	2892	102	2762	0.0	0.036929761042722664
chr11	MS4A4E	60213214	60213332	0	119	102	2892	102	2773	0.0	0.03678326721961774
chr11	PRPF19	60898100	60898271	20332	172	127049	2747	106717	2575	118.20930232558139	41.44349514563107
chr11	PRPF19	60905364	60905452	1906	89	127049	2747	125143	2658	21.415730337078653	47.081640331075995
chr11	SLC15A3	60937515	60937566	0	52	459	4224	459	4172	0.0	0.11001917545541706
chr11	SLC15A3	60941121	60941290	0	170	459	4224	459	4054	0.0	0.11322150962012827
chr11	SLC15A3	60942034	60942145	0	112	459	4224	459	4112	0.0	0.11162451361867705
chr11	DDB1	61316284	61316393	153	110	167	11635	14	11525	1.3909090909090909	0.0012147505422993492
chr11	CYB561A3	61353783	61353992	0	210	204	8318	204	8108	0.0	0.025160335471139616
chr11	CYB561A3	61357202	61357371	0	170	204	8318	204	8148	0.0	0.025036818851251842
chr11	CYB561A3	61357732	61357828	0	97	204	8318	204	8221	0.0	0.024814499452621337
chr11	CYB561A3	61353783	61353823	0	41	204	8318	204	8277	0.0	0.02464661109097499
chr11	CYB561A3	61352984	61353139	0	156	204	8318	204	8162	0.0	0.024993874050477823
chr11	CYB561A3	61359425	61359571	0	147	204	8318	204	8171	0.0	0.024966344388691716
chr11	CPSF7	61420469	61420573	0	105	2096	4905	2096	4800	0.0	0.43666666666666665
chr11	CPSF7	61421053	61421127	0	75	2096	4905	2096	4830	0.0	0.4339544513457557
chr11	CPSF7	61420546	61420573	0	28	2096	4905	2096	4877	0.0	0.4297724010662292
chr11	CPSF7	61421191	61421257	0	67	2096	4905	2096	4838	0.0	0.43323687474162875
chr11	CPSF7	61420469	61420530	0	62	2096	4905	2096	4843	0.0	0.43278959322733845
chr11	CPSF7	61421053	61421130	0	78	2096	4905	2096	4827	0.0	0.43422415579034596
chr11	SYT7	61546030	61546255	714	226	33865	7567	33151	7341	3.15929203539823	4.515869772510557
chr11	SYT7	61547176	61547308	0	133	33865	7567	33865	7434	0.0	4.555421038471886
chr11	SYT7	61546534	61546659	0	126	33865	7567	33865	7441	0.0	4.551135600053756
chr11	TMEM258	61789784	61789990	0	207	0	1996	0	1789	0.0	0.0
chr11	FADS1	61813242	61813353	0	112	481	9399	481	9287	0.0	0.05179282868525897
chr11	FADS1	61811818	61811978	127	161	481	9399	354	9238	0.7888198757763976	0.038319982680233816
chr11	FADS1	61828449	61828708	0	260	481	9399	481	9139	0.0	0.05263157894736842
chr11	RAB3IL1	61906465	61906684	3122	220	337626	3204	334504	2984	14.190909090909091	112.09919571045576
chr11	RAB3IL1	61905392	61905536	2365	145	337626	3204	335261	3059	16.310344827586206	109.59823471722785
chr11	RAB3IL1	61898841	61898931	2697	91	337626	3204	334929	3113	29.63736263736264	107.59042724060392
chr11	FTH1	61965368	61965515	0	148	0	1914	0	1766	0.0	0.0
chr11	AHNAK	62491731	62491831	26146	101	871923	18368	845777	18267	258.8712871287129	46.30081567854601
chr11	AHNAK	62536238	62536287	22	50	871923	18368	871901	18318	0.44	47.598045638170106
chr11	TUT1	62582470	62582592	0	123	36425	3550	36425	3427	0.0	10.628829880361833
chr11	B3GAT3	62621054	62621293	68874	240	408293	2413	339419	2173	286.975	156.19834330418774
chr11	B3GAT3	62621054	62621123	19979	70	408293	2413	388314	2343	285.4142857142857	165.7336747759283
chr11	GANAB	62634309	62634375	287	67	11212	5054	10925	4987	4.2835820895522385	2.1906958091036697
chr11	GANAB	62639358	62639467	0	110	11212	5054	11212	4944	0.0	2.267799352750809
chr11	GANAB	62639929	62640069	0	141	11212	5054	11212	4913	0.0	2.282108691227356
chr11	GANAB	62639929	62640066	0	138	11212	5054	11212	4916	0.0	2.2807160292921074
chr11	LBHD1	62669640	62669803	224	164	224	2716	0	2552	1.3658536585365855	0.0
chr11	LBHD1	62671239	62671388	0	150	224	2716	224	2566	0.0	0.08729540140296181
chr11	UBXN1	62676812	62677005	486	194	537	1724	51	1530	2.5051546391752577	0.03333333333333333
chr11	BSCL2	62691279	62691421	0	143	353	3676	353	3533	0.0	0.09991508632889895
chr11	BSCL2	62692662	62692797	0	136	353	3676	353	3540	0.0	0.09971751412429379
chr11	BSCL2	62705300	62705617	0	318	353	3676	353	3358	0.0	0.10512209648600357
chr11	BSCL2	62702467	62702549	0	83	353	3676	353	3593	0.0	0.09824659059281937
chr11	BSCL2	62705300	62705558	0	259	353	3676	353	3417	0.0	0.10330699443956687
chr11	BSCL2	62709146	62709254	0	109	353	3676	353	3567	0.0	0.09896271376506868
chr11	BSCL2	62706612	62706711	0	100	353	3676	353	3576	0.0	0.09871364653243848
chr11	NXF1	62796459	62796567	0	109	1354	5978	1354	5869	0.0	0.2307036973930823
chr11	NXF1	62801093	62801201	0	109	1354	5978	1354	5869	0.0	0.2307036973930823
chr11	NXF1	62798538	62798575	0	38	1354	5978	1354	5940	0.0	0.22794612794612795
chr11	NXF1	62804081	62804210	5	130	1354	5978	1349	5848	0.038461538461538464	0.23067715458276333
chr11	STX5	62827560	62827631	0	72	147	2433	147	2361	0.0	0.062261753494282084
chr11	STX5	62830357	62830520	0	164	147	2433	147	2269	0.0	0.06478624944909651
chr11	WDR74	62833617	62833674	0	58	102	4116	102	4058	0.0	0.025135534746180386
chr11	SNHG1	62852810	62852839	0	30	0	3736	0	3706	0.0	0.0
chr11	SNHG1	62854017	62854064	0	48	0	3736	0	3688	0.0	0.0
chr11	SNHG1	62854887	62854938	0	52	0	3736	0	3684	0.0	0.0
chr11	SNHG1	62855132	62855216	0	85	0	3736	0	3651	0.0	0.0
chr11	SNHG1	62855423	62855466	0	44	0	3736	0	3692	0.0	0.0
chr11	SNHG1	62855132	62855208	0	77	0	3736	0	3659	0.0	0.0
chr11	SNHG1	62854518	62854551	0	34	0	3736	0	3702	0.0	0.0
chr11	SNHG1	62855423	62855745	0	323	0	3736	0	3413	0.0	0.0
chr11	SNHG1	62852810	62852993	0	184	0	3736	0	3552	0.0	0.0
chr11	SNHG1	62854518	62854938	0	421	0	3736	0	3315	0.0	0.0
chr11	CHRM1	62920672	62920764	0	93	0	3254	0	3161	0.0	0.0
chr11	SLC22A8	63014625	63014983	0	359	0	3652	0	3293	0.0	0.0
chr11	SLC22A8	63014625	63014710	0	86	0	3652	0	3566	0.0	0.0
chr11	SLC22A8	63014625	63014962	0	338	0	3652	0	3314	0.0	0.0
chr11	SLC22A25	63167908	63168060	0	153	0	3763	0	3610	0.0	0.0
chr11	ATL3	63671289	63671411	215	123	13244	7614	13029	7491	1.7479674796747968	1.739287144573488
chr11	MACROD1	63998837	63998872	368	36	146048	2110	145680	2074	10.222222222222221	70.2410800385728
chr11	MACROD1	64015251	64015281	75	31	146048	2110	145973	2079	2.4193548387096775	70.21308321308321
chr11	TRPT1	64224099	64224210	0	112	0	1812	0	1700	0.0	0.0
chr11	TRPT1	64225498	64225580	0	83	0	1812	0	1729	0.0	0.0
chr11	TRPT1	64225785	64225869	0	85	0	1812	0	1727	0.0	0.0
chr11	TRPT1	64224099	64224162	0	64	0	1812	0	1748	0.0	0.0
chr11	BAD	64271612	64271803	0	192	150	1713	150	1521	0.0	0.09861932938856016
chr11	BAD	64276903	64277043	150	141	150	1713	0	1572	1.0638297872340425	0.0
chr11	NRXN2	64626462	64626552	352	91	137031	9747	136679	9656	3.868131868131868	14.154826014913008
chr11	NRXN2	64677013	64677037	0	25	137031	9747	137031	9722	0.0	14.09493931289858
chr11	NRXN2	64692846	64692876	0	31	137031	9747	137031	9716	0.0	14.103643474680938
chr11	NRXN2	64653695	64653722	0	28	137031	9747	137031	9719	0.0	14.099290050416709
chr11	NRXN2	64676992	64677037	0	46	137031	9747	137031	9701	0.0	14.125450984434595
chr11	NRXN2	64690404	64690476	0	73	137031	9747	137031	9674	0.0	14.164874922472608
chr11	RASGRP2	64740367	64740449	0	83	544	5724	544	5641	0.0	0.09643680198546357
chr11	RASGRP2	64743816	64743868	0	53	544	5724	544	5671	0.0	0.09592664433080586
chr11	RASGRP2	64740367	64740446	0	80	544	5724	544	5644	0.0	0.0963855421686747
chr11	RASGRP2	64744332	64744482	0	151	544	5724	544	5573	0.0	0.0976134936300018
chr11	SF1	64773429	64773505	0	77	0	5987	0	5910	0.0	0.0
chr11	SF1	64765950	64766155	0	206	0	5987	0	5781	0.0	0.0
chr11	SF1	64777986	64778146	0	161	0	5987	0	5826	0.0	0.0
chr11	MAP4K2	64800899	64801031	0	133	806318	7589	806318	7456	0.0	108.14350858369099
chr11	MAP4K2	64801578	64801621	0	44	806318	7589	806318	7545	0.0	106.86785950960902
chr11	MEN1	64805033	64805198	489	166	272834	4392	272345	4226	2.9457831325301207	64.44510175106484
chr11	MEN1	64805887	64806013	5040	127	272834	4392	267794	4265	39.68503937007874	62.788745603751465
chr11	EHD1	64878834	64879156	206143	323	1212940	6786	1006797	6463	638.2136222910217	155.77858579606993
chr11	MAJIN	64946089	64946153	1859	65	63057	2337	61198	2272	28.6	26.93573943661972
chr11	NAALADL1	65046188	65046362	31506	175	80493	3759	48987	3584	180.03428571428572	13.668247767857142
chr11	NAALADL1	65047474	65047565	230	92	80493	3759	80263	3667	2.5	21.88791928006545
chr11	NAALADL1	65047980	65048048	237	69	80493	3759	80256	3690	3.4347826086956523	21.74959349593496
chr11	NAALADL1	65054249	65054354	1923	106	80493	3759	78570	3653	18.141509433962263	21.508349301943607
chr11	NAALADL1	65057370	65057493	6	124	80493	3759	80487	3635	0.04838709677419355	22.14222833562586
chr11	NAALADL1	65046444	65046526	366	83	80493	3759	80127	3676	4.409638554216867	21.79733405875952
chr11	TMEM262	65088682	65088750	397	69	13933	697	13536	628	5.753623188405797	21.554140127388536
chr11	TMEM262	65088650	65088750	495	101	13933	697	13438	596	4.900990099009901	22.546979865771814
chr11	FAU	65120980	65121036	0	57	629	821	629	764	0.0	0.8232984293193717
chr11	SYVN1	65132247	65132351	51	105	255	5209	204	5104	0.4857142857142857	0.039968652037617555
chr11	SYVN1	65132731	65132780	0	50	255	5209	255	5159	0.0	0.04942818375654197
chr11	SYVN1	65132247	65132308	51	62	255	5209	204	5147	0.8225806451612904	0.0396347386827278
chr11	SLC25A45	65379375	65379561	544	187	323669	4923	323125	4736	2.909090909090909	68.2274070945946
chr11	SLC25A45	65379866	65379938	1312	73	323669	4923	322357	4850	17.972602739726028	66.46536082474226
chr11	SLC25A45	65381914	65381969	704	56	323669	4923	322965	4867	12.571428571428571	66.35812615574275
chr11	SLC25A45	65377332	65377423	473	92	323669	4923	323196	4831	5.141304347826087	66.90043469261022
chr11	SLC25A45	65381874	65381969	752	96	323669	4923	322917	4827	7.833333333333333	66.89807333747669
chr11	SLC25A45	65380533	65380622	30579	90	323669	4923	293090	4833	339.76666666666665	60.64349265466584
chr11	SLC25A45	65380533	65380632	32900	100	323669	4923	290769	4823	329.0	60.28799502384408
chr11	LTBP3	65540012	65540153	1566	142	468724	10116	467158	9974	11.028169014084508	46.837577702025264
chr11	LTBP3	65552859	65552982	0	124	468724	10116	468724	9992	0.0	46.90992794235388
chr11	LTBP3	65553424	65553530	0	107	468724	10116	468724	10009	0.0	46.83025277250474
chr11	KCNK7	65593309	65593383	0	75	2780	1463	2780	1388	0.0	2.0028818443804033
chr11	RELA	65660123	65660215	183421	93	2335268	4483	2151847	4390	1972.268817204301	490.170159453303
chr11	RELA	65661686	65661835	6730	150	2335268	4483	2328538	4333	44.86666666666667	537.3962612508655
chr11	RELA	65661936	65662088	29424	153	2335268	4483	2305844	4330	192.31372549019608	532.5274826789838
chr11	RELA	65662178	65662205	6020	28	2335268	4483	2329248	4455	215.0	522.8390572390572
chr11	RELA	65661686	65661868	7074	183	2335268	4483	2328194	4300	38.65573770491803	541.440465116279
chr11	RELA	65661686	65661819	6570	134	2335268	4483	2328698	4349	49.02985074626866	535.45596688894
chr11	RELA	65662178	65662347	38415	170	2335268	4483	2296853	4313	225.97058823529412	532.5418502202643
chr11	RNASEH2C	65717662	65717893	0	232	102	4492	102	4260	0.0	0.023943661971830985
chr11	CFL1	65858096	65858630	85	535	697189	5673	697104	5138	0.1588785046728972	135.67613857532115
chr11	CFL1	65858096	65858342	0	247	697189	5673	697189	5426	0.0	128.49041651308514
chr11	EFEMP2	65866844	65867079	0	236	13553	4066	13553	3830	0.0	3.5386422976501306
chr11	EFEMP2	65866809	65867079	0	271	13553	4066	13553	3795	0.0	3.571277997364954
chr11	EFEMP2	65867020	65867079	0	60	13553	4066	13553	4006	0.0	3.3831752371442834
chr11	EFEMP2	65866844	65866934	0	91	13553	4066	13553	3975	0.0	3.409559748427673
chr11	EFEMP2	65866865	65867079	0	215	13553	4066	13553	3851	0.0	3.5193456245131136
chr11	FIBP	65886321	65886422	0	102	5769	3155	5769	3053	0.0	1.8896167703897806
chr11	FOSL1	65894013	65894121	204	109	2865	1891	2661	1782	1.871559633027523	1.4932659932659933
chr11	FOSL1	65896808	65897006	0	199	2865	1891	2865	1692	0.0	1.6932624113475176
chr11	FOSL1	65894013	65894116	204	104	2865	1891	2661	1787	1.9615384615384615	1.489087856743145
chr11	EIF1AD	66000302	66000481	9453	180	117777	3333	108324	3153	52.516666666666666	34.3558515699334
chr11	EIF1AD	66000302	66000406	0	105	117777	3333	117777	3228	0.0	36.4860594795539
chr11	EIF1AD	66000302	66000505	17602	204	117777	3333	100175	3129	86.2843137254902	32.015020773410036
chr11	YIF1A	66285380	66285536	2748	157	27940	2353	25192	2196	17.503184713375795	11.47176684881603
chr11	YIF1A	66285700	66285758	1601	59	27940	2353	26339	2294	27.135593220338983	11.481691368788143
chr11	YIF1A	66287811	66287916	459	106	27940	2353	27481	2247	4.330188679245283	12.23008455718736
chr11	YIF1A	66288080	66288292	12009	213	27940	2353	15931	2140	56.38028169014085	7.444392523364486
chr11	YIF1A	66286940	66287014	646	75	27940	2353	27294	2278	8.613333333333333	11.981562774363477
chr11	RIN1	66335977	66336158	707	182	1058214	5231	1057507	5049	3.8846153846153846	209.4488017429194
chr11	BRMS1	66338242	66338282	0	41	255	2375	255	2334	0.0	0.10925449871465295
chr11	SLC29A2	66366430	66366564	0	135	37286	2733	37286	2598	0.0	14.3518090839107
chr11	MRPL11	66436801	66436909	250	109	77584	2546	77334	2437	2.293577981651376	31.733278621255643
chr11	MRPL11	66436815	66436909	208	95	77584	2546	77376	2451	2.1894736842105265	31.569155446756426
chr11	ZDHHC24	66524154	66524276	164	123	105766	6543	105602	6420	1.3333333333333333	16.448909657320872
chr11	ZDHHC24	66529311	66529488	71210	178	105766	6543	34556	6365	400.0561797752809	5.429065200314218
chr11	CTSF	66564741	66564806	1196	66	48495	3628	47299	3562	18.12121212121212	13.27877596855699
chr11	CTSF	66565830	66565927	0	98	48495	3628	48495	3530	0.0	13.737960339943342
chr11	RBM4B	66668614	66669291	0	678	969	4297	969	3619	0.0	0.26775352307267203
chr11	RBM4B	66666271	66666493	51	223	969	4297	918	4074	0.22869955156950672	0.22533136966126657
chr11	RBM4B	66670935	66670983	0	49	969	4297	969	4248	0.0	0.22810734463276836
chr11	SPTBN2	66721349	66721440	0	92	9864	12863	9864	12771	0.0	0.7723749119097957
chr11	PC	66957868	66957996	0	129	5619	7336	5619	7207	0.0	0.7796586651866241
chr11	PC	66954248	66954436	1530	189	5619	7336	4089	7147	8.095238095238095	0.5721281656639149
chr11	PC	66948087	66948203	0	117	5619	7336	5619	7219	0.0	0.7783626541072171
chr11	PC	66957739	66957996	102	258	5619	7336	5517	7078	0.3953488372093023	0.7794574738626731
chr11	PC	66952429	66952468	588	40	5619	7336	5031	7296	14.7	0.6895559210526315
chr11	POLD4	67352690	67352802	120370	113	1134864	2477	1014494	2364	1065.2212389380531	429.1429780033841
chr11	PPP1CA	67399560	67399665	0	106	816	3928	816	3822	0.0	0.21350078492935637
chr11	PPP1CA	67401067	67401232	0	166	816	3928	816	3762	0.0	0.21690590111642744
chr11	PPP1CA	67401067	67401199	0	133	816	3928	816	3795	0.0	0.2150197628458498
chr11	CORO1B	67440701	67440836	0	136	0	5227	0	5091	0.0	0.0
chr11	TMEM134	67464802	67464856	0	55	0	1799	0	1744	0.0	0.0
chr11	TMEM134	67465055	67465100	0	46	0	1799	0	1753	0.0	0.0
chr11	TMEM134	67465055	67465267	0	213	0	1799	0	1586	0.0	0.0
chr11	PITPNM1	67504102	67504221	0	120	125	6465	125	6345	0.0	0.019700551615445233
chr11	CABP2	67522545	67522716	37	172	630	1496	593	1324	0.21511627906976744	0.4478851963746224
chr11	CABP2	67522541	67522716	37	176	630	1496	593	1320	0.21022727272727273	0.4492424242424242
chr11	DOC2GP	67615614	67615686	0	73	0	1664	0	1591	0.0	0.0
chr11	ALDH3B2	67667472	67667635	0	164	12	3617	12	3453	0.0	0.0034752389226759338
chr11	ALDH3B2	67671062	67671325	0	264	12	3617	12	3353	0.0	0.003578884580972264
chr11	ALDH3B2	67674435	67674606	0	172	12	3617	12	3445	0.0	0.0034833091436865023
chr11	FAM86C2P	67796683	67796833	5916	151	72797	3409	66881	3258	39.17880794701987	20.528238182934317
chr11	FAM86C2P	67799373	67799475	27	103	72797	3409	72770	3306	0.2621359223300971	22.011494252873565
chr11	CHKA	68081403	68081457	0	55	2055	3785	2055	3730	0.0	0.5509383378016086
chr11	CHKA	68061492	68061830	0	339	2055	3785	2055	3446	0.0	0.5963435867672664
chr11	KMT5B	68180131	68180200	0	70	50836	8333	50836	8263	0.0	6.152244947355682
chr11	KMT5B	68189916	68190152	2648	237	50836	8333	48188	8096	11.172995780590718	5.9520750988142295
chr11	KMT5B	68179469	68179537	729	69	50836	8333	50107	8264	10.565217391304348	6.063286544046466
chr11	KMT5B	68174087	68174210	9964	124	50836	8333	40872	8209	80.35483870967742	4.9789255694968935
chr11	TESMIN	68742317	68742394	988	78	95457	4604	94469	4526	12.666666666666666	20.87251436146708
chr11	TESMIN	68744990	68745111	0	122	95457	4604	95457	4482	0.0	21.297858099062918
chr11	MRPL21	68900534	68900605	0	72	663	2831	663	2759	0.0	0.24030445813700615
chr11	MRPL21	68900547	68900605	0	59	663	2831	663	2772	0.0	0.23917748917748918
chr11	LTO1	69671748	69671819	0	72	19	5823	19	5751	0.0	0.0033037732568249
chr11	LTO1	69673215	69673321	0	107	19	5823	19	5716	0.0	0.003324002799160252
chr11	LTO1	69674550	69674766	0	217	19	5823	19	5606	0.0	0.0033892258294684267
chr11	FGF4	69774023	69774127	0	105	0	3168	0	3063	0.0	0.0
chr11	SHANK2	70500569	70500599	0	31	1312	19063	1312	19032	0.0	0.06893652795292139
chr11	SHANK2	70501922	70501931	0	10	1312	19063	1312	19053	0.0	0.06886054689550201
chr11	SHANK2	70477151	70477232	0	82	1312	19063	1312	18981	0.0	0.06912175333227964
chr11	SHANK2	70502205	70502286	0	82	1312	19063	1312	18981	0.0	0.06912175333227964
chr11	SHANK2	70500569	70500590	0	22	1312	19063	1312	19041	0.0	0.0689039441205819
chr11	SHANK2	70500569	70500596	0	28	1312	19063	1312	19035	0.0	0.06892566325190438
chr11	SHANK2	70895396	70895567	0	172	1312	19063	1312	18891	0.0	0.06945106135196655
chr11	ALG1L9P	71802857	71802972	738	116	220449	10393	219711	10277	6.362068965517241	21.378904349518344
chr11	AP002495.1	71923308	71923475	0	168	0	3091	0	2923	0.0	0.0
chr11	AP002495.1	71925932	71926104	0	173	0	3091	0	2918	0.0	0.0
chr11	NUMA1	72008091	72008145	0	55	152128	15188	152128	15133	0.0	10.052732439040508
chr11	NUMA1	72012894	72016260	49681	3367	152128	15188	102447	11821	14.755271755271755	8.666525674646815
chr11	NUMA1	72062588	72062686	0	99	152128	15188	152128	15089	0.0	10.08204652395785
chr11	NUMA1	72012400	72012442	0	43	152128	15188	152128	15145	0.0	10.044767249917465
chr11	NUMA1	72069841	72069911	0	71	152128	15188	152128	15117	0.0	10.063372362241186
chr11	NUMA1	72068104	72068231	36	128	152128	15188	152092	15060	0.28125	10.099070385126161
chr11	NUMA1	72049418	72049539	0	122	152128	15188	152128	15066	0.0	10.097437939731847
chr11	NUMA1	72068495	72068617	0	123	152128	15188	152128	15065	0.0	10.098108197809491
chr11	NUMA1	72076567	72076757	15	191	152128	15188	152113	14997	0.07853403141361257	10.14289524571581
chr11	NUMA1	72050661	72050833	0	173	152128	15188	152128	15015	0.0	10.131734931734933
chr11	NUMA1	72068078	72068231	88	154	152128	15188	152040	15034	0.5714285714285714	10.113077025409073
chr11	LAMTOR1	72098288	72098415	0	128	0	2695	0	2567	0.0	0.0
chr11	ANAPC15	72111411	72111496	0	86	0	2872	0	2786	0.0	0.0
chr11	ANAPC15	72111441	72111496	0	56	0	2872	0	2816	0.0	0.0
chr11	ANAPC15	72111156	72111286	0	131	0	2872	0	2741	0.0	0.0
chr11	CLPB	72302303	72302348	0	46	16540	12455	16540	12409	0.0	1.3329035377548553
chr11	CLPB	72372924	72373014	0	91	16540	12455	16540	12364	0.0	1.337754771918473
chr11	CLPB	72402965	72403052	828	88	16540	12455	15712	12367	9.409090909090908	1.270477884693135
chr11	CLPB	72408097	72408204	15357	108	16540	12455	1183	12347	142.19444444444446	0.09581274803596015
chr11	CLPB	72310943	72311051	0	109	16540	12455	16540	12346	0.0	1.3397051676656406
chr11	CLPB	72302303	72302373	0	71	16540	12455	16540	12384	0.0	1.3355943152454781
chr11	PDE2A	72608661	72608751	0	91	21413	7220	21413	7129	0.0	3.003647075326133
chr11	PDE2A	72642253	72642326	0	74	21413	7220	21413	7146	0.0	2.996501539322698
chr11	PDE2A	72631077	72631139	56	63	21413	7220	21357	7157	0.8888888888888888	2.984071538354059
chr11	PDE2A	72668297	72668426	94	130	21413	7220	21319	7090	0.7230769230769231	3.0069111424541606
chr11	ARAP1	72704151	72704334	0	184	14621	8718	14621	8534	0.0	1.7132645887040074
chr11	ARAP1	72692752	72692785	0	34	14621	8718	14621	8684	0.0	1.683671119299862
chr11	STARD10	72755700	72755753	0	54	2030	2748	2030	2694	0.0	0.7535263548626577
chr11	STARD10	72757766	72757884	0	119	2030	2748	2030	2629	0.0	0.7721567135793077
chr11	STARD10	72790336	72790390	0	55	2030	2748	2030	2693	0.0	0.753806164129224
chr11	FCHSD2	72842620	72842841	194	222	1884	5269	1690	5047	0.8738738738738738	0.33485238755696456
chr11	FCHSD2	73000989	73001134	0	146	1884	5269	1884	5123	0.0	0.36775326956861215
chr11	FCHSD2	73140030	73140128	0	99	1884	5269	1884	5170	0.0	0.3644100580270793
chr11	FCHSD2	72900256	72900328	0	73	1884	5269	1884	5196	0.0	0.3625866050808314
chr11	FCHSD2	73077617	73077670	0	54	1884	5269	1884	5215	0.0	0.36126558005752635
chr11	FAM168A	73468404	73468492	0	89	44409	7898	44409	7809	0.0	5.6868997310795235
chr11	FAM168A	73425021	73425048	28	28	44409	7898	44381	7870	1.0	5.639263024142313
chr11	RAB6A	73679653	73679720	0	68	8837	4907	8837	4839	0.0	1.826203761107667
chr11	RAB6A	73718612	73718718	650	107	8837	4907	8187	4800	6.074766355140187	1.705625
chr11	RAB6A	73718784	73718890	525	107	8837	4907	8312	4800	4.906542056074766	1.7316666666666667
chr11	RAB6A	73720845	73720899	1247	55	8837	4907	7590	4852	22.672727272727272	1.5643033800494641
chr11	COA4	73876478	73876575	0	98	0	1840	0	1742	0.0	0.0
chr11	UCP2	73975490	73975671	102	182	106008	2740	105906	2558	0.5604395604395604	41.401876465989055
chr11	UCP2	73980014	73980052	91	39	106008	2740	105917	2701	2.3333333333333335	39.21399481673454
chr11	P4HA3	74276984	74277144	0	161	51	3632	51	3471	0.0	0.014693171996542784
chr11	P4HA3	74287115	74287291	0	177	51	3632	51	3455	0.0	0.014761215629522432
chr11	KCNE3	74462747	74462855	49	109	2964145	3605	2964096	3496	0.44954128440366975	847.8535469107552
chr11	KCNE3	74464261	74464325	0	65	2964145	3605	2964145	3540	0.0	837.3290960451977
chr11	CHRDL2	74703304	74703499	1474	196	37356	3110	35882	2914	7.520408163265306	12.313658201784488
chr11	CHRDL2	74708301	74708395	1009	95	37356	3110	36347	3015	10.621052631578948	12.055389718076285
chr11	CHRDL2	74701591	74701646	0	56	37356	3110	37356	3054	0.0	12.231827111984282
chr11	CHRDL2	74713385	74713479	0	95	37356	3110	37356	3015	0.0	12.390049751243781
chr11	XRRA1	74851087	74851203	0	117	102	8801	102	8684	0.0	0.01174573929064947
chr11	XRRA1	74933800	74933872	0	73	102	8801	102	8728	0.0	0.011686526122823098
chr11	XRRA1	74945017	74945085	0	69	102	8801	102	8732	0.0	0.01168117269812185
chr11	XRRA1	74843853	74843959	0	107	102	8801	102	8694	0.0	0.011732229123533472
chr11	XRRA1	74859157	74859283	0	127	102	8801	102	8674	0.0	0.011759280608715702
chr11	XRRA1	74862980	74863021	0	42	102	8801	102	8759	0.0	0.011645164973170453
chr11	XRRA1	74927390	74927488	0	99	102	8801	102	8702	0.0	0.01172144334635716
chr11	XRRA1	74933824	74933872	0	49	102	8801	102	8752	0.0	0.011654478976234004
chr11	XRRA1	74940784	74940882	0	99	102	8801	102	8702	0.0	0.01172144334635716
chr11	XRRA1	74851988	74852082	0	95	102	8801	102	8706	0.0	0.01171605789110958
chr11	XRRA1	74906238	74906456	0	219	102	8801	102	8582	0.0	0.011885341412258214
chr11	OR2AT4	75096088	75096222	0	135	510	1838	510	1703	0.0	0.29947152084556666
chr11	OR2AT4	75096088	75096160	0	73	510	1838	510	1765	0.0	0.28895184135977336
chr11	ARRB1	75267651	75267703	0	53	538928	9907	538928	9854	0.0	54.69129287598945
chr11	ARRB1	75271700	75271724	0	25	538928	9907	538928	9882	0.0	54.536328678405184
chr11	ARRB1	75290008	75290039	0	32	538928	9907	538928	9875	0.0	54.57498734177215
chr11	GDPD5	75449884	75449983	0	100	358	9722	358	9622	0.0	0.037206401995427144
chr11	GDPD5	75479243	75479488	0	246	358	9722	358	9476	0.0	0.03777965386238919
chr11	GDPD5	75448491	75448649	0	159	358	9722	358	9563	0.0	0.03743595106138241
chr11	GDPD5	75439339	75439354	0	16	358	9722	358	9706	0.0	0.03688440140119514
chr11	THAP12	76364337	76364432	0	96	102	7895	102	7799	0.0	0.013078599820489806
chr11	LRRC32	76659582	76661508	0	1927	102	4460	102	2533	0.0	0.040268456375838924
chr11	GDPD4	77279305	77279399	46	95	797	2911	751	2816	0.4842105263157895	0.2666903409090909
chr11	PAK1	77337323	77337423	0	101	77775	5942	77775	5841	0.0	13.315356959424756
chr11	PAK1	77392330	77392541	0	212	77775	5942	77775	5730	0.0	13.573298429319372
chr11	PAK1	77325327	77325376	0	50	77775	5942	77775	5892	0.0	13.20010183299389
chr11	PAK1	77455880	77455937	112	58	77775	5942	77663	5884	1.9310344827586208	13.19901427600272
chr11	PAK1	77397026	77397158	0	133	77775	5942	77775	5809	0.0	13.388707178516096
chr11	PAK1	77408153	77408232	12	80	77775	5942	77763	5862	0.15	13.265609007164791
chr11	CLNS1A	77622499	77622673	0	175	29221	4489	29221	4314	0.0	6.7735280482151135
chr11	CLNS1A	77625716	77625818	0	103	29221	4489	29221	4386	0.0	6.662334701322389
chr11	CLNS1A	77629762	77629899	350	138	29221	4489	28871	4351	2.536231884057971	6.63548609515054
chr11	CLNS1A	77624962	77625070	51	109	29221	4489	29170	4380	0.46788990825688076	6.659817351598173
chr11	CLNS1A	77621865	77622044	549	180	29221	4489	28672	4309	3.05	6.653980041773033
chr11	RSF1	77725544	77725699	0	156	87388	15757	87388	15601	0.0	5.60143580539709
chr11	RSF1	77747035	77747128	0	94	87388	15757	87388	15663	0.0	5.579263231820213
chr11	INTS4	77978995	77979102	0	108	34195	5755	34195	5647	0.0	6.055427660704799
chr11	INTS4	77987603	77987698	0	96	34195	5755	34195	5659	0.0	6.042587029510514
chr11	INTS4	77987528	77987698	0	171	34195	5755	34195	5584	0.0	6.123746418338109
chr11	NDUFC2	78072997	78073141	0	145	204	2119	204	1974	0.0	0.1033434650455927
chr11	NDUFC2-KCTD14	78038663	78038758	0	96	0	830	0	734	0.0	0.0
chr11	NDUFC2	78072997	78073072	0	76	204	2119	204	2043	0.0	0.09985315712187959
chr11	ALG8	78109441	78109581	0	141	510	3191	510	3050	0.0	0.16721311475409836
chr11	ALG8	78127357	78127436	0	80	510	3191	510	3111	0.0	0.16393442622950818
chr11	ALG8	78102873	78102948	0	76	510	3191	510	3115	0.0	0.1637239165329053
chr11	ALG8	78107716	78107764	0	49	510	3191	510	3142	0.0	0.16231699554423934
chr11	ALG8	78112649	78112770	0	122	510	3191	510	3069	0.0	0.16617790811339198
chr11	ALG8	78127357	78127439	0	83	510	3191	510	3108	0.0	0.1640926640926641
chr11	ALG8	78114703	78114798	0	96	510	3191	510	3095	0.0	0.16478190630048464
chr11	ALG8	78135229	78135347	0	119	510	3191	510	3072	0.0	0.166015625
chr11	ALG8	78138709	78138767	0	59	510	3191	510	3132	0.0	0.16283524904214558
chr11	KCTD21	78186680	78186816	0	137	10614	3974	10614	3837	0.0	2.7662236121970287
chr11	KCTD21	78177738	78177985	0	248	10614	3974	10614	3726	0.0	2.848631239935588
chr11	KCTD21	78176887	78176985	4953	99	10614	3974	5661	3875	50.03030303030303	1.4609032258064516
chr11	GAB2	78250156	78250400	0	245	1377	6790	1377	6545	0.0	0.21038961038961038
chr11	GAB2	78364015	78364103	0	89	1377	6790	1377	6701	0.0	0.20549171765408147
chr11	NARS2	78441090	78441117	0	28	0	3161	0	3133	0.0	0.0
chr11	NARS2	78493062	78493195	0	134	0	3161	0	3027	0.0	0.0
chr11	TENM4	78778601	78778628	0	28	195	11480	195	11452	0.0	0.017027593433461403
chr11	TENM4	79148709	79148806	0	98	195	11480	195	11382	0.0	0.01713231418028466
chr11	MIR4300HG	82349925	82350004	0	80	51	4311	51	4231	0.0	0.012053887969747105
chr11	MIR4300HG	82015607	82015734	0	128	51	4311	51	4183	0.0	0.012192206550322734
chr11	MIR4300HG	82096460	82096608	0	149	51	4311	51	4162	0.0	0.0122537241710716
chr11	AP000793.1	82610012	82610090	0	79	4724	1063	4724	984	0.0	4.800813008130081
chr11	PRCP	82884822	82884885	0	64	16386	13162	16386	13098	0.0	1.2510306917086578
chr11	PRCP	82859976	82860117	0	142	16386	13162	16386	13020	0.0	1.2585253456221197
chr11	RAB30	82994038	82994122	0	85	121151	11843	121151	11758	0.0	10.303708113624767
chr11	RAB30	83034171	83034272	0	102	121151	11843	121151	11741	0.0	10.318627033472447
chr11	RAB30	82994038	82994106	0	69	121151	11843	121151	11774	0.0	10.289706132155597
chr11	RAB30	83060076	83060178	0	103	121151	11843	121151	11740	0.0	10.319505962521294
chr11	RAB30	83034726	83034782	0	57	121151	11843	121151	11786	0.0	10.279229594434074
chr11	AP000873.2	83192123	83192197	0	75	0	1749	0	1674	0.0	0.0
chr11	AP000873.2	83192427	83192541	0	115	0	1749	0	1634	0.0	0.0
chr11	CCDC90B	83265864	83265979	0	116	0	5909	0	5793	0.0	0.0
chr11	CCDC90B	83278725	83278829	0	105	0	5909	0	5804	0.0	0.0
chr11	CCDC90B	83280140	83280260	0	121	0	5909	0	5788	0.0	0.0
chr11	CCDC90B	83266866	83267038	0	173	0	5909	0	5736	0.0	0.0
chr11	CCDC90B	83285126	83285211	0	86	0	5909	0	5823	0.0	0.0
chr11	DLG2	83472726	83472777	0	52	67	16296	67	16244	0.0	0.004124599852253139
chr11	DLG2	83930327	83930483	0	157	67	16296	67	16139	0.0	0.004151434413532437
chr11	DLG2	83480371	83480413	0	43	67	16296	67	16253	0.0	0.004122315880145204
chr11	DLG2	84251237	84251291	0	55	67	16296	67	16241	0.0	0.004125361738809187
chr11	DLG2	83651838	83651930	0	93	67	16296	67	16203	0.0	0.0041350367215947665
chr11	DLG2	84272141	84272300	0	160	67	16296	67	16136	0.0	0.004152206246901338
chr11	CREBZF	85661636	85661749	0	114	0	4015	0	3901	0.0	0.0
chr11	SYTL2	85711112	85711232	0	121	191629	11277	191629	11156	0.0	17.177214055216922
chr11	SYTL2	85714412	85714507	56824	96	191629	11277	134805	11181	591.9166666666666	12.056613898577945
chr11	SYTL2	85717482	85717530	0	49	191629	11277	191629	11228	0.0	17.06706448165301
chr11	SYTL2	85757624	85758114	0	491	191629	11277	191629	10786	0.0	17.76645651770814
chr11	SYTL2	85708037	85708150	0	114	191629	11277	191629	11163	0.0	17.166442712532472
chr11	SYTL2	85717482	85717726	0	245	191629	11277	191629	11032	0.0	17.370286439448876
chr11	SYTL2	85716346	85716428	40	83	191629	11277	191589	11194	0.4819277108433735	17.115329640879043
chr11	SYTL2	85717044	85717140	899	97	191629	11277	190730	11180	9.268041237113403	17.059928443649373
chr11	PICALM	85976622	85976682	0	61	2952	6364	2952	6303	0.0	0.4683484055211804
chr11	PICALM	85990249	85990399	322	151	2952	6364	2630	6213	2.1324503311258276	0.42330597135039433
chr11	PICALM	86026291	86026367	0	77	2952	6364	2952	6287	0.0	0.46954032129791634
chr11	PICALM	85978069	85978093	75	25	2952	6364	2877	6339	3.0	0.4538570752484619
chr11	PICALM	85990249	85990378	175	130	2952	6364	2777	6234	1.3461538461538463	0.445460378569137
chr11	PICALM	85960674	85960777	0	104	2952	6364	2952	6260	0.0	0.4715654952076677
chr11	PICALM	85974707	85974812	357	106	2952	6364	2595	6258	3.3679245283018866	0.4146692233940556
chr11	PICALM	86068650	86068733	0	84	2952	6364	2952	6280	0.0	0.47006369426751593
chr11	ME3	86457365	86457759	0	395	1256	3801	1256	3406	0.0	0.36876100998238404
chr11	RAB38	88149674	88149955	0	282	1144	1435	1144	1153	0.0	0.9921942758022549
chr11	CTSC	88309162	88309318	0	157	51	15798	51	15641	0.0	0.0032606610830509556
chr11	CTSC	88312387	88312554	0	168	51	15798	51	15630	0.0	0.0032629558541266796
chr11	CTSC	88296132	88296264	0	133	51	15798	51	15665	0.0	0.003255665496329397
chr11	CTSC	88312449	88312554	0	106	51	15798	51	15692	0.0	0.00325006372673974
chr11	CTSC	88328111	88328196	0	86	51	15798	51	15712	0.0	0.003245926680244399
chr11	CTSC	88334936	88335082	0	147	51	15798	51	15651	0.0	0.003258577726662833
chr11	CTSC	88312426	88312554	0	129	51	15798	51	15669	0.0	0.003254834386367988
chr11	CTSC	88327243	88327358	0	116	51	15798	51	15682	0.0	0.003252136207116439
chr11	CTSC	88327928	88328016	0	89	51	15798	51	15709	0.0	0.003246546565662996
chr11	GRM5	88525308	88525404	0	97	306	8672	306	8575	0.0	0.03568513119533528
chr11	NOX4	89342073	89342193	0	121	51	6122	51	6001	0.0	0.0084985835694051
chr11	TRIM49	89801701	89801932	0	232	0	2171	0	1939	0.0	0.0
chr11	TRIM49D1	89914911	89915142	0	232	1718	2172	1718	1940	0.0	0.8855670103092783
chr11	CHORDC1	90215173	90215230	0	58	0	7182	0	7124	0.0	0.0
chr11	CHORDC1	90206747	90206810	0	64	0	7182	0	7118	0.0	0.0
chr11	CHORDC1	90216463	90216553	0	91	0	7182	0	7091	0.0	0.0
chr11	TAF1D	93738108	93738499	0	392	51	5700	51	5308	0.0	0.009608138658628486
chr11	TAF1D	93739236	93739331	0	96	51	5700	51	5604	0.0	0.009100642398286937
chr11	TAF1D	93738108	93738440	0	333	51	5700	51	5367	0.0	0.009502515371716043
chr11	GPR83	94396398	94396524	0	127	561	4281	561	4154	0.0	0.1350505536831969
chr11	MRE11	94445809	94445893	0	85	204	7556	204	7471	0.0	0.02730558158211752
chr11	MRE11	94479673	94479761	0	89	204	7556	204	7467	0.0	0.027320208919244676
chr11	MRE11	94445809	94445890	0	82	204	7556	204	7474	0.0	0.027294621354027295
chr11	AP000943.2	94695820	94695907	1987	88	3415	1181	1428	1093	22.579545454545453	1.3064958828911253
chr11	SESN3	95189778	95189961	0	184	612	10592	612	10408	0.0	0.058800922367409685
chr11	SESN3	95200910	95201103	0	194	612	10592	612	10398	0.0	0.058857472590882864
chr11	SESN3	95224451	95224484	0	34	612	10592	612	10558	0.0	0.05796552377344194
chr11	SESN3	95201236	95201355	0	120	612	10592	612	10472	0.0	0.05844155844155844
chr11	FAM76B	95779077	95779135	0	59	2301	5340	2301	5281	0.0	0.43571293315659915
chr11	FAM76B	95788858	95788947	0	90	2301	5340	2301	5250	0.0	0.4382857142857143
chr11	MTMR2	95841616	95841709	0	94	6134	10675	6134	10581	0.0	0.5797183631036764
chr11	MTMR2	95882373	95882496	0	124	6134	10675	6134	10551	0.0	0.5813666950999905
chr11	MTMR2	95888155	95888261	0	107	6134	10675	6134	10568	0.0	0.5804314912944739
chr11	MTMR2	95887611	95887684	0	74	6134	10675	6134	10601	0.0	0.5786246580511273
chr11	MTMR2	95917376	95917486	14	111	6134	10675	6120	10564	0.12612612612612611	0.5793260128739114
chr11	MTMR2	95914241	95914312	0	72	6134	10675	6134	10603	0.0	0.5785155144770348
chr11	MTMR2	95914241	95914333	0	93	6134	10675	6134	10582	0.0	0.5796635796635796
chr11	MTMR2	95866383	95866486	0	104	6134	10675	6134	10571	0.0	0.5802667675716583
chr11	MTMR2	95887325	95887373	0	49	6134	10675	6134	10626	0.0	0.5772633163937512
chr11	MTMR2	95887611	95887759	0	149	6134	10675	6134	10526	0.0	0.5827474824244727
chr11	MTMR2	95866402	95866486	0	85	6134	10675	6134	10590	0.0	0.5792256846081208
chr11	MTMR2	95907861	95907923	0	63	6134	10675	6134	10612	0.0	0.578024877497173
chr11	CCDC82	96385936	96386020	0	85	0	14215	0	14130	0.0	0.0
chr11	CCDC82	96389364	96389523	0	160	0	14215	0	14055	0.0	0.0
chr11	CCDC82	96388694	96388829	0	136	0	14215	0	14079	0.0	0.0
chr11	LINC02713	97918837	97918976	0	140	0	1903	0	1763	0.0	0.0
chr11	LINC02713	97916688	97916923	0	236	0	1903	0	1667	0.0	0.0
chr11	PGR	101049928	101050059	0	132	102	14342	102	14210	0.0	0.007178043631245602
chr11	PGR	101062446	101062752	0	307	102	14342	102	14035	0.0	0.007267545422158889
chr11	PGR	101091759	101091876	0	118	102	14342	102	14224	0.0	0.007170978627671541
chr11	PGR	101049928	101050007	0	80	102	14342	102	14262	0.0	0.00715187210769878
chr11	TRPC6	101476300	101476534	0	235	0	5630	0	5395	0.0	0.0
chr11	TRPC6	101488936	101489101	0	166	0	5630	0	5464	0.0	0.0
chr11	TRPC6	101491555	101491738	0	184	0	5630	0	5446	0.0	0.0
chr11	TMEM123	102448811	102448868	0	58	0	4452	0	4394	0.0	0.0
chr11	TMEM123	102448235	102448375	0	141	0	4452	0	4311	0.0	0.0
chr11	MMP8	102714555	102714709	0	155	349998	3451	349998	3296	0.0	106.18871359223301
chr11	MMP8	102722990	102723078	0	89	349998	3451	349998	3362	0.0	104.10410469958359
chr11	MMP8	102723479	102723546	0	68	349998	3451	349998	3383	0.0	103.45787762341118
chr11	MMP8	102723834	102723945	0	112	349998	3451	349998	3339	0.0	104.82120395327942
chr11	MMP13	102945118	102945236	0	119	7012	1695	7012	1576	0.0	4.449238578680203
chr11	DCUN1D5	103064274	103064377	84	104	2073	12866	1989	12762	0.8076923076923077	0.15585331452750353
chr11	DCUN1D5	103082747	103082839	0	93	2073	12866	2073	12773	0.0	0.1622954670007046
chr11	DCUN1D5	103089226	103089318	0	93	2073	12866	2073	12773	0.0	0.1622954670007046
chr11	DCUN1D5	103083255	103083326	0	72	2073	12866	2073	12794	0.0	0.16202907612943568
chr11	DCUN1D5	103079908	103079997	0	90	2073	12866	2073	12776	0.0	0.1622573575453976
chr11	LINC02552	104544698	104544786	0	89	0	15741	0	15652	0.0	0.0
chr11	LINC02552	104572556	104572597	0	42	0	15741	0	15699	0.0	0.0
chr11	LINC02552	104595481	104595533	0	53	0	15741	0	15688	0.0	0.0
chr11	LINC02552	104572075	104572222	0	148	0	15741	0	15593	0.0	0.0
chr11	LINC02552	104600302	104600382	0	81	0	15741	0	15660	0.0	0.0
chr11	LINC02552	104607022	104607136	0	115	0	15741	0	15626	0.0	0.0
chr11	CASP12	104887195	104887305	0	111	51	1795	51	1684	0.0	0.030285035629453682
chr11	CASP12	104891169	104891404	51	236	51	1795	0	1559	0.21610169491525424	0.0
chr11	CASP12	104897216	104897468	0	253	51	1795	51	1542	0.0	0.033073929961089495
chr11	CASP12	104892896	104892991	0	96	51	1795	51	1699	0.0	0.03001765744555621
chr11	CASP12	104891197	104891404	51	208	51	1795	0	1587	0.24519230769230768	0.0
chr11	CASP4LP	104906449	104907618	0	1170	0	3314	0	2144	0.0	0.0
chr11	CASP4LP	104906959	104907116	0	158	0	3314	0	3156	0.0	0.0
chr11	CASP4	104944747	104944851	0	105	0	5500	0	5395	0.0	0.0
chr11	CASP4	104951895	104952005	0	111	0	5500	0	5389	0.0	0.0
chr11	CASP4	104950924	104951098	0	175	0	5500	0	5325	0.0	0.0
chr11	CASP5	104995188	104995253	0	66	0	1603	0	1537	0.0	0.0
chr11	CASP5	105003273	105003383	0	111	0	1603	0	1492	0.0	0.0
chr11	CASP5	105008806	105009019	0	214	0	1603	0	1389	0.0	0.0
chr11	CASP5	105008806	105008980	0	175	0	1603	0	1428	0.0	0.0
chr11	CASP5	105007082	105007334	0	253	0	1603	0	1350	0.0	0.0
chr11	CASP5	105008806	105009053	0	248	0	1603	0	1355	0.0	0.0
chr11	CASP1	105029123	105029267	0	145	0	3706	0	3561	0.0	0.0
chr11	CASP1	105026225	105026356	0	132	0	3706	0	3574	0.0	0.0
chr11	CASP1	105031164	105031280	0	117	0	3706	0	3589	0.0	0.0
chr11	CASP1	105033063	105033126	0	64	0	3706	0	3642	0.0	0.0
chr11	CARD16	105043482	105043545	0	64	0	1212	0	1148	0.0	0.0
chr11	KBTBD3	106058864	106059109	0	246	51	4712	51	4466	0.0	0.01141961486789073
chr11	KBTBD3	106076506	106076707	0	202	51	4712	51	4510	0.0	0.01130820399113082
chr11	GUCY1A2	106746550	106746643	0	94	1829	16316	1829	16222	0.0	0.11274811983725805
chr11	GUCY1A2	106936649	106936712	0	64	1829	16316	1829	16252	0.0	0.11253999507752892
chr11	CWF19L2	107345413	107345490	0	78	250	3600	250	3522	0.0	0.0709823963657013
chr11	ALKBH8	107549752	107549823	0	72	51	4215	51	4143	0.0	0.012309920347574221
chr11	SLN	107711962	107712162	51	201	51	909	0	708	0.2537313432835821	0.0
chr11	SLC35F2	107804717	107804770	0	54	1922	3496	1922	3442	0.0	0.5583962812318419
chr11	SLC35F2	107815789	107815965	357	177	1922	3496	1565	3319	2.016949152542373	0.47152756854474237
chr11	SLC35F2	107840666	107840750	0	85	1922	3496	1922	3411	0.0	0.5634711228378775
chr11	NPAT	108208420	108208584	0	165	16211	7108	16211	6943	0.0	2.3348696528878006
chr11	C11ORF65	108407095	108407149	0	55	518	3784	518	3729	0.0	0.138911236256369
chr11	C11ORF65	108462547	108462640	0	94	518	3784	518	3690	0.0	0.14037940379403793
chr11	C11ORF65	108431745	108431838	0	94	518	3784	518	3690	0.0	0.14037940379403793
chr11	POGLUT3	108479300	108479495	0	196	0	4948	0	4752	0.0	0.0
chr11	POGLUT3	108478023	108478140	0	118	0	4948	0	4830	0.0	0.0
chr11	EXPH5	108528135	108528184	0	50	4074	10736	4074	10686	0.0	0.38124649073554184
chr11	RDX	110264778	110264874	0	97	2634	6114	2634	6017	0.0	0.43775968090410505
chr11	RDX	110286999	110287207	0	209	2634	6114	2634	5905	0.0	0.4460626587637595
chr11	RDX	110279680	110279756	0	77	2634	6114	2634	6037	0.0	0.4363094252111976
chr11	RDX	110181791	110181838	0	48	2634	6114	2634	6066	0.0	0.4342235410484669
chr11	RDX	110263959	110264234	0	276	2634	6114	2634	5838	0.0	0.4511819116135663
chr11	RDX	110200277	110200386	0	110	2634	6114	2634	6004	0.0	0.43870752831445703
chr11	RDX	110263331	110263435	0	105	2634	6114	2634	6009	0.0	0.43834248627059413
chr11	RDX	110272910	110273051	0	142	2634	6114	2634	5972	0.0	0.4410582719356999
chr11	RDX	110272910	110273033	0	124	2634	6114	2634	5990	0.0	0.4397328881469115
chr11	ARHGAP20	110712126	110712423	0	298	0	7144	0	6846	0.0	0.0
chr11	ARHGAP20	110690971	110691039	0	69	0	7144	0	7075	0.0	0.0
chr11	BTG4	111507834	111507918	0	85	1305	1808	1305	1723	0.0	0.7573998839233894
chr11	PPP2R1B	111753442	111753577	0	136	62094	6705	62094	6569	0.0	9.452580301415741
chr11	PPP2R1B	111764804	111764905	0	102	62094	6705	62094	6603	0.0	9.403907314856884
chr11	PPP2R1B	111765293	111765384	58	92	62094	6705	62036	6613	0.6304347826086957	9.38091637683351
chr11	ALG9	111853648	111853736	44	89	2564	7995	2520	7906	0.4943820224719101	0.3187452567670124
chr11	ALG9	111857601	111857737	1297	137	2564	7995	1267	7858	9.467153284671532	0.16123695596843982
chr11	ALG9	111865180	111865251	0	72	2564	7995	2564	7923	0.0	0.323614792376625
chr11	ALG9	111870231	111870370	0	140	2564	7995	2564	7855	0.0	0.32641629535327815
chr11	ALG9	111788440	111788569	0	130	2564	7995	2564	7865	0.0	0.3260012714558169
chr11	ALG9	111805093	111805315	0	223	2564	7995	2564	7772	0.0	0.3299022130725682
chr11	ALG9	111798093	111798195	295	103	2564	7995	2269	7892	2.8640776699029127	0.28750633552965027
chr11	ALG9	111871351	111871489	0	139	2564	7995	2564	7856	0.0	0.32637474541751527
chr11	FDXACB1	111878555	111878712	0	158	3979	3557	3979	3399	0.0	1.1706384230656075
chr11	ALG9	111870227	111870370	0	144	2564	7995	2564	7851	0.0	0.3265826009425551
chr11	AP001781.2	111875697	111876104	1428	408	2900	3366	1472	2958	3.5	0.4976335361730899
chr11	CRYAB	111912262	111912338	0	77	57088	3377	57088	3300	0.0	17.29939393939394
chr11	PIH1D2	112067794	112068005	372	212	4591	3232	4219	3020	1.7547169811320755	1.3970198675496688
chr11	TIMM8B	112085977	112086310	51	334	251	1169	200	835	0.15269461077844312	0.23952095808383234
chr11	IL18	112153591	112153603	0	13	0	1822	0	1809	0.0	0.0
chr11	DRD2	113414374	113414461	0	88	0	4125	0	4037	0.0	0.0
chr11	DRD2	113416862	113416999	0	138	0	4125	0	3987	0.0	0.0
chr11	DRD2	113413334	113413340	0	7	0	4125	0	4118	0.0	0.0
chr11	DRD2	113474229	113474415	0	187	0	4125	0	3938	0.0	0.0
chr11	TMPRSS5	113689764	113689917	0	154	34722	2681	34722	2527	0.0	13.740403640680649
chr11	TMPRSS5	113699961	113700168	16502	208	34722	2681	18220	2473	79.33653846153847	7.367569753336029
chr11	TMPRSS5	113698904	113699027	0	124	34722	2681	34722	2557	0.0	13.579194368400469
chr11	TMPRSS5	113700065	113700168	521	104	34722	2681	34201	2577	5.009615384615385	13.27163368257664
chr11	TMPRSS5	113699594	113699693	4394	100	34722	2681	30328	2581	43.94	11.750484308407595
chr11	USP28	113806488	113806584	0	97	79	5659	79	5562	0.0	0.014203523912261776
chr11	USP28	113817657	113817837	0	181	79	5659	79	5478	0.0	0.014421321650237313
chr11	USP28	113831919	113831993	0	75	79	5659	79	5584	0.0	0.01414756446991404
chr11	USP28	113834248	113834335	0	88	79	5659	79	5571	0.0	0.014180577993178962
chr11	USP28	113831919	113831989	0	71	79	5659	79	5588	0.0	0.014137437365783823
chr11	USP28	113835206	113835327	0	122	79	5659	79	5537	0.0	0.014267653964240564
chr11	USP28	113808022	113808136	0	115	79	5659	79	5544	0.0	0.01424963924963925
chr11	USP28	113828843	113828920	0	78	79	5659	79	5581	0.0	0.014155169324493818
chr11	USP28	113874516	113874800	0	285	79	5659	79	5374	0.0	0.01470040937848902
chr11	USP28	113874516	113874879	0	364	79	5659	79	5295	0.0	0.014919735599622286
chr11	NXPE1	114551973	114552085	0	113	0	4399	0	4286	0.0	0.0
chr11	NXPE1	114528795	114528832	0	38	0	4399	0	4361	0.0	0.0
chr11	CADM1	115190887	115190941	0	55	0	10877	0	10822	0.0	0.0
chr11	CADM1	115209573	115209657	0	85	0	10877	0	10792	0.0	0.0
chr11	CADM1	115198405	115198438	0	34	0	10877	0	10843	0.0	0.0
chr11	CADM1	115445760	115445836	0	77	0	10877	0	10800	0.0	0.0
chr11	LINC00900	115758806	115758906	0	101	0	5016	0	4915	0.0	0.0
chr11	ZPR1	116782157	116782244	0	88	5743	5417	5743	5329	0.0	1.077688121598799
chr11	ZPR1	116785098	116785146	46	49	5743	5417	5697	5368	0.9387755102040817	1.0612891207153503
chr11	ZPR1	116787481	116787643	0	163	5743	5417	5743	5254	0.0	1.0930719451846211
chr11	ZPR1	116787481	116787602	0	122	5743	5417	5743	5295	0.0	1.0846081208687441
chr11	APOA1	116837000	116837157	0	158	0	980	0	822	0.0	0.0
chr11	SIK3	116861273	116861383	0	111	1049	6921	1049	6810	0.0	0.1540381791483113
chr11	SIK3	116867945	116868089	0	145	1049	6921	1049	6776	0.0	0.15481109799291617
chr11	SIK3	116875865	116876009	0	145	1049	6921	1049	6776	0.0	0.15481109799291617
chr11	SIK3	116950132	116950256	0	125	1049	6921	1049	6796	0.0	0.15435550323719835
chr11	PCSK7	117207066	117207160	0	95	135275	20140	135275	20045	0.0	6.748565727113993
chr11	PCSK7	117230348	117230468	0	121	135275	20140	135275	20019	0.0	6.757330535990809
chr11	PCSK7	117231126	117231217	0	92	135275	20140	135275	20048	0.0	6.747555865921788
chr11	BACE1	117291711	117291813	0	103	2550	7202	2550	7099	0.0	0.35920552190449356
chr11	FXYD2	117822405	117822480	0	76	27	3961	27	3885	0.0	0.0069498069498069494
chr11	FXYD6	117840318	117840368	0	51	102	4097	102	4046	0.0	0.025210084033613446
chr11	FXYD6	117841147	117841184	0	38	102	4097	102	4059	0.0	0.025129342202512936
chr11	FXYD6	117858210	117858286	0	77	102	4097	102	4020	0.0	0.025373134328358207
chr11	FXYD6	117844109	117844206	0	98	102	4097	102	3999	0.0	0.025506376594148537
chr11	FXYD6	117840343	117840368	0	26	102	4097	102	4071	0.0	0.025055268975681652
chr11	FXYD6	117840236	117840368	0	133	102	4097	102	3964	0.0	0.025731584258324926
chr11	TMPRSS13	117911767	117911860	0	94	51	5382	51	5288	0.0	0.009644478063540091
chr11	TMPRSS13	117917169	117917274	0	106	51	5382	51	5276	0.0	0.009666413949962092
chr11	TMPRSS13	117918408	117918838	0	431	51	5382	51	4951	0.0	0.010300949303171077
chr11	SCN2B	118170318	118170422	0	105	0	5359	0	5254	0.0	0.0
chr11	JAML	118214823	118214886	0	64	239	6176	239	6112	0.0	0.03910340314136126
chr11	MPZL3	118237049	118237260	0	212	7412	3989	7412	3777	0.0	1.9624040243579561
chr11	CD3D	118339774	118339906	0	133	1395	775	1395	642	0.0	2.1728971962616823
chr11	CD3D	118340374	118340593	0	220	1395	775	1395	555	0.0	2.5135135135135136
chr11	AP001267.3	118527468	118527575	5511	108	9938	2698	4427	2590	51.02777777777778	1.7092664092664092
chr11	IFT46	118545408	118545494	6	87	6	3589	0	3502	0.06896551724137931	0.0
chr11	IFT46	118557737	118557890	0	154	6	3589	6	3435	0.0	0.0017467248908296944
chr11	IFT46	118565789	118565917	0	129	6	3589	6	3460	0.0	0.0017341040462427746
chr11	TREH	118661636	118661729	136	94	1421	3196	1285	3102	1.446808510638298	0.4142488716956802
chr11	TREH	118663338	118663439	0	102	1421	3196	1421	3094	0.0	0.4592760180995475
chr11	BCL9L	118903235	118903452	0	218	937924	10481	937924	10263	0.0	91.3888726493228
chr11	SLC37A4	119026602	119026688	0	87	2971	4259	2971	4172	0.0	0.7121284755512943
chr11	SLC37A4	119027627	119027872	713	246	2971	4259	2258	4013	2.8983739837398375	0.5626713182157986
chr11	SLC37A4	119028193	119028426	25	234	2971	4259	2946	4025	0.10683760683760683	0.7319254658385094
chr11	SLC37A4	119030231	119030735	102	505	2971	4259	2869	3754	0.201980198019802	0.7642514651038892
chr11	SLC37A4	119025691	119025757	0	67	2971	4259	2971	4192	0.0	0.7087309160305344
chr11	SLC37A4	119030547	119030735	60	189	2971	4259	2911	4070	0.31746031746031744	0.7152334152334152
chr11	SLC37A4	119027627	119027770	713	144	2971	4259	2258	4115	4.951388888888889	0.5487241798298906
chr11	SLC37A4	119028734	119028834	0	101	2971	4259	2971	4158	0.0	0.7145262145262146
chr11	HYOU1	119049017	119049203	969	187	136486	6178	135517	5991	5.181818181818182	22.620096811884494
chr11	HYOU1	119055749	119055843	0	95	136486	6178	136486	6083	0.0	22.43728423475259
chr11	HYOU1	119056278	119056418	0	141	136486	6178	136486	6037	0.0	22.60824913036276
chr11	HYOU1	119049017	119049370	1581	354	136486	6178	134905	5824	4.466101694915254	23.16363324175824
chr11	HYOU1	119056069	119056167	0	99	136486	6178	136486	6079	0.0	22.452048034216155
chr11	HYOU1	119056278	119056405	0	128	136486	6178	136486	6050	0.0	22.5596694214876
chr11	DPAGT1	119097854	119098043	0	190	589	3974	589	3784	0.0	0.15565539112050739
chr11	DPAGT1	119100629	119100843	0	215	589	3974	589	3759	0.0	0.1566906092045757
chr11	DPAGT1	119101017	119101138	0	122	589	3974	589	3852	0.0	0.15290758047767394
chr11	DPAGT1	119097141	119097297	0	157	589	3974	589	3817	0.0	0.154309667277967
chr11	DPAGT1	119100629	119100877	0	249	589	3974	589	3725	0.0	0.1581208053691275
chr11	DPAGT1	119100629	119100750	0	122	589	3974	589	3852	0.0	0.15290758047767394
chr11	DPAGT1	119100629	119100827	0	199	589	3974	589	3775	0.0	0.15602649006622515
chr11	DPAGT1	119097854	119097925	0	72	589	3974	589	3902	0.0	0.15094823167606355
chr11	DPAGT1	119101017	119101047	0	31	589	3974	589	3943	0.0	0.1493786457012427
chr11	MCAM	119310348	119310466	918	119	3315	6707	2397	6588	7.714285714285714	0.3638433515482696
chr11	MCAM	119315138	119315263	0	126	3315	6707	3315	6581	0.0	0.503722838474396
chr11	C1QTNF5	119340183	119340440	0	258	2435	1540	2435	1282	0.0	1.8993759750390016
chr11	MFRP	119341856	119341984	0	129	3768	4110	3768	3981	0.0	0.9464958553127355
chr11	MFRP	119346271	119346374	86	104	3768	4110	3682	4006	0.8269230769230769	0.9191213180229656
chr11	C1QTNF5	119340291	119340440	0	150	2435	1540	2435	1390	0.0	1.7517985611510791
chr11	USP2	119372706	119373521	0	816	3113	4538	3113	3722	0.0	0.8363782912412682
chr11	THY1	119420868	119420929	0	62	0	2543	0	2481	0.0	0.0
chr11	TRIM29	120116958	120117057	0	100	51	7755	51	7655	0.0	0.00666231221423906
chr11	TRIM29	120113536	120113655	0	120	51	7755	51	7635	0.0	0.0066797642436149315
chr11	AP001150.1	120265326	120265440	0	115	0	2609	0	2494	0.0	0.0
chr11	MIR100HG	122032257	122032310	0	54	189	24445	189	24391	0.0	0.007748759788446558
chr11	MIR100HG	122040216	122040249	0	34	189	24445	189	24411	0.0	0.0077424112080619395
chr11	MIR100HG	122038026	122038243	0	218	189	24445	189	24227	0.0	0.007801213522103438
chr11	MIR100HG	122033313	122033462	0	150	189	24445	189	24295	0.0	0.007779378472936818
chr11	MIR100HG	122066135	122066434	102	300	189	24445	87	24145	0.34	0.0036032304825015533
chr11	MIR100HG	122067382	122067511	0	130	189	24445	189	24315	0.0	0.007772979642196175
chr11	MIR100HG	122034282	122034411	0	130	189	24445	189	24315	0.0	0.007772979642196175
chr11	MIR100HG	122064179	122066434	102	2256	189	24445	87	22189	0.04521276595744681	0.003920861688223895
chr11	MIR100HG	122100373	122101167	0	795	189	24445	189	23650	0.0	0.00799154334038055
chr11	MIR100HG	122100373	122100406	0	34	189	24445	189	24411	0.0	0.0077424112080619395
chr11	MIR100HG	122155550	122155632	0	83	189	24445	189	24362	0.0	0.0077579837451769145
chr11	MIR100HG	122100373	122101029	0	657	189	24445	189	23788	0.0	0.007945182444930216
chr11	MIR100HG	122180335	122180398	0	64	189	24445	189	24381	0.0	0.007751937984496124
chr11	MIR100HG	122202763	122202909	0	147	189	24445	189	24298	0.0	0.007778417976788213
chr11	MIR100HG	122189453	122189525	0	73	189	24445	189	24372	0.0	0.00775480059084195
chr11	MIR100HG	122292283	122292403	0	121	189	24445	189	24324	0.0	0.007770103601381351
chr11	MIR100HG	122293306	122293606	0	301	189	24445	189	24144	0.0	0.007828031809145129
chr11	MIR100HG	122116132	122116323	0	192	189	24445	189	24253	0.0	0.007792850369026512
chr11	MIR100HG	122234280	122234375	0	96	189	24445	189	24349	0.0	0.007762125754651115
chr11	MIR100HG	122384365	122384621	0	257	189	24445	189	24188	0.0	0.007813791962956838
chr11	HSPA8	123060592	123060798	0	207	17697	4221	17697	4014	0.0	4.408819133034379
chr11	HSPA8	123060592	123060675	0	84	17697	4221	17697	4137	0.0	4.27773749093546
chr11	SCN3B	123633111	123633776	0	666	306	7226	306	6560	0.0	0.046646341463414634
chr11	SCN3B	123638776	123638829	0	54	306	7226	306	7172	0.0	0.04266592303402119
chr11	SCN3B	123641341	123641817	0	477	306	7226	306	6749	0.0	0.04534005037783375
chr11	ZNF202	123740392	123740536	0	145	0	4708	0	4563	0.0	0.0
chr11	ZNF202	123740116	123740232	0	117	0	4708	0	4591	0.0	0.0
chr11	ZNF202	123739433	123739543	0	111	0	4708	0	4597	0.0	0.0
chr11	OR10N1P	124108233	124108407	0	175	0	1347	0	1172	0.0	0.0
chr11	ESAM	124756206	124756362	3394	157	162599	2750	159205	2593	21.61783439490446	61.397994600848435
chr11	MSANTD2	124774718	124774974	0	257	28727	4540	28727	4283	0.0	6.707214569227177
chr11	MSANTD2	124774718	124774818	0	101	28727	4540	28727	4439	0.0	6.471502590673575
chr11	MSANTD2	124774718	124774831	0	114	28727	4540	28727	4426	0.0	6.490510619069137
chr11	TMEM218	125101443	125101521	0	79	51	4681	51	4602	0.0	0.01108213820078227
chr11	TMEM218	125110643	125110746	0	104	51	4681	51	4577	0.0	0.011142669871094604
chr11	TMEM218	125110490	125110549	0	60	51	4681	51	4621	0.0	0.01103657217052586
chr11	TMEM218	125102131	125102317	0	187	51	4681	51	4494	0.0	0.011348464619492658
chr11	TMEM218	125102131	125102302	0	172	51	4681	51	4509	0.0	0.011310711909514305
chr11	FEZ1	125463483	125463570	1764	88	862665	9010	860901	8922	20.045454545454547	96.49193006052455
chr11	FEZ1	125460497	125460666	0	170	862665	9010	862665	8840	0.0	97.58653846153847
chr11	FEZ1	125469048	125469156	0	109	862665	9010	862665	8901	0.0	96.91776204920795
chr11	PATE2	125777873	125778002	0	130	51	1670	51	1540	0.0	0.033116883116883114
chr11	PUS3	125895906	125896330	0	425	171	2015	171	1590	0.0	0.10754716981132076
chr11	PUS3	125900678	125900844	171	167	171	2015	0	1848	1.0239520958083832	0.0
chr11	CDON	126010810	126010918	0	109	255	10623	255	10514	0.0	0.024253376450447024
chr11	SRPRA	126268002	126268086	1275	85	7723	4160	6448	4075	15.0	1.5823312883435583
chr11	KIRREL3	126435267	126435303	0	37	0	6615	0	6578	0.0	0.0
chr11	ETS1	128480190	128480451	52	262	52	7163	0	6901	0.1984732824427481	0.0
chr11	KCNJ1	128850720	128850890	0	171	95706	4642	95706	4471	0.0	21.405949452024156
chr11	KCNJ1	128866522	128866655	0	134	95706	4642	95706	4508	0.0	21.23025732031943
chr11	ARHGAP32	129123887	129123929	0	43	102	11572	102	11529	0.0	0.008847254748894093
chr11	NFRKB	129893296	129893385	0	90	28828	6363	28828	6273	0.0	4.595568308624263
chr11	NFRKB	129893061	129893101	0	41	28828	6363	28828	6322	0.0	4.559949383106612
chr11	PRDM10	129912084	129912225	0	142	129	6649	129	6507	0.0	0.0198248040571692
chr11	PRDM10	129929409	129929421	0	13	129	6649	129	6636	0.0	0.019439421338155516
chr11	PRDM10	129955511	129955571	19	61	129	6649	110	6588	0.3114754098360656	0.016697024893746207
chr11	PRDM10	129912123	129912225	0	103	129	6649	129	6546	0.0	0.019706691109074245
chr11	ZBTB44	130236109	130236216	0	108	1992	9568	1992	9460	0.0	0.2105708245243129
chr11	SNX19	130880621	130880806	0	186	1273	15366	1273	15180	0.0	0.08386034255599473
chr11	SNX19	130907952	130908083	0	132	1273	15366	1273	15234	0.0	0.08356308257844296
chr11	SNX19	130914693	130914749	0	57	1273	15366	1273	15309	0.0	0.08315370043765105
chr11	OPCML	132435158	132435185	0	28	0	7595	0	7567	0.0	0.0
chr11	OPCML	132942925	132943010	0	86	0	7595	0	7509	0.0	0.0
chr11	NCAPD3	134216935	134217098	0	164	479	11001	479	10837	0.0	0.044200424471717265
chr11	NCAPD3	134183012	134183153	0	142	479	11001	479	10859	0.0	0.044110875771249655
chr11	THYN1	134248808	134248959	0	152	0	1816	0	1664	0.0	0.0
chr12	IQSEC3	125632	125912	0	281	1643	4806	1643	4525	0.0	0.3630939226519337
chr12	CCDC77	405510	405564	0	55	1468	3567	1468	3512	0.0	0.417995444191344
chr12	CCDC77	409367	409421	0	55	1468	3567	1468	3512	0.0	0.417995444191344
chr12	NINJ2-AS1	632774	632957	0	184	0	4365	0	4181	0.0	0.0
chr12	WNK1	871264	871348	0	85	95456	16067	95456	15982	0.0	5.972719309222875
chr12	WNK1	879572	880031	0	460	95456	16067	95456	15607	0.0	6.116229896841161
chr12	WNK1	882942	883059	0	118	95456	16067	95456	15949	0.0	5.985077434321901
chr12	WNK1	867865	869104	0	1240	95456	16067	95456	14827	0.0	6.437984757536926
chr12	WNK1	901560	901632	0	73	95456	16067	95456	15994	0.0	5.968238089283481
chr12	WNK1	865109	865364	95	256	95456	16067	95361	15811	0.37109375	6.031307317690215
chr12	WNK1	880720	880999	0	280	95456	16067	95456	15787	0.0	6.046493950718946
chr12	WNK1	904452	904494	0	43	95456	16067	95456	16024	0.0	5.957064403394908
chr12	ERC1	1263033	1263165	0	133	37225	12243	37225	12110	0.0	3.073905862923204
chr12	ERC1	1112214	1112298	0	85	37225	12243	37225	12158	0.0	3.061770027965126
chr12	ERC1	1027422	1027539	506	118	37225	12243	36719	12125	4.288135593220339	3.0283711340206185
chr12	ERC1	1204500	1204512	0	13	37225	12243	37225	12230	0.0	3.043744889615699
chr12	ERC1	1410388	1410453	0	66	37225	12243	37225	12177	0.0	3.0569926911390324
chr12	ERC1	1480842	1480898	0	57	37225	12243	37225	12186	0.0	3.054734941736419
chr12	WNT5B	1639683	1639976	476	294	13581	3765	13105	3471	1.619047619047619	3.7755690002881015
chr12	CACNA1C	2648474	2648507	0	34	28574	19162	28574	19128	0.0	1.4938310330405689
chr12	CACNA1C	2681949	2682054	0	106	28574	19162	28574	19056	0.0	1.4994752308984047
chr12	CACNA1C	2597229	2597289	765	61	28574	19162	27809	19101	12.540983606557377	1.4558923616564579
chr12	CACNA1C	2597436	2597496	0	61	28574	19162	28574	19101	0.0	1.4959426208051934
chr12	CACNA1C	2633628	2633712	0	85	28574	19162	28574	19077	0.0	1.4978246055459454
chr12	CACNA1C	2634296	2634380	0	85	28574	19162	28574	19077	0.0	1.4978246055459454
chr12	CACNA1C	2547449	2547524	0	76	28574	19162	28574	19086	0.0	1.4971183066121765
chr12	CACNA1C	2680362	2680575	0	214	28574	19162	28574	18948	0.0	1.5080219548237281
chr12	FKBP4	2796264	2796368	0	105	55500	2595	55500	2490	0.0	22.289156626506024
chr12	ITFG2	2840841	2840995	51	155	212	6111	161	5956	0.32903225806451614	0.027031564808596375
chr12	RHNO1	2885262	2885534	0	273	0	2529	0	2256	0.0	0.0
chr12	RHNO1	2885282	2885492	0	211	0	2529	0	2318	0.0	0.0
chr12	RHNO1	2885161	2885534	0	374	0	2529	0	2155	0.0	0.0
chr12	RHNO1	2877932	2878113	0	182	0	2529	0	2347	0.0	0.0
chr12	RHNO1	2886977	2887111	0	135	0	2529	0	2394	0.0	0.0
chr12	RHNO1	2885282	2885534	0	253	0	2529	0	2276	0.0	0.0
chr12	TULP3	2920762	2920922	642	161	36420	2658	35778	2497	3.987577639751553	14.328394072887464
chr12	TULP3	2930905	2930939	2266	35	36420	2658	34154	2623	64.74285714285715	13.020968356843309
chr12	TULP3	2933417	2933530	12684	114	36420	2658	23736	2544	111.26315789473684	9.330188679245284
chr12	TULP3	2937630	2937729	0	100	36420	2658	36420	2558	0.0	14.237685691946833
chr12	TULP3	2930247	2930345	0	99	36420	2658	36420	2559	0.0	14.232121922626026
chr12	TULP3	2940021	2940081	575	61	36420	2658	35845	2597	9.426229508196721	13.802464381979206
chr12	TEAD4	2994737	2994992	880	256	21171	2289	20291	2033	3.4375	9.980816527299558
chr12	TEAD4	3011003	3011068	0	66	21171	2289	21171	2223	0.0	9.523616734143049
chr12	TEAD4	3017397	3017526	0	130	21171	2289	21171	2159	0.0	9.80592867068087
chr12	TEAD4	3017062	3017095	0	34	21171	2289	21171	2255	0.0	9.388470066518847
chr12	TSPAN9	3083652	3083719	44	68	714	6917	670	6849	0.6470588235294118	0.09782449992699664
chr12	TSPAN9	3206279	3206418	0	140	714	6917	714	6777	0.0	0.10535635236830455
chr12	TSPAN9	3201176	3201256	0	81	714	6917	714	6836	0.0	0.10444704505558806
chr12	AC084375.1	4020979	4021081	0	103	0	1060	0	957	0.0	0.0
chr12	CCND2	4285274	4285316	0	43	143	7998	143	7955	0.0	0.017976115650534256
chr12	RAD51AP1	4546308	4546418	0	111	0	2491	0	2380	0.0	0.0
chr12	RAD51AP1	4556352	4556550	0	199	0	2491	0	2292	0.0	0.0
chr12	RAD51AP1	4545781	4545832	0	52	0	2491	0	2439	0.0	0.0
chr12	RAD51AP1	4556352	4556502	0	151	0	2491	0	2340	0.0	0.0
chr12	RAD51AP1	4545218	4545312	0	95	0	2491	0	2396	0.0	0.0
chr12	DYRK4	4607326	4607387	0	62	7240	7067	7240	7005	0.0	1.033547466095646
chr12	DYRK4	4573329	4573356	0	28	7240	7067	7240	7039	0.0	1.0285551924989345
chr12	DYRK4	4580823	4580977	0	155	7240	7067	7240	6912	0.0	1.0474537037037037
chr12	NDUFA9	4662532	4662635	68	104	24043	9831	23975	9727	0.6538461538461539	2.464788732394366
chr12	AC005833.1	4685258	4685325	0	68	14092	3979	14092	3911	0.0	3.6031705446177447
chr12	AC005906.2	5023523	5023621	0	99	0	7869	0	7770	0.0	0.0
chr12	AC005906.2	4979689	4979775	0	87	0	7869	0	7782	0.0	0.0
chr12	AC005906.2	5021687	5021768	0	82	0	7869	0	7787	0.0	0.0
chr12	AC005906.2	5018301	5018381	0	81	0	7869	0	7788	0.0	0.0
chr12	CD9	6200421	6200565	0	145	0	4900	0	4755	0.0	0.0
chr12	CD9	6200383	6200565	0	183	0	4900	0	4717	0.0	0.0
chr12	CD9	6200892	6200973	0	82	0	4900	0	4818	0.0	0.0
chr12	CD9	6232936	6233005	0	70	0	4900	0	4830	0.0	0.0
chr12	CD9	6205958	6206084	0	127	0	4900	0	4773	0.0	0.0
chr12	LTBR	6386065	6386162	0	98	0	5914	0	5816	0.0	0.0
chr12	LTBR	6388397	6388505	0	109	0	5914	0	5805	0.0	0.0
chr12	LTBR	6387797	6387910	0	114	0	5914	0	5800	0.0	0.0
chr12	TAPBPL	6458644	6458947	0	304	0	3198	0	2894	0.0	0.0
chr12	TAPBPL	6453066	6453297	0	232	0	3198	0	2966	0.0	0.0
chr12	NCAPD2	6510074	6510133	200	60	88638	6409	88438	6349	3.3333333333333335	13.92943770672547
chr12	COPS7A	6724613	6724818	0	206	9	2633	9	2427	0.0	0.003708281829419036
chr12	COPS7A	6730668	6730820	0	153	9	2633	9	2480	0.0	0.0036290322580645163
chr12	COPS7A	6727925	6728001	0	77	9	2633	9	2556	0.0	0.0035211267605633804
chr12	COPS7A	6725864	6725959	0	96	9	2633	9	2537	0.0	0.0035474970437524636
chr12	COPS7A	6727670	6727800	0	131	9	2633	9	2502	0.0	0.0035971223021582736
chr12	COPS7A	6725647	6725757	9	111	9	2633	0	2522	0.08108108108108109	0.0
chr12	CD4	6799537	6799623	196	87	1055	3864	859	3777	2.2528735632183907	0.22742917659518136
chr12	CD4	6800306	6800471	284	166	1055	3864	771	3698	1.7108433734939759	0.20849107625743646
chr12	CD4	6800071	6800187	378	117	1055	3864	677	3747	3.230769230769231	0.1806778756338404
chr12	CD4	6798879	6799074	0	196	1055	3864	1055	3668	0.0	0.2876226826608506
chr12	GPR162	6823467	6823763	0	297	129	2902	129	2605	0.0	0.04952015355086373
chr12	GPR162	6823467	6824765	0	1299	129	2902	129	1603	0.0	0.08047411104179664
chr12	P3H3	6833741	6833809	12513	69	185517	3979	173004	3910	181.34782608695653	44.246547314578
chr12	P3H3	6833743	6833809	12206	67	185517	3979	173311	3912	182.17910447761193	44.30240286298569
chr12	P3H3	6833745	6833809	11902	65	185517	3979	173615	3914	183.1076923076923	44.35743484925907
chr12	GNB3	6840868	6841033	47190	166	338288	2973	291098	2807	284.27710843373495	103.70431065194157
chr12	GNB3	6841772	6841903	518	132	338288	2973	337770	2841	3.9242424242424243	118.89123548046463
chr12	RPL13P5	6882195	6882327	0	133	11313	1337	11313	1204	0.0	9.396179401993356
chr12	LRRC23	6905844	6905954	0	111	348	3064	348	2953	0.0	0.11784625804266848
chr12	LRRC23	6912729	6913027	0	299	348	3064	348	2765	0.0	0.12585895117540688
chr12	LRRC23	6907314	6907445	0	132	348	3064	348	2932	0.0	0.11869031377899045
chr12	LRRC23	6909889	6910026	0	138	348	3064	348	2926	0.0	0.11893369788106631
chr12	ENO2	6922055	6922164	0	110	765	3883	765	3773	0.0	0.20275642724622317
chr12	C12ORF57	6944106	6944173	8	68	32178	1715	32170	1647	0.11764705882352941	19.532483302975105
chr12	PTPN6	6951463	6951520	0	58	355882	4799	355882	4741	0.0	75.06475427125079
chr12	PTPN6	6951608	6951731	144	124	355882	4799	355738	4675	1.1612903225806452	76.09368983957219
chr12	EMG1	6975228	6975378	19869	151	3329812	6141	3309943	5990	131.58278145695365	552.5781302170284
chr12	EMG1	6983001	6983206	51	206	3329812	6141	3329761	5935	0.24757281553398058	561.0380791912385
chr12	C1S	7062474	7062682	0	209	83353	5258	83353	5049	0.0	16.508813626460686
chr12	C1RL-AS1	7110063	7110147	168	85	17718	6108	17550	6023	1.9764705882352942	2.9138303171177156
chr12	C1RL-AS1	7115385	7118677	0	3293	17718	6108	17718	2815	0.0	6.2941385435168735
chr12	PEX5	7199010	7199113	0	104	5387	5387	5387	5283	0.0	1.019685784592088
chr12	PEX5	7190361	7190524	0	164	5387	5387	5387	5223	0.0	1.0313995787861383
chr12	PEX5	7190887	7190923	0	37	5387	5387	5387	5350	0.0	1.0069158878504674
chr12	PEX5	7190021	7190216	0	196	5387	5387	5387	5191	0.0	1.0377576574841072
chr12	PEX5	7202240	7202351	0	112	5387	5387	5387	5275	0.0	1.0212322274881516
chr12	PEX5	7190361	7190569	0	209	5387	5387	5387	5178	0.0	1.0403630745461567
chr12	PEX5	7212771	7212871	0	101	5387	5387	5387	5286	0.0	1.0191070752932274
chr12	NECAP1	8091768	8091850	0	83	2154	8370	2154	8287	0.0	0.25992518402316883
chr12	NECAP1	8092675	8092784	0	110	2154	8370	2154	8260	0.0	0.26077481840193706
chr12	NECAP1	8095600	8095703	16	104	2154	8370	2138	8266	0.15384615384615385	0.2586498911202516
chr12	NECAP1	8091839	8091850	0	12	2154	8370	2154	8358	0.0	0.25771715721464467
chr12	NECAP1	8094650	8094743	0	94	2154	8370	2154	8276	0.0	0.2602706621556307
chr12	CLEC4A	8129263	8129362	0	100	0	1287	0	1187	0.0	0.0
chr12	CLEC4A	8125560	8125677	0	118	0	1287	0	1169	0.0	0.0
chr12	CLEC4A	8135584	8135736	0	153	0	1287	0	1134	0.0	0.0
chr12	FAM66C	8187731	8188225	0	495	53112	4631	53112	4136	0.0	12.841392649903288
chr12	FAM66C	8193519	8193655	0	137	53112	4631	53112	4494	0.0	11.818424566088117
chr12	FAM66C	8195276	8195412	2084	137	53112	4631	51028	4494	15.211678832116789	11.354695149087673
chr12	RIMKLB	8699784	8700614	0	831	671	7829	671	6998	0.0	0.09588453843955416
chr12	AC092490.1	8789999	8790263	17	265	170	2265	153	2000	0.06415094339622641	0.0765
chr12	PHC1	8919755	8919866	0	112	112100	5613	112100	5501	0.0	20.378113070350846
chr12	PHC1	8935123	8935238	35	116	112100	5613	112065	5497	0.3017241379310345	20.38657449517919
chr12	PHC1	8916060	8916069	0	10	112100	5613	112100	5603	0.0	20.007139032661076
chr12	PHC1	8921600	8921750	0	151	112100	5613	112100	5462	0.0	20.52361772244599
chr12	PHC1	8919755	8919917	0	163	112100	5613	112100	5450	0.0	20.568807339449542
chr12	PHC1	8933206	8933350	30724	145	112100	5613	81376	5468	211.8896551724138	14.88222384784199
chr12	KLRG1	8995118	8995288	0	171	0	2466	0	2295	0.0	0.0
chr12	KLRG1	8992205	8992310	0	106	0	2466	0	2360	0.0	0.0
chr12	AC010175.1	9247580	9247677	0	98	102	1292	102	1194	0.0	0.08542713567839195
chr12	LINC02367	9394530	9394657	0	128	89	5657	89	5529	0.0	0.01609694338940134
chr12	LINC02367	9377559	9377610	0	52	89	5657	89	5605	0.0	0.015878679750223015
chr12	AC092821.3	9513559	9513634	0	76	55981	5997	55981	5921	0.0	9.454652930248269
chr12	AC092821.3	9656567	9656649	0	83	55981	5997	55981	5914	0.0	9.465843760568143
chr12	AC092821.3	9655124	9655303	0	180	55981	5997	55981	5817	0.0	9.623689186866082
chr12	AC092821.3	9656567	9656697	0	131	55981	5997	55981	5866	0.0	9.543300375042618
chr12	AC092821.3	9655220	9655303	0	84	55981	5997	55981	5913	0.0	9.467444613563336
chr12	CLEC2D	9680922	9681033	0	112	102	6863	102	6751	0.0	0.015108872759591172
chr12	CLEC2D	9693033	9693115	0	83	102	6863	102	6780	0.0	0.01504424778761062
chr12	CLEC2D	9693415	9693948	102	534	102	6863	0	6329	0.19101123595505617	0.0
chr12	CLEC2D	9692827	9692931	0	105	102	6863	102	6758	0.0	0.015093222846996152
chr12	CLEC2D	9680189	9680251	0	63	102	6863	102	6800	0.0	0.015
chr12	CLEC2D	9692827	9693948	102	1122	102	6863	0	5741	0.09090909090909091	0.0
chr12	CLEC2D	9693824	9693948	0	125	102	6863	102	6738	0.0	0.015138023152270703
chr12	KLRF1	9833302	9833452	639	151	5591	1266	4952	1115	4.231788079470198	4.441255605381166
chr12	KLRF1	9842320	9842433	2077	114	5591	1266	3514	1152	18.219298245614034	3.0503472222222223
chr12	KLRF1	9841811	9841951	0	141	5591	1266	5591	1125	0.0	4.969777777777778
chr12	KLRF1	9842301	9842433	2077	133	5591	1266	3514	1133	15.61654135338346	3.1015004413062663
chr12	CLEC12A	9978965	9979064	0	100	0	3258	0	3158	0.0	0.0
chr12	TMEM52B	10182549	10182593	0	45	0	3474	0	3429	0.0	0.0
chr12	GABARAPL1	10213835	10214187	0	353	0	3148	0	2795	0.0	0.0
chr12	GABARAPL1	10218062	10218141	0	80	0	3148	0	3068	0.0	0.0
chr12	GABARAPL1	10214668	10214779	0	112	0	3148	0	3036	0.0	0.0
chr12	GABARAPL1	10213835	10213974	0	140	0	3148	0	3008	0.0	0.0
chr12	KLRD1	10304465	10304547	0	83	459	15814	459	15731	0.0	0.02917805606763715
chr12	KLRD1	10309387	10309480	0	94	459	15814	459	15720	0.0	0.02919847328244275
chr12	KLRD1	10309625	10309688	0	64	459	15814	459	15750	0.0	0.029142857142857144
chr12	KLRK1-AS1	10374034	10374136	99	103	25635	3848	25536	3745	0.9611650485436893	6.818691588785047
chr12	LINC02366	10776511	10776801	203	291	407	966	204	675	0.697594501718213	0.3022222222222222
chr12	LINC02366	10774805	10774866	0	62	407	966	407	904	0.0	0.4502212389380531
chr12	LINC02366	10775864	10775984	0	121	407	966	407	845	0.0	0.4816568047337278
chr12	LINC02366	10775888	10775984	0	97	407	966	407	869	0.0	0.46835443037974683
chr12	LINC02366	10775891	10775984	0	94	407	966	407	872	0.0	0.46674311926605505
chr12	BCL2L14	12068128	12068222	85	95	118	5083	33	4988	0.8947368421052632	0.006615878107457899
chr12	BCL2L14	12072224	12072499	16	276	118	5083	102	4807	0.057971014492753624	0.021219055543998337
chr12	BCL2L14	12077705	12077978	0	274	118	5083	118	4809	0.0	0.024537325847369517
chr12	BORCS5	12361205	12361349	0	145	51	6525	51	6380	0.0	0.00799373040752351
chr12	APOLD1	12726296	12726373	0	78	89751	7208	89751	7130	0.0	12.587798036465639
chr12	APOLD1	12812260	12812440	0	181	89751	7208	89751	7027	0.0	12.77230681656468
chr12	DDX47	12821207	12821396	0	190	10597	4034	10597	3844	0.0	2.7567637877211237
chr12	DDX47	12823869	12824016	0	148	10597	4034	10597	3886	0.0	2.726968605249614
chr12	GPRC5A	12908242	12909171	2753	930	45623	7667	42870	6737	2.960215053763441	6.363366483598041
chr12	GPRC5D-AS1	12978940	12979021	32220	82	82268	3432	50048	3350	392.9268292682927	14.939701492537313
chr12	GPRC5D-AS1	12966758	12966857	0	100	82268	3432	82268	3332	0.0	24.690276110444177
chr12	GPRC5D-AS1	12979999	12980391	40276	393	82268	3432	41992	3039	102.48346055979644	13.81770319183942
chr12	EMP1	13199177	13199533	0	357	9038	6588	9038	6231	0.0	1.4504894880436527
chr12	EMP1	13213478	13213575	0	98	9038	6588	9038	6490	0.0	1.3926040061633282
chr12	EMP1	13211468	13211588	708	121	9038	6588	8330	6467	5.851239669421488	1.288077934127107
chr12	ATF7IP	14423908	14425473	0	1566	204	12643	204	11077	0.0	0.018416538774036293
chr12	ATF7IP	14457206	14457295	0	90	204	12643	204	12553	0.0	0.016251095355691865
chr12	ATF7IP	14369145	14369324	0	180	204	12643	204	12463	0.0	0.0163684506138169
chr12	ATF7IP	14420301	14420446	0	146	204	12643	204	12497	0.0	0.01632391774025766
chr12	C12ORF60	14829637	14829679	0	43	414	4525	414	4482	0.0	0.09236947791164658
chr12	PTPRO	15501619	15502063	0	445	157	18862	157	18417	0.0	0.008524732584025628
chr12	PTPRO	15551550	15551671	0	122	157	18862	157	18740	0.0	0.008377801494130203
chr12	PTPRO	15560192	15560276	0	85	157	18862	157	18777	0.0	0.008361293071310645
chr12	PTPRO	15565592	15565628	0	37	157	18862	157	18825	0.0	0.008339973439575033
chr12	PTPRO	15570088	15570135	0	48	157	18862	157	18814	0.0	0.008344849580099926
chr12	PTPRO	15569099	15569284	0	186	157	18862	157	18676	0.0	0.008406511030199185
chr12	STRAP	15883540	15883676	0	137	51	2226	51	2089	0.0	0.024413595021541407
chr12	STRAP	15900946	15901012	0	67	51	2226	51	2159	0.0	0.023622047244094488
chr12	STRAP	15883082	15883121	0	40	51	2226	51	2186	0.0	0.02333028362305581
chr12	DERA	15982307	15982436	0	130	8619	2827	8619	2697	0.0	3.195773081201335
chr12	DERA	15916116	15916316	3	201	8619	2827	8616	2626	0.014925373134328358	3.281035795887281
chr12	DERA	15958187	15958335	0	149	8619	2827	8619	2678	0.0	3.2184466019417477
chr12	DERA	15911690	15911753	0	64	8619	2827	8619	2763	0.0	3.1194353963083605
chr12	DERA	15958239	15958335	0	97	8619	2827	8619	2730	0.0	3.157142857142857
chr12	MGST1	16357604	16357699	0	96	102	6231	102	6135	0.0	0.016625916870415647
chr12	MGST1	16354230	16354270	0	41	102	6231	102	6190	0.0	0.016478190630048465
chr12	MGST1	16354230	16354378	0	149	102	6231	102	6082	0.0	0.016770799079250248
chr12	AC092793.1	17069510	17069646	0	137	0	1632	0	1495	0.0	0.0
chr12	AC048352.1	17657281	17657357	0	77	0	4229	0	4152	0.0	0.0
chr12	PIK3C2G	18362763	18362886	0	124	52	6128	52	6004	0.0	0.008660892738174551
chr12	PLEKHA5	19260948	19261021	45	74	234	12573	189	12499	0.6081081081081081	0.015121209696775741
chr12	PLEKHA5	19270187	19270205	0	19	234	12573	234	12554	0.0	0.0186394774573841
chr12	PLEKHA5	19320020	19320056	0	37	234	12573	234	12536	0.0	0.01866624122527122
chr12	PLEKHA5	19346993	19347182	0	190	234	12573	234	12383	0.0	0.01889687474763789
chr12	PLEKHA5	19314813	19314894	0	82	234	12573	234	12491	0.0	0.01873348811144024
chr12	AEBP2	19514670	19514784	0	115	3515	6279	3515	6164	0.0	0.5702465931213497
chr12	AEBP2	19515420	19515434	0	15	3515	6279	3515	6264	0.0	0.5611430395913155
chr12	AC024901.1	20008644	20008767	0	124	0	2765	0	2641	0.0	0.0
chr12	SLCO1C1	20715138	20715285	0	148	48873	4794	48873	4646	0.0	10.519371502367628
chr12	SLCO1B3	20813523	20813638	0	116	0	3560	0	3444	0.0	0.0
chr12	AC022335.1	21089907	21089929	0	23	0	865	0	842	0.0	0.0
chr12	AC022335.1	21119603	21119627	0	25	0	865	0	840	0.0	0.0
chr12	IAPP	21373641	21373733	0	93	0	2157	0	2064	0.0	0.0
chr12	IAPP	21376322	21376364	0	43	0	2157	0	2114	0.0	0.0
chr12	PYROXD1	21441206	21441300	0	95	137	5425	137	5330	0.0	0.025703564727954972
chr12	PYROXD1	21452080	21452154	0	75	137	5425	137	5350	0.0	0.02560747663551402
chr12	PYROXD1	21456864	21457086	0	223	137	5425	137	5202	0.0	0.0263360246059208
chr12	GOLT1B	21506884	21506976	0	93	102	3657	102	3564	0.0	0.02861952861952862
chr12	GOLT1B	21508382	21508561	0	180	102	3657	102	3477	0.0	0.029335634167385678
chr12	GOLT1B	21515237	21515270	0	34	102	3657	102	3623	0.0	0.028153463980126966
chr12	GOLT1B	21507943	21508109	0	167	102	3657	102	3490	0.0	0.029226361031518624
chr12	GOLT1B	21507116	21507151	0	36	102	3657	102	3621	0.0	0.028169014084507043
chr12	CMAS	22055148	22055291	0	144	0	1792	0	1648	0.0	0.0
chr12	CMAS	22058566	22058700	0	135	0	1792	0	1657	0.0	0.0
chr12	CMAS	22061280	22061452	0	173	0	1792	0	1619	0.0	0.0
chr12	AC053513.1	22601351	22601470	0	120	3677	1213	3677	1093	0.0	3.364135407136322
chr12	ETNK1	22682280	22682339	0	60	26737	13315	26737	13255	0.0	2.0171256129762356
chr12	ETNK1	22656431	22656745	0	315	26737	13315	26737	13000	0.0	2.0566923076923076
chr12	AC084816.1	22869320	22869413	0	94	79	6101	79	6007	0.0	0.013151323455968037
chr12	AC084816.1	22787559	22787720	0	162	79	6101	79	5939	0.0	0.013301902677218386
chr12	AC084816.1	23046107	23046201	0	95	79	6101	79	6006	0.0	0.013153513153513154
chr12	AC084816.1	23167038	23167078	0	41	79	6101	79	6060	0.0	0.013036303630363037
chr12	SOX5-AS1	24227710	24227818	0	109	0	3161	0	3052	0.0	0.0
chr12	SOX5-AS1	24230558	24230615	0	58	0	3161	0	3103	0.0	0.0
chr12	SOX5-AS1	24239879	24239998	0	120	0	3161	0	3041	0.0	0.0
chr12	AC023796.1	24771459	24771562	0	104	51	2536	51	2432	0.0	0.020970394736842105
chr12	AC023796.1	24765597	24765691	0	95	51	2536	51	2441	0.0	0.020893076607947564
chr12	AC023796.1	24760615	24760783	0	169	51	2536	51	2367	0.0	0.021546261089987327
chr12	AC023796.1	24760129	24760194	0	66	51	2536	51	2470	0.0	0.020647773279352227
chr12	IRAG2	25061591	25061653	0	63	520	6459	520	6396	0.0	0.08130081300813008
chr12	IRAG2	25066364	25066512	0	149	520	6459	520	6310	0.0	0.08240887480190175
chr12	IRAG2	25104360	25104462	24	103	520	6459	496	6356	0.23300970873786409	0.07803650094398994
chr12	IRAG2	25062819	25062900	0	82	520	6459	520	6377	0.0	0.08154304531911558
chr12	IRAG2	25101937	25102025	121	89	520	6459	399	6370	1.3595505617977528	0.06263736263736264
chr12	ETFRF1	25203724	25203832	0	109	90	2377	90	2268	0.0	0.03968253968253968
chr12	ETFRF1	25203724	25203823	0	100	90	2377	90	2277	0.0	0.039525691699604744
chr12	RASSF8	25995036	25995130	0	95	1836	5419	1836	5324	0.0	0.34485349361382417
chr12	FGFR1OP2	26960514	26960628	0	115	51	5892	51	5777	0.0	0.00882811147654492
chr12	FGFR1OP2	26953548	26953706	0	159	51	5892	51	5733	0.0	0.008895866038723181
chr12	MED21	27026419	27026534	0	116	1268	2970	1268	2854	0.0	0.4442887175893483
chr12	MED21	27060826	27060993	1224	168	1268	2970	44	2802	7.285714285714286	0.015703069236259814
chr12	STK38L	27308338	27308461	0	124	3768	6882	3768	6758	0.0	0.5575614087007991
chr12	STK38L	27312548	27312672	0	125	3768	6882	3768	6757	0.0	0.5576439248187065
chr12	STK38L	27297029	27297158	0	130	3768	6882	3768	6752	0.0	0.5580568720379147
chr12	STK38L	27300553	27300601	0	49	3768	6882	3768	6833	0.0	0.5514415337333528
chr12	ARNTL2	27376345	27376387	220	43	2872	7001	2652	6958	5.116279069767442	0.38114400689853406
chr12	ARNTL2	27418087	27418196	0	110	2872	7001	2872	6891	0.0	0.4167755042809462
chr12	ARNTL2	27370128	27370230	0	103	2872	7001	2872	6898	0.0	0.41635256596114817
chr12	ARNTL2	27370167	27370230	0	64	2872	7001	2872	6937	0.0	0.4140118206717601
chr12	SMCO2	27475581	27475731	8383	151	12286	1987	3903	1836	55.51655629139073	2.1258169934640523
chr12	PPFIBP1	27647728	27647842	0	115	48323	11261	48323	11146	0.0	4.335456666068545
chr12	PPFIBP1	27655142	27655235	256	94	48323	11261	48067	11167	2.723404255319149	4.3043789737619775
chr12	PPFIBP1	27674191	27674221	0	31	48323	11261	48323	11230	0.0	4.303027604630454
chr12	PPFIBP1	27687384	27687507	1936	124	48323	11261	46387	11137	15.612903225806452	4.165125258148514
chr12	PPFIBP1	27658815	27658848	0	34	48323	11261	48323	11227	0.0	4.304177429411241
chr12	PPFIBP1	27677063	27677096	0	34	48323	11261	48323	11227	0.0	4.304177429411241
chr12	MRPS35	27714779	27714820	63	42	982	1939	919	1897	1.5	0.4844491302055878
chr12	MRPS35	27735446	27735556	0	111	982	1939	982	1828	0.0	0.537199124726477
chr12	MRPS35	27725576	27725667	91	92	982	1939	891	1847	0.9891304347826086	0.4824038982133189
chr12	KLHL42	27797246	27797349	0	104	125471	7360	125471	7256	0.0	17.292034178610805
chr12	CCDC91	28304625	28304711	0	87	2676	7033	2676	6946	0.0	0.38525770227469047
chr12	CCDC91	28391303	28391411	0	109	2676	7033	2676	6924	0.0	0.38648180242634317
chr12	CCDC91	28198942	28199056	0	115	2676	7033	2676	6918	0.0	0.3868169991326973
chr12	CCDC91	28412753	28412938	0	186	2676	7033	2676	6847	0.0	0.39082809989776546
chr12	CCDC91	28571216	28571263	0	48	2676	7033	2676	6985	0.0	0.38310665712240516
chr12	CCDC91	28573239	28573338	0	100	2676	7033	2676	6933	0.0	0.3859800951968845
chr12	FAR2	29270411	29270638	0	228	63	5429	63	5201	0.0	0.012113055181695828
chr12	FAR2	29293299	29293475	0	177	63	5429	63	5252	0.0	0.011995430312261995
chr12	FAR2	29291415	29291494	0	80	63	5429	63	5349	0.0	0.011777902411665733
chr12	FAR2	29332844	29332908	0	65	63	5429	63	5364	0.0	0.01174496644295302
chr12	AC010198.2	30798144	30798315	0	172	71602	18419	71602	18247	0.0	3.924042308324656
chr12	AC010198.2	30796982	30797210	0	229	71602	18419	71602	18190	0.0	3.936338647608576
chr12	TSPAN11	30953980	30954075	0	96	41951	7125	41951	7029	0.0	5.968274292217954
chr12	DDX11	31084582	31084669	0	88	36	7413	36	7325	0.0	0.004914675767918089
chr12	DDX11	31089402	31089490	0	89	36	7413	36	7324	0.0	0.004915346805024577
chr12	DDX11	31101832	31101982	0	151	36	7413	36	7262	0.0	0.004957312035251997
chr12	DDX11	31103316	31103395	0	80	36	7413	36	7333	0.0	0.004909314059729988
chr12	DDX11	31084968	31085126	0	159	36	7413	36	7254	0.0	0.004962779156327543
chr12	DDX11	31086024	31086212	0	189	36	7413	36	7224	0.0	0.0049833887043189366
chr12	DDX11	31103321	31103395	0	75	36	7413	36	7338	0.0	0.004905968928863451
chr12	DDX11	31077944	31078288	0	345	36	7413	36	7068	0.0	0.0050933786078098476
chr12	ETFBKMT	31666086	31666217	0	132	1169	6875	1169	6743	0.0	0.17336497108112117
chr12	RESF1	31970188	31970356	0	169	0	6654	0	6485	0.0	0.0
chr12	RESF1	31980877	31985957	0	5081	0	6654	0	1573	0.0	0.0
chr12	RESF1	31987238	31987322	0	85	0	6654	0	6569	0.0	0.0
chr12	BICD1	32338785	32338979	0	195	2181	12614	2181	12419	0.0	0.1756180046702633
chr12	FGD4	32576265	32576449	0	185	3088	7667	3088	7482	0.0	0.4127238706228281
chr12	FGD4	32581959	32582467	0	509	3088	7667	3088	7158	0.0	0.43140542050852193
chr12	FGD4	32600409	32600509	0	101	3088	7667	3088	7566	0.0	0.40814168649220195
chr12	FGD4	32556873	32556995	0	123	3088	7667	3088	7544	0.0	0.4093319194061506
chr12	FGD4	32624658	32624751	0	94	3088	7667	3088	7573	0.0	0.40776442625115544
chr12	FGD4	32637649	32637855	0	207	3088	7667	3088	7460	0.0	0.41394101876675604
chr12	DNM1L	32707366	32707413	0	48	709	7139	709	7091	0.0	0.09998589761669723
chr12	DNM1L	32708152	32708224	0	73	709	7139	709	7066	0.0	0.10033965468440419
chr12	DNM1L	32710928	32711015	0	88	709	7139	709	7051	0.0	0.10055311303361225
chr12	DNM1L	32713208	32713371	0	164	709	7139	709	6975	0.0	0.10164874551971326
chr12	DNM1L	32718642	32718763	0	122	709	7139	709	7017	0.0	0.10104033062562348
chr12	DNM1L	32738263	32738296	0	34	709	7139	709	7105	0.0	0.09978888106966925
chr12	DNM1L	32705824	32705863	0	40	709	7139	709	7099	0.0	0.0998732215805043
chr12	DNM1L	32737864	32737942	0	79	709	7139	709	7060	0.0	0.10042492917847025
chr12	DNM1L	32706689	32706814	0	126	709	7139	709	7013	0.0	0.10109796092970198
chr12	DNM1L	32732537	32732610	0	74	709	7139	709	7065	0.0	0.10035385704175513
chr12	C12ORF40	39643778	39643917	0	140	153	4475	153	4335	0.0	0.03529411764705882
chr12	C12ORF40	39684120	39684312	0	193	153	4475	153	4282	0.0	0.035730966837926204
chr12	LRRK2	40240482	40240617	0	136	1275	11039	1275	10903	0.0	0.11694029166284509
chr12	LRRK2	40257247	40257377	0	131	1275	11039	1275	10908	0.0	0.11688668866886688
chr12	LRRK2	40227890	40227916	0	27	1275	11039	1275	11012	0.0	0.11578278241917908
chr12	LRRK2	40300812	40301064	0	253	1275	11039	1275	10786	0.0	0.11820878917114779
chr12	CNTN1	40910072	40910105	0	34	102	7523	102	7489	0.0	0.013619975964748298
chr12	CNTN1	40895949	40896109	0	161	102	7523	102	7362	0.0	0.013854930725346373
chr12	CNTN1	40763095	40763198	0	104	102	7523	102	7419	0.0	0.013748483623129802
chr12	CNTN1	41061761	41061884	0	124	102	7523	102	7399	0.0	0.013785646709014731
chr12	PDZRN4	41459950	41460070	0	121	588	4885	588	4764	0.0	0.12342569269521411
chr12	PDZRN4	41477864	41477920	23	57	588	4885	565	4828	0.40350877192982454	0.11702568351284176
chr12	LINC02400	41764737	41764806	0	70	0	1273	0	1203	0.0	0.0
chr12	PPHLN1	42351884	42352049	0	166	204	8564	204	8398	0.0	0.024291497975708502
chr12	PPHLN1	42384939	42384996	0	58	204	8564	204	8506	0.0	0.023983070773571598
chr12	PPHLN1	42332659	42332702	0	44	204	8564	204	8520	0.0	0.023943661971830985
chr12	PPHLN1	42374862	42375074	0	213	204	8564	204	8351	0.0	0.024428212190156867
chr12	PPHLN1	42374637	42374733	0	97	204	8564	204	8467	0.0	0.024093539624424235
chr12	PPHLN1	42374955	42375074	0	120	204	8564	204	8444	0.0	0.024159166271909047
chr12	LINC02450	42693827	42693931	0	105	4307	1477	4307	1372	0.0	3.139212827988338
chr12	IRAK4	43768102	43768272	0	171	0	5626	0	5455	0.0	0.0
chr12	IRAK4	43763301	43763456	0	156	0	5626	0	5470	0.0	0.0
chr12	IRAK4	43771219	43771365	0	147	0	5626	0	5479	0.0	0.0
chr12	IRAK4	43771037	43771104	0	68	0	5626	0	5558	0.0	0.0
chr12	IRAK4	43760924	43760972	0	49	0	5626	0	5577	0.0	0.0
chr12	TMEM117	43944209	43944342	0	134	36	3451	36	3317	0.0	0.010853180584865842
chr12	TMEM117	44143524	44143624	0	101	36	3451	36	3350	0.0	0.010746268656716417
chr12	TMEM117	44376594	44376724	0	131	36	3451	36	3320	0.0	0.010843373493975903
chr12	ANO6	45302013	45302093	0	81	2510	8262	2510	8181	0.0	0.30680845862364015
chr12	ANO6	45270461	45270524	0	64	2510	8262	2510	8198	0.0	0.30617223713100755
chr12	ANO6	45228167	45228273	2510	107	2510	8262	0	8155	23.457943925233646	0.0
chr12	ARID2	45904341	45904398	0	58	1345	12025	1345	11967	0.0	0.11239241246761929
chr12	AC008014.1	46470152	46470262	0	111	6346	4863	6346	4752	0.0	1.3354377104377104
chr12	PCED1B	47216221	47216689	0	469	0	2624	0	2155	0.0	0.0
chr12	PCED1B	47223527	47223672	0	146	0	2624	0	2478	0.0	0.0
chr12	PCED1B	47223923	47224039	0	117	0	2624	0	2507	0.0	0.0
chr12	LINC02156	47405079	47405201	0	123	102	2804	102	2681	0.0	0.03804550540842969
chr12	LINC02156	47415083	47415232	0	150	102	2804	102	2654	0.0	0.03843255463451394
chr12	LINC02156	47408430	47408514	0	85	102	2804	102	2719	0.0	0.03751379183523354
chr12	LINC02156	47418184	47418272	0	89	102	2804	102	2715	0.0	0.03756906077348066
chr12	AC004241.1	47717491	47717636	0	146	0	5115	0	4969	0.0	0.0
chr12	AC004241.1	47719599	47719699	0	101	0	5115	0	5014	0.0	0.0
chr12	LINC02354	47832153	47832337	0	185	0	950	0	765	0.0	0.0
chr12	TMEM106C	47966088	47966172	0	85	0	3201	0	3116	0.0	0.0
chr12	TMEM106C	47965837	47965997	0	161	0	3201	0	3040	0.0	0.0
chr12	TMEM106C	47965281	47965345	0	65	0	3201	0	3136	0.0	0.0
chr12	PFKM	48135290	48135383	0	94	6091	6825	6091	6731	0.0	0.904917545684148
chr12	PFKM	48142781	48142946	0	166	6091	6825	6091	6659	0.0	0.9147019071932723
chr12	PFKM	48108071	48108194	0	124	6091	6825	6091	6701	0.0	0.9089688106252798
chr12	PFKM	48107364	48107455	0	92	6091	6825	6091	6733	0.0	0.9046487449873756
chr12	PFKM	48118481	48118577	0	97	6091	6825	6091	6728	0.0	0.9053210463733651
chr12	PFKM	48125324	48125562	1074	239	6091	6825	5017	6586	4.493723849372385	0.761767385362891
chr12	PFKM	48132018	48132211	0	194	6091	6825	6091	6631	0.0	0.9185643191072237
chr12	C12ORF54	48489095	48489294	0	200	3909	1886	3909	1686	0.0	2.3185053380782916
chr12	C12ORF54	48495551	48495595	0	45	3909	1886	3909	1841	0.0	2.1233025529603475
chr12	TEX49	48736087	48736172	4479	86	4636	667	157	581	52.08139534883721	0.270223752151463
chr12	CACNB3	48823680	48823803	0	124	0	6342	0	6218	0.0	0.0
chr12	CACNB3	48824257	48824373	0	117	0	6342	0	6225	0.0	0.0
chr12	CACNB3	48824948	48824968	0	21	0	6342	0	6321	0.0	0.0
chr12	CACNB3	48825162	48825243	0	82	0	6342	0	6260	0.0	0.0
chr12	CACNB3	48824260	48824373	0	114	0	6342	0	6228	0.0	0.0
chr12	CACNB3	48819635	48819942	0	308	0	6342	0	6034	0.0	0.0
chr12	DDN-AS1	49009314	49009389	0	76	29	1408	29	1332	0.0	0.02177177177177177
chr12	DDN-AS1	49009308	49009389	0	82	29	1408	29	1326	0.0	0.021870286576168928
chr12	TUBA1C	49256396	49256511	0	116	20594	3750	20594	3634	0.0	5.667033571821684
chr12	TUBA1C	49257883	49258001	0	119	20594	3750	20594	3631	0.0	5.671715780776646
chr12	TROAP	49323844	49324037	11141	194	793646	3637	782505	3443	57.42783505154639	227.2741794946268
chr12	TROAP	49325500	49325658	3149	159	793646	3637	790497	3478	19.80503144654088	227.28493387004025
chr12	TROAP	49323844	49323946	4907	103	793646	3637	788739	3534	47.640776699029125	223.18590831918505
chr12	DNAJC22	49347643	49348105	0	463	5771	5151	5771	4688	0.0	1.2310153583617747
chr12	SPATS2	49454224	49454385	0	162	61859	6730	61859	6568	0.0	9.418239951278927
chr12	SPATS2	49371227	49371290	0	64	61859	6730	61859	6666	0.0	9.27977797779778
chr12	SPATS2	49512861	49512905	0	45	61859	6730	61859	6685	0.0	9.253403141361257
chr12	SPATS2	49519072	49519182	0	111	61859	6730	61859	6619	0.0	9.345671551593897
chr12	SPATS2	49367519	49367587	0	69	61859	6730	61859	6661	0.0	9.286743732172347
chr12	SPATS2	49441729	49441816	855	88	61859	6730	61004	6642	9.715909090909092	9.18458295694068
chr12	SPATS2	49406472	49406565	5	94	61859	6730	61854	6636	0.05319148936170213	9.320976491862568
chr12	SPATS2	49387053	49387137	0	85	61859	6730	61859	6645	0.0	9.309104589917231
chr12	SPATS2	49486249	49486348	0	100	61859	6730	61859	6630	0.0	9.330165912518854
chr12	KCNH3	49542333	49542408	0	76	7816	4514	7816	4438	0.0	1.7611536728255972
chr12	PRPF40B	49630544	49630625	0	82	3233	8412	3233	8330	0.0	0.3881152460984394
chr12	TMBIM6	49741201	49741329	0	129	4852	5925	4852	5796	0.0	0.8371290545203589
chr12	TMBIM6	49744412	49744542	39	131	4852	5925	4813	5794	0.29770992366412213	0.830686917500863
chr12	TMBIM6	49741956	49742115	0	160	4852	5925	4852	5765	0.0	0.8416305290546401
chr12	TMBIM6	49749617	49749856	51	240	4852	5925	4801	5685	0.2125	0.8445030782761653
chr12	TMBIM6	49743416	49743565	78	150	4852	5925	4774	5775	0.52	0.8266666666666667
chr12	TMBIM6	49741956	49742280	0	325	4852	5925	4852	5600	0.0	0.8664285714285714
chr12	TMBIM6	49742437	49742607	51	171	4852	5925	4801	5754	0.2982456140350877	0.8343760862009038
chr12	LINC02395	49926947	49927083	0	137	63998	6673	63998	6536	0.0	9.791615667074664
chr12	LINC02395	49924139	49924513	40	375	63998	6673	63958	6298	0.10666666666666667	10.15528739282312
chr12	LINC02395	49928970	49929062	0	93	63998	6673	63998	6580	0.0	9.726139817629178
chr12	LINC02395	49921925	49921979	148	55	63998	6673	63850	6618	2.690909090909091	9.647929888183741
chr12	LINC02395	49923781	49923877	0	97	63998	6673	63998	6576	0.0	9.732055961070559
chr12	LINC02395	49928967	49929062	0	96	63998	6673	63998	6577	0.0	9.730576250570168
chr12	LINC02395	49923781	49924000	66	220	63998	6673	63932	6453	0.3	9.907329924066326
chr12	LINC02395	49926080	49926145	222	66	63998	6673	63776	6607	3.3636363636363638	9.652792492810656
chr12	LINC02395	49924330	49924513	0	184	63998	6673	63998	6489	0.0	9.862536600400679
chr12	LINC02395	49923781	49924513	510	733	63998	6673	63488	5940	0.6957708049113234	10.688215488215489
chr12	LINC02395	49925261	49925388	160	128	63998	6673	63838	6545	1.25	9.753705118411
chr12	LINC02395	49926080	49926137	174	58	63998	6673	63824	6615	3.0	9.648374905517763
chr12	ASIC1	50076967	50077049	0	83	13495	4848	13495	4765	0.0	2.832109129066107
chr12	ASIC1	50076967	50077060	0	94	13495	4848	13495	4754	0.0	2.838662179217501
chr12	SMARCD1	50087362	50087485	0	124	8683	4503	8683	4379	0.0	1.9828728020095912
chr12	SMARCD1	50088520	50088637	0	118	8683	4503	8683	4385	0.0	1.9801596351197264
chr12	SMARCD1	50096849	50096972	429	124	8683	4503	8254	4379	3.4596774193548385	1.884905229504453
chr12	GPD1	50104414	50104458	0	45	51	3832	51	3787	0.0	0.013467124372854503
chr12	GPD1	50106287	50106426	0	140	51	3832	51	3692	0.0	0.0138136511375948
chr12	GPD1	50107566	50107800	0	235	51	3832	51	3597	0.0	0.014178482068390326
chr12	COX14	50112831	50112903	0	73	0	974	0	901	0.0	0.0
chr12	COX14	50118492	50118552	0	61	0	974	0	913	0.0	0.0
chr12	LARP4	50453459	50453672	4201	214	105070	8113	100869	7899	19.630841121495326	12.769844284086593
chr12	LARP4	50461134	50461347	1122	214	105070	8113	103948	7899	5.242990654205608	13.159640460817824
chr12	LARP4	50402674	50402813	0	140	105070	8113	105070	7973	0.0	13.178226514486392
chr12	LARP4	50416345	50416434	0	90	105070	8113	105070	8023	0.0	13.096098716190951
chr12	LARP4	50412404	50412453	864	50	105070	8113	104206	8063	17.28	12.923973707056927
chr12	DIP2B	50691048	50691151	0	104	21976	10390	21976	10286	0.0	2.1364962084386545
chr12	ATF1	50788207	50788325	0	119	3330	2841	3330	2722	0.0	1.2233651726671566
chr12	LETMD1	51052091	51052207	0	117	357	3857	357	3740	0.0	0.09545454545454546
chr12	LETMD1	51053777	51053860	0	84	357	3857	357	3773	0.0	0.09461966604823747
chr12	LETMD1	51055834	51056021	51	188	357	3857	306	3669	0.2712765957446808	0.08340147179067865
chr12	LETMD1	51056143	51056245	0	103	357	3857	357	3754	0.0	0.09509856153436334
chr12	LETMD1	51058031	51058128	0	98	357	3857	357	3759	0.0	0.09497206703910614
chr12	LETMD1	51052087	51052207	0	121	357	3857	357	3736	0.0	0.09555674518201285
chr12	LETMD1	51049033	51049185	0	153	357	3857	357	3704	0.0	0.09638228941684665
chr12	LETMD1	51055986	51056021	0	36	357	3857	357	3821	0.0	0.09343103899502748
chr12	LETMD1	51052091	51052246	0	156	357	3857	357	3701	0.0	0.09646041610375575
chr12	LETMD1	51058005	51058128	0	124	357	3857	357	3733	0.0	0.09563353870881329
chr12	LETMD1	51058074	51058128	0	55	357	3857	357	3802	0.0	0.09389794844818516
chr12	DAZAP2	51240342	51240461	0	120	0	3807	0	3687	0.0	0.0
chr12	DAZAP2	51240870	51241039	0	170	0	3807	0	3637	0.0	0.0
chr12	DAZAP2	51240870	51241116	0	247	0	3807	0	3560	0.0	0.0
chr12	DAZAP2	51240966	51241116	0	151	0	3807	0	3656	0.0	0.0
chr12	DAZAP2	51240898	51241116	0	219	0	3807	0	3588	0.0	0.0
chr12	SCN8A	51780648	51780771	0	124	11102	16021	11102	15897	0.0	0.698370761778952
chr12	SCN8A	51768112	51768172	0	61	11102	16021	11102	15960	0.0	0.6956140350877194
chr12	SCN8A	51780201	51780271	0	71	11102	16021	11102	15950	0.0	0.696050156739812
chr12	ANKRD33	51889070	51889196	0	127	2808	2094	2808	1967	0.0	1.42755465175394
chr12	ANKRD33	51889066	51889196	0	131	2808	2094	2808	1963	0.0	1.4304635761589404
chr12	ACVRL1	51913098	51913350	0	253	243	4519	243	4266	0.0	0.056962025316455694
chr12	ACVR1B	51986817	51986942	0	126	0	5670	0	5544	0.0	0.0
chr12	ACVR1B	51982685	51982808	0	124	0	5670	0	5546	0.0	0.0
chr12	ACVR1B	51960055	51960187	0	133	0	5670	0	5537	0.0	0.0
chr12	NR4A1	52052495	52052645	0	151	578	6100	578	5949	0.0	0.09715918641788536
chr12	NR4A1	52052473	52052645	0	173	578	6100	578	5927	0.0	0.0975198245318036
chr12	LINC00592	52212043	52212156	0	114	24	2261	24	2147	0.0	0.011178388448998603
chr12	LINC00592	52212598	52213027	0	430	24	2261	24	1831	0.0	0.013107591480065538
chr12	LINC00592	52213479	52213688	0	210	24	2261	24	2051	0.0	0.011701608971233545
chr12	LINC00592	52221976	52222028	0	53	24	2261	24	2208	0.0	0.010869565217391304
chr12	LINC00592	52222689	52222943	0	255	24	2261	24	2006	0.0	0.011964107676969093
chr12	LINC00592	52221340	52221489	0	150	24	2261	24	2111	0.0	0.011369019422074847
chr12	LINC00592	52222685	52223074	0	390	24	2261	24	1871	0.0	0.012827365045430252
chr12	LINC00592	52222689	52223074	0	386	24	2261	24	1875	0.0	0.0128
chr12	EIF4B	53016472	53016610	0	139	0	5369	0	5230	0.0	0.0
chr12	EIF4B	53022492	53022627	0	136	0	5369	0	5233	0.0	0.0
chr12	EIF4B	53019909	53020026	0	118	0	5369	0	5251	0.0	0.0
chr12	EIF4B	53027781	53027919	0	139	0	5369	0	5230	0.0	0.0
chr12	EIF4B	53025226	53025345	0	120	0	5369	0	5249	0.0	0.0
chr12	EIF4B	53022253	53022366	0	114	0	5369	0	5255	0.0	0.0
chr12	IGFBP6	53099266	53099324	51	59	51	1352	0	1293	0.864406779661017	0.0
chr12	SOAT2	53105560	53105620	0	61	0	2088	0	2027	0.0	0.0
chr12	SOAT2	53118889	53118935	0	47	0	2088	0	2041	0.0	0.0
chr12	ESPL1	53285923	53286912	0	990	1243	7320	1243	6330	0.0	0.19636650868878358
chr12	PFDN5	53295838	53295941	33	104	4909	2927	4876	2823	0.3173076923076923	1.7272405242649664
chr12	PFDN5	53296243	53296275	0	33	4909	2927	4909	2894	0.0	1.6962681409813407
chr12	PFDN5	53296218	53296275	0	58	4909	2927	4909	2869	0.0	1.7110491460439177
chr12	PFDN5	53296429	53296467	0	39	4909	2927	4909	2888	0.0	1.699792243767313
chr12	AC073611.1	53303033	53303193	35	161	119	2859	84	2698	0.21739130434782608	0.031134173461823574
chr12	AC073611.1	53305907	53306060	0	154	119	2859	119	2705	0.0	0.043992606284658044
chr12	PFDN5	53296429	53296551	0	123	4909	2927	4909	2804	0.0	1.7507132667617689
chr12	PFDN5	53297849	53297924	0	76	4909	2927	4909	2851	0.0	1.7218519817607858
chr12	AC073611.1	53303033	53303172	35	140	119	2859	84	2719	0.25	0.030893710923133505
chr12	PFDN5	53296453	53296551	0	99	4909	2927	4909	2828	0.0	1.7358557284299858
chr12	MYG1	53306197	53306320	0	124	821	2506	821	2382	0.0	0.3446683459277918
chr12	AMHR2	53428895	53429010	0	116	116825	3292	116825	3176	0.0	36.783690176322416
chr12	PCBP2	53455346	53455370	0	25	82648	6885	82648	6860	0.0	12.047813411078717
chr12	PCBP2	53464759	53464852	0	94	82648	6885	82648	6791	0.0	12.170225298188779
chr12	PCBP2	53465931	53465973	303	43	82648	6885	82345	6842	7.046511627906977	12.035223618824904
chr12	PCBP2	53467804	53467843	0	40	82648	6885	82648	6845	0.0	12.074214755295836
chr12	PCBP2	53460330	53460425	9437	96	82648	6885	73211	6789	98.30208333333333	10.783767859773162
chr12	TARBP2	53502014	53502184	0	171	204	3979	204	3808	0.0	0.05357142857142857
chr12	TARBP2	53505134	53505262	0	129	204	3979	204	3850	0.0	0.052987012987012985
chr12	TARBP2	53502059	53502184	0	126	204	3979	204	3853	0.0	0.05294575655333506
chr12	TARBP2	53503026	53503129	0	104	204	3979	204	3875	0.0	0.05264516129032258
chr12	AC076968.2	53848858	53848956	0	99	71682	3598	71682	3499	0.0	20.48642469276936
chr12	AC076968.2	53875154	53875248	168	95	71682	3598	71514	3503	1.768421052631579	20.41507279474736
chr12	AC076968.2	53860783	53860878	430	96	71682	3598	71252	3502	4.479166666666667	20.346087949743005
chr12	AC023794.2	54093590	54093646	0	57	918	1667	918	1610	0.0	0.5701863354037268
chr12	AC023794.2	54092601	54092727	0	127	918	1667	918	1540	0.0	0.5961038961038961
chr12	LINC02381	54140245	54140444	0	200	0	4290	0	4090	0.0	0.0
chr12	HNRNPA1	54281385	54281502	0	118	51	4239	51	4121	0.0	0.012375636981315215
chr12	HNRNPA1	54281794	54281941	0	148	51	4239	51	4091	0.0	0.012466389635785871
chr12	HNRNPA1	54282572	54282665	0	94	51	4239	51	4145	0.0	0.012303980699638117
chr12	HNRNPA1	54282799	54282874	0	76	51	4239	51	4163	0.0	0.012250780687004564
chr12	HNRNPA1	54283811	54283967	0	157	51	4239	51	4082	0.0	0.012493875551200392
chr12	HNRNPA1	54284257	54284317	0	61	51	4239	51	4178	0.0	0.012206797510770704
chr12	HNRNPA1	54284239	54284317	0	79	51	4239	51	4160	0.0	0.012259615384615384
chr12	HNRNPA1	54283078	54283234	0	157	51	4239	51	4082	0.0	0.012493875551200392
chr12	HNRNPA1	54282572	54282662	0	91	51	4239	51	4148	0.0	0.012295081967213115
chr12	HNRNPA1	54281352	54281502	0	151	51	4239	51	4088	0.0	0.012475538160469667
chr12	HNRNPA1	54286661	54286732	0	72	51	4239	51	4167	0.0	0.012239020878329733
chr12	HNRNPA1	54283062	54283234	0	173	51	4239	51	4066	0.0	0.012543039842597147
chr12	HNRNPA1	54283791	54283967	0	177	51	4239	51	4062	0.0	0.012555391432791729
chr12	HNRNPA1	54283778	54283967	0	190	51	4239	51	4049	0.0	0.012595702642627809
chr12	HNRNPA1	54283891	54283967	0	77	51	4239	51	4162	0.0	0.0122537241710716
chr12	HNRNPA1	54285973	54286112	0	140	51	4239	51	4099	0.0	0.012442059038789949
chr12	HNRNPA1	54285984	54286112	0	129	51	4239	51	4110	0.0	0.012408759124087591
chr12	HNRNPA1	54285950	54286112	0	163	51	4239	51	4076	0.0	0.012512266928361139
chr12	HNRNPA1	54284517	54284601	0	85	51	4239	51	4154	0.0	0.01227732306210881
chr12	HNRNPA1	54286679	54286732	0	54	51	4239	51	4185	0.0	0.012186379928315413
chr12	COPZ1	54325082	54325181	0	100	39891	3204	39891	3104	0.0	12.851481958762887
chr12	COPZ1	54340546	54340615	0	70	39891	3204	39891	3134	0.0	12.728462029355457
chr12	COPZ1	54343224	54343316	0	93	39891	3204	39891	3111	0.0	12.822565091610414
chr12	COPZ1	54340462	54340615	0	154	39891	3204	39891	3050	0.0	13.079016393442624
chr12	COPZ1	54345459	54345515	0	57	39891	3204	39891	3147	0.0	12.67588179218303
chr12	COPZ1	54346611	54346674	0	64	39891	3204	39891	3140	0.0	12.704140127388534
chr12	COPZ1	54342205	54342287	0	83	39891	3204	39891	3121	0.0	12.781480294777316
chr12	PDE1B	54554216	54554377	0	162	65139	7322	65139	7160	0.0	9.097625698324022
chr12	OR9K2	55126827	55126911	0	85	0	3123	0	3038	0.0	0.0
chr12	BLOC1S1	55716932	55717005	0	74	0	1506	0	1432	0.0	0.0
chr12	RDH5	55721688	55721947	0	260	0	2787	0	2527	0.0	0.0
chr12	ORMDL2	55819090	55819173	0	84	0	2692	0	2608	0.0	0.0
chr12	ORMDL2	55818998	55819173	0	176	0	2692	0	2516	0.0	0.0
chr12	TMEM198B	55831256	55831349	0	94	51	4040	51	3946	0.0	0.012924480486568676
chr12	TMEM198B	55832958	55833014	0	57	51	4040	51	3983	0.0	0.012804418779814211
chr12	TMEM198B	55832958	55833038	0	81	51	4040	51	3959	0.0	0.012882040919424097
chr12	TMEM198B	55832958	55833125	0	168	51	4040	51	3872	0.0	0.013171487603305785
chr12	TMEM198B	55832870	55833014	0	145	51	4040	51	3895	0.0	0.013093709884467265
chr12	TMEM198B	55834568	55834726	0	159	51	4040	51	3881	0.0	0.013140943055913424
chr12	DGKA	55935304	55935404	0	101	0	7520	0	7419	0.0	0.0
chr12	DGKA	55936652	55936856	0	205	0	7520	0	7315	0.0	0.0
chr12	DGKA	55938510	55938560	0	51	0	7520	0	7469	0.0	0.0
chr12	DGKA	55940081	55940170	0	90	0	7520	0	7430	0.0	0.0
chr12	DGKA	55941509	55941584	0	76	0	7520	0	7444	0.0	0.0
chr12	DGKA	55938637	55938698	0	62	0	7520	0	7458	0.0	0.0
chr12	DGKA	55940081	55940168	0	88	0	7520	0	7432	0.0	0.0
chr12	CDK2	55967856	55967934	0	79	321	3698	321	3619	0.0	0.08869853550704615
chr12	CDK2	55969474	55969576	66	103	321	3698	255	3595	0.6407766990291263	0.07093184979137691
chr12	CDK2	55970597	55970741	0	145	321	3698	321	3553	0.0	0.09034618632141853
chr12	RAB5B	55989946	55990098	0	153	188	6535	188	6382	0.0	0.0294578502036979
chr12	RAB5B	55990681	55990804	0	124	188	6535	188	6411	0.0	0.029324598346591794
chr12	RAB5B	55979371	55979474	0	104	188	6535	188	6431	0.0	0.029233400715285338
chr12	RAB5B	55985599	55985723	0	125	188	6535	188	6410	0.0	0.029329173166926677
chr12	RAB5B	55980888	55980922	0	35	188	6535	188	6500	0.0	0.028923076923076923
chr12	SUOX	56002542	56002720	0	179	77	4350	77	4171	0.0	0.01846080076720211
chr12	SUOX	55997614	55997723	26	110	77	4350	51	4240	0.23636363636363636	0.012028301886792454
chr12	SUOX	56002211	56002271	0	61	77	4350	77	4289	0.0	0.01795290277453952
chr12	SUOX	55999332	55999458	0	127	77	4350	77	4223	0.0	0.018233483305706844
chr12	SUOX	55999332	55999590	0	259	77	4350	77	4091	0.0	0.018821803959912002
chr12	SUOX	56001308	56001472	0	165	77	4350	77	4185	0.0	0.018399044205495818
chr12	SUOX	56002603	56002720	0	118	77	4350	77	4232	0.0	0.018194706994328923
chr12	SUOX	56001885	56001948	0	64	77	4350	77	4286	0.0	0.017965468968735417
chr12	IKZF4	56011416	56011494	0	79	0	6273	0	6194	0.0	0.0
chr12	IKZF4	56023670	56023764	0	95	0	6273	0	6178	0.0	0.0
chr12	RPL41	56117188	56117211	132	24	8945	1110	8813	1086	5.5	8.115101289134438
chr12	ESYT1	56142284	56142425	763	142	36392	5186	35629	5044	5.373239436619718	7.063639968279143
chr12	MYL6	56160625	56160670	0	46	18059	3310	18059	3264	0.0	5.532781862745098
chr12	MYL6	56159586	56159730	373	145	18059	3310	17686	3165	2.5724137931034483	5.587993680884676
chr12	MYL6	56159622	56159730	373	109	18059	3310	17686	3201	3.4220183486238533	5.525148391127773
chr12	MYL6	56159586	56159622	0	37	18059	3310	18059	3273	0.0	5.517567980446074
chr12	MYL6	56162562	56162639	0	78	18059	3310	18059	3232	0.0	5.587561881188119
chr12	NABP2	56223583	56223712	92	130	301360	2114	301268	1984	0.7076923076923077	151.84879032258064
chr12	SLC39A5	56230830	56230873	0	44	0	2914	0	2870	0.0	0.0
chr12	SLC39A5	56230239	56230295	0	57	0	2914	0	2857	0.0	0.0
chr12	SLC39A5	56237149	56237340	0	192	0	2914	0	2722	0.0	0.0
chr12	AC073896.2	56312406	56312499	0	94	1479	3830	1479	3736	0.0	0.3958779443254818
chr12	RBMS2	56562416	56562583	0	168	83323	8931	83323	8763	0.0	9.50850165468447
chr12	RBMS2	56568974	56569033	0	60	83323	8931	83323	8871	0.0	9.392740390034945
chr12	RBMS2	56581183	56581263	0	81	83323	8931	83323	8850	0.0	9.415028248587571
chr12	RBMS2	56539685	56539764	0	80	83323	8931	83323	8851	0.0	9.413964523782623
chr12	HSD17B6	56763217	56763414	0	198	164	2281	164	2083	0.0	0.07873259721555449
chr12	NAB2	57093406	57093598	0	193	51	2762	51	2569	0.0	0.01985208252238225
chr12	LRP1	57191319	57191512	0	194	23645	20587	23645	20393	0.0	1.1594664835973127
chr12	NXPH4	57221306	57221544	0	239	51	2155	51	1916	0.0	0.02661795407098121
chr12	SHMT2	57230802	57231000	0	199	0	3713	0	3514	0.0	0.0
chr12	SHMT2	57232452	57232575	0	124	0	3713	0	3589	0.0	0.0
chr12	SHMT2	57231480	57231560	0	81	0	3713	0	3632	0.0	0.0
chr12	SHMT2	57232482	57232575	0	94	0	3713	0	3619	0.0	0.0
chr12	SHMT2	57232424	57232575	0	152	0	3713	0	3561	0.0	0.0
chr12	MARS1	57489895	57489971	6347	77	397713	6060	391366	5983	82.42857142857143	65.41300350994484
chr12	MARS1	57498156	57498273	6527	118	397713	6060	391186	5942	55.313559322033896	65.83406260518343
chr12	MARS1	57489423	57489558	49230	136	397713	6060	348483	5924	361.9852941176471	58.825624577987845
chr12	MARS1	57489266	57489345	10752	80	397713	6060	386961	5980	134.4	64.70919732441472
chr12	MARS1	57489018	57489109	42870	92	397713	6060	354843	5968	465.9782608695652	59.457607238605895
chr12	MARS1	57516138	57516158	0	21	397713	6060	397713	6039	0.0	65.85742672627919
chr12	MBD6	57524028	57524416	0	389	757	4948	757	4559	0.0	0.16604518534766396
chr12	KIF5A	57564107	57564212	42	106	116444	8616	116402	8510	0.39622641509433965	13.678260869565218
chr12	KIF5A	57572579	57572726	2482	148	116444	8616	113962	8468	16.77027027027027	13.457959376476145
chr12	KIF5A	57579185	57579206	0	22	116444	8616	116444	8594	0.0	13.54945310681871
chr12	KIF5A	57582601	57582629	0	29	116444	8616	116444	8587	0.0	13.56049842785606
chr12	KIF5A	57583100	57583215	0	116	116444	8616	116444	8500	0.0	13.699294117647058
chr12	KIF5A	57561517	57561554	0	38	116444	8616	116444	8578	0.0	13.574726043366752
chr12	KIF5A	57582854	57582861	0	8	116444	8616	116444	8608	0.0	13.527416356877323
chr12	KIF5A	57582776	57582861	27	86	116444	8616	116417	8530	0.313953488372093	13.647948417350527
chr12	PIP4K2C	57599399	57599438	7361	40	114363	3262	107002	3222	184.025	33.209807572936064
chr12	PIP4K2C	57595887	57596031	0	145	114363	3262	114363	3117	0.0	36.69008662175168
chr12	PIP4K2C	57597957	57598062	132	106	114363	3262	114231	3156	1.2452830188679245	36.194866920152094
chr12	DTX3	57605988	57606029	2756	42	77103	3005	74347	2963	65.61904761904762	25.091798852514344
chr12	DTX3	57605343	57605731	18481	389	77103	3005	58622	2616	47.508997429305914	22.409021406727827
chr12	DTX3	57605570	57605731	5227	162	77103	3005	71876	2843	32.26543209876543	25.28174463594794
chr12	SLC26A10	57624499	57624606	8016	108	242086	3092	234070	2984	74.22222222222223	78.4416890080429
chr12	SLC26A10	57625235	57625318	36933	84	242086	3092	205153	3008	439.67857142857144	68.20246010638297
chr12	SLC26A10	57622786	57622934	0	149	242086	3092	242086	2943	0.0	82.25823989126741
chr12	SLC26A10	57624723	57624793	42659	71	242086	3092	199427	3021	600.830985915493	66.01357166501158
chr12	SLC26A10	57625235	57625330	41535	96	242086	3092	200551	2996	432.65625	66.93958611481976
chr12	OS9	57694749	57694926	51	178	17230	4766	17179	4588	0.28651685393258425	3.7443330427201396
chr12	OS9	57696274	57696373	0	100	17230	4766	17230	4666	0.0	3.692670381483069
chr12	OS9	57694705	57694926	51	222	17230	4766	17179	4544	0.22972972972972974	3.7805897887323945
chr12	OS9	57720098	57720263	216	166	17230	4766	17014	4600	1.3012048192771084	3.698695652173913
chr12	OS9	57695542	57695677	370	136	17230	4766	16860	4630	2.7205882352941178	3.6414686825053995
chr12	TSPAN31	57746349	57746448	0	100	4742	4546	4742	4446	0.0	1.0665766981556455
chr12	EEF1AKMT3	57774628	57774767	0	140	2554	3164	2554	3024	0.0	0.8445767195767195
chr12	TSFM	57792985	57793073	0	89	3486	3221	3486	3132	0.0	1.1130268199233717
chr12	TSFM	57783940	57784170	0	231	3486	3221	3486	2990	0.0	1.1658862876254181
chr12	TSFM	57783614	57783652	342	39	3486	3221	3144	3182	8.76923076923077	0.9880578252671276
chr12	TSFM	57791964	57792027	0	64	3486	3221	3486	3157	0.0	1.1042128603104213
chr12	TSFM	57802173	57802264	0	92	3486	3221	3486	3129	0.0	1.1140939597315436
chr12	TSFM	57783614	57784170	342	557	3486	3221	3144	2664	0.6140035906642729	1.1801801801801801
chr12	ATP23	57946994	57947076	0	83	31660	3335	31660	3252	0.0	9.735547355473555
chr12	ATP23	57945627	57945673	0	47	31660	3335	31660	3288	0.0	9.628953771289538
chr12	AC020637.1	58803241	58803349	0	109	0	1739	0	1630	0.0	0.0
chr12	AC020637.1	58811921	58812033	0	113	0	1739	0	1626	0.0	0.0
chr12	SLC16A7	59696392	59696524	0	133	0	13706	0	13573	0.0	0.0
chr12	SLC16A7	59734049	59734187	0	139	0	13706	0	13567	0.0	0.0
chr12	SLC16A7	59735929	59735988	0	60	0	13706	0	13646	0.0	0.0
chr12	SLC16A7	59768125	59768323	0	199	0	13706	0	13507	0.0	0.0
chr12	SLC16A7	59733715	59733831	0	117	0	13706	0	13589	0.0	0.0
chr12	USP15	62325871	62325933	0	63	180138	19446	180138	19383	0.0	9.293607800650054
chr12	USP15	62396294	62396398	0	105	180138	19446	180138	19341	0.0	9.313789359391965
chr12	USP15	62312285	62312309	0	25	180138	19446	180138	19421	0.0	9.27542351063282
chr12	USP15	62349220	62349307	0	88	180138	19446	180138	19358	0.0	9.30561008368633
chr12	USP15	62328292	62328405	0	114	180138	19446	180138	19332	0.0	9.31812538795779
chr12	MON2	62544765	62544768	0	4	102	15990	102	15986	0.0	0.006380583010133867
chr12	MON2	62566013	62566031	0	19	102	15990	102	15971	0.0	0.0063865756683989736
chr12	MON2	62588855	62588916	0	62	102	15990	102	15928	0.0	0.0064038171772978405
chr12	MON2	62470700	62470778	0	79	102	15990	102	15911	0.0	0.006410659292313494
chr12	MON2	62490035	62490116	0	82	102	15990	102	15908	0.0	0.006411868242393764
chr12	RXYLT1	63782540	63782704	0	165	0	4507	0	4342	0.0	0.0
chr12	TBK1	64455839	64455957	0	119	25815	12697	25815	12578	0.0	2.052393067260296
chr12	TBK1	64460188	64460329	88	142	25815	12697	25727	12555	0.6197183098591549	2.0491437674233373
chr12	TBK1	64474229	64474390	0	162	25815	12697	25815	12535	0.0	2.059433585959314
chr12	TBK1	64481841	64482021	1054	181	25815	12697	24761	12516	5.823204419889502	1.978347714924896
chr12	TBK1	64488486	64488588	0	103	25815	12697	25815	12594	0.0	2.049785612196284
chr12	TBK1	64490040	64490119	0	80	25815	12697	25815	12617	0.0	2.0460489815328526
chr12	TBK1	64495698	64495775	0	78	25815	12697	25815	12619	0.0	2.0457247008479276
chr12	TBK1	64495981	64496089	0	109	25815	12697	25815	12588	0.0	2.0507626310772165
chr12	TBK1	64497967	64498039	0	73	25815	12697	25815	12624	0.0	2.0449144486692017
chr12	TBK1	64495698	64495772	0	75	25815	12697	25815	12622	0.0	2.045238472508319
chr12	TBK1	64494752	64494977	0	226	25815	12697	25815	12471	0.0	2.0700024055809476
chr12	TBK1	64455815	64455957	0	143	25815	12697	25815	12554	0.0	2.0563167118050023
chr12	TBK1	64460246	64460329	0	84	25815	12697	25815	12613	0.0	2.0466978514231347
chr12	TBK1	64499066	64499280	0	215	25815	12697	25815	12482	0.0	2.068178176574267
chr12	TBK1	64455916	64455957	0	42	25815	12697	25815	12655	0.0	2.039905175819834
chr12	TBK1	64457750	64458018	0	269	25815	12697	25815	12428	0.0	2.0771644673318312
chr12	TBK1	64457907	64458018	0	112	25815	12697	25815	12585	0.0	2.0512514898688914
chr12	TBK1	64479711	64479918	0	208	25815	12697	25815	12489	0.0	2.0670189766994955
chr12	TBK1	64453979	64454181	0	203	25815	12697	25815	12494	0.0	2.0661917720505842
chr12	TBK1	64462472	64462521	0	50	25815	12697	25815	12647	0.0	2.0411955404443742
chr12	TBK1	64464572	64464657	0	86	25815	12697	25815	12611	0.0	2.04702244072635
chr12	TBK1	64485454	64485513	0	60	25815	12697	25815	12637	0.0	2.0428107937010367
chr12	TBK1	64468875	64469289	0	415	25815	12697	25815	12282	0.0	2.101856375183195
chr12	TBK1	64471743	64471995	0	253	25815	12697	25815	12444	0.0	2.074493731918997
chr12	TBK1	64469990	64470108	0	119	25815	12697	25815	12578	0.0	2.052393067260296
chr12	TBK1	64468572	64468672	0	101	25815	12697	25815	12596	0.0	2.04946014607812
chr12	TBK1	64475639	64475845	0	207	25815	12697	25815	12490	0.0	2.066853482786229
chr12	TBK1	64487148	64487311	0	164	25815	12697	25815	12533	0.0	2.059762227718822
chr12	TBK1	64495703	64495775	0	73	25815	12697	25815	12624	0.0	2.0449144486692017
chr12	TBK1	64499066	64499144	0	79	25815	12697	25815	12618	0.0	2.045886828340466
chr12	TBK1	64500104	64500313	0	210	25815	12697	25815	12487	0.0	2.0673500440458077
chr12	RASSF3	64688215	64688453	0	239	7062	4232	7062	3993	0.0	1.7685950413223142
chr12	TBC1D30	64787359	64787381	0	23	163528	9874	163528	9851	0.0	16.600142117551517
chr12	TBC1D30	64830376	64830502	320	127	163528	9874	163208	9747	2.5196850393700787	16.7444341848774
chr12	LINC02389	64900576	64900698	5	123	4288	7783	4283	7660	0.04065040650406504	0.5591383812010444
chr12	LINC02389	64987728	64987855	0	128	4288	7783	4288	7655	0.0	0.5601567602873938
chr12	LINC02389	64884915	64884983	931	69	4288	7783	3357	7714	13.492753623188406	0.43518278454757586
chr12	LINC02389	64885193	64885300	0	108	4288	7783	4288	7675	0.0	0.5586970684039088
chr12	LINC02389	64981619	64981789	0	171	4288	7783	4288	7612	0.0	0.5633210719915922
chr12	LINC02389	64947315	64947462	0	148	4288	7783	4288	7635	0.0	0.5616240995415848
chr12	MSRB3	65308528	65308655	0	128	153	7420	153	7292	0.0	0.020981897970378496
chr12	MSRB3	65306862	65307026	0	165	153	7420	153	7255	0.0	0.021088904203997245
chr12	AC090023.1	65559971	65560044	0	74	0	1031	0	957	0.0	0.0
chr12	HMGA2	65842133	65842254	0	122	816	14141	816	14019	0.0	0.058206719452172054
chr12	HMGA2	65867488	65867807	0	320	816	14141	816	13821	0.0	0.05904059040590406
chr12	HMGA2	65881742	65881890	459	149	816	14141	357	13992	3.0805369127516777	0.02551457975986278
chr12	IRAK3	66203710	66203893	0	184	21702	9701	21702	9517	0.0	2.2803404434170433
chr12	HELB	66313985	66314163	248	179	6312	4541	6064	4362	1.3854748603351956	1.3901879871618523
chr12	DYRK2	67649796	67649945	0	150	28547	9476	28547	9326	0.0	3.0610122238901996
chr12	IFNG-AS1	68006089	68006146	0	58	51	4547	51	4489	0.0	0.011361104923145467
chr12	IFNG-AS1	68013530	68013648	0	119	51	4547	51	4428	0.0	0.011517615176151762
chr12	IFNG-AS1	67989946	67990048	0	103	51	4547	51	4444	0.0	0.011476147614761477
chr12	RAP1B	68648698	68648781	0	84	306	16213	306	16129	0.0	0.018972037944075888
chr12	RAP1B	68651994	68652051	0	58	306	16213	306	16155	0.0	0.01894150417827298
chr12	RAP1B	68654111	68654252	0	142	306	16213	306	16071	0.0	0.01904050774687325
chr12	RAP1B	68656305	68656449	0	145	306	16213	306	16068	0.0	0.019044062733383122
chr12	RAP1B	68657100	68657217	0	118	306	16213	306	16095	0.0	0.0190121155638397
chr12	RAP1B	68624670	68624873	0	204	306	16213	306	16009	0.0	0.019114248235367604
chr12	RAP1B	68624507	68624873	0	367	306	16213	306	15846	0.0	0.019310867095797046
chr12	RAP1B	68624674	68624873	0	200	306	16213	306	16013	0.0	0.0191094735527384
chr12	RAP1B	68641033	68641153	0	121	306	16213	306	16092	0.0	0.01901565995525727
chr12	RAP1B	68641037	68641153	0	117	306	16213	306	16096	0.0	0.01901093439363817
chr12	RAP1B	68648705	68648781	0	77	306	16213	306	16136	0.0	0.018963807635101637
chr12	RAP1B	68650399	68650468	0	70	306	16213	306	16143	0.0	0.018955584463854303
chr12	RAP1B	68648669	68648781	0	113	306	16213	306	16100	0.0	0.019006211180124223
chr12	RAP1B	68647992	68648095	0	104	306	16213	306	16109	0.0	0.01899559252591719
chr12	RAP1B	68621445	68621491	0	47	306	16213	306	16166	0.0	0.018928615613014968
chr12	NUP107	68691967	68692112	0	146	13005	8054	13005	7908	0.0	1.64453717754173
chr12	NUP107	68700725	68700853	0	129	13005	8054	13005	7925	0.0	1.6410094637223975
chr12	NUP107	68725726	68725796	0	71	13005	8054	13005	7983	0.0	1.629086809470124
chr12	MDM2	68813553	68813628	0	76	0	10870	0	10794	0.0	0.0
chr12	MDM2	68816811	68816945	0	135	0	10870	0	10735	0.0	0.0
chr12	MDM2	68824554	68824651	0	98	0	10870	0	10772	0.0	0.0
chr12	MDM2	68828770	68828931	0	162	0	10870	0	10708	0.0	0.0
chr12	MDM2	68836671	68836749	0	79	0	10870	0	10791	0.0	0.0
chr12	MDM2	68820324	68820374	0	51	0	10870	0	10819	0.0	0.0
chr12	MDM2	68814602	68814689	0	88	0	10870	0	10782	0.0	0.0
chr12	MDM2	68835828	68835984	0	157	0	10870	0	10713	0.0	0.0
chr12	MDM2	68815627	68815720	0	94	0	10870	0	10776	0.0	0.0
chr12	MDM2	68824362	68824430	0	69	0	10870	0	10801	0.0	0.0
chr12	MDM2	68820884	68820910	0	27	0	10870	0	10843	0.0	0.0
chr12	MDM2	68819952	68819997	0	46	0	10870	0	10824	0.0	0.0
chr12	MDM2	68823414	68823514	0	101	0	10870	0	10769	0.0	0.0
chr12	AC127894.1	69219454	69219580	236	127	12817	1739	12581	1612	1.858267716535433	7.804590570719603
chr12	CPSF6	69252085	69252216	0	132	5187	7934	5187	7802	0.0	0.6648295308895155
chr12	CPSF6	69255001	69256052	153	1052	5187	7934	5034	6882	0.14543726235741444	0.7314734088927637
chr12	CPSF6	69258034	69258145	0	112	5187	7934	5187	7822	0.0	0.6631296343646126
chr12	LYZ	69352219	69352298	0	80	0	1728	0	1648	0.0	0.0
chr12	YEATS4	69361316	69361433	0	118	51	1790	51	1672	0.0	0.030502392344497607
chr12	YEATS4	69364176	69364299	0	124	51	1790	51	1666	0.0	0.030612244897959183
chr12	FRS2	69480298	69480359	0	62	0	7260	0	7198	0.0	0.0
chr12	FRS2	69569004	69569096	0	93	0	7260	0	7167	0.0	0.0
chr12	FRS2	69486201	69486297	0	97	0	7260	0	7163	0.0	0.0
chr12	FRS2	69537915	69537983	0	69	0	7260	0	7191	0.0	0.0
chr12	FRS2	69557799	69557856	0	58	0	7260	0	7202	0.0	0.0
chr12	FRS2	69491537	69491651	0	115	0	7260	0	7145	0.0	0.0
chr12	CCT2	69597967	69598071	0	105	51	4246	51	4141	0.0	0.012315865732914755
chr12	CCT2	69599862	69600004	0	143	51	4246	51	4103	0.0	0.012429929320009749
chr12	CCT2	69585750	69586009	0	260	51	4246	51	3986	0.0	0.012794781736076268
chr12	RAB3IP	69801608	69801721	561	114	57874	10469	57313	10355	4.921052631578948	5.534814099468855
chr12	RAB3IP	69812777	69812877	0	101	57874	10469	57874	10368	0.0	5.581983024691358
chr12	RAB3IP	69800208	69800337	0	130	57874	10469	57874	10339	0.0	5.597640003868846
chr12	MYRFL	69955362	69955437	0	76	1898	3627	1898	3551	0.0	0.5344973246972684
chr12	CNOT2	70319297	70319364	0	68	6804	10263	6804	10195	0.0	0.6673859735164296
chr12	CNOT2	70330286	70330469	755	184	6804	10263	6049	10079	4.103260869565218	0.6001587459073321
chr12	CNOT2	70342257	70342307	0	51	6804	10263	6804	10212	0.0	0.6662749706227967
chr12	CNOT2	70346179	70346324	0	146	6804	10263	6804	10117	0.0	0.6725313828209943
chr12	CNOT2	70294236	70294294	0	59	6804	10263	6804	10204	0.0	0.666797334378675
chr12	CNOT2	70297758	70297879	0	122	6804	10263	6804	10141	0.0	0.6709397495316044
chr12	CNOT2	70285399	70285586	0	188	6804	10263	6804	10075	0.0	0.6753349875930521
chr12	CNOT2	70301704	70301865	0	162	6804	10263	6804	10101	0.0	0.6735966735966736
chr12	CNOT2	70332766	70332846	0	81	6804	10263	6804	10182	0.0	0.6682380671773719
chr12	CNOT2	70294070	70294294	0	225	6804	10263	6804	10038	0.0	0.6778242677824268
chr12	CNOT2	70290726	70290803	0	78	6804	10263	6804	10185	0.0	0.668041237113402
chr12	CNOT2	70337755	70337820	39	66	6804	10263	6765	10197	0.5909090909090909	0.6634304207119741
chr12	KCNMB4	70422706	70422849	0	144	0	4864	0	4720	0.0	0.0
chr12	AC025569.1	70470212	70470308	0	97	411	6358	411	6261	0.0	0.06564446574029707
chr12	AC025569.1	70522523	70522630	0	108	411	6358	411	6250	0.0	0.06576
chr12	AC025569.1	70527674	70527738	0	65	411	6358	411	6293	0.0	0.06531066264102972
chr12	AC025569.1	70507894	70508001	232	108	411	6358	179	6250	2.1481481481481484	0.02864
chr12	AC025569.1	70510407	70510577	7	171	411	6358	404	6187	0.04093567251461988	0.06529820591562954
chr12	AC025569.1	70520785	70520928	0	144	411	6358	411	6214	0.0	0.06614097199871258
chr12	AC025569.1	70525359	70525426	51	68	411	6358	360	6290	0.75	0.057233704292527825
chr12	LGR5	71553072	71553288	0	217	0	5242	0	5025	0.0	0.0
chr12	LGR5	71561780	71561852	0	73	0	5242	0	5169	0.0	0.0
chr12	TMEM19	71690338	71690430	0	93	102	3519	102	3426	0.0	0.0297723292469352
chr12	TBC1D15	71841100	71841231	0	132	51	8252	51	8120	0.0	0.006280788177339901
chr12	TBC1D15	71880468	71880607	0	140	51	8252	51	8112	0.0	0.00628698224852071
chr12	TBC1D15	71884810	71885021	0	212	51	8252	51	8040	0.0	0.006343283582089552
chr12	TBC1D15	71894324	71894375	0	52	51	8252	51	8200	0.0	0.0062195121951219515
chr12	TBC1D15	71854562	71854602	0	41	51	8252	51	8211	0.0	0.006211180124223602
chr12	TBC1D15	71854784	71854853	0	70	51	8252	51	8182	0.0	0.006233194817892936
chr12	TBC1D15	71861404	71861496	0	93	51	8252	51	8159	0.0	0.006250766025248192
chr12	TPH2	72042824	72042884	0	61	9659	6953	9659	6892	0.0	1.401479976784678
chr12	GLIPR1L1	75369959	75369986	0	28	0	1360	0	1332	0.0	0.0
chr12	GLIPR1L2	75413597	75413701	0	105	0	3778	0	3673	0.0	0.0
chr12	GLIPR1L2	75403016	75403146	0	131	0	3778	0	3647	0.0	0.0
chr12	GLIPR1	75490405	75490518	0	114	0	6217	0	6103	0.0	0.0
chr12	GLIPR1	75487738	75487809	0	72	0	6217	0	6145	0.0	0.0
chr12	LNCOG	76302761	76302879	0	119	1632	2113	1632	1994	0.0	0.8184553660982948
chr12	ZDHHC17	76797433	76797537	0	105	9676	7820	9676	7715	0.0	1.2541801685029164
chr12	ZDHHC17	76809042	76809120	0	79	9676	7820	9676	7741	0.0	1.249967704430952
chr12	ZDHHC17	76821057	76821167	0	111	9676	7820	9676	7709	0.0	1.255156310805552
chr12	ZDHHC17	76781628	76781683	0	56	9676	7820	9676	7764	0.0	1.2462648119526019
chr12	ZDHHC17	76769072	76769201	9246	130	9676	7820	430	7690	71.12307692307692	0.055916775032509754
chr12	ZDHHC17	76813312	76813449	0	138	9676	7820	9676	7682	0.0	1.2595678208799792
chr12	NAV3	77994802	77994871	0	70	0	13128	0	13058	0.0	0.0
chr12	NAV3	78127166	78127208	0	43	0	13128	0	13085	0.0	0.0
chr12	NAV3	78176438	78176459	0	22	0	13128	0	13106	0.0	0.0
chr12	NAV3	78177619	78177685	0	67	0	13128	0	13061	0.0	0.0
chr12	NAV3	78188608	78188777	0	170	0	13128	0	12958	0.0	0.0
chr12	NAV3	78121939	78122428	0	490	0	13128	0	12638	0.0	0.0
chr12	SYT1	79047296	79047362	0	67	0	6410	0	6343	0.0	0.0
chr12	SYT1	78995758	78995847	0	90	0	6410	0	6320	0.0	0.0
chr12	SYT1	79103013	79103055	0	43	0	6410	0	6367	0.0	0.0
chr12	OTOGL	80296826	80296961	255	136	14081	12344	13826	12208	1.875	1.1325360419397117
chr12	OTOGL	80366267	80366353	0	87	14081	12344	14081	12257	0.0	1.1488129232275435
chr12	OTOGL	80361067	80361185	0	119	14081	12344	14081	12225	0.0	1.1518200408997954
chr12	PTPRQ	80422944	80423148	1211	205	1525	12477	314	12272	5.907317073170732	0.025586701434159063
chr12	PTPRQ	80423696	80423833	0	138	1525	12477	1525	12339	0.0	0.1235918631979901
chr12	PTPRQ	80436124	80436382	0	259	1525	12477	1525	12218	0.0	0.12481584547389098
chr12	PTPRQ	80648896	80648923	0	28	1525	12477	1525	12449	0.0	0.12249979918065708
chr12	LINC01490	80764221	80764324	0	104	0	1770	0	1666	0.0	0.0
chr12	LINC01490	80763589	80763704	0	116	0	1770	0	1654	0.0	0.0
chr12	LINC01490	80763589	80763617	0	29	0	1770	0	1741	0.0	0.0
chr12	LINC01490	80763589	80763648	0	60	0	1770	0	1710	0.0	0.0
chr12	LINC01490	80767347	80767656	0	310	0	1770	0	1460	0.0	0.0
chr12	ACSS3	81199659	81199711	0	53	0	16849	0	16796	0.0	0.0
chr12	PPFIA2-AS1	81292342	81292362	0	21	6	2017	6	1996	0.0	0.003006012024048096
chr12	PPFIA2-AS1	81298062	81298163	0	102	6	2017	6	1915	0.0	0.003133159268929504
chr12	PPFIA2-AS1	81284215	81284379	0	165	6	2017	6	1852	0.0	0.0032397408207343412
chr12	AC069228.1	81471161	81471308	0	148	0	9203	0	9055	0.0	0.0
chr12	AC069228.1	81521185	81521250	0	66	0	9203	0	9137	0.0	0.0
chr12	AC069228.1	81424660	81424698	0	39	0	9203	0	9164	0.0	0.0
chr12	METTL25	82369448	82369560	51	113	51	3661	0	3548	0.45132743362831856	0.0
chr12	TMTC2	82857009	82857580	0	572	0	8337	0	7765	0.0	0.0
chr12	AC090679.2	84293927	84294141	0	215	0	1075	0	860	0.0	0.0
chr12	LRRIQ1	85052176	85052251	0	76	4041	8823	4041	8747	0.0	0.4619869669601006
chr12	NTS	85878344	85878569	0	226	0	1559	0	1333	0.0	0.0
chr12	C12ORF29	88045581	88045779	0	199	0	4662	0	4463	0.0	0.0
chr12	C12ORF29	88040147	88040265	0	119	0	4662	0	4543	0.0	0.0
chr12	C12ORF29	88036041	88036073	0	33	0	4662	0	4629	0.0	0.0
chr12	TMTC3	88153290	88153509	0	220	51	7342	51	7122	0.0	0.007160909856781803
chr12	TMTC3	88172965	88173089	0	125	51	7342	51	7217	0.0	0.007066648191769434
chr12	LINC02392	90297073	90297143	0	71	0	2438	0	2367	0.0	0.0
chr12	LINC02822	90679634	90679945	0	312	1	12517	1	12205	0.0	8.19336337566571e-05
chr12	LINC02823	91365116	91365224	0	109	0	1948	0	1839	0.0	0.0
chr12	LINC02823	91356899	91357114	0	216	0	1948	0	1732	0.0	0.0
chr12	LINC02823	91366430	91366473	0	44	0	1948	0	1904	0.0	0.0
chr12	CLLU1	92425377	92425934	0	558	0	6813	0	6255	0.0	0.0
chr12	PLEKHG7	92721384	92721523	0	140	0	5995	0	5855	0.0	0.0
chr12	AC138123.2	93106321	93106414	0	94	0	2993	0	2899	0.0	0.0
chr12	NUDT4	93380987	93381031	0	45	0	10086	0	10041	0.0	0.0
chr12	MRPL42	93476953	93477017	0	65	51	15816	51	15751	0.0	0.003237889657799505
chr12	MRPL42	93470485	93470590	0	106	51	15816	51	15710	0.0	0.003246339910884787
chr12	MRPL42	93470485	93470505	0	21	51	15816	51	15795	0.0	0.003228869895536562
chr12	CRADD	93859318	93859442	0	125	21910	4087	21910	3962	0.0	5.530035335689046
chr12	PLXNC1	94259336	94259375	0	40	2624	9844	2624	9804	0.0	0.26764585883312936
chr12	PLXNC1	94298631	94298795	0	165	2624	9844	2624	9679	0.0	0.271102386610187
chr12	VEZT	95256549	95256622	0	74	349	7893	349	7819	0.0	0.04463486379332395
chr12	VEZT	95258244	95258287	0	44	349	7893	349	7849	0.0	0.04446426296343483
chr12	VEZT	95257149	95257239	0	91	349	7893	349	7802	0.0	0.044732119969238655
chr12	VEZT	95262905	95263081	0	177	349	7893	349	7716	0.0	0.04523068947641265
chr12	VEZT	95224179	95224236	0	58	349	7893	349	7835	0.0	0.04454371410338226
chr12	VEZT	95258244	95258282	0	39	349	7893	349	7854	0.0	0.04443595620066208
chr12	VEZT	95263745	95263797	0	53	349	7893	349	7840	0.0	0.04451530612244898
chr12	VEZT	95243940	95244009	0	70	349	7893	349	7823	0.0	0.04461204141633644
chr12	VEZT	95257153	95257239	0	87	349	7893	349	7806	0.0	0.04470919805277991
chr12	METAP2	95476070	95476178	0	109	2386	4434	2386	4325	0.0	0.5516763005780346
chr12	METAP2	95483214	95483280	0	67	2386	4434	2386	4367	0.0	0.5463705060682391
chr12	METAP2	95511894	95511998	0	105	2386	4434	2386	4329	0.0	0.5511665511665512
chr12	METAP2	95482126	95482210	0	85	2386	4434	2386	4349	0.0	0.5486318693952633
chr12	METAP2	95476142	95476178	0	37	2386	4434	2386	4397	0.0	0.5426427109392767
chr12	METAP2	95476073	95476178	0	106	2386	4434	2386	4328	0.0	0.5512939001848429
chr12	AMDHD1	95954910	95954975	0	66	0	2618	0	2552	0.0	0.0
chr12	ELK3	96246939	96247734	0	796	45123	4653	45123	3857	0.0	11.698988851438942
chr12	ELK3	96198025	96198142	0	118	45123	4653	45123	4535	0.0	9.949944873208379
chr12	CFAP54	96503885	96504029	5	145	10210	12986	10205	12841	0.034482758620689655	0.7947200373802663
chr12	CFAP54	96682141	96682336	0	196	10210	12986	10210	12790	0.0	0.7982799061767005
chr12	NEDD1	96907603	96907624	0	22	1892	4482	1892	4460	0.0	0.4242152466367713
chr12	NEDD1	96907701	96907856	0	156	1892	4482	1892	4326	0.0	0.4373555247341655
chr12	NEDD1	96907603	96907856	0	254	1892	4482	1892	4228	0.0	0.4474929044465468
chr12	NEDD1	96917620	96917737	0	118	1892	4482	1892	4364	0.0	0.43354720439963335
chr12	RMST	97465667	97465727	0	61	78	10114	78	10053	0.0	0.007758877946881528
chr12	RMST	97493176	97493285	0	110	78	10114	78	10004	0.0	0.007796881247501
chr12	RMST	97495930	97496056	0	127	78	10114	78	9987	0.0	0.007810153199158907
chr12	RMST	97564149	97564328	0	180	78	10114	78	9934	0.0	0.007851822025367425
chr12	RMST	97491643	97491712	0	70	78	10114	78	10044	0.0	0.007765830346475508
chr12	RMST	97541205	97541357	0	153	78	10114	78	9961	0.0	0.00783053910249975
chr12	RMST	97551831	97552082	0	252	78	10114	78	9862	0.0	0.007909146217805718
chr12	RMST	97493180	97493285	0	106	78	10114	78	10008	0.0	0.0077937649880095924
chr12	RMST	97483430	97483488	0	59	78	10114	78	10055	0.0	0.007757334659373446
chr12	RMST	97541205	97541308	0	104	78	10114	78	10010	0.0	0.007792207792207792
chr12	TMPO	98544229	98544349	0	121	0	8456	0	8335	0.0	0.0
chr12	TMPO	98544441	98544537	0	97	0	8456	0	8359	0.0	0.0
chr12	TMPO	98544950	98545061	0	112	0	8456	0	8344	0.0	0.0
chr12	SLC25A3	98601170	98601281	0	112	51	7682	51	7570	0.0	0.006737120211360634
chr12	APAF1	98703370	98703499	0	130	127	7025	127	6895	0.0	0.01841914430746918
chr12	APAF1	98725414	98725540	0	127	127	7025	127	6898	0.0	0.018411133661930996
chr12	ACTR6	100210072	100210208	0	137	864	3828	864	3691	0.0	0.23408290436196152
chr12	ACTR6	100208771	100208889	0	119	864	3828	864	3709	0.0	0.23294688595308707
chr12	SCYL2	100282942	100283147	0	206	102	6940	102	6734	0.0	0.015147015147015146
chr12	SCYL2	100317680	100317692	0	13	102	6940	102	6927	0.0	0.014724989172802079
chr12	SCYL2	100319223	100319286	0	64	102	6940	102	6876	0.0	0.014834205933682374
chr12	SCYL2	100327184	100327234	0	51	102	6940	102	6889	0.0	0.014806212803019306
chr12	SLC17A8	100402595	100402745	51	151	5610	4286	5559	4135	0.33774834437086093	1.3443772672309553
chr12	NR1H4	100532457	100532598	0	142	11626	3643	11626	3501	0.0	3.3207654955726937
chr12	NR1H4	100532457	100532610	0	154	11626	3643	11626	3489	0.0	3.332186873029521
chr12	NR1H4	100490815	100490982	0	168	11626	3643	11626	3475	0.0	3.345611510791367
chr12	NR1H4	100499852	100500024	0	173	11626	3643	11626	3470	0.0	3.3504322766570604
chr12	GAS2L3	100591735	100591856	0	122	32798	6817	32798	6695	0.0	4.898879761015683
chr12	GAS2L3	100592373	100592449	0	77	32798	6817	32798	6740	0.0	4.8661721068249255
chr12	GAS2L3	100611007	100611263	2466	257	32798	6817	30332	6560	9.59533073929961	4.623780487804878
chr12	ANO4	100922225	100922330	0	106	10519	5033	10519	4927	0.0	2.1349705703267707
chr12	ANO4	101083677	101083818	0	142	10519	5033	10519	4891	0.0	2.1506849315068495
chr12	ANO4	101079192	101079275	0	84	10519	5033	10519	4949	0.0	2.1254798949282683
chr12	MYBPC1	101636671	101636728	0	58	51	7493	51	7435	0.0	0.006859448554135844
chr12	MYBPC1	101682603	101682662	0	60	51	7493	51	7433	0.0	0.006861294228440737
chr12	MYBPC1	101684381	101684424	0	44	51	7493	51	7449	0.0	0.00684655658477648
chr12	MYBPC1	101614495	101614531	0	37	51	7493	51	7456	0.0	0.006840128755364807
chr12	MYBPC1	101617201	101617243	0	43	51	7493	51	7450	0.0	0.006845637583892617
chr12	MYBPC1	101666743	101666797	0	55	51	7493	51	7438	0.0	0.006856681903737564
chr12	MYBPC1	101626871	101626910	0	40	51	7493	51	7453	0.0	0.006842882060915068
chr12	MYBPC1	101627768	101627804	0	37	51	7493	51	7456	0.0	0.006840128755364807
chr12	MYBPC1	101600359	101600455	0	97	51	7493	51	7396	0.0	0.006895619253650622
chr12	MYBPC1	101621527	101621587	0	61	51	7493	51	7432	0.0	0.00686221743810549
chr12	CHPT1	101719489	101719516	0	28	2127	4140	2127	4112	0.0	0.5172665369649806
chr12	CHPT1	101717236	101717394	0	159	2127	4140	2127	3981	0.0	0.5342878673700076
chr12	DRAM1	101908185	101908363	0	179	0	3949	0	3770	0.0	0.0
chr12	DRAM1	101890087	101890221	0	135	0	3949	0	3814	0.0	0.0
chr12	PARPBP	102148229	102148463	0	235	36787	4762	36787	4527	0.0	8.126132096311023
chr12	PARPBP	102195311	102195447	0	137	36787	4762	36787	4625	0.0	7.953945945945946
chr12	PARPBP	102151569	102151800	0	232	36787	4762	36787	4530	0.0	8.12075055187638
chr12	PARPBP	102150263	102150371	408	109	36787	4762	36379	4653	3.743119266055046	7.81839673329035
chr12	PARPBP	102148234	102148463	0	230	36787	4762	36787	4532	0.0	8.117166813768755
chr12	PARPBP	102182548	102182627	0	80	36787	4762	36787	4682	0.0	7.857112345151645
chr12	AC068643.2	103155222	103155269	0	48	0	2446	0	2398	0.0	0.0
chr12	AC068643.2	103164399	103164437	0	39	0	2446	0	2407	0.0	0.0
chr12	AC068643.2	103164690	103164763	0	74	0	2446	0	2372	0.0	0.0
chr12	AC068643.2	103155146	103155269	0	124	0	2446	0	2322	0.0	0.0
chr12	AC068643.2	103161580	103161630	0	51	0	2446	0	2395	0.0	0.0
chr12	LINC02401	103548667	103548980	0	314	102	4467	102	4153	0.0	0.02456055863231399
chr12	LINC02401	103563675	103563820	0	146	102	4467	102	4321	0.0	0.023605646841009027
chr12	LINC02401	103557408	103557596	0	189	102	4467	102	4278	0.0	0.023842917251051893
chr12	LINC02401	103548854	103548980	0	127	102	4467	102	4340	0.0	0.023502304147465437
chr12	LINC02401	103563678	103563820	0	143	102	4467	102	4324	0.0	0.02358926919518964
chr12	STAB2	103704880	103705027	0	148	89	9297	89	9149	0.0	0.009727839108099245
chr12	HSP90B1	103931710	103931748	0	39	80	4445	80	4406	0.0	0.018157058556513846
chr12	TDG	103967853	103967971	0	119	0	4696	0	4577	0.0	0.0
chr12	TDG	103972959	103973033	0	75	0	4696	0	4621	0.0	0.0
chr12	TDG	103983135	103983218	0	84	0	4696	0	4612	0.0	0.0
chr12	TDG	103976917	103977060	0	144	0	4696	0	4552	0.0	0.0
chr12	HCFC2	104087985	104088038	0	54	0	6717	0	6663	0.0	0.0
chr12	TXNRD1	104311289	104311412	0	124	206226	6737	206226	6613	0.0	31.1849387569938
chr12	TXNRD1	104288930	104289040	0	111	206226	6737	206226	6626	0.0	31.123754904920013
chr12	TXNRD1	104290992	104291104	0	113	206226	6737	206226	6624	0.0	31.133152173913043
chr12	TXNRD1	104289465	104289542	0	78	206226	6737	206226	6659	0.0	30.969514942183512
chr12	TXNRD1	104309758	104310099	48	342	206226	6737	206178	6395	0.14035087719298245	32.240500390930414
chr12	TXNRD1	104309758	104309950	48	193	206226	6737	206178	6544	0.24870466321243523	31.506418092909534
chr12	TXNRD1	104346018	104346155	1606	138	206226	6737	204620	6599	11.63768115942029	31.00772844370359
chr12	C12ORF45	104991711	104991848	0	138	5100	24741	5100	24603	0.0	0.2072917936836971
chr12	WASHC4	105111124	105111264	0	141	11074	7697	11074	7556	0.0	1.465590259396506
chr12	WASHC4	105160000	105160148	0	149	11074	7697	11074	7548	0.0	1.4671436142024377
chr12	WASHC4	105155109	105155208	2080	100	11074	7697	8994	7597	20.8	1.1838883769909174
chr12	C12ORF75	105365806	105365842	0	37	17	2703	17	2666	0.0	0.006376594148537134
chr12	C12ORF75	105348601	105348626	0	26	17	2703	17	2677	0.0	0.00635039223010833
chr12	TCP11L2	106304092	106304231	0	140	0	6342	0	6202	0.0	0.0
chr12	TCP11L2	106312292	106312434	0	143	0	6342	0	6199	0.0	0.0
chr12	TCP11L2	106307281	106307370	0	90	0	6342	0	6252	0.0	0.0
chr12	RFX4	106608796	106608883	0	88	2797	6711	2797	6623	0.0	0.4223161709195229
chr12	RFX4	106662180	106662262	0	83	2797	6711	2797	6628	0.0	0.421997585998793
chr12	RIC8B	106775323	106775425	0	103	0	7787	0	7684	0.0	0.0
chr12	RIC8B	106783996	106784044	0	49	0	7787	0	7738	0.0	0.0
chr12	RIC8B	106814695	106815304	0	610	0	7787	0	7177	0.0	0.0
chr12	RIC8B	106797976	106798069	0	94	0	7787	0	7693	0.0	0.0
chr12	RIC8B	106874480	106874567	0	88	0	7787	0	7699	0.0	0.0
chr12	RIC8B	106870822	106870942	0	121	0	7787	0	7666	0.0	0.0
chr12	RIC8B	106868300	106868423	0	124	0	7787	0	7663	0.0	0.0
chr12	RIC8B	106873031	106873174	0	144	0	7787	0	7643	0.0	0.0
chr12	TMEM263	106959287	106959385	0	99	0	4777	0	4678	0.0	0.0
chr12	TMEM263	106957081	106957149	0	69	0	4777	0	4708	0.0	0.0
chr12	TMEM263	106967282	106967401	0	120	0	4777	0	4657	0.0	0.0
chr12	TMEM263	106959269	106959385	0	117	0	4777	0	4660	0.0	0.0
chr12	BTBD11	107520486	107520636	0	151	51	7936	51	7785	0.0	0.006551059730250481
chr12	WSCD2	108195281	108196214	0	934	384	6757	384	5823	0.0	0.06594538897475528
chr12	WSCD2	108167424	108167581	0	158	384	6757	384	6599	0.0	0.05819063494468859
chr12	WSCD2	108244521	108244581	0	61	384	6757	384	6696	0.0	0.05734767025089606
chr12	ISCU	108567919	108568016	0	98	0	2718	0	2620	0.0	0.0
chr12	ISCU	108567657	108567743	0	87	0	2718	0	2631	0.0	0.0
chr12	ISCU	108564059	108564155	0	97	0	2718	0	2621	0.0	0.0
chr12	ISCU	108567657	108567757	0	101	0	2718	0	2617	0.0	0.0
chr12	DAO	108884997	108885200	0	204	0	2970	0	2766	0.0	0.0
chr12	DAO	108887449	108887564	0	116	0	2970	0	2854	0.0	0.0
chr12	DAO	108889468	108889545	0	78	0	2970	0	2892	0.0	0.0
chr12	USP30	109057925	109058108	0	184	90608	5010	90608	4826	0.0	18.77496891835889
chr12	USP30	109054679	109054792	0	114	90608	5010	90608	4896	0.0	18.50653594771242
chr12	USP30	109056681	109056791	102	111	90608	5010	90506	4899	0.918918918918919	18.474382527046338
chr12	UNG	109101901	109101999	0	99	4674	2552	4674	2453	0.0	1.905421932327762
chr12	ACACB	109247605	109247703	38	99	81568	14561	81530	14462	0.3838383838383838	5.6375328446964454
chr12	ACACB	109260064	109260149	0	86	81568	14561	81568	14475	0.0	5.635094991364421
chr12	UBE3B	109481636	109481742	0	107	121808	11625	121808	11518	0.0	10.575447126237194
chr12	UBE3B	109509595	109509714	0	120	121808	11625	121808	11505	0.0	10.587396784006954
chr12	UBE3B	109517916	109518013	204	98	121808	11625	121604	11527	2.0816326530612246	10.54949249587924
chr12	MVK	109579801	109579946	0	146	51	6501	51	6355	0.0	0.008025177025963809
chr12	MVK	109581394	109581550	0	157	51	6501	51	6344	0.0	0.008039092055485498
chr12	MVK	109575997	109576145	0	149	51	6501	51	6352	0.0	0.00802896725440806
chr12	MVK	109590770	109590861	0	92	51	6501	51	6409	0.0	0.007957559681697613
chr12	MVK	109579164	109579282	0	119	51	6501	51	6382	0.0	0.00799122532121592
chr12	MVK	109590682	109590861	0	180	51	6501	51	6321	0.0	0.008068343616516375
chr12	ANKRD13A	110033796	110033957	102	162	34404	6836	34302	6674	0.6296296296296297	5.139646388972131
chr12	IFT81	110132546	110132636	0	91	0	6495	0	6404	0.0	0.0
chr12	IFT81	110143381	110143545	0	165	0	6495	0	6330	0.0	0.0
chr12	ATP2A2	110322991	110323072	0	82	40266	7473	40266	7391	0.0	5.44797726965228
chr12	ATP2A2	110347392	110347453	0	62	40266	7473	40266	7411	0.0	5.433274861692079
chr12	FAM216A	110485077	110485199	338	123	30811	2675	30473	2552	2.747967479674797	11.940830721003135
chr12	RAD9B	110515049	110515156	0	108	0	3723	0	3615	0.0	0.0
chr12	RAD9B	110512778	110512878	0	101	0	3723	0	3622	0.0	0.0
chr12	RAD9B	110530524	110530633	0	110	0	3723	0	3613	0.0	0.0
chr12	RAD9B	110511427	110511583	0	157	0	3723	0	3566	0.0	0.0
chr12	TCTN1	110619835	110619956	612	122	11632	5815	11020	5693	5.016393442622951	1.9357105216933075
chr12	TCTN1	110634395	110634463	0	69	11632	5815	11632	5746	0.0	2.024364775495997
chr12	TCTN1	110647748	110647893	0	146	11632	5815	11632	5669	0.0	2.0518609984124185
chr12	TCTN1	110634669	110634779	51	111	11632	5815	11581	5704	0.4594594594594595	2.030329593267882
chr12	TCTN1	110616720	110616904	0	185	11632	5815	11632	5630	0.0	2.0660746003552397
chr12	TCTN1	110616276	110616352	0	77	11632	5815	11632	5738	0.0	2.027187173231091
chr12	TCTN1	110628051	110628224	0	174	11632	5815	11632	5641	0.0	2.06204573657153
chr12	TCTN1	110616747	110616904	0	158	11632	5815	11632	5657	0.0	2.0562135407459783
chr12	TCTN1	110627929	110628224	0	296	11632	5815	11632	5519	0.0	2.1076281935133174
chr12	TCTN1	110641023	110641149	0	127	11632	5815	11632	5688	0.0	2.0450070323488045
chr12	TCTN1	110644966	110645129	0	164	11632	5815	11632	5651	0.0	2.058396743939126
chr12	CCDC63	110853404	110853574	0	171	130553	2196	130553	2025	0.0	64.47061728395062
chr12	CCDC63	110879905	110880087	102	183	130553	2196	130451	2013	0.5573770491803278	64.80427223050174
chr12	CCDC63	110852858	110852963	0	106	130553	2196	130553	2090	0.0	62.46555023923445
chr12	LINC01405	110938289	110938512	18480	224	140253	5398	121773	5174	82.5	23.535562427522226
chr12	ACAD10	111712497	111712657	0	161	0	8026	0	7865	0.0	0.0
chr12	ACAD10	111715820	111715962	0	143	0	8026	0	7883	0.0	0.0
chr12	ACAD10	111727961	111728143	0	183	0	8026	0	7843	0.0	0.0
chr12	ACAD10	111729805	111729956	0	152	0	8026	0	7874	0.0	0.0
chr12	ACAD10	111686350	111686374	0	25	0	8026	0	8001	0.0	0.0
chr12	ACAD10	111710272	111710365	0	94	0	8026	0	7932	0.0	0.0
chr12	ALDH2	111783157	111783298	28	142	2647	6558	2619	6416	0.19718309859154928	0.4081982543640898
chr12	ALDH2	111799905	111800063	893	159	2647	6558	1754	6399	5.616352201257862	0.2741053289576496
chr12	ALDH2	111775604	111775720	0	117	2647	6558	2647	6441	0.0	0.41096103089582364
chr12	MAPKAPK5	111868752	111868861	72	110	146701	8890	146629	8780	0.6545454545454545	16.700341685649203
chr12	MAPKAPK5	111882789	111882853	81	65	146701	8890	146620	8825	1.2461538461538462	16.614164305949007
chr12	ERP29	112019755	112019894	0	140	1734	3054	1734	2914	0.0	0.5950583390528483
chr12	TRAFD1	112140118	112140205	0	88	14464	3776	14464	3688	0.0	3.9219088937093276
chr12	TRAFD1	112133139	112133320	0	182	14464	3776	14464	3594	0.0	4.024485253199777
chr12	TRAFD1	112126084	112126149	204	66	14464	3776	14260	3710	3.090909090909091	3.8436657681940702
chr12	RPH3A	112792142	112792263	0	122	46828	9716	46828	9594	0.0	4.880967271211174
chr12	RPH3A	112828300	112828389	0	90	46828	9716	46828	9626	0.0	4.8647413255765635
chr12	RPH3A	112836490	112836502	0	13	46828	9716	46828	9703	0.0	4.826136246521695
chr12	RPH3A	112847695	112847842	0	148	46828	9716	46828	9568	0.0	4.894230769230769
chr12	RPH3A	112718005	112718087	0	83	46828	9716	46828	9633	0.0	4.861206270113152
chr12	RPH3A	112617724	112617842	90	119	46828	9716	46738	9597	0.7563025210084033	4.870063561529645
chr12	RPH3A	112836498	112836502	0	5	46828	9716	46828	9711	0.0	4.822160436618268
chr12	RPH3A	112813321	112813385	0	65	46828	9716	46828	9651	0.0	4.852139674645114
chr12	RPH3A	112831744	112831853	0	110	46828	9716	46828	9606	0.0	4.874869872996044
chr12	OAS3	112941569	112941852	0	284	144397	8177	144397	7893	0.0	18.294311415178004
chr12	OAS2	112987037	112987308	400	272	510	5140	110	4868	1.4705882352941178	0.02259654889071487
chr12	OAS2	112987037	112987083	0	47	510	5140	510	5093	0.0	0.10013744354997055
chr12	CFAP73	113154413	113154635	0	223	0	1734	0	1511	0.0	0.0
chr12	RITA1	113186192	113186316	0	125	0	2313	0	2188	0.0	0.0
chr12	RITA1	113186184	113186316	0	133	0	2313	0	2180	0.0	0.0
chr12	TPCN1	113226727	113226964	0	238	0	8434	0	8196	0.0	0.0
chr12	TPCN1	113225243	113225336	0	94	0	8434	0	8340	0.0	0.0
chr12	TPCN1	113245911	113246063	0	153	0	8434	0	8281	0.0	0.0
chr12	TPCN1	113284717	113284771	0	55	0	8434	0	8379	0.0	0.0
chr12	TPCN1	113288494	113288526	0	33	0	8434	0	8401	0.0	0.0
chr12	PLBD2	113369115	113369209	0	95	8833	5277	8833	5182	0.0	1.7045542261675029
chr12	PLBD2	113384850	113384946	0	97	8833	5277	8833	5180	0.0	1.7052123552123553
chr12	SDSL	113427961	113428156	0	196	2059	2082	2059	1886	0.0	1.091728525980912
chr12	SDSL	113429159	113429299	0	141	2059	2082	2059	1941	0.0	1.0607934054611026
chr12	SDSL	113427129	113427251	0	123	2059	2082	2059	1959	0.0	1.0510464522715672
chr12	AC026765.3	114749843	114750024	0	182	0	2312	0	2130	0.0	0.0
chr12	AC026765.3	114748095	114748210	0	116	0	2312	0	2196	0.0	0.0
chr12	AC026765.3	114752899	114753011	0	113	0	2312	0	2199	0.0	0.0
chr12	RNFT2	116849313	116849484	0	172	271	4472	271	4300	0.0	0.06302325581395349
chr12	RNFT2	116748661	116748744	0	84	271	4472	271	4388	0.0	0.061759343664539654
chr12	RFC5	118017689	118017815	0	127	0	3264	0	3137	0.0	0.0
chr12	RFC5	118017994	118018053	0	60	0	3264	0	3204	0.0	0.0
chr12	RFC5	118017689	118018053	0	365	0	3264	0	2899	0.0	0.0
chr12	RFC5	118017689	118017852	0	164	0	3264	0	3100	0.0	0.0
chr12	SUDS3	118401982	118402004	0	23	51	5572	51	5549	0.0	0.009190845197332853
chr12	SRRM4	119144538	119144554	0	17	153	11922	153	11905	0.0	0.012851742965140698
chr12	HSPB8	119187024	119187088	0	65	0	3593	0	3528	0.0	0.0
chr12	HSPB8	119213676	119213741	0	66	0	3593	0	3527	0.0	0.0
chr12	HSPB8	119187249	119187321	0	73	0	3593	0	3520	0.0	0.0
chr12	HSPB8	119187208	119187321	0	114	0	3593	0	3479	0.0	0.0
chr12	HSPB8	119187191	119187321	0	131	0	3593	0	3462	0.0	0.0
chr12	PRKAB1	119671494	119671668	0	175	0	3766	0	3591	0.0	0.0
chr12	BICDL1	120072510	120072729	0	220	51	5177	51	4957	0.0	0.01028848093605003
chr12	BICDL1	120074442	120074586	0	145	51	5177	51	5032	0.0	0.010135135135135136
chr12	BICDL1	120090910	120091019	0	110	51	5177	51	5067	0.0	0.010065127294256957
chr12	PXN-AS1	120210929	120211106	0	178	2091	4119	2091	3941	0.0	0.5305759959401167
chr12	AC003982.1	120393501	120393577	0	77	0	414	0	337	0.0	0.0
chr12	GATC	120454932	120455030	0	99	0	4421	0	4322	0.0	0.0
chr12	RNF10	120552498	120552698	450	201	398034	5535	397584	5334	2.2388059701492535	74.5376827896513
chr12	RNF10	120562944	120563070	0	127	398034	5535	398034	5408	0.0	73.60096153846153
chr12	RNF10	120566824	120566980	0	157	398034	5535	398034	5378	0.0	74.01152844923763
chr12	RNF10	120571190	120571291	1989	102	398034	5535	396045	5433	19.5	72.8961899503037
chr12	RNF10	120539367	120539468	162	102	398034	5535	397872	5433	1.588235294117647	73.23246824958586
chr12	RNF10	120574467	120574537	11372	71	398034	5535	386662	5464	160.16901408450704	70.76537335285505
chr12	CABP1	120656092	120656272	26728	181	699808	4733	673080	4552	147.6685082872928	147.8646748681898
chr12	MLEC	120695094	120695152	0	59	11657	2623	11657	2564	0.0	4.546411856474259
chr12	MLEC	120694823	120695000	0	178	11657	2623	11657	2445	0.0	4.767689161554192
chr12	HNF1A	120988832	120989032	0	201	167401	4197	167401	3996	0.0	41.89214214214214
chr12	HNF1A	120993519	120993706	0	188	167401	4197	167401	4009	0.0	41.75629832876029
chr12	HNF1A	120994163	120994405	0	243	167401	4197	167401	3954	0.0	42.337126960040464
chr12	P2RX7	121160901	121160974	18013	74	65201	5559	47188	5485	243.4189189189189	8.60309936189608
chr12	P2RX7	121162423	121162520	0	98	65201	5559	65201	5461	0.0	11.939388390404687
chr12	P2RX7	121167487	121167624	876	138	65201	5559	64325	5421	6.3478260869565215	11.865891901863124
chr12	P2RX7	121154784	121154953	18744	170	65201	5559	46457	5389	110.25882352941177	8.62070885136389
chr12	P2RX7	121162270	121162520	0	251	65201	5559	65201	5308	0.0	12.28353428786737
chr12	P2RX7	121166057	121166187	1224	131	65201	5559	63977	5428	9.34351145038168	11.78647752394989
chr12	P2RX7	121155235	121155374	2022	140	65201	5559	63179	5419	14.442857142857143	11.658793135264808
chr12	P2RX4	121217133	121217281	132	149	1248	2757	1116	2608	0.8859060402684564	0.4279141104294479
chr12	P2RX4	121222946	121223043	0	98	1248	2757	1248	2659	0.0	0.46934937946596467
chr12	P2RX4	121216954	121217002	0	49	1248	2757	1248	2708	0.0	0.4608567208271787
chr12	P2RX4	121222729	121222767	0	39	1248	2757	1248	2718	0.0	0.45916114790286977
chr12	P2RX4	121222946	121222962	0	17	1248	2757	1248	2740	0.0	0.4554744525547445
chr12	RNF34	121402741	121402807	0	67	51	4729	51	4662	0.0	0.010939510939510939
chr12	RNF34	121404848	121405113	0	266	51	4729	51	4463	0.0	0.011427291059825229
chr12	TMEM120B	121774657	121774722	0	66	78566	6676	78566	6610	0.0	11.885930408472012
chr12	TMEM120B	121776821	121777897	0	1077	78566	6676	78566	5599	0.0	14.032148597963921
chr12	PSMD9	121899633	121899845	0	213	7947	8780	7947	8567	0.0	0.9276292751254815
chr12	PSMD9	121910941	121911006	0	66	7947	8780	7947	8714	0.0	0.9119807206793665
chr12	PSMD9	121894738	121894841	40	104	7947	8780	7907	8676	0.38461538461538464	0.9113646841862609
chr12	PSMD9	121899633	121899889	0	257	7947	8780	7947	8523	0.0	0.9324181626187962
chr12	AC156455.1	122064549	122064682	408	134	571	1721	163	1587	3.044776119402985	0.10270951480781348
chr12	AC156455.1	122064138	122064433	0	296	571	1721	571	1425	0.0	0.4007017543859649
chr12	MLXIP	122132291	122132383	0	93	72972	13103	72972	13010	0.0	5.60891621829362
chr12	B3GNT4	122204521	122204684	177	164	31644	2353	31467	2189	1.079268292682927	14.37505710370032
chr12	CLIP1-AS1	122396582	122396705	0	124	2958	1812	2958	1688	0.0	1.7523696682464456
chr12	KNTC1	122544158	122544269	0	112	22846	10601	22846	10489	0.0	2.178091333778244
chr12	KNTC1	122617406	122617501	0	96	22846	10601	22846	10505	0.0	2.174773917182294
chr12	CCDC62	122823365	122823459	83	95	8885	4293	8802	4198	0.8736842105263158	2.0967127203430205
chr12	HIP1R	122860422	122860523	0	102	38636	6969	38636	6867	0.0	5.62632881898937
chr12	OGFOD2	122976252	122976401	130	150	43629	3734	43499	3584	0.8666666666666667	12.136997767857142
chr12	OGFOD2	122975810	122975867	0	58	43629	3734	43629	3676	0.0	11.86860718171926
chr12	OGFOD2	122976653	122976767	1905	115	43629	3734	41724	3619	16.565217391304348	11.529151699364466
chr12	OGFOD2	122977980	122978091	0	112	43629	3734	43629	3622	0.0	12.045554942020983
chr12	OGFOD2	122976600	122976767	1989	168	43629	3734	41640	3566	11.839285714285714	11.676948962422882
chr12	OGFOD2	122977980	122978199	0	220	43629	3734	43629	3514	0.0	12.415765509391008
chr12	OGFOD2	122977980	122978057	0	78	43629	3734	43629	3656	0.0	11.933533916849015
chr12	C12ORF65	123233739	123233924	0	186	626801	6318	626801	6132	0.0	102.21803652968036
chr12	KMT5A	123389432	123389554	0	123	723	4523	723	4400	0.0	0.1643181818181818
chr12	TMED2	123587610	123587631	0	22	102	3838	102	3816	0.0	0.026729559748427674
chr12	DDX55	123616510	123616603	338	94	389	5270	51	5176	3.595744680851064	0.009853168469860896
chr12	DDX55	123607431	123607523	0	93	389	5270	389	5177	0.0	0.07514004249565386
chr12	GTF2H3	123639263	123639343	1448	81	6799	3941	5351	3860	17.876543209876544	1.3862694300518135
chr12	GTF2H3	123655770	123655824	92	55	6799	3941	6707	3886	1.6727272727272726	1.7259392691713844
chr12	GTF2H3	123647962	123648126	18	165	6799	3941	6781	3776	0.10909090909090909	1.7958156779661016
chr12	GTF2H3	123639293	123639343	458	51	6799	3941	6341	3890	8.980392156862745	1.6300771208226221
chr12	GTF2H3	123639956	123640001	1152	46	6799	3941	5647	3895	25.043478260869566	1.4498074454428755
chr12	GTF2H3	123654923	123654998	0	76	6799	3941	6799	3865	0.0	1.7591203104786546
chr12	ATP6V0A2	123742028	123742093	6352	66	34249	17237	27897	17171	96.24242424242425	1.624657853357405
chr12	ATP6V0A2	123735892	123736540	3458	649	34249	17237	30791	16588	5.328197226502311	1.8562213648420545
chr12	DNAH10	123793941	123794112	3785	172	128109	16312	124324	16140	22.00581395348837	7.702850061957869
chr12	DNAH10	123932617	123932731	0	115	128109	16312	128109	16197	0.0	7.9094276717910725
chr12	ZNF664	123988042	123988138	0	97	57613	6130	57613	6033	0.0	9.549643626719709
chr12	ZNF664	123988045	123988138	0	94	57613	6130	57613	6036	0.0	9.544897282968854
chr12	AACS	125078095	125078370	0	276	239	16061	239	15785	0.0	0.01514095660437124
chr12	AACS	125136661	125136864	0	204	239	16061	239	15857	0.0	0.015072207857728448
chr12	LINC02826	126030564	126030821	51	258	51	3943	0	3685	0.19767441860465115	0.0
chr12	LINC02826	126027205	126027313	0	109	51	3943	51	3834	0.0	0.013302034428794992
chr12	LINC02826	126028213	126028320	0	108	51	3943	51	3835	0.0	0.013298565840938721
chr12	LINC02359	126111090	126111225	0	136	51	9009	51	8873	0.0	0.005747774146286487
chr12	AC007368.1	126225264	126225314	0	51	51	5841	51	5790	0.0	0.008808290155440414
chr12	AC007368.1	126350458	126350613	51	156	51	5841	0	5685	0.3269230769230769	0.0
chr12	LINC02347	126460882	126461000	0	119	45	5846	45	5727	0.0	0.00785751702462022
chr12	LINC02347	126466548	126466727	0	180	45	5846	45	5666	0.0	0.007942110836569007
chr12	LINC02347	126442965	126443027	0	63	45	5846	45	5783	0.0	0.0077814283243991
chr12	LINC02347	126457932	126458541	0	610	45	5846	45	5236	0.0	0.008594346829640947
chr12	LINC02347	126457932	126458130	0	199	45	5846	45	5647	0.0	0.007968833008677173
chr12	LINC02347	126462717	126462825	0	109	45	5846	45	5737	0.0	0.007843820812271222
chr12	LINC02347	126466548	126467321	0	774	45	5846	45	5072	0.0	0.00887223974763407
chr12	LINC00943	126725582	126725673	0	92	0	8509	0	8417	0.0	0.0
chr12	LINC00943	126742739	126743480	0	742	0	8509	0	7767	0.0	0.0
chr12	LINC00943	126744769	126744919	0	151	0	8509	0	8358	0.0	0.0
chr12	LINC00943	126744769	126744888	0	120	0	8509	0	8389	0.0	0.0
chr12	LINC00943	126744774	126744919	0	146	0	8509	0	8363	0.0	0.0
chr12	LINC00943	126743375	126743480	0	106	0	8509	0	8403	0.0	0.0
chr12	LINC00943	126744774	126744888	0	115	0	8509	0	8394	0.0	0.0
chr12	LINC00943	126743339	126743480	0	142	0	8509	0	8367	0.0	0.0
chr12	AC078878.2	126885864	126885938	0	75	0	1291	0	1216	0.0	0.0
chr12	LINC02393	127893867	127893961	0	95	0	2323	0	2228	0.0	0.0
chr12	LINC00507	127944717	127944799	0	83	663	6567	663	6484	0.0	0.10225169648365207
chr12	LINC00507	127948823	127948958	0	136	663	6567	663	6431	0.0	0.10309438656507541
chr12	LINC00507	127944717	127944787	0	71	663	6567	663	6496	0.0	0.1020628078817734
chr12	LINC00507	127948823	127948922	0	100	663	6567	663	6467	0.0	0.10252048863460646
chr12	LINC00507	127934289	127934349	0	61	663	6567	663	6506	0.0	0.10190593298493698
chr12	LINC00507	127947471	127947949	0	479	663	6567	663	6088	0.0	0.10890275952693824
chr12	LINC00507	127942381	127942980	0	600	663	6567	663	5967	0.0	0.1111111111111111
chr12	LINC00507	127918915	127919115	0	201	663	6567	663	6366	0.0	0.10414703110273327
chr12	GLT1D1	128899235	128899287	0	53	0	3493	0	3440	0.0	0.0
chr12	GLT1D1	128906906	128906954	0	49	0	3493	0	3444	0.0	0.0
chr12	TMEM132D-AS1	129110992	129111139	0	148	0	696	0	548	0.0	0.0
chr12	TMEM132D-AS1	129111419	129111515	0	97	0	696	0	599	0.0	0.0
chr12	TMEM132D-AS1	129111419	129111669	0	251	0	696	0	445	0.0	0.0
chr12	RAN	130872583	130872629	0	47	0	3779	0	3732	0.0	0.0
chr12	RAN	130872583	130872617	0	35	0	3779	0	3744	0.0	0.0
chr12	RAN	130874033	130874084	0	52	0	3779	0	3727	0.0	0.0
chr12	ADGRD1	130981883	130982063	0	181	0	12355	0	12174	0.0	0.0
chr12	ADGRD1	130968976	130969072	0	97	0	12355	0	12258	0.0	0.0
chr12	LINC01257	131215406	131215548	0	143	0	4249	0	4106	0.0	0.0
chr12	LINC01257	131212204	131212286	0	83	0	4249	0	4166	0.0	0.0
chr12	SFSWAP	131764455	131764686	0	232	255	8562	255	8330	0.0	0.030612244897959183
chr12	SFSWAP	131785072	131785228	0	157	255	8562	255	8405	0.0	0.030339083878643664
chr12	MMP17	131838194	131838327	0	134	0	3010	0	2876	0.0	0.0
chr12	PUS1	131929734	131929796	0	63	0	5331	0	5268	0.0	0.0
chr12	EP400	131981488	131981596	0	109	51	16228	51	16119	0.0	0.003163967988088591
chr12	EP400	131963531	131963642	0	112	51	16228	51	16116	0.0	0.0031645569620253164
chr12	EP400P1	132090848	132090943	0	96	0	11921	0	11825	0.0	0.0
chr12	EP400P1	132103996	132105304	0	1309	0	11921	0	10612	0.0	0.0
chr12	EP400P1	132085256	132085316	0	61	0	11921	0	11860	0.0	0.0
chr12	EP400P1	132091394	132091516	0	123	0	11921	0	11798	0.0	0.0
chr12	EP400P1	132084963	132085316	0	354	0	11921	0	11567	0.0	0.0
chr12	EP400P1	132109767	132109832	0	66	0	11921	0	11855	0.0	0.0
chr12	NOC4L	132150980	132151041	0	62	0	2036	0	1974	0.0	0.0
chr12	NOC4L	132146239	132146365	0	127	0	2036	0	1909	0.0	0.0
chr12	FBRSL1	132571067	132571136	100	70	67492	9402	67392	9332	1.4285714285714286	7.221603086155165
chr12	FBRSL1	132574089	132574158	209	70	67492	9402	67283	9332	2.9857142857142858	7.209922846120874
chr12	P2RX2	132619678	132619750	268	73	44489	1867	44221	1794	3.671232876712329	24.649386845039018
chr12	P2RX2	132619843	132619919	173	77	44489	1867	44316	1790	2.2467532467532467	24.757541899441343
chr12	PXMP2	132695883	132696046	0	164	0	1427	0	1263	0.0	0.0
chr12	PXMP2	132701249	132701369	0	121	0	1427	0	1306	0.0	0.0
chr12	PXMP2	132702428	132702564	0	137	0	1427	0	1290	0.0	0.0
chr12	ZNF26	133007436	133007532	0	97	0	4793	0	4696	0.0	0.0
chr12	ZNF26	133001632	133001731	0	100	0	4793	0	4693	0.0	0.0
chr12	ZNF84	133050523	133050586	0	64	816	8823	816	8759	0.0	0.09316131978536363
chr12	ZNF140	133081272	133081329	0	58	652	4746	652	4688	0.0	0.13907849829351535
chr12	ZNF140	133093414	133093505	0	92	652	4746	652	4654	0.0	0.1400945423291792
chr12	ZNF140	133081531	133081613	60	83	652	4746	592	4663	0.7228915662650602	0.1269568947029809
chr12	ZNF140	133100986	133101053	320	68	652	4746	332	4678	4.705882352941177	0.07097050021376657
chr12	ZNF10	133130836	133131014	1050	179	49304	5508	48254	5329	5.865921787709497	9.054982173015576
chr12	ZNF10	133144433	133144525	0	93	49304	5508	49304	5415	0.0	9.105078485687905
chr12	ZNF10	133143519	133143622	0	104	49304	5508	49304	5404	0.0	9.123612139156181
chr12	ZNF10	133139198	133139249	0	52	49304	5508	49304	5456	0.0	9.036656891495602
chr12	ZNF268	133187871	133188072	0	202	534043	14004	534043	13802	0.0	38.69316041153456
chr12	ZNF268	133191488	133191615	0	128	534043	14004	534043	13876	0.0	38.4868117613145
chr12	ZNF268	133193427	133193533	0	107	534043	14004	534043	13897	0.0	38.4286536662589
chr12	ZNF268	133191907	133192003	0	97	534043	14004	534043	13907	0.0	38.40102106852664
chr12	ZNF268	133184663	133184759	0	97	534043	14004	534043	13907	0.0	38.40102106852664
chr12	ZNF268	133187864	133188072	0	209	534043	14004	534043	13795	0.0	38.712794490757524
chr12	ZNF268	133191533	133191615	0	83	534043	14004	534043	13921	0.0	38.36240212628403
chr12	SLC6A12	197899	198003	0	105	0	5131	0	5026	0.0	0.0
chr12	SLC6A12	201761	201849	0	89	0	5131	0	5042	0.0	0.0
chr12	SLC6A12	210204	210568	0	365	0	5131	0	4766	0.0	0.0
chr12	SLC6A12	212025	212110	0	86	0	5131	0	5045	0.0	0.0
chr12	SLC6A13	259850	260057	0	208	0	3973	0	3765	0.0	0.0
chr12	SLC6A13	238170	238343	0	174	0	3973	0	3799	0.0	0.0
chr12	KDM5A	384030	384153	623	124	1919	12060	1296	11936	5.024193548387097	0.10857908847184987
chr12	KDM5A	387247	387274	36	28	1919	12060	1883	12032	1.2857142857142858	0.15649933510638298
chr12	RAD52	932974	933076	0	103	6464	4296	6464	4193	0.0	1.5416169806820892
chr12	RAD52	926795	926946	0	152	6464	4296	6464	4144	0.0	1.5598455598455598
chr12	RAD52	936806	936882	0	77	6464	4296	6464	4219	0.0	1.5321166153116852
chr12	RAD52	931219	931321	0	103	6464	4296	6464	4193	0.0	1.5416169806820892
chr12	CACNA2D4	1810542	1810587	1058	46	32325	7501	31267	7455	23.0	4.194097920858484
chr12	CACNA2D4	1811661	1811723	0	63	32325	7501	32325	7438	0.0	4.345926324280721
chr12	CACNA2D4	1801573	1801644	0	72	32325	7501	32325	7429	0.0	4.351191277426302
chr12	CACNA2D4	1853950	1854044	0	95	32325	7501	32325	7406	0.0	4.364704293815825
chr12	CACNA2D4	1874603	1874675	0	73	32325	7501	32325	7428	0.0	4.351777059773829
chr12	CACNA2D4	1878314	1878389	0	76	32325	7501	32325	7425	0.0	4.353535353535354
chr12	CACNA2D4	1878314	1878441	400	128	32325	7501	31925	7373	3.125	4.329987793299878
chr12	DCP1B	1991120	1991246	0	127	0	4542	0	4415	0.0	0.0
chr12	CACNA1C-AS4	2222199	2222420	0	222	0	1791	0	1569	0.0	0.0
chr12	FOXM1	2865354	2865399	0	46	51	4411	51	4365	0.0	0.01168384879725086
chr12	FOXM1	2872095	2872247	0	153	51	4411	51	4258	0.0	0.011977454203851573
chr12	FOXM1	2872095	2872244	0	150	51	4411	51	4261	0.0	0.011969021356489086
chr12	FOXM1	2861298	2861412	0	115	51	4411	51	4296	0.0	0.011871508379888268
chr12	AC005865.1	3331809	3332392	0	584	0	4670	0	4086	0.0	0.0
chr12	THCAT155	3489928	3490241	0	314	0	6525	0	6211	0.0	0.0
chr12	PARP11	3828909	3829030	0	122	0	3337	0	3215	0.0	0.0
chr12	PARP11	3863835	3863957	0	123	0	3337	0	3214	0.0	0.0
chr12	PARP11	3814994	3815053	0	60	0	3337	0	3277	0.0	0.0
chr12	C12ORF4	4518773	4518880	0	108	304	4948	304	4840	0.0	0.0628099173553719
chr12	C12ORF4	4529868	4530050	0	183	304	4948	304	4765	0.0	0.06379853095487933
chr12	C12ORF4	4536016	4536219	0	204	304	4948	304	4744	0.0	0.06408094435075885
chr12	C12ORF4	4536016	4536211	0	196	304	4948	304	4752	0.0	0.06397306397306397
chr12	C12ORF4	4502310	4502482	0	173	304	4948	304	4775	0.0	0.06366492146596858
chr12	C12ORF4	4536016	4536082	0	67	304	4948	304	4881	0.0	0.062282319196885885
chr12	AKAP3	4641898	4642004	0	107	4508	3678	4508	3571	0.0	1.2623914869784374
chr12	AKAP3	4641898	4642033	0	136	4508	3678	4508	3542	0.0	1.2727272727272727
chr12	LINC02443	5239887	5240112	0	226	204	3988	204	3762	0.0	0.05422647527910686
chr12	LINC02443	5243067	5243281	0	215	204	3988	204	3773	0.0	0.05406838059899284
chr12	LINC02443	5239979	5240112	0	134	204	3988	204	3854	0.0	0.052932018681888945
chr12	ANO2	5732865	5732877	0	13	0	5698	0	5685	0.0	0.0
chr12	ANO2	5836777	5836780	0	4	0	5698	0	5694	0.0	0.0
chr12	ANO2	5851956	5851959	0	4	0	5698	0	5694	0.0	0.0
chr12	VWF	6122724	6122966	0	243	0	10404	0	10161	0.0	0.0
chr12	TNFRSF1A	6330852	6330926	0	75	68010	3562	68010	3487	0.0	19.503871522798967
chr12	TNFRSF1A	6333736	6333865	0	130	68010	3562	68010	3432	0.0	19.816433566433567
chr12	TNFRSF1A	6334090	6334244	0	155	68010	3562	68010	3407	0.0	19.961843263868506
chr12	TNFRSF1A	6333844	6333865	0	22	68010	3562	68010	3540	0.0	19.21186440677966
chr12	TNFRSF1A	6333736	6333838	0	103	68010	3562	68010	3459	0.0	19.66175195143105
chr12	SCNN1A	6349163	6349221	0	59	1142545	5671	1142545	5612	0.0	203.58962936564504
chr12	SCNN1A	6362050	6362241	0	192	1142545	5671	1142545	5479	0.0	208.5316663624749
chr12	SCNN1A	6362067	6362241	0	175	1142545	5671	1142545	5496	0.0	207.88664483260553
chr12	CD27-AS1	6448639	6448737	0	99	291043	3028	291043	2929	0.0	99.36599522021167
chr12	CD27-AS1	6448639	6448757	0	119	291043	3028	291043	2909	0.0	100.04915778618081
chr12	CD27-AS1	6450340	6450980	31284	641	291043	3028	259759	2387	48.80499219968799	108.82237117720989
chr12	VAMP1	6466224	6466351	0	128	153	3275	153	3147	0.0	0.04861773117254528
chr12	MRPL51	6492861	6492972	0	112	41127	1177	41127	1065	0.0	38.6169014084507
chr12	IFFO1	6549475	6549484	0	10	35589	4956	35589	4946	0.0	7.195511524464213
chr12	IFFO1	6551397	6551503	102	107	35589	4956	35487	4849	0.9532710280373832	7.31841616828212
chr12	NOP2	6564149	6564248	0	100	66208	4122	66208	4022	0.0	16.461461959224266
chr12	NOP2	6558015	6558137	1234	123	66208	4122	64974	3999	10.032520325203253	16.247561890472618
chr12	CHD4	6580581	6580699	0	119	724713	11254	724713	11135	0.0	65.08423888639425
chr12	CHD4	6583197	6583378	0	182	724713	11254	724713	11072	0.0	65.4545700867052
chr12	CHD4	6570868	6571032	726	165	724713	11254	723987	11089	4.4	65.28875462169718
chr12	CHD4	6583195	6583378	0	184	724713	11254	724713	11070	0.0	65.46639566395665
chr12	CHD4	6583197	6583375	0	179	724713	11254	724713	11075	0.0	65.43683972911964
chr12	CHD4	6580581	6580679	0	99	724713	11254	724713	11155	0.0	64.96754818467055
chr12	CHD4	6572929	6572984	810	56	724713	11254	723903	11198	14.464285714285714	64.64574031076978
chr12	CHD4	6590072	6590213	0	142	724713	11254	724713	11112	0.0	65.2189524838013
chr12	ACRBP	6646482	6646577	329755	96	11571302	2699	11241547	2603	3434.9479166666665	4318.688820591625
chr12	ING4	6652270	6652418	0	149	153	2186	153	2037	0.0	0.07511045655375552
chr12	ING4	6653229	6653396	0	168	153	2186	153	2018	0.0	0.07581764122893954
chr12	ING4	6656726	6656798	0	73	153	2186	153	2113	0.0	0.07240889730241364
chr12	ING4	6652270	6652309	0	40	153	2186	153	2146	0.0	0.07129543336439888
chr12	ING4	6655637	6655913	153	277	153	2186	0	1909	0.5523465703971119	0.0
chr12	ING4	6657804	6657852	0	49	153	2186	153	2137	0.0	0.07159569489939167
chr12	ZNF384	6678662	6678710	0	49	80964	3521	80964	3472	0.0	23.319124423963135
chr12	ZNF384	6688166	6688226	0	61	80964	3521	80964	3460	0.0	23.4
chr12	ZNF384	6672349	6672532	10770	184	80964	3521	70194	3337	58.53260869565217	21.03506143242433
chr12	ZNF384	6677166	6677259	51	94	80964	3521	80913	3427	0.5425531914893617	23.610446454625038
chr12	CDCA3	6850832	6851009	0	178	12554	4204	12554	4026	0.0	3.118231495280676
chr12	CDCA3	6849322	6849429	0	108	12554	4204	12554	4096	0.0	3.06494140625
chr12	CDCA3	6849322	6849413	0	92	12554	4204	12554	4112	0.0	3.0530155642023344
chr12	PHB2	6965910	6965916	5213	7	312765	2236	307552	2229	744.7142857142857	137.9775684163302
chr12	PHB2	6969497	6969577	16132	81	312765	2236	296633	2155	199.1604938271605	137.64872389791182
chr12	PHB2	6969955	6970063	153	109	312765	2236	312612	2127	1.4036697247706422	146.9732016925247
chr12	LPCAT3	6981003	6981182	4670	180	3123305	4160	3118635	3980	25.944444444444443	783.5766331658291
chr12	LPCAT3	6981594	6981632	401	39	3123305	4160	3122904	4121	10.282051282051283	757.8024751273963
chr12	LPCAT3	7001427	7001486	0	60	3123305	4160	3123305	4100	0.0	761.7817073170731
chr12	C1R	7085860	7086016	14345	157	184783	4719	170438	4562	91.36942675159236	37.36036825953529
chr12	C1R	7091451	7091680	444	230	184783	4719	184339	4489	1.9304347826086956	41.06460236132769
chr12	C1RL	7099685	7099760	0	76	24923	4392	24923	4316	0.0	5.774559777571826
chr12	C1R	7091451	7091636	306	186	184783	4719	184477	4533	1.6451612903225807	40.69644826825502
chr12	C1RL	7099900	7100026	815	127	24923	4392	24108	4265	6.417322834645669	5.652520515826494
chr12	C1RL	7108250	7108479	290	230	24923	4392	24633	4162	1.2608695652173914	5.918548774627583
chr12	CD163L1	7398263	7398584	0	322	2875	5555	2875	5233	0.0	0.5493980508312631
chr12	CD163	7481160	7481256	0	97	233	5760	233	5663	0.0	0.0411442698216493
chr12	CD163	7482642	7482762	0	121	233	5760	233	5639	0.0	0.04131938286930307
chr12	APOBEC1	7654604	7654632	0	29	51	899	51	870	0.0	0.05862068965517241
chr12	CLEC4C	7741420	7741531	0	112	0	1574	0	1462	0.0	0.0
chr12	CLEC4C	7746330	7746423	0	94	0	1574	0	1480	0.0	0.0
chr12	SLC2A14	7831603	7831764	0	162	51	5594	51	5432	0.0	0.00938880706921944
chr12	SLC2A14	7871872	7871948	0	77	51	5594	51	5517	0.0	0.009244154431756389
chr12	SLC2A14	7863368	7863457	0	90	51	5594	51	5504	0.0	0.009265988372093024
chr12	SLC2A14	7871178	7871283	0	106	51	5594	51	5488	0.0	0.009293002915451895
chr12	SLC2A14	7872110	7872372	0	263	51	5594	51	5331	0.0	0.009566685424873381
chr12	SLC2A14	7870840	7871062	0	223	51	5594	51	5371	0.0	0.00949543846583504
chr12	SLC2A14	7839716	7839920	0	205	51	5594	51	5389	0.0	0.00946372239747634
chr12	SLC2A3	7933809	7933902	0	94	0	5763	0	5669	0.0	0.0
chr12	FAM90A1	8225835	8225992	0	158	0	2545	0	2387	0.0	0.0
chr12	FAM90A1	8225835	8226014	0	180	0	2545	0	2365	0.0	0.0
chr12	CLEC4E	8536089	8536205	0	117	0	2107	0	1990	0.0	0.0
chr12	AICDA	8604806	8604922	0	117	0	3111	0	2994	0.0	0.0
chr12	AICDA	8605214	8605485	0	272	0	3111	0	2839	0.0	0.0
chr12	AICDA	8604806	8604892	0	87	0	3111	0	3024	0.0	0.0
chr12	MFAP5	8651661	8651691	0	31	0	3781	0	3750	0.0	0.0
chr12	MFAP5	8660862	8660898	0	37	0	3781	0	3744	0.0	0.0
chr12	MFAP5	8654436	8654481	0	46	0	3781	0	3735	0.0	0.0
chr12	MFAP5	8648486	8648555	0	70	0	3781	0	3711	0.0	0.0
chr12	M6PR	8946715	8946824	0	110	563	2693	563	2583	0.0	0.21796360820751065
chr12	A2M	9112376	9112536	0	161	145477	6357	145477	6196	0.0	23.479180116204002
chr12	PZP	9164132	9164259	0	128	1100	6291	1100	6163	0.0	0.17848450429985396
chr12	PZP	9162596	9162648	0	53	1100	6291	1100	6238	0.0	0.17633857005450465
chr12	AC010186.1	9647455	9647564	2	110	46	719	44	609	0.01818181818181818	0.0722495894909688
chr12	CLECL1	9718640	9718774	0	135	153	1576	153	1441	0.0	0.10617626648161
chr12	CLEC2B	9862498	9862573	104	76	2705	2643	2601	2567	1.368421052631579	1.0132450331125828
chr12	CLEC1B	9998281	9998380	0	100	0	3679	0	3579	0.0	0.0
chr12	CLEC1A	10089123	10089222	0	100	0	3177	0	3077	0.0	0.0
chr12	CLEC1A	10081236	10081413	0	178	0	3177	0	2999	0.0	0.0
chr12	CLEC1A	10092421	10092519	0	99	0	3177	0	3078	0.0	0.0
chr12	CLEC7A	10123244	10123363	0	120	0	3288	0	3168	0.0	0.0
chr12	CLEC7A	10126570	10126708	0	139	0	3288	0	3149	0.0	0.0
chr12	CLEC7A	10127746	10127845	0	100	0	3288	0	3188	0.0	0.0
chr12	CLEC7A	10125086	10125173	0	88	0	3288	0	3200	0.0	0.0
chr12	CLEC7A	10125296	10125448	0	153	0	3288	0	3135	0.0	0.0
chr12	CLEC7A	10127039	10127089	0	51	0	3288	0	3237	0.0	0.0
chr12	OLR1	10160346	10160462	0	117	0	1852	0	1735	0.0	0.0
chr12	OLR1	10160785	10160925	0	141	0	1852	0	1711	0.0	0.0
chr12	OLR1	10167186	10167308	0	123	0	1852	0	1729	0.0	0.0
chr12	KLRC4-KLRK1	10379446	10379482	0	37	19284	2526	19284	2489	0.0	7.747689835275211
chr12	KLRC4-KLRK1	10389942	10390027	0	86	19284	2526	19284	2440	0.0	7.9032786885245905
chr12	KLRC4-KLRK1	10393809	10393867	0	59	19284	2526	19284	2467	0.0	7.81678151601135
chr12	KLRC4-KLRK1	10405849	10405950	0	102	19284	2526	19284	2424	0.0	7.955445544554456
chr12	KLRC4-KLRK1	10409388	10409478	0	91	19284	2526	19284	2435	0.0	7.919507186858316
chr12	KLRC4-KLRK1	10391834	10391891	0	58	19284	2526	19284	2468	0.0	7.813614262560778
chr12	KLRC1	10449913	10449967	0	55	51	2736	51	2681	0.0	0.019022752704214847
chr12	MAGOHB	10609097	10609383	0	287	0	3788	0	3501	0.0	0.0
chr12	MAGOHB	10612639	10612978	0	340	0	3788	0	3448	0.0	0.0
chr12	MAGOHB	10612814	10612978	0	165	0	3788	0	3623	0.0	0.0
chr12	STYK1	10637070	10637196	0	127	33	3454	33	3327	0.0	0.009918845807033363
chr12	STYK1	10667288	10667455	0	168	33	3454	33	3286	0.0	0.01004260499087036
chr12	STYK1	10640669	10640734	0	66	33	3454	33	3388	0.0	0.00974025974025974
chr12	YBX3	10709907	10710114	0	208	306	7024	306	6816	0.0	0.0448943661971831
chr12	PRH1	10883060	10883096	0	37	395	2778	395	2741	0.0	0.1441079897847501
chr12	AC018630.4	10884153	10884275	0	123	920	1630	920	1507	0.0	0.6104844061048441
chr12	PRH1	11121009	11121180	51	172	395	2778	344	2606	0.29651162790697677	0.13200306983883345
chr12	AC078950.1	11435125	11435158	0	34	0	1264	0	1230	0.0	0.0
chr12	AC078950.1	11434991	11435158	0	168	0	1264	0	1096	0.0	0.0
chr12	LRP6	12126690	12126921	0	232	4929	9350	4929	9118	0.0	0.5405790743584119
chr12	LRP6	12244261	12244655	0	395	4929	9350	4929	8955	0.0	0.5504187604690117
chr12	MANSC1	12348178	12348248	0	71	255	5721	255	5650	0.0	0.04513274336283186
chr12	DUSP16	12480222	12480346	0	125	408	7143	408	7018	0.0	0.058136221145625534
chr12	DUSP16	12500518	12500682	0	165	408	7143	408	6978	0.0	0.058469475494411005
chr12	DUSP16	12554535	12554659	0	125	408	7143	408	7018	0.0	0.058136221145625534
chr12	GPRC5D	12942260	12942328	4832	69	11788	1128	6956	1059	70.02898550724638	6.568460812086874
chr12	GSG1	13087906	13088059	0	154	612	3041	612	2887	0.0	0.2119847592656737
chr12	GSG1	13089207	13089276	0	70	612	3041	612	2971	0.0	0.20599124873779873
chr12	GSG1	13089207	13089348	0	142	612	3041	612	2899	0.0	0.21110727837185236
chr12	GRIN2B	13981341	13981576	0	236	0	6171	0	5935	0.0	0.0
chr12	PLBD1	14553192	14553412	0	221	1555	2387	1555	2166	0.0	0.7179132040627886
chr12	WBP11	14801877	14802032	102	156	5204	5271	5102	5115	0.6538461538461539	0.9974584555229716
chr12	ART4	14840444	14841153	408	710	408	5248	0	4538	0.5746478873239437	0.0
chr12	ART4	14841081	14841153	0	73	408	5248	408	5175	0.0	0.07884057971014492
chr12	MGP	14882971	14883047	0	77	0	2892	0	2815	0.0	0.0
chr12	MGP	14884812	14884887	0	76	0	2892	0	2816	0.0	0.0
chr12	ARHGDIB	14956175	14956333	11925	159	61411	1780	49486	1621	75.0	30.528069093152375
chr12	RERG	15121062	15121119	0	58	102	4162	102	4104	0.0	0.024853801169590642
chr12	EPS8	15665755	15665892	0	138	1272	8578	1272	8440	0.0	0.15071090047393365
chr12	EPS8	15681225	15681302	0	78	1272	8578	1272	8500	0.0	0.1496470588235294
chr12	EPS8	15787962	15788010	0	49	1272	8578	1272	8529	0.0	0.14913823425958495
chr12	EPS8	15828180	15828372	0	193	1272	8578	1272	8385	0.0	0.1516994633273703
chr12	EPS8	15672453	15672504	0	52	1272	8578	1272	8526	0.0	0.14919071076706544
chr12	EPS8	15713265	15713325	0	61	1272	8578	1272	8517	0.0	0.14934836209933075
chr12	EPS8	15634738	15634762	0	25	1272	8578	1272	8553	0.0	0.14871974745703262
chr12	EPS8	15837572	15837724	0	153	1272	8578	1272	8425	0.0	0.15097922848664688
chr12	EPS8	15665022	15665106	0	85	1272	8578	1272	8493	0.0	0.14977039915224302
chr12	EPS8	15684196	15684302	0	107	1272	8578	1272	8471	0.0	0.15015936725298076
chr12	EPS8	15684168	15684302	0	135	1272	8578	1272	8443	0.0	0.15065734928343005
chr12	LMO3	16606065	16606132	0	68	0	6936	0	6868	0.0	0.0
chr12	LMO3	16594136	16594261	0	126	0	6936	0	6810	0.0	0.0
chr12	AC092110.1	17156722	17156874	0	153	0	1842	0	1689	0.0	0.0
chr12	RERGL	18089228	18089385	0	158	0	1560	0	1402	0.0	0.0
chr12	PLCZ1	18705165	18705315	0	151	51	2968	51	2817	0.0	0.01810436634717785
chr12	PLCZ1	18723310	18723542	51	233	51	2968	0	2735	0.21888412017167383	0.0
chr12	PLCZ1	18723310	18723545	51	236	51	2968	0	2732	0.21610169491525424	0.0
chr12	PLCZ1	18683543	18683631	0	89	51	2968	51	2879	0.0	0.017714484195901353
chr12	PLCZ1	18705165	18705284	0	120	51	2968	51	2848	0.0	0.017907303370786515
chr12	PLCZ1	18713736	18713825	0	90	51	2968	51	2878	0.0	0.017720639332870047
chr12	PLCZ1	18685489	18685658	0	170	51	2968	51	2798	0.0	0.018227305218012867
chr12	LINC02468	20125738	20125835	0	98	0	1350	0	1252	0.0	0.0
chr12	LINC02468	20125726	20125835	0	110	0	1350	0	1240	0.0	0.0
chr12	SLCO1A2	21314548	21314681	0	134	0	11312	0	11178	0.0	0.0
chr12	SLCO1A2	21318781	21318923	0	143	0	11312	0	11169	0.0	0.0
chr12	SLCO1A2	21374398	21374525	0	128	0	11312	0	11184	0.0	0.0
chr12	SLCO1A2	21319371	21319579	0	209	0	11312	0	11103	0.0	0.0
chr12	RECQL	21501169	21501215	0	47	0	3755	0	3708	0.0	0.0
chr12	RECQL	21501169	21501372	0	204	0	3755	0	3551	0.0	0.0
chr12	LDHB	21656987	21657214	1455	228	15146	2807	13691	2579	6.381578947368421	5.308646762310973
chr12	LDHB	21657750	21657835	1552	86	15146	2807	13594	2721	18.046511627906977	4.99595736861448
chr12	KCNJ8	21774545	21774683	0	139	561	2516	561	2377	0.0	0.23601177955405975
chr12	ABCC9	21882765	21882873	0	109	608376	11660	608376	11551	0.0	52.66868669379274
chr12	ABCC9	21938017	21938077	0	61	608376	11660	608376	11599	0.0	52.450728511078545
chr12	ST8SIA1	22068862	22069020	0	159	32424	13989	32424	13830	0.0	2.344468546637744
chr12	ST8SIA1	22255279	22255389	0	111	32424	13989	32424	13878	0.0	2.3363597060095116
chr12	ST8SIA1	22325797	22325932	0	136	32424	13989	32424	13853	0.0	2.340576048509348
chr12	C2CD5	22493222	22493337	0	116	1326	6790	1326	6674	0.0	0.19868145040455498
chr12	C2CD5	22506710	22506819	0	110	1326	6790	1326	6680	0.0	0.19850299401197605
chr12	C2CD5	22458483	22458585	0	103	1326	6790	1326	6687	0.0	0.19829519964109465
chr12	C2CD5	22512646	22512679	0	34	1326	6790	1326	6756	0.0	0.19626998223801065
chr12	C2CD5	22458483	22458555	0	73	1326	6790	1326	6717	0.0	0.19740955783832068
chr12	C2CD5	22502738	22502804	0	67	1326	6790	1326	6723	0.0	0.19723337795626952
chr12	C2CD5	22459491	22459542	0	52	1326	6790	1326	6738	0.0	0.19679430097951914
chr12	SOX5	23546315	23546424	0	110	3	11064	3	10954	0.0	0.00027387255796969143
chr12	SOX5	23575660	23575838	0	179	3	11064	3	10885	0.0	0.0002756086357372531
chr12	SOX5	24059222	24059296	0	75	3	11064	3	10989	0.0	0.000273000273000273
chr12	SOX5	24407484	24407566	0	83	3	11064	3	10981	0.0	0.00027319916218923596
chr12	BCAT1	24881300	24881411	0	112	51	11431	51	11319	0.0	0.004505698383249403
chr12	BCAT1	24901813	24901885	0	73	51	11431	51	11358	0.0	0.004490227152667723
chr12	CFAP94	25158471	25158563	0	93	645	3013	645	2920	0.0	0.2208904109589041
chr12	CFAP94	25190613	25190631	0	19	645	3013	645	2994	0.0	0.2154308617234469
chr12	CFAP94	25161112	25161197	0	86	645	3013	645	2927	0.0	0.22036214554151007
chr12	CFAP94	25185748	25185786	0	39	645	3013	645	2974	0.0	0.2168796234028245
chr12	CFAP94	25158689	25158737	0	49	645	3013	645	2964	0.0	0.21761133603238866
chr12	CFAP94	25192693	25192826	0	134	645	3013	645	2879	0.0	0.22403612365404654
chr12	KRAS	25215436	25215560	0	125	0	6852	0	6727	0.0	0.0
chr12	LMNTD1	25526098	25526218	0	121	0	3102	0	2981	0.0	0.0
chr12	LMNTD1	25547224	25547351	0	128	0	3102	0	2974	0.0	0.0
chr12	LMNTD1	25552870	25552989	0	120	0	3102	0	2982	0.0	0.0
chr12	LMNTD1	25546373	25546554	0	182	0	3102	0	2920	0.0	0.0
chr12	LMNTD1	25549325	25549546	0	222	0	3102	0	2880	0.0	0.0
chr12	RASSF8-AS1	25955137	25955241	0	105	12577	9597	12577	9492	0.0	1.3250105351875263
chr12	RASSF8-AS1	25956226	25956347	7447	122	12577	9597	5130	9475	61.040983606557376	0.5414248021108179
chr12	RASSF8-AS1	25952757	25953076	0	320	12577	9597	12577	9277	0.0	1.3557184434623262
chr12	AC022509.1	26231922	26231985	0	64	153	2404	153	2340	0.0	0.06538461538461539
chr12	ITPR2	26790156	26790227	0	72	4705	13851	4705	13779	0.0	0.3414616445315335
chr12	ITPR2	26486816	26486933	0	118	4705	13851	4705	13733	0.0	0.3426054030437632
chr12	INTS13	26914407	26914578	0	172	204	3078	204	2906	0.0	0.07019958706125258
chr12	INTS13	26917643	26917733	0	91	204	3078	204	2987	0.0	0.06829594911282223
chr12	INTS13	26937657	26937809	92	153	204	3078	112	2925	0.6013071895424836	0.03829059829059829
chr12	TM7SF3	26979783	26979936	0	154	556	5517	556	5363	0.0	0.10367331717322394
chr12	TM7SF3	26982772	26982859	0	88	556	5517	556	5429	0.0	0.10241296739731073
chr12	TM7SF3	27003235	27003390	0	156	556	5517	556	5361	0.0	0.10371199403096437
chr12	TM7SF3	26976259	26976357	0	99	556	5517	556	5418	0.0	0.10262089331856773
chr12	TM7SF3	26977951	26978094	13	144	556	5517	543	5373	0.09027777777777778	0.10106085985482971
chr12	TM7SF3	26983492	26983596	0	105	556	5517	556	5412	0.0	0.10273466371027347
chr12	TM7SF3	26999525	26999676	0	152	556	5517	556	5365	0.0	0.10363466915191052
chr12	TM7SF3	26996741	26996862	0	122	556	5517	556	5395	0.0	0.10305838739573679
chr12	TM7SF3	27003235	27003405	0	171	556	5517	556	5346	0.0	0.10400299289188178
chr12	AC009509.1	27704737	27704924	0	188	1160	1560	1160	1372	0.0	0.8454810495626822
chr12	ERGIC2	29356381	29356477	0	97	4437	5842	4437	5745	0.0	0.7723237597911227
chr12	ERGIC2	29372463	29372520	0	58	4437	5842	4437	5784	0.0	0.7671161825726142
chr12	ERGIC2	29372854	29372967	0	114	4437	5842	4437	5728	0.0	0.7746159217877095
chr12	TMTC1	29572104	29572218	0	115	49702	14707	49702	14592	0.0	3.4061129385964914
chr12	LINC02386	30288408	30288463	0	56	0	1074	0	1018	0.0	0.0
chr12	IPO8	30686320	30686659	0	340	0	6688	0	6348	0.0	0.0
chr12	CAPRIN2	30731342	30731510	0	169	3570	8052	3570	7883	0.0	0.4528732715971077
chr12	CAPRIN2	30711738	30711782	0	45	3570	8052	3570	8007	0.0	0.445859872611465
chr12	CAPRIN2	30719078	30719225	0	148	3570	8052	3570	7904	0.0	0.45167004048583
chr12	CAPRIN2	30720810	30720915	0	106	3570	8052	3570	7946	0.0	0.44928265794110245
chr12	CAPRIN2	30733628	30733711	0	84	3570	8052	3570	7968	0.0	0.4480421686746988
chr12	CAPRIN2	30753343	30753559	0	217	3570	8052	3570	7835	0.0	0.45564773452456925
chr12	DDX11-AS1	31060659	31060770	0	112	0	3844	0	3732	0.0	0.0
chr12	AC024940.1	31112111	31112288	0	178	1971	7252	1971	7074	0.0	0.2786259541984733
chr12	AC024940.1	31115202	31115703	0	502	1971	7252	1971	6750	0.0	0.292
chr12	AC024940.1	31183213	31183323	0	111	1971	7252	1971	7141	0.0	0.2760117630583952
chr12	AC024940.1	31177009	31177084	0	76	1971	7252	1971	7176	0.0	0.2746655518394649
chr12	SINHCAF	31298076	31298224	0	149	510	5586	510	5437	0.0	0.093801728894611
chr12	SINHCAF	31296909	31297044	0	136	510	5586	510	5450	0.0	0.09357798165137615
chr12	DENND5B	31479588	31480255	0	668	12265	11371	12265	10703	0.0	1.1459403905447072
chr12	DENND5B	31499605	31499671	0	67	12265	11371	12265	11304	0.0	1.0850141542816703
chr12	DENND5B	31540919	31541031	0	113	12265	11371	12265	11258	0.0	1.0894475039971576
chr12	AMN1	31709292	31709425	0	134	455	3144	455	3010	0.0	0.1511627906976744
chr12	AMN1	31714440	31714631	0	192	455	3144	455	2952	0.0	0.15413279132791327
chr12	AMN1	31719217	31719356	0	140	455	3144	455	3004	0.0	0.1514647137150466
chr12	AMN1	31714881	31714951	0	71	455	3144	455	3073	0.0	0.1480637813211845
chr12	PKP2	32843181	32843313	0	133	38980	6985	38980	6852	0.0	5.688849970811442
chr12	SYT10	33423909	33424009	0	101	0	5091	0	4990	0.0	0.0
chr12	AC140847.2	34211873	34212021	0	149	1071	2159	1071	2010	0.0	0.5328358208955224
chr12	LINC02406	39095544	39095809	0	266	102	1374	102	1108	0.0	0.09205776173285199
chr12	LINC02406	39093465	39093541	0	77	102	1374	102	1297	0.0	0.07864302235929067
chr12	KIF21A	39315228	39315240	0	13	29	10156	29	10143	0.0	0.002859114660356896
chr12	KIF21A	39318072	39318201	0	130	29	10156	29	10026	0.0	0.0028924795531617793
chr12	KIF21A	39322667	39322882	0	216	29	10156	29	9940	0.0	0.0029175050301810867
chr12	KIF21A	39330241	39330262	0	22	29	10156	29	10134	0.0	0.0028616538385632523
chr12	KIF21A	39333211	39333280	0	70	29	10156	29	10086	0.0	0.002875272655165576
chr12	KIF21A	39346465	39346504	0	40	29	10156	29	10116	0.0	0.002866745749308027
chr12	KIF21A	39315228	39315243	0	16	29	10156	29	10140	0.0	0.0028599605522682445
chr12	KIF21A	39315931	39315970	0	40	29	10156	29	10116	0.0	0.002866745749308027
chr12	KIF21A	39321347	39322882	0	1536	29	10156	29	8620	0.0	0.0033642691415313227
chr12	GXYLT1	42129758	42129851	0	94	51	7500	51	7406	0.0	0.0068863083985957335
chr12	YAF2	42210547	42210619	0	73	0	6459	0	6386	0.0	0.0
chr12	YAF2	42237598	42237724	0	127	0	6459	0	6332	0.0	0.0
chr12	YAF2	42199135	42199235	0	101	0	6459	0	6358	0.0	0.0
chr12	YAF2	42172139	42172209	0	71	0	6459	0	6388	0.0	0.0
chr12	YAF2	42210354	42210454	0	101	0	6459	0	6358	0.0	0.0
chr12	YAF2	42235613	42235755	0	143	0	6459	0	6316	0.0	0.0
chr12	YAF2	42212443	42212484	0	42	0	6459	0	6417	0.0	0.0
chr12	ZCRB1	42324018	42324104	0	87	0	8686	0	8599	0.0	0.0
chr12	ZCRB1	42322417	42322446	0	30	0	8686	0	8656	0.0	0.0
chr12	ZCRB1	42324067	42324104	0	38	0	8686	0	8648	0.0	0.0
chr12	PRICKLE1	42483757	42483985	0	229	102	8022	102	7793	0.0	0.013088669318619274
chr12	PRICKLE1	42584358	42584480	0	123	102	8022	102	7899	0.0	0.012913026965438662
chr12	PRICKLE1	42550207	42550329	0	123	102	8022	102	7899	0.0	0.012913026965438662
chr12	LINC02402	42629460	42629686	470	227	470	1549	0	1322	2.0704845814977975	0.0
chr12	ADAMTS20	43429616	43429724	0	109	0	7564	0	7455	0.0	0.0
chr12	PUS7L	43754335	43755261	0	927	51	14023	51	13096	0.0	0.0038943188759926694
chr12	PUS7L	43755216	43755261	0	46	51	14023	51	13977	0.0	0.003648851684910925
chr12	TWF1	43805830	43805885	0	56	0	3656	0	3600	0.0	0.0
chr12	TWF1	43804494	43804572	0	79	0	3656	0	3577	0.0	0.0
chr12	TWF1	43798564	43798585	0	22	0	3656	0	3634	0.0	0.0
chr12	TWF1	43805523	43805637	0	115	0	3656	0	3541	0.0	0.0
chr12	TWF1	43804175	43804240	0	66	0	3656	0	3590	0.0	0.0
chr12	TWF1	43805830	43806002	0	173	0	3656	0	3483	0.0	0.0
chr12	NELL2	44532580	44532721	0	142	6	6365	6	6223	0.0	0.0009641651936365097
chr12	NELL2	44875506	44875639	0	134	6	6365	6	6231	0.0	0.0009629272989889263
chr12	NELL2	44881778	44881839	0	62	6	6365	6	6303	0.0	0.0009519276534983341
chr12	PLEKHA8P1	45190793	45190961	0	169	0	2324	0	2155	0.0	0.0
chr12	SCAF11	45974189	45975734	0	1546	153	14007	153	12461	0.0	0.01227830832196453
chr12	SLC38A1	46243199	46243314	0	116	1549	10037	1549	9921	0.0	0.15613345428888217
chr12	SLC38A1	46239678	46239893	0	216	1549	10037	1549	9821	0.0	0.1577232461052846
chr12	SLC38A1	46254813	46254936	0	124	1549	10037	1549	9913	0.0	0.15625945727832138
chr12	SLC38A2	46363020	46363145	224	126	3111	6328	2887	6202	1.7777777777777777	0.4654950016123831
chr12	SLC38A2	46370511	46370627	0	117	3111	6328	3111	6211	0.0	0.5008855256802447
chr12	SLC38A4	46803602	46803794	0	193	254108	2622	254108	2429	0.0	104.61424454508028
chr12	SLC38A4	46824305	46824385	0	81	254108	2622	254108	2541	0.0	100.00314836678473
chr12	AMIGO2	47079141	47079248	0	108	0	3967	0	3859	0.0	0.0
chr12	AMIGO2	47079146	47079248	0	103	0	3967	0	3864	0.0	0.0
chr12	PCED1B-AS1	47206510	47206588	0	79	0	1838	0	1759	0.0	0.0
chr12	PCED1B-AS1	47206510	47206585	0	76	0	1838	0	1762	0.0	0.0
chr12	PCED1B-AS1	47210639	47210761	0	123	0	1838	0	1715	0.0	0.0
chr12	PCED1B-AS1	47209280	47209458	0	179	0	1838	0	1659	0.0	0.0
chr12	RPAP3	47679492	47679594	0	103	2571	5369	2571	5266	0.0	0.48822635776680595
chr12	RPAP3	47702687	47702846	0	160	2571	5369	2571	5209	0.0	0.4935688231906316
chr12	ENDOU	47720752	47720875	0	124	0	2689	0	2565	0.0	0.0
chr12	ENDOU	47718128	47718194	0	67	0	2689	0	2622	0.0	0.0
chr12	RAPGEF3	47740641	47740823	0	183	51	11994	51	11811	0.0	0.004318008636017272
chr12	RAPGEF3	47743529	47743676	0	148	51	11994	51	11846	0.0	0.0043052507175417865
chr12	RAPGEF3	47739370	47739418	0	49	51	11994	51	11945	0.0	0.0042695688572624525
chr12	HDAC7	47802223	47802274	0	52	255	7662	255	7610	0.0	0.03350854139290407
chr12	HDAC7	47795905	47796016	0	112	255	7662	255	7550	0.0	0.03377483443708609
chr12	HDAC7	47792537	47792669	0	133	255	7662	255	7529	0.0	0.03386903971310931
chr12	HDAC7	47798784	47798972	136	189	255	7662	119	7473	0.7195767195767195	0.015923993041616485
chr12	HDAC7	47784694	47784801	0	108	255	7662	255	7554	0.0	0.03375694996028594
chr12	HDAC7	47788834	47788951	0	118	255	7662	255	7544	0.0	0.0338016967126193
chr12	HDAC7	47819119	47819142	0	24	255	7662	255	7638	0.0	0.03338570306362922
chr12	VDR	47882693	47882774	0	82	153	5295	153	5213	0.0	0.029349702666410897
chr12	VDR	47899836	47899958	0	123	153	5295	153	5172	0.0	0.029582366589327145
chr12	COL2A1	47999918	48000125	0	208	668	6719	668	6511	0.0	0.10259560743357395
chr12	SENP1	48089162	48089293	0	132	5564	5824	5564	5692	0.0	0.977512297962052
chr12	ASB8	48150086	48150140	0	55	932	4093	932	4038	0.0	0.23080733036156514
chr12	ASB8	48151609	48151665	0	57	932	4093	932	4036	0.0	0.2309217046580773
chr12	ASB8	48150086	48150170	0	85	932	4093	932	4008	0.0	0.23253493013972057
chr12	ASB8	48151564	48151665	0	102	932	4093	932	3991	0.0	0.23352543222250063
chr12	ASB8	48157121	48157257	0	137	932	4093	932	3956	0.0	0.23559150657229525
chr12	ZNF641	48350045	48350218	0	174	0	8510	0	8336	0.0	0.0
chr12	ZNF641	48347148	48347343	0	196	0	8510	0	8314	0.0	0.0
chr12	KANSL2	48679035	48679150	0	116	152	3188	152	3072	0.0	0.049479166666666664
chr12	KANSL2	48660467	48660619	0	153	152	3188	152	3035	0.0	0.050082372322899506
chr12	KANSL2	48662559	48662654	0	96	152	3188	152	3092	0.0	0.04915912031047866
chr12	KANSL2	48679035	48679238	0	204	152	3188	152	2984	0.0	0.05093833780160858
chr12	KANSL2	48681857	48682065	0	209	152	3188	152	2979	0.0	0.05102383350117489
chr12	KANSL2	48681971	48682065	0	95	152	3188	152	3093	0.0	0.04914322664080181
chr12	CCNT1	48695998	48696162	0	165	255	7391	255	7226	0.0	0.03528923332410739
chr12	ADCY6	48773939	48774098	0	160	0	8137	0	7977	0.0	0.0
chr12	DDX23	48837523	48837657	0	135	106	4903	106	4768	0.0	0.022231543624161073
chr12	DDX23	48835119	48835214	0	96	106	4903	106	4807	0.0	0.022051175369253172
chr12	DDX23	48847255	48847347	0	93	106	4903	106	4810	0.0	0.02203742203742204
chr12	DDX23	48847255	48847350	0	96	106	4903	106	4807	0.0	0.022051175369253172
chr12	ARF3	48939996	48940107	0	112	51	2250	51	2138	0.0	0.023854069223573433
chr12	ARF3	48941567	48941577	0	11	51	2250	51	2239	0.0	0.022778025904421618
chr12	ARF3	48953112	48953274	0	163	51	2250	51	2087	0.0	0.024436990896023
chr12	ARF3	48956097	48956350	0	254	51	2250	51	1996	0.0	0.02555110220440882
chr12	WNT10B	48969109	48969144	0	36	102	2607	102	2571	0.0	0.039673278879813305
chr12	PRKAG1	49003557	49003595	0	39	0	3614	0	3575	0.0	0.0
chr12	PRKAG1	49004506	49004633	0	128	0	3614	0	3486	0.0	0.0
chr12	PRKAG1	49005742	49005852	0	111	0	3614	0	3503	0.0	0.0
chr12	PRKAG1	49005667	49005742	0	76	0	3614	0	3538	0.0	0.0
chr12	PRKAG1	49005742	49005881	0	140	0	3614	0	3474	0.0	0.0
chr12	PRKAG1	49008425	49008599	0	175	0	3614	0	3439	0.0	0.0
chr12	PRKAG1	49016606	49016839	0	234	0	3614	0	3380	0.0	0.0
chr12	PRKAG1	49017156	49017550	0	395	0	3614	0	3219	0.0	0.0
chr12	KMT2D	49024052	49024100	0	49	52407	20387	52407	20338	0.0	2.576802045432196
chr12	RHEBL1	49066967	49067035	144	69	651	1307	507	1238	2.0869565217391304	0.4095315024232633
chr12	RHEBL1	49066955	49067035	192	81	651	1307	459	1226	2.3703703703703702	0.3743882544861338
chr12	LMBR1L	49097943	49098105	350	163	3592	4888	3242	4725	2.147239263803681	0.6861375661375662
chr12	LMBR1L	49104447	49104551	0	105	3592	4888	3592	4783	0.0	0.7509931005644993
chr12	LMBR1L	49105923	49105957	0	35	3592	4888	3592	4853	0.0	0.7401607253245415
chr12	LMBR1L	49106960	49107045	0	86	3592	4888	3592	4802	0.0	0.7480216576426489
chr12	LMBR1L	49106544	49106746	0	203	3592	4888	3592	4685	0.0	0.7667022411953042
chr12	LMBR1L	49109726	49109881	0	156	3592	4888	3592	4732	0.0	0.7590870667793744
chr12	LMBR1L	49104718	49104885	0	168	3592	4888	3592	4720	0.0	0.7610169491525424
chr12	LMBR1L	49106510	49106746	0	237	3592	4888	3592	4651	0.0	0.7723070307460761
chr12	LMBR1L	49104745	49104885	0	141	3592	4888	3592	4747	0.0	0.7566884348009268
chr12	LMBR1L	49106653	49106746	0	94	3592	4888	3592	4794	0.0	0.7492699207342511
chr12	TUBA1B	49130118	49130402	51	285	102	2468	51	2183	0.17894736842105263	0.0233623453962437
chr12	TUBA1B	49130118	49130274	51	157	102	2468	51	2311	0.3248407643312102	0.02206836867157075
chr12	TUBA1B	49130118	49130344	51	227	102	2468	51	2241	0.22466960352422907	0.022757697456492636
chr12	TUBA1A	49186989	49187084	0	96	1071	3106	1071	3010	0.0	0.3558139534883721
chr12	MCRS1	49566721	49566841	0	121	357	3102	357	2981	0.0	0.11975847031197585
chr12	MCRS1	49567646	49567749	0	104	357	3102	357	2998	0.0	0.119079386257505
chr12	MCRS1	49566076	49566215	0	140	357	3102	357	2962	0.0	0.12052667116812964
chr12	FAM186B	49587561	49587752	0	192	1544	4585	1544	4393	0.0	0.3514682449351241
chr12	FMNL3	49658441	49658594	0	154	601956	11520	601956	11366	0.0	52.96111208868555
chr12	FMNL3	49646638	49646753	0	116	601956	11520	601956	11404	0.0	52.78463696948439
chr12	FAIM2	49887385	49887439	0	55	17229	6072	17229	6017	0.0	2.863387069968423
chr12	FAIM2	49889480	49889568	141	89	17229	6072	17088	5983	1.5842696629213484	2.8560922614073205
chr12	AC025154.2	49954133	49954348	5598	216	28460	1579	22862	1363	25.916666666666668	16.77329420396185
chr12	RACGAP1	49997039	49997204	2525	166	31290	4511	28765	4345	15.210843373493976	6.620253164556962
chr12	RACGAP1	50006433	50006636	216	204	31290	4511	31074	4307	1.0588235294117647	7.214766658927328
chr12	RACGAP1	50019743	50019806	406	64	31290	4511	30884	4447	6.34375	6.944906678659771
chr12	RACGAP1	50016630	50016719	261	90	31290	4511	31029	4421	2.9	7.018547839855237
chr12	RACGAP1	50018515	50018589	31	75	31290	4511	31259	4436	0.41333333333333333	7.046663660955816
chr12	RACGAP1	50021061	50021177	43	117	31290	4511	31247	4394	0.36752136752136755	7.11128812016386
chr12	RACGAP1	50016630	50016715	261	86	31290	4511	31029	4425	3.0348837209302326	7.012203389830509
chr12	CERS5	50134545	50134702	0	158	15600	5888	15600	5730	0.0	2.722513089005236
chr12	CERS5	50137727	50137820	0	94	15600	5888	15600	5794	0.0	2.6924404556437693
chr12	CERS5	50142052	50142110	0	59	15600	5888	15600	5829	0.0	2.676273803396809
chr12	CERS5	50143951	50144057	0	107	15600	5888	15600	5781	0.0	2.6984950700570836
chr12	CERS5	50144768	50144969	51	202	15600	5888	15549	5686	0.2524752475247525	2.734611326064017
chr12	CERS5	50132961	50133064	0	104	15600	5888	15600	5784	0.0	2.6970954356846475
chr12	CERS5	50135432	50135652	153	221	15600	5888	15447	5667	0.6923076923076923	2.725780836421387
chr12	CERS5	50132961	50134068	102	1108	15600	5888	15498	4780	0.09205776173285199	3.2422594142259413
chr12	CERS5	50138566	50138617	68	52	15600	5888	15532	5836	1.3076923076923077	2.6614119259766964
chr12	CERS5	50154227	50154320	0	94	15600	5888	15600	5794	0.0	2.6924404556437693
chr12	CERS5	50165821	50165943	0	123	15600	5888	15600	5765	0.0	2.7059843885516046
chr12	CERS5	50153828	50153951	0	124	15600	5888	15600	5764	0.0	2.7064538514920193
chr12	CERS5	50148471	50148588	20	118	15600	5888	15580	5770	0.1694915254237288	2.700173310225303
chr12	LIMA1	50192451	50192561	0	111	18444	5924	18444	5813	0.0	3.172888353690005
chr12	LIMA1	50185389	50185448	3379	60	18444	5924	15065	5864	56.31666666666667	2.5690654843110505
chr12	LIMA1	50201302	50201324	0	23	18444	5924	18444	5901	0.0	3.125571936959837
chr12	LIMA1	50249682	50249786	0	105	18444	5924	18444	5819	0.0	3.1696167726413473
chr12	SLC11A2	51000597	51000633	0	37	762	9310	762	9273	0.0	0.08217405370430282
chr12	SLC11A2	51010694	51010766	0	73	762	9310	762	9237	0.0	0.08249431633647288
chr12	SLC11A2	51000562	51000633	0	72	762	9310	762	9238	0.0	0.08248538644728297
chr12	SLC11A2	51005652	51005677	0	26	762	9310	762	9284	0.0	0.08207669108143041
chr12	SLC11A2	51008475	51008624	0	150	762	9310	762	9160	0.0	0.0831877729257642
chr12	SLC11A2	51006173	51006271	0	99	762	9310	762	9211	0.0	0.08272717403104983
chr12	CSRNP2	51076410	51076647	0	238	3929	5233	3929	4995	0.0	0.7865865865865865
chr12	CSRNP2	51082520	51082694	0	175	3929	5233	3929	5058	0.0	0.776789244760775
chr12	TFCP2	51109120	51109273	400	154	4208	2120	3808	1966	2.5974025974025974	1.9369277721261444
chr12	POU6F1	51196798	51196927	357	130	12746	6060	12389	5930	2.746153846153846	2.0892074198988198
chr12	POU6F1	51199746	51199868	51	123	12746	6060	12695	5937	0.4146341463414634	2.1382853292908877
chr12	POU6F1	51206788	51206883	0	96	12746	6060	12746	5964	0.0	2.1371562709590877
chr12	SMAGP	51251464	51251583	0	120	0	2875	0	2755	0.0	0.0
chr12	SMAGP	51253573	51253593	0	21	0	2875	0	2854	0.0	0.0
chr12	BIN2	51302019	51302115	0	97	0	3267	0	3170	0.0	0.0
chr12	BIN2	51313822	51313903	0	82	0	3267	0	3185	0.0	0.0
chr12	BIN2	51304119	51304265	0	147	0	3267	0	3120	0.0	0.0
chr12	GALNT6	51360720	51360838	0	119	10039	7363	10039	7244	0.0	1.3858365543898399
chr12	GALNT6	51383460	51383582	124	123	10039	7363	9915	7240	1.008130081300813	1.3694751381215469
chr12	GALNT6	51390849	51390937	0	89	10039	7363	10039	7274	0.0	1.380120978828705
chr12	GALNT6	51382312	51382509	481	198	10039	7363	9558	7165	2.4292929292929295	1.3339846475924633
chr12	GALNT6	51391081	51391195	0	115	10039	7363	10039	7248	0.0	1.3850717439293598
chr12	LINC02874	52206513	52206643	0	131	306	2111	306	1980	0.0	0.15454545454545454
chr12	LINC02874	52210576	52210925	0	350	306	2111	306	1761	0.0	0.1737649063032368
chr12	LINC02874	52208104	52208388	0	285	306	2111	306	1826	0.0	0.16757940854326397
chr12	KRT5	52518452	52518493	3	42	54	4142	51	4100	0.07142857142857142	0.012439024390243903
chr12	KRT74	52569489	52569531	249	43	74751	3016	74502	2973	5.790697674418604	25.059535822401614
chr12	KRT72	52590835	52590961	0	127	3891	2164	3891	2037	0.0	1.9101620029455082
chr12	KRT72	52599270	52599409	0	140	3891	2164	3891	2024	0.0	1.9224308300395256
chr12	KRT72	52599270	52599302	0	33	3891	2164	3891	2131	0.0	1.8259033317691225
chr12	KRT73	52614578	52614674	0	97	0	2660	0	2563	0.0	0.0
chr12	KRT77	52698175	52698260	0	86	4990	4023	4990	3937	0.0	1.2674625349250699
chr12	KRT4	52811762	52811977	0	216	0	2886	0	2670	0.0	0.0
chr12	KRT78	52839452	52839487	0	36	0	3271	0	3235	0.0	0.0
chr12	KRT8	52901158	52901219	0	62	0	6121	0	6059	0.0	0.0
chr12	KRT8	52949455	52949585	0	131	0	6121	0	5990	0.0	0.0
chr12	KRT8	52949455	52949517	0	63	0	6121	0	6058	0.0	0.0
chr12	AC068888.1	53045599	53045653	0	55	0	5374	0	5319	0.0	0.0
chr12	AC068888.1	53045064	53045186	0	123	0	5374	0	5251	0.0	0.0
chr12	AC068888.1	53053395	53053574	0	180	0	5374	0	5194	0.0	0.0
chr12	AC068888.1	53043097	53043147	0	51	0	5374	0	5323	0.0	0.0
chr12	AC068888.1	53045960	53046061	0	102	0	5374	0	5272	0.0	0.0
chr12	AC068888.1	53045586	53045653	0	68	0	5374	0	5306	0.0	0.0
chr12	SPRYD3	53074648	53074784	0	137	0	2839	0	2702	0.0	0.0
chr12	SPRYD3	53078060	53078171	0	112	0	2839	0	2727	0.0	0.0
chr12	CSAD	53161126	53161191	0	66	51	4328	51	4262	0.0	0.011966213045518537
chr12	CSAD	53171325	53171441	0	117	51	4328	51	4211	0.0	0.012111137497031584
chr12	CSAD	53171272	53171441	0	170	51	4328	51	4158	0.0	0.012265512265512266
chr12	ITGB7	53200242	53200446	0	205	0	4220	0	4015	0.0	0.0
chr12	ITGB7	53201071	53201194	0	124	0	4220	0	4096	0.0	0.0
chr12	ITGB7	53201117	53201194	0	78	0	4220	0	4142	0.0	0.0
chr12	ITGB7	53193707	53193901	0	195	0	4220	0	4025	0.0	0.0
chr12	ITGB7	53201146	53201194	0	49	0	4220	0	4171	0.0	0.0
chr12	ITGB7	53206673	53206804	0	132	0	4220	0	4088	0.0	0.0
chr12	RARG	53215645	53215794	0	150	0	4962	0	4812	0.0	0.0
chr12	RARG	53227361	53227687	0	327	0	4962	0	4635	0.0	0.0
chr12	RARG	53231168	53231235	0	68	0	4962	0	4894	0.0	0.0
chr12	AAAS	53307844	53307929	0	86	306	4055	306	3969	0.0	0.07709750566893424
chr12	AAAS	53315334	53315426	0	93	306	4055	306	3962	0.0	0.07723372034326098
chr12	AAAS	53314750	53314849	0	100	306	4055	306	3955	0.0	0.07737041719342605
chr12	SP7	53335625	53335693	0	69	2679	3390	2679	3321	0.0	0.8066847335140018
chr12	ATF7	53552540	53552637	0	98	2505	4276	2505	4178	0.0	0.5995691718525611
chr12	ATP5MC2	53673695	53673812	0	118	77780	2796	77780	2678	0.0	29.04406273338312
chr12	CALCOCO1	53716259	53716415	0	157	131557	7583	131557	7426	0.0	17.715728521411258
chr12	CALCOCO1	53712774	53712846	4	73	131557	7583	131553	7510	0.0547945205479452	17.51704394141145
chr12	CALCOCO1	53725689	53725759	0	71	131557	7583	131557	7512	0.0	17.512912673056444
chr12	CALCOCO1	53726243	53726334	0	92	131557	7583	131557	7491	0.0	17.562007742624484
chr12	CISTR	53755819	53755935	0	117	102	2038	102	1921	0.0	0.05309734513274336
chr12	HOTAIR	53964230	53964283	0	54	0	2610	0	2556	0.0	0.0
chr12	HOTAIR	53967268	53967394	0	127	0	2610	0	2483	0.0	0.0
chr12	SMUG1	54187818	54187905	0	88	0	4520	0	4432	0.0	0.0
chr12	SMUG1	54183655	54183959	0	305	0	4520	0	4215	0.0	0.0
chr12	SMUG1	54188514	54188596	0	83	0	4520	0	4437	0.0	0.0
chr12	SMUG1	54186846	54187011	0	166	0	4520	0	4354	0.0	0.0
chr12	SMUG1	54187818	54187840	0	23	0	4520	0	4497	0.0	0.0
chr12	NFE2	54300146	54300276	0	131	0	2368	0	2237	0.0	0.0
chr12	ZNF385A	54371472	54371715	204	244	116705	3203	116501	2959	0.8360655737704918	39.37174721189591
chr12	ZNF385A	54375843	54375954	1255	112	116705	3203	115450	3091	11.205357142857142	37.350372047880946
chr12	ZNF385A	54371472	54371642	102	171	116705	3203	116603	3032	0.5964912280701754	38.45745382585752
chr12	ZNF385A	54384858	54385002	0	145	116705	3203	116705	3058	0.0	38.16383257030739
chr12	ZNF385A	54372893	54373031	0	139	116705	3203	116705	3064	0.0	38.08909921671018
chr12	ITGA5	54399644	54399758	586	115	406619	7121	406033	7006	5.095652173913043	57.95503853839566
chr12	ITGA5	54409484	54409597	72	114	406619	7121	406547	7007	0.631578947368421	58.020122734408446
chr12	ITGA5	54411833	54411964	57	132	406619	7121	406562	6989	0.4318181818181818	58.171698383173556
chr12	GTSF1	54459312	54459453	0	142	357	2536	357	2394	0.0	0.14912280701754385
chr12	GTSF1	54465066	54465167	0	102	357	2536	357	2434	0.0	0.1466721446179129
chr12	PPP1R1A	54581975	54582131	5482	157	193852	2983	188370	2826	34.9171974522293	66.65605095541402
chr12	PPP1R1A	54582731	54582795	0	65	193852	2983	193852	2918	0.0	66.43317340644276
chr12	GLYCAM1	54608618	54608846	0	229	0	529	0	300	0.0	0.0
chr12	GLYCAM1	54608652	54608846	0	195	0	529	0	334	0.0	0.0
chr12	DCD	54644883	54644947	195	65	2635	885	2440	820	3.0	2.975609756097561
chr12	DCD	54645983	54646150	2392	168	2635	885	243	717	14.238095238095237	0.3389121338912134
chr12	TESPA1	54961167	54961267	0	101	0	5057	0	4956	0.0	0.0
chr12	TESPA1	54966052	54966151	0	100	0	5057	0	4957	0.0	0.0
chr12	TESPA1	54981773	54981945	0	173	0	5057	0	4884	0.0	0.0
chr12	TESPA1	54983993	54984166	0	174	0	5057	0	4883	0.0	0.0
chr12	AC122685.1	55476548	55476601	0	54	0	686	0	632	0.0	0.0
chr12	ITGA7	55694777	55694970	0	194	79	6257	79	6063	0.0	0.013029853207982847
chr12	ITGA7	55698382	55698576	0	195	79	6257	79	6062	0.0	0.013032002639392939
chr12	ITGA7	55701378	55701416	0	39	79	6257	79	6218	0.0	0.012705049855258926
chr12	ITGA7	55699869	55699989	0	121	79	6257	79	6136	0.0	0.012874837027379401
chr12	ITGA7	55700261	55700393	0	133	79	6257	79	6124	0.0	0.012900065316786414
chr12	ITGA7	55686201	55686314	0	114	79	6257	79	6143	0.0	0.01286016604265017
chr12	SARNP	55800853	55800900	0	48	9820	3377	9820	3329	0.0	2.949834785220787
chr12	AC023055.1	55820238	55820449	0	212	9718	2553	9718	2341	0.0	4.151217428449381
chr12	DNAJC14	55829488	55829636	0	149	51	4199	51	4050	0.0	0.012592592592592593
chr12	MMP19	55837554	55837682	0	129	0	4340	0	4211	0.0	0.0
chr12	MMP19	55839495	55839741	0	247	0	4340	0	4093	0.0	0.0
chr12	MMP19	55841105	55841236	0	132	0	4340	0	4208	0.0	0.0
chr12	MMP19	55841105	55841207	0	103	0	4340	0	4237	0.0	0.0
chr12	PYM1	55914275	55914366	0	92	102	2413	102	2321	0.0	0.043946574752261956
chr12	PYM1	55927075	55927267	0	193	102	2413	102	2220	0.0	0.04594594594594595
chr12	PMEL	55957922	55958084	0	163	126	3339	126	3176	0.0	0.039672544080604534
chr12	PMEL	55961316	55961463	0	148	126	3339	126	3191	0.0	0.039486054528361014
chr12	PMEL	55961621	55961732	0	112	126	3339	126	3227	0.0	0.039045553145336226
chr12	PMEL	55965935	55966062	0	128	126	3339	126	3211	0.0	0.03924011211460604
chr12	SMARCC2	56171678	56171937	1767	260	30332	7617	28565	7357	6.796153846153846	3.882696751393231
chr12	SMARCC2	56172936	56173029	159	94	30332	7617	30173	7523	1.6914893617021276	4.010766981257477
chr12	SMARCC2	56183860	56183930	0	71	30332	7617	30332	7546	0.0	4.019613040021203
chr12	SMARCC2	56164302	56164368	268	67	30332	7617	30064	7550	4.0	3.9819867549668873
chr12	RNF41	56216428	56216613	21155	186	83006	6543	61851	6357	113.73655913978494	9.729589428975933
chr12	RNF41	56207167	56207310	98	144	83006	6543	82908	6399	0.6805555555555556	12.956399437412095
chr12	RNF41	56212995	56213138	8238	144	83006	6543	74768	6399	57.208333333333336	11.684325675886857
chr12	RNF41	56212995	56213077	0	83	83006	6543	83006	6460	0.0	12.84922600619195
chr12	ANKRD52	56254577	56254720	0	144	335	8841	335	8697	0.0	0.038519029550419685
chr12	CS	56282419	56282608	0	190	2530	5231	2530	5041	0.0	0.5018845467169213
chr12	CS	56283791	56283857	0	67	2530	5231	2530	5164	0.0	0.48993028659953525
chr12	CS	56285915	56286023	0	109	2530	5231	2530	5122	0.0	0.4939476766887934
chr12	CS	56298608	56298691	70	84	2530	5231	2460	5147	0.8333333333333334	0.47794831940936466
chr12	CS	56291219	56291306	0	88	2530	5231	2530	5143	0.0	0.49193077970056387
chr12	CS	56282859	56282991	4	133	2530	5231	2526	5098	0.03007518796992481	0.4954884268340526
chr12	CS	56291630	56291793	8	164	2530	5231	2522	5067	0.04878048780487805	0.49773041247286365
chr12	CS	56285144	56285244	0	101	2530	5231	2530	5130	0.0	0.49317738791423
chr12	CNPY2	56315129	56315242	0	114	31	2842	31	2728	0.0	0.011363636363636364
chr12	PAN2	56318236	56318434	0	199	13664	6864	13664	6665	0.0	2.050112528132033
chr12	PAN2	56319087	56319181	0	95	13664	6864	13664	6769	0.0	2.018614270941055
chr12	PAN2	56332812	56333208	3360	397	13664	6864	10304	6467	8.463476070528968	1.59331993196227
chr12	STAT2	56349162	56349261	0	100	20980	4706	20980	4606	0.0	4.5549283543204515
chr12	STAT2	56351291	56351450	459	160	20980	4706	20521	4546	2.86875	4.514078310602728
chr12	STAT2	56353232	56353285	0	54	20980	4706	20980	4652	0.0	4.509888220120378
chr12	MIP	56455791	56455884	0	94	782	3560	782	3466	0.0	0.2256203115983843
chr12	MIP	56458477	56458574	51	98	782	3560	731	3462	0.5204081632653061	0.21114962449451186
chr12	GLS2	56479051	56479181	315	131	3963	3878	3648	3747	2.404580152671756	0.9735788630904724
chr12	GLS2	56475043	56475110	0	68	3963	3878	3963	3810	0.0	1.0401574803149607
chr12	GLS2	56480287	56480387	0	101	3963	3878	3963	3777	0.0	1.0492454328832406
chr12	GLS2	56475043	56475183	0	141	3963	3878	3963	3737	0.0	1.0604763179020604
chr12	GLS2	56479051	56479147	315	97	3963	3878	3648	3781	3.247422680412371	0.964824120603015
chr12	GLS2	56475944	56475977	0	34	3963	3878	3963	3844	0.0	1.0309573361082207
chr12	BAZ2A	56617394	56617532	0	139	290466	10465	290466	10326	0.0	28.129575828006974
chr12	BAZ2A	56630775	56630865	21	91	290466	10465	290445	10374	0.23076923076923078	27.9973973395026
chr12	ATP5F1B	56639979	56640192	105	214	53926	2227	53821	2013	0.49065420560747663	26.736711376055638
chr12	ATP5F1B	56642672	56642831	1116	160	53926	2227	52810	2067	6.975	25.54910498306725
chr12	ATP5F1B	56645170	56645353	362	184	53926	2227	53564	2043	1.9673913043478262	26.21830641213901
chr12	ATP5F1B	56642672	56642684	65	13	53926	2227	53861	2214	5.0	24.327461607949413
chr12	PTGES3	56670274	56670364	400	91	1017005	3408	1016605	3317	4.395604395604396	306.483268013265
chr12	PTGES3	56671748	56671847	98	100	1017005	3408	1016907	3308	0.98	307.4084038694075
chr12	PTGES3	56666203	56666266	134366	64	1017005	3408	882639	3344	2099.46875	263.94706937799043
chr12	PTGES3	56686868	56686917	562	50	1017005	3408	1016443	3358	11.24	302.6929720071471
chr12	NACA	56724451	56724572	0	122	342650	7785	342650	7663	0.0	44.71486363043194
chr12	NACA	56715870	56716110	16998	241	342650	7785	325652	7544	70.5311203319502	43.167020148462356
chr12	NACA	56715870	56716206	17126	337	342650	7785	325524	7448	50.81899109792285	43.7062298603652
chr12	NACA	56719725	56721459	149741	1735	342650	7785	192909	6050	86.30605187319885	31.885785123966944
chr12	NACA	56715870	56721459	431263	5590	342650	7785	-88613	2195	77.1490161001789	-40.37038724373576
chr12	NACA	56719536	56719596	0	61	342650	7785	342650	7724	0.0	44.36172967374417
chr12	NACA	56724451	56724523	0	73	342650	7785	342650	7712	0.0	44.43075726141079
chr12	NACA	56724451	56724549	0	99	342650	7785	342650	7686	0.0	44.58105646630237
chr12	PRIM1	56740011	56740128	1517	118	47906	2848	46389	2730	12.85593220338983	16.99230769230769
chr12	RDH16	56954905	56955164	102	260	1131	3468	1029	3208	0.3923076923076923	0.32076059850374067
chr12	TAC3	57012821	57012875	0	55	2479	1582	2479	1527	0.0	1.6234446627373935
chr12	TAC3	57012620	57012737	0	118	2479	1582	2479	1464	0.0	1.6933060109289617
chr12	TAC3	57010726	57010903	1168	178	2479	1582	1311	1404	6.561797752808989	0.9337606837606838
chr12	TAC3	57012133	57012291	510	159	2479	1582	1969	1423	3.207547169811321	1.3836964160224876
chr12	MYO1A	57047060	57047107	0	48	1023447	4229	1023447	4181	0.0	244.78521884716574
chr12	NEMP1	57064070	57064185	7222	116	1639097	5740	1631875	5624	62.258620689655174	290.1626955903272
chr12	NEMP1	57069233	57069306	0	74	1639097	5740	1639097	5666	0.0	289.28644546417223
chr12	STAT6	57107604	57107743	1173	140	502380	7192	501207	7052	8.378571428571428	71.0730289279637
chr12	STAT6	57108162	57108299	335952	138	502380	7192	166428	7054	2434.4347826086955	23.59342217181741
chr12	STAT6	57100845	57100899	0	55	502380	7192	502380	7137	0.0	70.39092055485499
chr12	STAT6	57110042	57110110	48	69	502380	7192	502332	7123	0.6956521739130435	70.52253264074126
chr12	STAT6	57107658	57107743	575	86	502380	7192	501805	7106	6.686046511627907	70.61708415423585
chr12	STAT6	57110076	57110110	35	35	502380	7192	502345	7157	1.0	70.18932513623027
chr12	STAT6	57109940	57110110	150	171	502380	7192	502230	7021	0.8771929824561403	71.53254522147841
chr12	STAC3	57245144	57245211	0	68	0	2103	0	2035	0.0	0.0
chr12	STAC3	57249570	57249637	0	68	0	2103	0	2035	0.0	0.0
chr12	STAC3	57249570	57249730	0	161	0	2103	0	1942	0.0	0.0
chr12	R3HDM2	57288856	57288910	0	55	1332	5933	1332	5878	0.0	0.22660768969037087
chr12	R3HDM2	57395748	57395818	1332	71	1332	5933	0	5862	18.760563380281692	0.0
chr12	R3HDM2	57272452	57272554	0	103	1332	5933	1332	5830	0.0	0.22847341337907376
chr12	R3HDM2	57289008	57289040	0	33	1332	5933	1332	5900	0.0	0.22576271186440677
chr12	R3HDM2	57292571	57292667	0	97	1332	5933	1332	5836	0.0	0.22823851953392735
chr12	R3HDM2	57305639	57305663	0	25	1332	5933	1332	5908	0.0	0.22545700744752878
chr12	R3HDM2	57292571	57292649	0	79	1332	5933	1332	5854	0.0	0.22753672702425692
chr12	ARHGAP9	57473602	57473708	0	107	54163	4871	54163	4764	0.0	11.369227539882452
chr12	ARHGAP9	57474041	57474176	53	136	54163	4871	54110	4735	0.3897058823529412	11.42766631467793
chr12	ARHGAP9	57474422	57474476	0	55	54163	4871	54163	4816	0.0	11.246470099667775
chr12	ARHGAP9	57476870	57476963	0	94	54163	4871	54163	4777	0.0	11.338287628218547
chr12	ARHGAP9	57473602	57473691	0	90	54163	4871	54163	4781	0.0	11.328801505961096
chr12	DCTN2	57532212	57532315	4511	104	32018	6940	27507	6836	43.375	4.023844353423055
chr12	DCTN2	57533237	57533303	0	67	32018	6940	32018	6873	0.0	4.6585188418449
chr12	DCTN2	57533952	57534097	110	146	32018	6940	31908	6794	0.7534246575342466	4.696496909037386
chr12	DCTN2	57535483	57535545	0	63	32018	6940	32018	6877	0.0	4.655809219136251
chr12	DCTN2	57546027	57546096	0	70	32018	6940	32018	6870	0.0	4.660553129548763
chr12	DCTN2	57538518	57538524	0	7	32018	6940	32018	6933	0.0	4.618202798211453
chr12	DCTN2	57541363	57541372	0	10	32018	6940	32018	6930	0.0	4.62020202020202
chr12	DCTN2	57538482	57538524	0	43	32018	6940	32018	6897	0.0	4.642308249963753
chr12	B4GALNT1	57629047	57629146	78	100	1054223	7003	1054145	6903	0.78	152.70824279298856
chr12	B4GALNT1	57630477	57630518	0	42	1054223	7003	1054223	6961	0.0	151.44706220370637
chr12	B4GALNT1	57631199	57631364	1224	166	1054223	7003	1052999	6837	7.373493975903615	154.0147725610648
chr12	B4GALNT1	57629047	57629174	102	128	1054223	7003	1054121	6875	0.796875	153.3266909090909
chr12	B4GALNT1	57631199	57631254	1050	56	1054223	7003	1053173	6947	18.75	151.60112278681444
chr12	B4GALNT1	57631338	57631364	0	27	1054223	7003	1054223	6976	0.0	151.12141628440367
chr12	B4GALNT1	57632540	57632581	0	42	1054223	7003	1054223	6961	0.0	151.44706220370637
chr12	AGAP2	57728317	57728377	5	61	6752	6748	6747	6687	0.08196721311475409	1.0089726334679228
chr12	CDK4	57751206	57751342	0	137	3896	2948	3896	2811	0.0	1.3859836357168267
chr12	CDK4	57751499	57751736	765	238	3896	2948	3131	2710	3.2142857142857144	1.155350553505535
chr12	CDK4	57751499	57751659	765	161	3896	2948	3131	2787	4.751552795031056	1.1234302116971655
chr12	CDK4	57751499	57751696	765	198	3896	2948	3131	2750	3.8636363636363638	1.1385454545454545
chr12	CDK4	57751499	57751752	765	254	3896	2948	3131	2694	3.0118110236220472	1.1622123236822568
chr12	METTL1	57769771	57769956	478	186	805	1954	327	1768	2.5698924731182795	0.18495475113122173
chr12	METTL1	57771093	57771257	0	165	805	1954	805	1789	0.0	0.44997205142537733
chr12	METTL1	57771479	57771605	0	127	805	1954	805	1827	0.0	0.44061302681992337
chr12	AVIL	57803523	57803669	0	147	3090	5206	3090	5059	0.0	0.610792646768136
chr12	AVIL	57815577	57815692	0	116	3090	5206	3090	5090	0.0	0.6070726915520629
chr12	AC083805.1	57886527	57886696	412	170	83625	5555	83213	5385	2.4235294117647057	15.452739090064995
chr12	AC083805.1	57872852	57872976	294	125	83625	5555	83331	5430	2.352	15.346408839779006
chr12	GIHCG	57935469	57935553	2255	85	105441	3815	103186	3730	26.529411764705884	27.663806970509384
chr12	GIHCG	57935394	57935553	5128	160	105441	3815	100313	3655	32.05	27.445417236662106
chr12	GIHCG	57935469	57935592	6186	124	105441	3815	99255	3691	49.88709677419355	26.891086426442698
chr12	GIHCG	57935469	57935572	3604	104	105441	3815	101837	3711	34.65384615384615	27.441929399083804
chr12	GIHCG	57935297	57935553	7623	257	105441	3815	97818	3558	29.66147859922179	27.49241146711636
chr12	LRIG3	58880368	58880478	0	111	51	5787	51	5676	0.0	0.008985200845665961
chr12	TAFA2	62023651	62023779	0	129	1155	8739	1155	8610	0.0	0.13414634146341464
chr12	TAFA2	61720686	61720924	30	239	1155	8739	1125	8500	0.12552301255230125	0.1323529411764706
chr12	TAFA2	61890341	61890423	0	83	1155	8739	1155	8656	0.0	0.13343345656192238
chr12	DPY19L2	63580661	63580836	0	176	19	5637	19	5461	0.0	0.003479216260758103
chr12	DPY19L2	63624039	63624131	0	93	19	5637	19	5544	0.0	0.003427128427128427
chr12	DPY19L2	63663757	63663845	15	89	19	5637	4	5548	0.16853932584269662	0.0007209805335255948
chr12	DPY19L2	63590998	63591127	0	130	19	5637	19	5507	0.0	0.0034501543490103505
chr12	C12ORF56	64277679	64277803	0	125	4635	5084	4635	4959	0.0	0.9346642468239564
chr12	C12ORF56	64318574	64318980	0	407	4635	5084	4635	4677	0.0	0.9910198845413727
chr12	C12ORF56	64312678	64312752	0	75	4635	5084	4635	5009	0.0	0.9253343980834497
chr12	GNS	64728955	64729057	0	103	51	6283	51	6180	0.0	0.00825242718446602
chr12	GNS	64752697	64752757	0	61	51	6283	51	6222	0.0	0.00819672131147541
chr12	GNS	64756666	64756762	0	97	51	6283	51	6186	0.0	0.008244422890397672
chr12	AC025419.1	65626611	65626685	0	75	1740	4040	1740	3965	0.0	0.43883984867591425
chr12	AC025419.1	65538683	65538761	0	79	1740	4040	1740	3961	0.0	0.4392830093410755
chr12	AC025419.1	65613178	65613277	0	100	1740	4040	1740	3940	0.0	0.4416243654822335
chr12	AC025419.1	65587342	65587452	0	111	1740	4040	1740	3929	0.0	0.4428607788241283
chr12	AC025419.1	65561863	65561941	14	79	1740	4040	1726	3961	0.17721518987341772	0.43574854834637716
chr12	TMBIM4	66138723	66138769	0	47	306	2161	306	2114	0.0	0.14474929044465468
chr12	TMBIM4	66160164	66160305	0	142	306	2161	306	2019	0.0	0.1515601783060921
chr12	TMBIM4	66168914	66169353	0	440	306	2161	306	1721	0.0	0.17780360255665312
chr12	TMBIM4	66138723	66138734	0	12	306	2161	306	2149	0.0	0.14239181014425314
chr12	TMBIM4	66169289	66169353	0	65	306	2161	306	2096	0.0	0.14599236641221375
chr12	GRIP1	66377016	66377061	0	46	15709	6603	15709	6557	0.0	2.395760256214732
chr12	GRIP1	66455408	66455564	0	157	15709	6603	15709	6446	0.0	2.4370152032268075
chr12	GRIP1	66596846	66596927	0	82	15709	6603	15709	6521	0.0	2.408986351786536
chr12	GRIP1	66456186	66456342	0	157	15709	6603	15709	6446	0.0	2.4370152032268075
chr12	GRIP1	66462923	66463093	0	171	15709	6603	15709	6432	0.0	2.4423196517412937
chr12	GRIP1	66455408	66455561	0	154	15709	6603	15709	6449	0.0	2.4358815320204683
chr12	MDM1	68296922	68296982	0	61	0	5181	0	5120	0.0	0.0
chr12	MDM1	68325440	68325575	0	136	0	5181	0	5045	0.0	0.0
chr12	MDM1	68326656	68327021	0	366	0	5181	0	4815	0.0	0.0
chr12	MDM1	68316580	68316610	0	31	0	5181	0	5150	0.0	0.0
chr12	CPM	68885791	68885889	0	99	0	2730	0	2631	0.0	0.0
chr12	CPM	68885791	68885885	0	95	0	2730	0	2635	0.0	0.0
chr12	BEST3	69676915	69677068	0	154	112055	6878	112055	6724	0.0	16.664931588340274
chr12	BEST3	69693673	69693907	0	235	112055	6878	112055	6643	0.0	16.86813186813187
chr12	BEST3	69697646	69697813	0	168	112055	6878	112055	6710	0.0	16.699701937406857
chr12	BEST3	69694369	69694464	0	96	112055	6878	112055	6782	0.0	16.52241226776762
chr12	AC025263.1	69730572	69730696	0	125	0	2799	0	2674	0.0	0.0
chr12	PRANCR	70242180	70242229	0	50	760	5036	760	4986	0.0	0.152426795026073
chr12	PRANCR	70224964	70225032	0	69	760	5036	760	4967	0.0	0.15300986510972417
chr12	PRANCR	70229851	70230018	0	168	760	5036	760	4868	0.0	0.1561216105176664
chr12	PRANCR	70243065	70243204	0	140	760	5036	760	4896	0.0	0.15522875816993464
chr12	PTPRB	70566434	70566704	51	271	1888	14362	1837	14091	0.1881918819188192	0.13036690085870414
chr12	PTPRB	70576381	70576645	0	265	1888	14362	1888	14097	0.0	0.13392920479534653
chr12	PTPRB	70589963	70590233	0	271	1888	14362	1888	14091	0.0	0.13398623234688808
chr12	PTPRR	70701136	70701323	0	188	2256	5055	2256	4867	0.0	0.46352989521265664
chr12	PTPRR	70639518	70639672	216	155	2256	5055	2040	4900	1.3935483870967742	0.4163265306122449
chr12	PTPRR	70672719	70672976	0	258	2256	5055	2256	4797	0.0	0.47029393370856787
chr12	TSPAN8	71277350	71277412	0	63	0	2436	0	2373	0.0	0.0
chr12	TRHDE-AS1	72264481	72264621	0	141	2847	8148	2847	8007	0.0	0.35556388160359687
chr12	TRHDE-AS1	72261197	72261428	0	232	2847	8148	2847	7916	0.0	0.35965133906013136
chr12	TRHDE-AS1	72261197	72264621	1785	3425	2847	8148	1062	4723	0.5211678832116788	0.22485708236290494
chr12	TRHDE-AS1	72259385	72259540	0	156	2847	8148	2847	7992	0.0	0.35623123123123124
chr12	TRHDE-AS1	72264481	72264616	0	136	2847	8148	2847	8012	0.0	0.3553419870194708
chr12	AC090503.2	73127889	73128016	0	128	0	1043	0	915	0.0	0.0
chr12	LINC02882	73835059	73835114	0	56	0	8438	0	8382	0.0	0.0
chr12	LINC02882	74321534	74321694	0	161	0	8438	0	8277	0.0	0.0
chr12	LINC02882	74194073	74194153	0	81	0	8438	0	8357	0.0	0.0
chr12	LINC02882	74339664	74339795	0	132	0	8438	0	8306	0.0	0.0
chr12	LINC02882	74377562	74377632	0	71	0	8438	0	8367	0.0	0.0
chr12	LINC02882	74332233	74332395	0	163	0	8438	0	8275	0.0	0.0
chr12	LINC02882	74203797	74203890	0	94	0	8438	0	8344	0.0	0.0
chr12	LINC02882	74325997	74326171	0	175	0	8438	0	8263	0.0	0.0
chr12	LINC02882	74340142	74340256	0	115	0	8438	0	8323	0.0	0.0
chr12	KCNC2	75042279	75042374	0	96	0	5547	0	5451	0.0	0.0
chr12	KCNC2	75048152	75048317	0	166	0	5547	0	5381	0.0	0.0
chr12	KCNC2	75049884	75049988	0	105	0	5547	0	5442	0.0	0.0
chr12	CAPS2	75323176	75323222	0	47	223	6680	223	6633	0.0	0.033619779888436604
chr12	CAPS2	75298870	75298966	0	97	223	6680	223	6583	0.0	0.033875132918122434
chr12	CAPS2	75322973	75323087	0	115	223	6680	223	6565	0.0	0.033968012185833965
chr12	CAPS2	75390321	75390381	19	61	223	6680	204	6619	0.3114754098360656	0.03082036561414111
chr12	CAPS2	75371078	75371482	0	405	223	6680	223	6275	0.0	0.03553784860557769
chr12	KRR1	75503903	75504074	0	172	102	10603	102	10431	0.0	0.009778544722461893
chr12	NAP1L1	76059797	76059878	0	82	0	4739	0	4657	0.0	0.0
chr12	NAP1L1	76068908	76068994	0	87	0	4739	0	4652	0.0	0.0
chr12	NAP1L1	76074202	76074239	0	38	0	4739	0	4701	0.0	0.0
chr12	NAP1L1	76067370	76067473	0	104	0	4739	0	4635	0.0	0.0
chr12	NAP1L1	76057743	76057776	0	34	0	4739	0	4705	0.0	0.0
chr12	NAP1L1	76056573	76056672	0	100	0	4739	0	4639	0.0	0.0
chr12	NAP1L1	76059776	76059878	0	103	0	4739	0	4636	0.0	0.0
chr12	NAP1L1	76061009	76061087	0	79	0	4739	0	4660	0.0	0.0
chr12	OSBPL8	76450850	76450988	867	139	701165	9227	700298	9088	6.237410071942446	77.0574383802817
chr12	OSBPL8	76534233	76534281	0	49	701165	9227	701165	9178	0.0	76.39627369797341
chr12	OSBPL8	76459858	76459895	46	38	701165	9227	701119	9189	1.2105263157894737	76.2998149961911
chr12	OSBPL8	76450850	76450979	821	130	701165	9227	700344	9097	6.315384615384615	76.98625920633175
chr12	OSBPL8	76537956	76537986	0	31	701165	9227	701165	9196	0.0	76.24673771204871
chr12	OSBPL8	76410563	76410634	43	72	701165	9227	701122	9155	0.5972222222222222	76.58350628072091
chr12	OSBPL8	76537003	76537041	0	39	701165	9227	701165	9188	0.0	76.31312581628211
chr12	CSRP2	76862809	76862959	0	151	590	3237	590	3086	0.0	0.19118600129617627
chr12	E2F7	77025557	77025982	0	426	816	6305	816	5879	0.0	0.13879911549583263
chr12	E2F7	77044245	77044269	0	25	816	6305	816	6280	0.0	0.12993630573248408
chr12	PPP1R12A	79786373	79786478	51	106	4388	10162	4337	10056	0.4811320754716981	0.43128480509148764
chr12	PPP1R12A	79805591	79805768	0	178	4388	10162	4388	9984	0.0	0.4395032051282051
chr12	PPP1R12A	79806165	79806333	0	169	4388	10162	4388	9993	0.0	0.43910737516261383
chr12	PPP1R12A	79822115	79822190	0	76	4388	10162	4388	10086	0.0	0.43505849692643267
chr12	PPP1R12A	79782570	79782595	0	26	4388	10162	4388	10136	0.0	0.43291239147592736
chr12	PPP1R12A	79779338	79779351	0	14	4388	10162	4388	10148	0.0	0.4324004729996058
chr12	PPP1R12A	79789597	79789680	0	84	4388	10162	4388	10078	0.0	0.4354038499702322
chr12	PPP1R12A	79779320	79779351	0	32	4388	10162	4388	10130	0.0	0.43316880552813425
chr12	PPP1R12A	79806165	79806297	0	133	4388	10162	4388	10029	0.0	0.4375311596370525
chr12	PPP1R12A	79810394	79810511	0	118	4388	10162	4388	10044	0.0	0.4368777379530068
chr12	PPP1R12A	79848787	79848931	0	145	4388	10162	4388	10017	0.0	0.4380553059798343
chr12	LIN7A	80848098	80848175	0	78	51	6803	51	6725	0.0	0.00758364312267658
chr12	AC078955.1	81104768	81104828	0	61	0	909	0	848	0.0	0.0
chr12	PPFIA2	81261948	81262040	0	93	0	7396	0	7303	0.0	0.0
chr12	PPFIA2	81368102	81368166	0	65	0	7396	0	7331	0.0	0.0
chr12	PPFIA2	81284240	81284303	0	64	0	7396	0	7332	0.0	0.0
chr12	PPFIA2	81439971	81440046	0	76	0	7396	0	7320	0.0	0.0
chr12	PPFIA2	81676790	81676844	0	55	0	7396	0	7341	0.0	0.0
chr12	PPFIA2	81312159	81312168	0	10	0	7396	0	7386	0.0	0.0
chr12	PPFIA2	81283009	81283039	0	31	0	7396	0	7365	0.0	0.0
chr12	SLC6A15	84891831	84892308	0	478	102	8520	102	8042	0.0	0.012683412086545635
chr12	TSPAN19	85015887	85015971	0	85	0	1576	0	1491	0.0	0.0
chr12	TSPAN19	85024651	85024772	0	122	0	1576	0	1454	0.0	0.0
chr12	TSPAN19	85027898	85028023	0	126	0	1576	0	1450	0.0	0.0
chr12	TSPAN19	85035132	85035256	0	125	0	1576	0	1451	0.0	0.0
chr12	MGAT4C	86028087	86028207	0	121	0	3695	0	3574	0.0	0.0
chr12	MGAT4C	86028103	86028204	0	102	0	3695	0	3593	0.0	0.0
chr12	MGAT4C	86022448	86022544	0	97	0	3695	0	3598	0.0	0.0
chr12	C12ORF50	87987849	87987966	0	118	93	5625	93	5507	0.0	0.016887597603050662
chr12	CEP290	88054339	88054413	0	75	527	21189	527	21114	0.0	0.0249597423510467
chr12	CEP290	88059897	88060020	0	124	527	21189	527	21065	0.0	0.025017802041300736
chr12	CEP290	88060829	88060994	0	166	527	21189	527	21023	0.0	0.025067782904437997
chr12	CEP290	88114419	88114562	0	144	527	21189	527	21045	0.0	0.025041577571869804
chr12	CEP290	88117032	88117145	0	114	527	21189	527	21075	0.0	0.025005931198102016
chr12	CEP290	88130544	88130565	0	22	527	21189	527	21167	0.0	0.024897245712665942
chr12	CEP290	88131164	88131218	0	55	527	21189	527	21134	0.0	0.024936121888899404
chr12	CEP290	88068037	88068046	0	10	527	21189	527	21179	0.0	0.02488313895840219
chr12	CEP290	88115477	88115570	0	94	527	21189	527	21095	0.0	0.024982223275657738
chr12	CEP290	88115765	88116533	0	769	527	21189	527	20420	0.0	0.025808031341821743
chr12	CEP290	88119020	88119150	0	131	527	21189	527	21058	0.0	0.025026118339823347
chr12	KITLG	88515533	88515617	0	85	3609	6217	3609	6132	0.0	0.5885518590998043
chr12	KITLG	88564207	88564344	0	138	3609	6217	3609	6079	0.0	0.5936831715742721
chr12	DUSP6	89350587	89351025	0	439	0	3814	0	3375	0.0	0.0
chr12	POC1B	89459637	89459718	0	82	0	8786	0	8704	0.0	0.0
chr12	POC1B	89497170	89497342	0	173	0	8786	0	8613	0.0	0.0
chr12	POC1B	89460015	89460038	0	24	0	8786	0	8762	0.0	0.0
chr12	POC1B	89467616	89467685	0	70	0	8786	0	8716	0.0	0.0
chr12	POC1B	89497038	89497342	0	305	0	8786	0	8481	0.0	0.0
chr12	ATP2B1	89598589	89598743	0	155	51	9425	51	9270	0.0	0.005501618122977346
chr12	ATP2B1	89601325	89601433	0	109	51	9425	51	9316	0.0	0.005474452554744526
chr12	ATP2B1	89598656	89598743	0	88	51	9425	51	9337	0.0	0.005462139873621078
chr12	DCN	91164604	91164717	0	114	51	7464	51	7350	0.0	0.0069387755102040816
chr12	DCN	91158295	91158509	0	215	51	7464	51	7249	0.0	0.007035453165953925
chr12	DCN	91179361	91179686	20	326	51	7464	31	7138	0.06134969325153374	0.004342953208181563
chr12	DCN	91157074	91157188	0	115	51	7464	51	7349	0.0	0.006939719689753708
chr12	LINC01619	91990287	91990362	0	76	0	4212	0	4136	0.0	0.0
chr12	LINC01619	91990283	91990362	0	80	0	4212	0	4132	0.0	0.0
chr12	EEA1	92864859	92864987	0	129	0	10182	0	10053	0.0	0.0
chr12	EEA1	92879246	92879363	0	118	0	10182	0	10064	0.0	0.0
chr12	AC124947.1	93339638	93339736	0	99	153	1299	153	1200	0.0	0.1275
chr12	UBE2N	93410733	93410874	0	142	47	4147	47	4005	0.0	0.011735330836454432
chr12	SOCS2-AS1	93567063	93567159	0	97	0	4449	0	4352	0.0	0.0
chr12	CEP83	94435274	94435327	0	54	876	6852	876	6798	0.0	0.12886142983230361
chr12	CEP83	94328204	94328308	0	105	876	6852	876	6747	0.0	0.1298354824366385
chr12	CEP83	94434002	94434053	0	52	876	6852	876	6800	0.0	0.1288235294117647
chr12	NDUFA12	94996903	94996976	30	74	350	1804	320	1730	0.40540540540540543	0.18497109826589594
chr12	NDUFA12	94994169	94994257	0	89	350	1804	350	1715	0.0	0.20408163265306123
chr12	NDUFA12	94972394	94972489	320	96	350	1804	30	1708	3.3333333333333335	0.01756440281030445
chr12	NR2C1	95040475	95040597	0	123	0	5319	0	5196	0.0	0.0
chr12	NR2C1	95049067	95049233	0	167	0	5319	0	5152	0.0	0.0
chr12	NR2C1	95059905	95059984	0	80	0	5319	0	5239	0.0	0.0
chr12	NR2C1	95067330	95067391	0	62	0	5319	0	5257	0.0	0.0
chr12	NR2C1	95031348	95031488	0	141	0	5319	0	5178	0.0	0.0
chr12	FGD6	95084497	95084646	0	150	102	10068	102	9918	0.0	0.0102843315184513
chr12	FGD6	95208842	95211267	0	2426	102	10068	102	7642	0.0	0.013347291285003926
chr12	AC084879.1	95380853	95380958	0	106	20860	3186	20860	3080	0.0	6.7727272727272725
chr12	AC084879.1	95396814	95397000	0	187	20860	3186	20860	2999	0.0	6.955651883961321
chr12	USP44	95520996	95521202	0	207	204	5382	204	5175	0.0	0.03942028985507246
chr12	USP44	95528806	95529002	0	197	204	5382	204	5185	0.0	0.03934426229508197
chr12	USP44	95535372	95535426	0	55	204	5382	204	5327	0.0	0.03829547587760466
chr12	NTN4	95670077	95670146	0	70	164	4379	164	4309	0.0	0.03805987468090044
chr12	CCDC38	95919553	95919623	0	71	60794	4874	60794	4803	0.0	12.657505725588175
chr12	CCDC38	95919438	95919623	0	186	60794	4874	60794	4688	0.0	12.968003412969283
chr12	HAL	95976428	95976498	0	71	0	5065	0	4994	0.0	0.0
chr12	HAL	95993771	95993838	0	68	0	5065	0	4997	0.0	0.0
chr12	HAL	95993643	95993674	0	32	0	5065	0	5033	0.0	0.0
chr12	LTA4H	96003837	96003920	51	84	134	5226	83	5142	0.6071428571428571	0.016141579152080903
chr12	LTA4H	96003837	96003981	51	145	134	5226	83	5081	0.35172413793103446	0.01633536705372958
chr12	CDK17	96334718	96334865	102	148	53721	6488	53619	6340	0.6891891891891891	8.457255520504733
chr12	IKBIP	98634295	98634413	0	119	0	4167	0	4048	0.0	0.0
chr12	ANKS1B	98829173	98829353	0	181	1347	9547	1347	9366	0.0	0.143818065342729
chr12	ANKS1B	99779870	99779972	0	103	1347	9547	1347	9444	0.0	0.1426302414231258
chr12	ANKS1B	98807843	98807915	0	73	1347	9547	1347	9474	0.0	0.14217859404686511
chr12	ANKS1B	98807843	98807918	0	76	1347	9547	1347	9471	0.0	0.14222363002850807
chr12	ANKS1B	98829173	98829251	0	79	1347	9547	1347	9468	0.0	0.14226869455006338
chr12	UHRF1BP1L	100084475	100084658	0	184	51	6666	51	6482	0.0	0.00786794199321197
chr12	UHRF1BP1L	100128579	100128725	0	147	51	6666	51	6519	0.0	0.007823285780027611
chr12	GOLGA2P5	100157348	100157445	0	98	436	6935	436	6837	0.0	0.06377065964604359
chr12	GOLGA2P5	100170763	100170852	0	90	436	6935	436	6845	0.0	0.06369612856099342
chr12	GOLGA2P5	100171221	100171260	0	40	436	6935	436	6895	0.0	0.06323422770123278
chr12	AC010203.1	100198843	100198972	0	130	1728	1297	1728	1167	0.0	1.480719794344473
chr12	DEPDC4	100263496	100263893	0	398	0	3131	0	2733	0.0	0.0
chr12	DEPDC4	100261729	100261768	0	40	0	3131	0	3091	0.0	0.0
chr12	DEPDC4	100253488	100253715	0	228	0	3131	0	2903	0.0	0.0
chr12	DEPDC4	100263496	100263692	0	197	0	3131	0	2934	0.0	0.0
chr12	ARL1	101405843	101405981	0	139	0	4578	0	4439	0.0	0.0
chr12	ARL1	101403141	101403255	0	115	0	4578	0	4463	0.0	0.0
chr12	GNPTAB	101756419	101756566	0	148	90361	9249	90361	9101	0.0	9.928689155037908
chr12	WASHC3	102039867	102039978	0	112	0	2668	0	2556	0.0	0.0
chr12	WASHC3	102048289	102048397	0	109	0	2668	0	2559	0.0	0.0
chr12	WASHC3	102017719	102017805	0	87	0	2668	0	2581	0.0	0.0
chr12	WASHC3	102039867	102039975	0	109	0	2668	0	2559	0.0	0.0
chr12	WASHC3	102019276	102019371	0	96	0	2668	0	2572	0.0	0.0
chr12	WASHC3	102050188	102050291	0	104	0	2668	0	2564	0.0	0.0
chr12	WASHC3	102050517	102050639	0	123	0	2668	0	2545	0.0	0.0
chr12	NUP37	102079058	102079216	0	159	13792	3500	13792	3341	0.0	4.1281053576773425
chr12	IGF1	102417954	102418003	0	50	3980	8123	3980	8073	0.0	0.49300136256657995
chr12	PAH	102846894	102846951	0	58	0	7403	0	7345	0.0	0.0
chr12	PAH	102866595	102866663	0	69	0	7403	0	7334	0.0	0.0
chr12	PAH	102913801	102913933	0	133	0	7403	0	7270	0.0	0.0
chr12	PAH	102917070	102917225	0	156	0	7403	0	7247	0.0	0.0
chr12	C12ORF42	103267633	103267708	0	76	0	4757	0	4681	0.0	0.0
chr12	C12ORF42	103273791	103273883	0	93	0	4757	0	4664	0.0	0.0
chr12	C12ORF42	103268857	103268962	0	106	0	4757	0	4651	0.0	0.0
chr12	C12ORF42	103378707	103378792	0	86	0	4757	0	4671	0.0	0.0
chr12	C12ORF42	103368011	103368106	0	96	0	4757	0	4661	0.0	0.0
chr12	NT5DC3	103785570	103785747	0	178	0	5597	0	5419	0.0	0.0
chr12	TTC41P	103844510	103844649	0	140	0	5454	0	5314	0.0	0.0
chr12	TTC41P	103890764	103890904	0	141	0	5454	0	5313	0.0	0.0
chr12	C12ORF73	103953413	103953534	0	122	0	2983	0	2861	0.0	0.0
chr12	C12ORF73	103954874	103954968	0	95	0	2983	0	2888	0.0	0.0
chr12	C12ORF73	103955705	103955771	0	67	0	2983	0	2916	0.0	0.0
chr12	GLT8D2	104021356	104021491	0	136	0	3287	0	3151	0.0	0.0
chr12	NFYB	104131753	104131838	0	86	0	4909	0	4823	0.0	0.0
chr12	SLC41A2	104909654	104909762	0	109	5202	5166	5202	5057	0.0	1.0286731263595017
chr12	SLC41A2	104931631	104931791	0	161	5202	5166	5202	5005	0.0	1.0393606393606394
chr12	APPL2	105229124	105229223	0	100	1558	5070	1558	4970	0.0	0.31348088531187124
chr12	CKAP4	106254077	106254219	0	143	0	3671	0	3528	0.0	0.0
chr12	AC079385.1	106507627	106507810	0	184	666	2427	666	2243	0.0	0.2969237628176549
chr12	AC079385.1	106683501	106683744	0	244	666	2427	666	2183	0.0	0.3050847457627119
chr12	MTERF2	106985114	106985225	0	112	0	1176	0	1064	0.0	0.0
chr12	MTERF2	106985114	106985215	0	102	0	1176	0	1074	0.0	0.0
chr12	MTERF2	106980620	106980713	0	94	0	1176	0	1082	0.0	0.0
chr12	CMKLR1	108293588	108293664	0	77	0	5672	0	5595	0.0	0.0
chr12	CMKLR1	108329994	108330207	0	214	0	5672	0	5458	0.0	0.0
chr12	SART3	108537487	108537595	0	109	0	7034	0	6925	0.0	0.0
chr12	SART3	108544426	108544478	0	53	0	7034	0	6981	0.0	0.0
chr12	SART3	108544426	108544532	0	107	0	7034	0	6927	0.0	0.0
chr12	SART3	108542769	108542851	0	83	0	7034	0	6951	0.0	0.0
chr12	TMEM119	108594163	108594545	0	383	0	3188	0	2805	0.0	0.0
chr12	TMEM119	108594336	108594545	0	210	0	3188	0	2978	0.0	0.0
chr12	CORO1C	108701123	108701323	0	201	8	4794	8	4593	0.0	0.0017417809710428913
chr12	SSH1	108802321	108802368	0	48	0	14534	0	14486	0.0	0.0
chr12	SSH1	108811259	108811328	0	70	0	14534	0	14464	0.0	0.0
chr12	SSH1	108818248	108818313	0	66	0	14534	0	14468	0.0	0.0
chr12	SSH1	108823257	108823361	0	105	0	14534	0	14429	0.0	0.0
chr12	SVOP	108977397	108977496	0	100	61777	7114	61777	7014	0.0	8.807670373538636
chr12	SVOP	108978577	108978663	0	87	61777	7114	61777	7027	0.0	8.791376120677388
chr12	ALKBH2	109090008	109090207	0	200	3583	1630	3583	1430	0.0	2.5055944055944055
chr12	FOXN4	109287396	109287524	0	129	0	3545	0	3416	0.0	0.0
chr12	KCTD10	109457991	109458078	0	88	0	7167	0	7079	0.0	0.0
chr12	KCTD10	109460635	109460805	0	171	0	7167	0	6996	0.0	0.0
chr12	KCTD10	109469514	109469728	0	215	0	7167	0	6952	0.0	0.0
chr12	KCTD10	109457991	109458081	0	91	0	7167	0	7076	0.0	0.0
chr12	KCTD10	109469514	109471377	0	1864	0	7167	0	5303	0.0	0.0
chr12	KCTD10	109457991	109458184	0	194	0	7167	0	6973	0.0	0.0
chr12	KCTD10	109457991	109458048	0	58	0	7167	0	7109	0.0	0.0
chr12	MMAB	109571648	109571710	0	63	172	6029	172	5966	0.0	0.028830036875628563
chr12	MMAB	109561242	109561329	0	88	172	6029	172	5941	0.0	0.0289513549907423
chr12	MMAB	109568769	109568863	0	95	172	6029	172	5934	0.0	0.028985507246376812
chr12	MMAB	109569971	109570094	19	124	172	6029	153	5905	0.1532258064516129	0.025910245554614734
chr12	MMAB	109567010	109567167	0	158	172	6029	172	5871	0.0	0.029296542326690513
chr12	FAM222A-AS1	109742104	109742165	0	62	0	1072	0	1010	0.0	0.0
chr12	TRPV4	109796524	109796704	0	181	0	3893	0	3712	0.0	0.0
chr12	TRPV4	109800617	109800758	0	142	0	3893	0	3751	0.0	0.0
chr12	TRPV4	109800617	109800787	0	171	0	3893	0	3722	0.0	0.0
chr12	GLTP	109857854	109858193	0	340	171	2752	171	2412	0.0	0.0708955223880597
chr12	GLTP	109858139	109858193	0	55	171	2752	171	2697	0.0	0.06340378197997776
chr12	GIT2	109965759	109965765	21	7	46971	13482	46950	13475	3.0	3.484230055658627
chr12	GIT2	109991626	109991760	0	135	46971	13482	46971	13347	0.0	3.5192178017532028
chr12	GIT2	109967313	109967319	14	7	46971	13482	46957	13475	2.0	3.4847495361781076
chr12	GIT2	109951166	109951316	0	151	46971	13482	46971	13331	0.0	3.523441602280399
chr12	GIT2	109945259	109945349	0	91	46971	13482	46971	13391	0.0	3.5076543947427377
chr12	ANAPC7	110377392	110377617	357	226	24492	6021	24135	5795	1.579646017699115	4.164797238999137
chr12	ANAPC7	110388511	110388623	0	113	24492	6021	24492	5908	0.0	4.145565335138794
chr12	ANAPC7	110396265	110396452	0	188	24492	6021	24492	5833	0.0	4.198868506771816
chr12	ARPC3	110440311	110440388	0	78	1801	2641	1801	2563	0.0	0.7026921576277799
chr12	GPN3	110468155	110468375	1479	221	39280	2573	37801	2352	6.6923076923076925	16.0718537414966
chr12	VPS29	110492995	110493231	357	237	1476	3202	1119	2965	1.5063291139240507	0.37740303541315345
chr12	VPS29	110499534	110499546	0	13	1476	3202	1476	3189	0.0	0.4628410159924741
chr12	VPS29	110498819	110498859	0	41	1476	3202	1476	3161	0.0	0.4669408415058526
chr12	VPS29	110501416	110501559	0	144	1476	3202	1476	3058	0.0	0.48266841072596467
chr12	VPS29	110499456	110499546	0	91	1476	3202	1476	3111	0.0	0.47444551591128253
chr12	HVCN1	110683224	110683264	0	41	126	3009	126	2968	0.0	0.04245283018867924
chr12	ATXN2	111464661	111464715	0	55	0	13978	0	13923	0.0	0.0
chr12	ATXN2	111485264	111485331	0	68	0	13978	0	13910	0.0	0.0
chr12	ATXN2	111510384	111510582	0	199	0	13978	0	13779	0.0	0.0
chr12	ATXN2	111516153	111516363	0	211	0	13978	0	13767	0.0	0.0
chr12	ATXN2	111552905	111552977	0	73	0	13978	0	13905	0.0	0.0
chr12	ATXN2	111453676	111453845	0	170	0	13978	0	13808	0.0	0.0
chr12	ATXN2	111479069	111479102	0	34	0	13978	0	13944	0.0	0.0
chr12	ATXN2	111485270	111485331	0	62	0	13978	0	13916	0.0	0.0
chr12	ATXN2	111516153	111516399	0	247	0	13978	0	13731	0.0	0.0
chr12	ATXN2	111455044	111455119	0	76	0	13978	0	13902	0.0	0.0
chr12	ATXN2	111510384	111510444	0	61	0	13978	0	13917	0.0	0.0
chr12	ATXN2	111461138	111461305	0	168	0	13978	0	13810	0.0	0.0
chr12	ATXN2	111555882	111555919	0	38	0	13978	0	13940	0.0	0.0
chr12	ATXN2	111482786	111482831	0	46	0	13978	0	13932	0.0	0.0
chr12	MAPKAPK5-AS1	111841326	111841470	0	145	94	2732	94	2587	0.0	0.0363355237727097
chr12	TMEM116	111936691	111936830	663	140	8518	5425	7855	5285	4.735714285714286	1.4862819299905392
chr12	TMEM116	111943264	111943369	0	106	8518	5425	8518	5319	0.0	1.6014288400075203
chr12	TMEM116	112003799	112003863	0	65	8518	5425	8518	5360	0.0	1.589179104477612
chr12	TMEM116	111965594	111965759	0	166	8518	5425	8518	5259	0.0	1.619699562654497
chr12	TMEM116	111978735	111978787	0	53	8518	5425	8518	5372	0.0	1.5856291883842144
chr12	TMEM116	111936741	111936830	663	90	8518	5425	7855	5335	7.366666666666666	1.472352389878163
chr12	TMEM116	112005601	112005686	0	86	8518	5425	8518	5339	0.0	1.5954298557782356
chr12	NAA25	112087682	112087801	5502	120	17295	9927	11793	9807	45.85	1.2025084123585195
chr12	NAA25	112093050	112093136	272	87	17295	9927	17023	9840	3.1264367816091956	1.729979674796748
chr12	NAA25	112049482	112049611	0	130	17295	9927	17295	9797	0.0	1.7653363274471776
chr12	NAA25	112097240	112097441	827	202	17295	9927	16468	9725	4.094059405940594	1.6933676092544987
chr12	HECTD4	112168632	112168806	0	175	104460	19857	104460	19682	0.0	5.307387460623921
chr12	RPL6	112408419	112408656	21	238	51	3049	30	2811	0.08823529411764706	0.010672358591248666
chr12	RASAL1	113112085	113112278	0	194	352	4715	352	4521	0.0	0.07785888077858881
chr12	DDX54	113164066	113164285	0	220	102	5086	102	4866	0.0	0.02096177558569667
chr12	SLC8B1	113320330	113320498	0	169	102	6033	102	5864	0.0	0.017394270122783082
chr12	SLC8B1	113334442	113334838	0	397	102	6033	102	5636	0.0	0.01809794180269695
chr12	SLC8B1	113302139	113302700	0	562	102	6033	102	5471	0.0	0.018643757996709927
chr12	SLC8B1	113334442	113334835	0	394	102	6033	102	5639	0.0	0.018088313530767865
chr12	LINC01234	113767074	113767208	0	135	339919	11884	339919	11749	0.0	28.93173887139331
chr12	LINC01234	113767074	113767236	0	163	339919	11884	339919	11721	0.0	29.000853169524785
chr12	LINC01234	113753430	113753563	0	134	339919	11884	339919	11750	0.0	28.929276595744682
chr12	RBM19	113959211	113959404	0	194	18946	5676	18946	5482	0.0	3.456037942356804
chr12	TBX5	114403751	114403936	0	186	3306	4453	3306	4267	0.0	0.7747832200609327
chr12	TBX3	114679912	114679972	0	61	0	5966	0	5905	0.0	0.0
chr12	MED13L	115968939	115969097	0	159	262	26268	262	26109	0.0	0.01003485388180321
chr12	SPRING1	116723066	116723223	153	158	7399	8683	7246	8525	0.9683544303797469	0.8499706744868035
chr12	TESC	117041946	117041994	0	49	0	1937	0	1888	0.0	0.0
chr12	TESC	117056805	117056886	0	82	0	1937	0	1855	0.0	0.0
chr12	TESC	117048680	117048810	0	131	0	1937	0	1806	0.0	0.0
chr12	FBXO21	117166897	117167077	0	181	92082	6901	92082	6720	0.0	13.70267857142857
chr12	NOS1	117255935	117256037	222	103	8451	13145	8229	13042	2.1553398058252426	0.6309615089710167
chr12	WSB2	118038287	118038388	0	102	51	3937	51	3835	0.0	0.013298565840938721
chr12	VSIG10	118082126	118082429	0	304	102	7227	102	6923	0.0	0.014733497038855988
chr12	TAOK3	118212913	118212995	0	83	1650	9442	1650	9359	0.0	0.17630088684688536
chr12	TAOK3	118239226	118239272	0	47	1650	9442	1650	9395	0.0	0.17562533262373603
chr12	TAOK3	118296941	118297163	0	223	1650	9442	1650	9219	0.0	0.17897819720143182
chr12	TAOK3	118283604	118283702	0	99	1650	9442	1650	9343	0.0	0.1766028042384673
chr12	TAOK3	118261496	118261673	18	178	1650	9442	1632	9264	0.10112359550561797	0.17616580310880828
chr12	TAOK3	118295239	118295381	0	143	1650	9442	1650	9299	0.0	0.1774384342402409
chr12	LINC02423	118759973	118760067	0	95	0	1060	0	965	0.0	0.0
chr12	AC002070.1	119402314	119402430	0	117	0	1471	0	1354	0.0	0.0
chr12	CIT	119710250	119710386	0	137	408	25017	408	24880	0.0	0.01639871382636656
chr12	CIT	119770784	119770910	51	127	408	25017	357	24890	0.4015748031496063	0.014343109682603454
chr12	RAB35	120098810	120098935	0	126	13514	3944	13514	3818	0.0	3.539549502357255
chr12	RAB35	120108591	120108703	553	113	13514	3944	12961	3831	4.893805309734513	3.383189767684678
chr12	RPLP0	120198553	120198739	0	187	2390	2408	2390	2221	0.0	1.0760918505177848
chr12	RPLP0	120198853	120199000	322	148	2390	2408	2068	2260	2.175675675675676	0.9150442477876106
chr12	RPLP0	120198553	120198631	0	79	2390	2408	2390	2329	0.0	1.0261914984972091
chr12	RPLP0	120198894	120199000	0	107	2390	2408	2390	2301	0.0	1.0386788352890048
chr12	RPLP0	120198553	120198770	934	218	2390	2408	1456	2190	4.284403669724771	0.6648401826484018
chr12	RPLP0	120200045	120200150	0	106	2390	2408	2390	2302	0.0	1.0382276281494354
chr12	PXN	120215559	120215661	0	103	16445	7481	16445	7378	0.0	2.2289238275955543
chr12	PXN	120215929	120216090	204	162	16445	7481	16241	7319	1.2592592592592593	2.219018991665528
chr12	PXN	120216272	120216581	0	310	16445	7481	16445	7171	0.0	2.293264537721378
chr12	PXN	120224642	120224727	0	86	16445	7481	16445	7395	0.0	2.2237998647734956
chr12	PLA2G1B	120324933	120325061	0	129	0	628	0	499	0.0	0.0
chr12	MSI1	120351343	120351400	0	58	180	3090	180	3032	0.0	0.059366754617414245
chr12	SRSF9	120464732	120464822	0	91	0	3090	0	2999	0.0	0.0
chr12	COQ5	120516566	120516788	0	223	31721	2512	31721	2289	0.0	13.858016601135867
chr12	COQ5	120522213	120522363	0	151	31721	2512	31721	2361	0.0	13.435408725116476
chr12	COQ5	120526456	120526546	0	91	31721	2512	31721	2421	0.0	13.102437009500207
chr12	COQ5	120523884	120524002	0	119	31721	2512	31721	2393	0.0	13.255745925616381
chr12	POP5	120579773	120579923	204	151	29184	1561	28980	1410	1.3509933774834437	20.5531914893617
chr12	SPPL3	120791468	120791557	0	90	115687	6675	115687	6585	0.0	17.56826119969628
chr12	HNF1A-AS1	120976798	120976921	0	124	19368	4467	19368	4343	0.0	4.459590145061018
chr12	C12ORF43	121010827	121010926	18	100	316840	6147	316822	6047	0.18	52.39325285265421
chr12	C12ORF43	121012429	121012686	886	258	316840	6147	315954	5889	3.434108527131783	53.65155374426897
chr12	OASL	121027575	121027817	0	243	7372	3523	7372	3280	0.0	2.247560975609756
chr12	OASL	121033460	121033743	0	284	7372	3523	7372	3239	0.0	2.276011114541525
chr12	OASL	121023989	121024137	0	149	7372	3523	7372	3374	0.0	2.1849436870183756
chr12	CAMKK2	121244572	121244615	0	44	7032	7180	7032	7136	0.0	0.9854260089686099
chr12	CAMKK2	121248605	121248734	5479	130	7032	7180	1553	7050	42.146153846153844	0.22028368794326242
chr12	ANAPC5	121331346	121331428	0	83	2778	10333	2778	10250	0.0	0.27102439024390246
chr12	ANAPC5	121347801	121347881	0	81	2778	10333	2778	10252	0.0	0.2709715177526336
chr12	ANAPC5	121330582	121330672	0	91	2778	10333	2778	10242	0.0	0.27123608670181604
chr12	ANAPC5	121331226	121331428	0	203	2778	10333	2778	10130	0.0	0.2742349457058243
chr12	ANAPC5	121351059	121351203	0	145	2778	10333	2778	10188	0.0	0.27267373380447585
chr12	KDM2B	121443679	121443793	0	115	56377	13372	56377	13257	0.0	4.252621256694576
chr12	KDM2B	121575780	121575859	0	80	56377	13372	56377	13292	0.0	4.241423412578995
chr12	KDM2B	121516468	121516520	0	53	56377	13372	56377	13319	0.0	4.232825287183722
chr12	MORN3	121653074	121653259	51	186	2833	3863	2782	3677	0.27419354838709675	0.756595050312755
chr12	LINC01089	121801571	121801608	0	38	95	3882	95	3844	0.0	0.024713839750260147
chr12	LINC01089	121802630	121802784	0	155	95	3882	95	3727	0.0	0.025489669975851892
chr12	LINC01089	121802630	121802806	0	177	95	3882	95	3705	0.0	0.02564102564102564
chr12	DIABLO	122218265	122218397	7987	133	126542	5932	118555	5799	60.05263157894737	20.44404207622004
chr12	DIABLO	122224511	122224644	0	134	126542	5932	126542	5798	0.0	21.82511210762332
chr12	AC048338.2	122225964	122226653	51	690	26001	2108	25950	1418	0.07391304347826087	18.300423131170664
chr12	DIABLO	122220529	122220627	3261	99	126542	5932	123281	5833	32.93939393939394	21.13509343391051
chr12	DIABLO	122224644	122224748	0	105	126542	5932	126542	5827	0.0	21.716492191522224
chr12	DIABLO	122209772	122209858	0	87	126542	5932	126542	5845	0.0	21.64961505560308
chr12	DIABLO	122209696	122209858	21	163	126542	5932	126521	5769	0.12883435582822086	21.931183914023226
chr12	VPS33A	122250982	122251099	816	118	36485	5708	35669	5590	6.915254237288136	6.380858676207513
chr12	VPS33A	122264711	122264804	0	94	36485	5708	36485	5614	0.0	6.49893124332027
chr12	VPS33A	122241008	122241131	308	124	36485	5708	36177	5584	2.4838709677419355	6.478689111747851
chr12	VPS33A	122265635	122265725	5492	91	36485	5708	30993	5617	60.35164835164835	5.517714082250311
chr12	CLIP1	122336631	122336748	132	118	88903	17314	88771	17196	1.11864406779661	5.16230518725285
chr12	CLIP1	122355114	122355312	2346	199	88903	17314	86557	17115	11.78894472361809	5.057376570260006
chr12	CLIP1	122347374	122347479	2475	106	88903	17314	86428	17208	23.349056603773583	5.022547652254765
chr12	CLIP1	122351110	122351143	0	34	88903	17314	88903	17280	0.0	5.144849537037037
chr12	CLIP1	122276438	122276444	0	7	88903	17314	88903	17307	0.0	5.136823250707806
chr12	CLIP1	122322113	122324381	153	2269	88903	17314	88750	15045	0.06743058616130454	5.898969757394483
chr12	CLIP1	122400131	122400243	0	113	88903	17314	88903	17201	0.0	5.168478576826929
chr12	ZCCHC8	122483459	122483563	255	105	58904	7908	58649	7803	2.4285714285714284	7.516211713443547
chr12	ZCCHC8	122483278	122483563	255	286	58904	7908	58649	7622	0.8916083916083916	7.694699553922855
chr12	ZCCHC8	122483278	122483344	0	67	58904	7908	58904	7841	0.0	7.512307103685754
chr12	ZCCHC8	122490934	122491053	0	120	58904	7908	58904	7788	0.0	7.563430919363123
chr12	RSRC2	122506833	122506923	2	91	563	7431	561	7340	0.02197802197802198	0.07643051771117167
chr12	RSRC2	122522142	122522299	0	158	563	7431	563	7273	0.0	0.07740959714010724
chr12	RSRC2	122520503	122520581	0	79	563	7431	563	7352	0.0	0.0765778019586507
chr12	RSRC2	122514711	122514728	0	18	563	7431	563	7413	0.0	0.07594765951706461
chr12	RSRC2	122513766	122513874	0	109	563	7431	563	7322	0.0	0.07689155968314668
chr12	RSRC2	122522798	122522906	0	109	563	7431	563	7322	0.0	0.07689155968314668
chr12	RSRC2	122526169	122526293	0	125	563	7431	563	7306	0.0	0.07705995072543115
chr12	ABCB9	122940806	122940995	0	190	34673	13134	34673	12944	0.0	2.67869283065513
chr12	ABCB9	122944390	122944519	0	130	34673	13134	34673	13004	0.0	2.6663334358658872
chr12	PITPNM2	122991754	122991898	0	145	112296	9192	112296	9047	0.0	12.412512435061346
chr12	PITPNM2	122989786	122989948	39371	163	112296	9192	72925	9029	241.53987730061348	8.07675268579023
chr12	MPHOSPH9	123162114	123162218	0	105	16409	8436	16409	8331	0.0	1.9696314968191093
chr12	MPHOSPH9	123203249	123203375	0	127	16409	8436	16409	8309	0.0	1.9748465519316405
chr12	MPHOSPH9	123223037	123223127	0	91	16409	8436	16409	8345	0.0	1.9663271420011983
chr12	MPHOSPH9	123227462	123227616	0	155	16409	8436	16409	8281	0.0	1.9815239705349597
chr12	MPHOSPH9	123226287	123226351	0	65	16409	8436	16409	8371	0.0	1.9602198064747343
chr12	MPHOSPH9	123162114	123162192	0	79	16409	8436	16409	8357	0.0	1.9635036496350364
chr12	MPHOSPH9	123227545	123227616	0	72	16409	8436	16409	8364	0.0	1.9618603538976567
chr12	MPHOSPH9	123227462	123227572	0	111	16409	8436	16409	8325	0.0	1.971051051051051
chr12	RILPL1	123475662	123475750	1243	89	79759	5702	78516	5613	13.96629213483146	13.988241582041688
chr12	EIF2B1	123624786	123624862	0	77	3795	3177	3795	3100	0.0	1.2241935483870967
chr12	CCDC92	123944271	123944364	0	94	12100	6039	12100	5945	0.0	2.035323801513877
chr12	CCDC92	123956283	123956444	3324	162	12100	6039	8776	5877	20.51851851851852	1.4932788837842437
chr12	NCOR2	124327408	124327633	0	226	9321	12472	9321	12246	0.0	0.7611464968152867
chr12	NCOR2	124340601	124340751	0	151	9321	12472	9321	12321	0.0	0.7565132700267836
chr12	NCOR2	124374412	124374463	0	52	9321	12472	9321	12420	0.0	0.7504830917874397
chr12	NCOR2	124457105	124457162	8402	58	9321	12472	919	12414	144.86206896551724	0.07402932173352667
chr12	NCOR2	124327546	124327633	0	88	9321	12472	9321	12384	0.0	0.7526647286821705
chr12	NCOR2	124340601	124340694	0	94	9321	12472	9321	12378	0.0	0.7530295685894328
chr12	SCARB1	124782682	124782811	205	130	26043	4213	25838	4083	1.5769230769230769	6.328190056331129
chr12	LINC00939	125982799	125983009	0	211	102	6810	102	6599	0.0	0.015456887407182906
chr12	AC006065.4	126665444	126665564	0	121	0	1197	0	1076	0.0	0.0
chr12	LINC00944	126732310	126732407	0	98	51	4790	51	4692	0.0	0.010869565217391304
chr12	LINC00944	126732342	126732407	0	66	51	4790	51	4724	0.0	0.010795935647756138
chr12	LINC00944	126747930	126748127	0	198	51	4790	51	4592	0.0	0.011106271777003485
chr12	LINC00944	126763414	126763498	0	85	51	4790	51	4705	0.0	0.010839532412327312
chr12	LINC00944	126760931	126761057	0	127	51	4790	51	4663	0.0	0.010937164915290586
chr12	LINC00944	126770192	126770254	0	63	51	4790	51	4727	0.0	0.010789083985614555
chr12	LINC02405	126923029	126923205	0	177	0	7641	0	7464	0.0	0.0
chr12	LINC02405	126997209	126997301	0	93	0	7641	0	7548	0.0	0.0
chr12	LINC02405	126975838	126975917	0	80	0	7641	0	7561	0.0	0.0
chr12	LINC02376	127276166	127276240	0	75	0	1050	0	975	0.0	0.0
chr12	LINC02411	127635357	127635402	0	46	0	2406	0	2360	0.0	0.0
chr12	LINC02411	127633767	127634768	0	1002	0	2406	0	1404	0.0	0.0
chr12	LINC02411	127633767	127634746	0	980	0	2406	0	1426	0.0	0.0
chr12	LINC02411	127632574	127632784	0	211	0	2406	0	2195	0.0	0.0
chr12	LINC02411	127632373	127632784	0	412	0	2406	0	1994	0.0	0.0
chr12	LINC02369	128112196	128112423	0	228	0	2394	0	2166	0.0	0.0
chr12	SLC15A4	128809942	128810111	0	170	0	5009	0	4839	0.0	0.0
chr12	SLC15A4	128809942	128810053	0	112	0	5009	0	4897	0.0	0.0
chr12	FZD10-AS1	130157043	130157210	0	168	0	11504	0	11336	0.0	0.0
chr12	RIMBP2	130424141	130424858	0	718	102	9642	102	8924	0.0	0.011429852084267144
chr12	RIMBP2	130470692	130470743	0	52	102	9642	102	9590	0.0	0.010636079249217936
chr12	RIMBP2	130469148	130469169	0	22	102	9642	102	9620	0.0	0.010602910602910603
chr12	RIMBP2	130471749	130472338	0	590	102	9642	102	9052	0.0	0.011268228015908087
chr12	RIMBP2	130469019	130469169	0	151	102	9642	102	9491	0.0	0.010747023495943525
chr12	RIMBP2	130517827	130517917	0	91	102	9642	102	9551	0.0	0.01067950999895299
chr12	STX2	130795994	130796120	0	127	102	3735	102	3608	0.0	0.02827050997782705
chr12	STX2	130812309	130812443	0	135	102	3735	102	3600	0.0	0.028333333333333332
chr12	AC073578.1	131474306	131474458	0	153	0	1513	0	1360	0.0	0.0
chr12	AC073578.1	131465076	131465182	0	107	0	1513	0	1406	0.0	0.0
chr12	GALNT9	132240506	132240728	1071	223	42387	4904	41316	4681	4.802690582959642	8.8263191625721
chr12	POLE	132680606	132680687	0	82	211617	15952	211617	15870	0.0	13.334404536862003
chr12	POLE	132658691	132658743	0	53	211617	15952	211617	15899	0.0	13.31008239511919
chr12	POLE	132678451	132678569	0	119	211617	15952	211617	15833	0.0	13.365565590854544
chr12	ANKLE2	132729678	132730270	0	593	0	16453	0	15860	0.0	0.0
chr12	ANKLE2	132741808	132741891	0	84	0	16453	0	16369	0.0	0.0
chr12	CHFR	132851617	132851737	0	121	41	16627	41	16506	0.0	0.002483945232036835
chr12	CHFR	132869618	132869798	0	181	41	16627	41	16446	0.0	0.0024930074182171955
chr12	CHFR	132862332	132862425	0	94	41	16627	41	16533	0.0	0.0024798887074336177
chr12	CHFR	132851617	132851734	0	118	41	16627	41	16509	0.0	0.0024834938518383913
chr12	CHFR	132870723	132870783	0	61	41	16627	41	16566	0.0	0.0024749486900881323
chr12	CHFR	132869618	132869834	0	217	41	16627	41	16410	0.0	0.002498476538695917
chr12	CHFR	132898999	132899213	0	215	41	16627	41	16412	0.0	0.002498172069217646
chr12	ZNF605	132948147	132948270	0	124	41	10832	41	10708	0.0	0.003828912962271199
chr12	ZNF605	132932712	132932805	0	94	41	10832	41	10738	0.0	0.0038182156826224623
chr12	ZNF891	133128327	133128467	198	141	16527	15585	16329	15444	1.4042553191489362	1.0573038073038072
chr13	ANKRD26P3	19331625	19331883	0	259	0	4491	0	4232	0.0	0.0
chr13	TPTE2	19473913	19474075	0	163	2428	2310	2428	2147	0.0	1.1308802980903587
chr13	TPTE2	19467224	19467344	2428	121	2428	2310	0	2189	20.06611570247934	0.0
chr13	TPTE2	19482487	19482547	0	61	2428	2310	2428	2249	0.0	1.079590929301912
chr13	PSPC1	19699379	19699398	0	20	1715	4829	1715	4809	0.0	0.35662299854439594
chr13	ZMYM5	19838699	19838985	0	287	102	3733	102	3446	0.0	0.02959953569355775
chr13	GJB6	20230697	20230807	3	111	27609	3279	27606	3168	0.02702702702702703	8.714015151515152
chr13	GJB6	20231381	20231505	0	125	27609	3279	27609	3154	0.0	8.753646163601775
chr13	GJB6	20230865	20231061	0	197	27609	3279	27609	3082	0.0	8.95814406229721
chr13	GJB6	20231381	20231492	0	112	27609	3279	27609	3167	0.0	8.717713924850015
chr13	GJB6	20230697	20230813	3	117	27609	3279	27606	3162	0.02564102564102564	8.730550284629981
chr13	GJB6	20230741	20230813	0	73	27609	3279	27609	3206	0.0	8.61166562694947
chr13	CRYL1	20476870	20476992	0	123	8918	4343	8918	4220	0.0	2.113270142180095
chr13	CRYL1	20439592	20439754	2057	163	8918	4343	6861	4180	12.61963190184049	1.6413875598086125
chr13	CRYL1	20515720	20515820	0	101	8918	4343	8918	4242	0.0	2.102310231023102
chr13	CRYL1	20513450	20513681	0	232	8918	4343	8918	4111	0.0	2.169301873023595
chr13	CRYL1	20418397	20419084	1326	688	8918	4343	7592	3655	1.927325581395349	2.0771545827633378
chr13	CRYL1	20472965	20473074	0	110	8918	4343	8918	4233	0.0	2.106780061422159
chr13	CRYL1	20405903	20406128	0	226	8918	4343	8918	4117	0.0	2.1661403934904055
chr13	SKA3	21172619	21172681	0	63	1798	2980	1798	2917	0.0	0.61638669866301
chr13	SKA3	21155692	21155811	0	120	1798	2980	1798	2860	0.0	0.6286713286713287
chr13	LINC00539	21311685	21311843	0	159	52378	4251	52378	4092	0.0	12.800097751710656
chr13	LINC00539	21312278	21312365	0	88	52378	4251	52378	4163	0.0	12.581791976939707
chr13	LINC00539	21312145	21312360	0	216	52378	4251	52378	4035	0.0	12.98091697645601
chr13	LINC00539	21312638	21312761	0	124	52378	4251	52378	4127	0.0	12.691543494063485
chr13	LINC00539	21312145	21312365	0	221	52378	4251	52378	4030	0.0	12.997022332506203
chr13	LINC00539	21312150	21312365	0	216	52378	4251	52378	4035	0.0	12.98091697645601
chr13	ZDHHC20	21378660	21378738	0	79	29525	5585	29525	5506	0.0	5.362332001452961
chr13	ZDHHC20	21425651	21425678	0	28	29525	5585	29525	5557	0.0	5.313118589166817
chr13	ZDHHC20	21381900	21381945	0	46	29525	5585	29525	5539	0.0	5.330384545946922
chr13	MICU2	21496051	21496160	0	110	396	3528	396	3418	0.0	0.11585722644821533
chr13	MICU2	21515533	21515560	0	28	396	3528	396	3500	0.0	0.11314285714285714
chr13	LINC00424	21875365	21875566	782	202	34194	1915	33412	1713	3.871287128712871	19.50496205487449
chr13	LINC00424	21875365	21875985	19266	621	34194	1915	14928	1294	31.02415458937198	11.536321483771252
chr13	LINC00621	22876297	22876474	0	178	306	6924	306	6746	0.0	0.04536021345982805
chr13	SACS	23341444	23341690	0	247	306	15925	306	15678	0.0	0.01951779563719862
chr13	SACS	23371077	23371165	0	89	306	15925	306	15836	0.0	0.019323061379136145
chr13	CENPJ	24889315	24889400	0	86	459	5689	459	5603	0.0	0.08192039978582902
chr13	CENPJ	24886233	24886385	0	153	459	5689	459	5536	0.0	0.08291184971098266
chr13	CENPJ	24886234	24886385	0	152	459	5689	459	5537	0.0	0.08289687556438505
chr13	TPTE2P1	24967391	24967453	0	63	0	3308	0	3245	0.0	0.0
chr13	LINC00463	25176675	25176849	0	175	0	2935	0	2760	0.0	0.0
chr13	WASF3-AS1	26622625	26622746	2280	122	1054138	3667	1051858	3545	18.688524590163933	296.71593794076165
chr13	MTIF3	27441016	27441077	0	62	0	1611	0	1549	0.0	0.0
chr13	MTIF3	27449851	27449918	0	68	0	1611	0	1543	0.0	0.0
chr13	FLT3	28025283	28025415	0	133	318226	4185	318226	4052	0.0	78.535538005923
chr13	MTUS2-AS2	29242528	29242698	280536	171	284433	1062	3897	891	1640.561403508772	4.373737373737374
chr13	MTUS2-AS1	29482113	29482377	0	265	102	2573	102	2308	0.0	0.04419410745233969
chr13	LINC00426	30364068	30364205	0	138	280499	4490	280499	4352	0.0	64.45289522058823
chr13	LINC00426	30367600	30367717	0	118	280499	4490	280499	4372	0.0	64.15805123513266
chr13	HMGB1	30461638	30461688	0	51	0	7702	0	7651	0.0	0.0
chr13	TEX26-AS1	30899913	30899986	0	74	9286	6332	9286	6258	0.0	1.4838606583573026
chr13	TEX26-AS1	30883937	30884060	0	124	9286	6332	9286	6208	0.0	1.495811855670103
chr13	TEX26-AS1	30932108	30932474	0	367	9286	6332	9286	5965	0.0	1.55674769488684
chr13	HSPH1	31143791	31143923	0	133	460	6340	460	6207	0.0	0.074109875946512
chr13	N4BP2L1	32403655	32403761	0	107	0	5266	0	5159	0.0	0.0
chr13	N4BP2L1	32411527	32411592	0	66	0	5266	0	5200	0.0	0.0
chr13	N4BP2L1	32416550	32416703	0	154	0	5266	0	5112	0.0	0.0
chr13	N4BP2L1	32415958	32416029	0	72	0	5266	0	5194	0.0	0.0
chr13	N4BP2L1	32420370	32420576	0	207	0	5266	0	5059	0.0	0.0
chr13	N4BP2L2	32521372	32521449	0	78	1521	10496	1521	10418	0.0	0.14599731234401997
chr13	N4BP2L2	32527407	32527532	0	126	1521	10496	1521	10370	0.0	0.14667309546769527
chr13	N4BP2L2	32535768	32537027	816	1260	1521	10496	705	9236	0.6476190476190476	0.0763317453443049
chr13	N4BP2L2	32538617	32538684	0	68	1521	10496	1521	10428	0.0	0.14585730724971233
chr13	N4BP2L2	32536932	32537027	0	96	1521	10496	1521	10400	0.0	0.14625
chr13	N4BP2L2	32522181	32522270	0	90	1521	10496	1521	10406	0.0	0.14616567364981742
chr13	N4BP2L2	32527457	32527532	0	76	1521	10496	1521	10420	0.0	0.14596928982725527
chr13	AL139383.1	33663885	33664137	0	253	91	6334	91	6081	0.0	0.014964643973030751
chr13	DCLK1	35788211	35788285	0	75	2332	14471	2332	14396	0.0	0.16198944151153097
chr13	CCDC169	36283468	36283509	0	42	378	8851	378	8809	0.0	0.042910659552730164
chr13	CCDC169	36283468	36283505	0	38	378	8851	378	8813	0.0	0.04289118347895155
chr13	CCDC169	36295777	36295857	0	81	378	8851	378	8770	0.0	0.043101482326111745
chr13	CCDC169	36240569	36240666	0	98	378	8851	378	8753	0.0	0.04318519364789215
chr13	SPART	36368873	36368990	0	118	1831	5898	1831	5780	0.0	0.31678200692041525
chr13	SMAD9	36867272	36867383	0	112	13306	5843	13306	5731	0.0	2.321758855348107
chr13	SMAD9	36874209	36874354	6	146	13306	5843	13300	5697	0.0410958904109589	2.3345620502018605
chr13	ALG5	36994988	36995035	0	48	409	2243	409	2195	0.0	0.18633257403189066
chr13	SUPT20H	37010551	37010655	0	105	53297	10212	53297	10107	0.0	5.273275947363214
chr13	SUPT20H	37025319	37025437	0	119	53297	10212	53297	10093	0.0	5.28059050827306
chr13	SUPT20H	37029764	37029836	0	73	53297	10212	53297	10139	0.0	5.256632804024066
chr13	SUPT20H	37045246	37045373	0	128	53297	10212	53297	10084	0.0	5.285303451011504
chr13	SUPT20H	37048563	37048599	0	37	53297	10212	53297	10175	0.0	5.238034398034398
chr13	SUPT20H	37045246	37045376	0	131	53297	10212	53297	10081	0.0	5.286876301954171
chr13	POSTN	37571368	37571458	0	91	60884	4931	60884	4840	0.0	12.579338842975206
chr13	POSTN	37574571	37574652	99	82	60884	4931	60785	4849	1.2073170731707317	12.53557434522582
chr13	POSTN	37569299	37569383	37	85	60884	4931	60847	4846	0.43529411764705883	12.556128765992572
chr13	POSTN	37570579	37570669	0	91	60884	4931	60884	4840	0.0	12.579338842975206
chr13	TRPC4	37651264	37651459	0	196	0	3351	0	3155	0.0	0.0
chr13	TRPC4	37663415	37663729	0	315	0	3351	0	3036	0.0	0.0
chr13	TRPC4	37691998	37692335	0	338	0	3351	0	3013	0.0	0.0
chr13	TRPC4	37745936	37746455	0	520	0	3351	0	2831	0.0	0.0
chr13	TRPC4	37651249	37651459	0	211	0	3351	0	3140	0.0	0.0
chr13	LINC00571	38062148	38062234	0	87	60	1581	60	1494	0.0	0.040160642570281124
chr13	LINC00571	38059518	38059708	0	191	60	1581	60	1390	0.0	0.04316546762589928
chr13	STOML3	38980051	38980135	0	85	1536	2006	1536	1921	0.0	0.799583550234253
chr13	PROSER1	39034130	39034196	0	67	0	6068	0	6001	0.0	0.0
chr13	LINC00598	40377050	40377228	51	179	17311	19717	17260	19538	0.2849162011173184	0.8834066946463303
chr13	LINC00598	40466506	40466677	0	172	17311	19717	17311	19545	0.0	0.8856996674341264
chr13	LINC00598	40473993	40474095	0	103	17311	19717	17311	19614	0.0	0.8825838686652391
chr13	LINC00598	40343956	40344205	0	250	17311	19717	17311	19467	0.0	0.8892484717727436
chr13	LINC00598	40451063	40451203	0	141	17311	19717	17311	19576	0.0	0.8842970984879445
chr13	LINC00598	40457513	40458668	0	1156	17311	19717	17311	18561	0.0	0.9326544905985669
chr13	LINC00598	40469995	40470162	0	168	17311	19717	17311	19549	0.0	0.8855184408409638
chr13	LINC00598	40480235	40480468	0	234	17311	19717	17311	19483	0.0	0.8885181953497922
chr13	TPTE2P5	40908158	40908212	0	55	0	2529	0	2474	0.0	0.0
chr13	SUGT1P3	40921473	40921531	0	59	0	1143	0	1084	0.0	0.0
chr13	ELF1	40951583	40951701	0	119	397	4453	397	4334	0.0	0.09160129210890632
chr13	MTRF1	41257672	41257796	0	125	186	3854	186	3729	0.0	0.0498793242156074
chr13	MTRF1	41262047	41262331	0	285	186	3854	186	3569	0.0	0.05211543849817876
chr13	MTRF1	41262410	41262481	87	72	186	3854	99	3782	1.2083333333333333	0.02617662612374405
chr13	MTRF1	41257672	41257797	0	126	186	3854	186	3728	0.0	0.049892703862660946
chr13	EPSTI1	42889210	42889242	0	33	5529	4643	5529	4610	0.0	1.199349240780911
chr13	EPSTI1	42919299	42919332	0	34	5529	4643	5529	4609	0.0	1.1996094597526579
chr13	EPSTI1	42970611	42970670	0	60	5529	4643	5529	4583	0.0	1.2064150120008728
chr13	EPSTI1	42991098	42991182	0	85	5529	4643	5529	4558	0.0	1.2130320315928038
chr13	LINC00390	44119650	44119765	0	116	102	5805	102	5689	0.0	0.017929337317630516
chr13	LINC00390	44119650	44119762	0	113	102	5805	102	5692	0.0	0.017919887561489812
chr13	TPT1	45339496	45339602	0	107	153	6154	153	6047	0.0	0.02530180254671738
chr13	TPT1	45340711	45340785	0	75	153	6154	153	6079	0.0	0.025168613258759666
chr13	TPT1	45337466	45337553	0	88	153	6154	153	6066	0.0	0.025222551928783383
chr13	TPT1	45340711	45340820	0	110	153	6154	153	6044	0.0	0.025314361350099273
chr13	SLC25A30	45408926	45409074	0	149	0	5015	0	4866	0.0	0.0
chr13	SLC25A30	45411361	45411480	0	120	0	5015	0	4895	0.0	0.0
chr13	SLC25A30	45411732	45411938	0	207	0	5015	0	4808	0.0	0.0
chr13	ERICH6B	45607563	45607615	11072	53	22988	2960	11916	2907	208.9056603773585	4.099071207430341
chr13	CPB2	46067306	46067417	0	112	7368	6711	7368	6599	0.0	1.1165328080012122
chr13	CPB2	46064647	46064741	0	95	7368	6711	7368	6616	0.0	1.1136638452237002
chr13	LCP1	46194023	46194105	0	83	12190	5101	12190	5018	0.0	2.4292546831406936
chr13	RUBCNL	46345446	46345600	0	155	0	15943	0	15788	0.0	0.0
chr13	RUBCNL	46371940	46372597	0	658	0	15943	0	15285	0.0	0.0
chr13	RUBCNL	46377889	46378005	0	117	0	15943	0	15826	0.0	0.0
chr13	RUBCNL	46363735	46363853	0	119	0	15943	0	15824	0.0	0.0
chr13	RUBCNL	46371499	46371648	0	150	0	15943	0	15793	0.0	0.0
chr13	RUBCNL	46354762	46354863	0	102	0	15943	0	15841	0.0	0.0
chr13	RUBCNL	46376491	46376584	0	94	0	15943	0	15849	0.0	0.0
chr13	RUBCNL	46368488	46368615	0	128	0	15943	0	15815	0.0	0.0
chr13	RUBCNL	46371940	46372078	0	139	0	15943	0	15804	0.0	0.0
chr13	RUBCNL	46371940	46372210	0	271	0	15943	0	15672	0.0	0.0
chr13	LINC01198	46460944	46461170	0	227	51	5378	51	5151	0.0	0.009900990099009901
chr13	LINC01198	46465842	46465987	0	146	51	5378	51	5232	0.0	0.00974770642201835
chr13	LINC01198	46460944	46461085	0	142	51	5378	51	5236	0.0	0.00974025974025974
chr13	LINC01198	46465903	46465987	0	85	51	5378	51	5293	0.0	0.009635367466465143
chr13	LINC01198	46465908	46465987	0	80	51	5378	51	5298	0.0	0.009626274065685165
chr13	LINC01198	46463933	46464019	0	87	51	5378	51	5291	0.0	0.009639009639009639
chr13	LINC01198	46460989	46461170	0	182	51	5378	51	5196	0.0	0.009815242494226328
chr13	LINC01198	46466608	46466709	0	102	51	5378	51	5276	0.0	0.009666413949962092
chr13	ESD	46790596	46790661	0	66	4563	3540	4563	3474	0.0	1.3134715025906736
chr13	HTR2A	46895494	46896234	612	741	3213	5632	2601	4891	0.8259109311740891	0.5317930893477817
chr13	SUCLA2	47996842	47997023	0	182	153	8002	153	7820	0.0	0.01956521739130435
chr13	SUCLA2	47965577	47965640	0	64	153	8002	153	7938	0.0	0.01927437641723356
chr13	SUCLA2	47991502	47991678	0	177	153	8002	153	7825	0.0	0.019552715654952077
chr13	SUCLA2	47956839	47956878	0	40	153	8002	153	7962	0.0	0.01921627731725697
chr13	SUCLA2	47994799	47994896	0	98	153	8002	153	7904	0.0	0.01935728744939271
chr13	SUCLA2	48015170	48015248	0	79	153	8002	153	7923	0.0	0.019310867095797046
chr13	MED4	48093547	48093687	0	141	0	2599	0	2458	0.0	0.0
chr13	RB1-DT	48297602	48297940	0	339	99	1836	99	1497	0.0	0.06613226452905811
chr13	LPAR6	48401297	48401407	0	111	0	3454	0	3343	0.0	0.0
chr13	LPAR6	48408623	48408767	0	145	0	3454	0	3309	0.0	0.0
chr13	LPAR6	48404180	48404263	0	84	0	3454	0	3370	0.0	0.0
chr13	LPAR6	48416312	48416564	0	253	0	3454	0	3201	0.0	0.0
chr13	RCBTB2	48510628	48510771	1591	144	3681	3559	2090	3415	11.04861111111111	0.6120058565153733
chr13	RCBTB2	48521897	48521962	0	66	3681	3559	3681	3493	0.0	1.0538219295734326
chr13	CAB39L	49344178	49344238	0	61	0	4839	0	4778	0.0	0.0
chr13	CAB39L	49401132	49401270	0	139	0	4839	0	4700	0.0	0.0
chr13	EBPL	49663056	49663195	0	140	0	1567	0	1427	0.0	0.0
chr13	EBPL	49669776	49669846	0	71	0	1567	0	1496	0.0	0.0
chr13	EBPL	49661865	49661927	0	63	0	1567	0	1504	0.0	0.0
chr13	SPRYD7	49931017	49931134	0	118	768	3342	768	3224	0.0	0.23821339950372208
chr13	DLEU2	50045117	50045232	0	116	34690	11660	34690	11544	0.0	3.005024255024255
chr13	DLEU2	50070581	50070641	1	61	34690	11660	34689	11599	0.01639344262295082	2.9906888524872834
chr13	DLEU2	50071515	50071629	35	115	34690	11660	34655	11545	0.30434782608695654	3.0017323516673886
chr13	DLEU2	50075558	50075653	39	96	34690	11660	34651	11564	0.40625	2.9964545140089935
chr13	RNASEH2B-AS1	50886057	50886127	0	71	51	7830	51	7759	0.0	0.006573011986080681
chr13	RNASEH2B-AS1	50889608	50889735	0	128	51	7830	51	7702	0.0	0.006621656712542197
chr13	RNASEH2B-AS1	50904720	50904863	0	144	51	7830	51	7686	0.0	0.00663544106167057
chr13	RNASEH2B-AS1	50891303	50891504	0	202	51	7830	51	7628	0.0	0.006685894074462507
chr13	GUCY1B2	51028207	51028404	0	198	8	4035	8	3837	0.0	0.0020849622100599426
chr13	GUCY1B2	51034002	51034159	0	158	8	4035	8	3877	0.0	0.0020634511220015478
chr13	INTS6	51423029	51423090	0	62	255	25534	255	25472	0.0	0.010010992462311559
chr13	DHRS12	51797825	51797908	0	84	0	3227	0	3143	0.0	0.0
chr13	TMEM272	51822054	51822137	0	84	108	4158	108	4074	0.0	0.026509572901325478
chr13	TMEM272	51826565	51826625	0	61	108	4158	108	4097	0.0	0.026360751769587503
chr13	ATP7B	51944108	51944291	0	184	78021	13652	78021	13468	0.0	5.793065043065043
chr13	ATP7B	51946283	51946478	0	196	78021	13652	78021	13456	0.0	5.798231272294887
chr13	ATP7B	51949661	51949796	144	136	78021	13652	77877	13516	1.0588235294117647	5.761837821840781
chr13	ATP7B	51958310	51958544	0	235	78021	13652	78021	13417	0.0	5.815085339494671
chr13	ATP7B	51960147	51960322	1839	176	78021	13652	76182	13476	10.448863636363637	5.653161175422974
chr13	ATP7B	51949715	51949796	0	82	78021	13652	78021	13570	0.0	5.749521002210759
chr13	ATP7B	51961836	51961913	0	78	78021	13652	78021	13574	0.0	5.747826727567408
chr13	ATP7B	51958310	51958400	0	91	78021	13652	78021	13561	0.0	5.753336774574146
chr13	ATP7B	51947850	51947870	0	21	78021	13652	78021	13631	0.0	5.723791357934121
chr13	ATP7B	51972594	51972832	0	239	78021	13652	78021	13413	0.0	5.816819503466786
chr13	NEK5	52099742	52099876	0	135	309562	7079	309562	6944	0.0	44.57978110599078
chr13	NEK5	52082237	52082312	0	76	309562	7079	309562	7003	0.0	44.204198200771096
chr13	NEK5	52093053	52093235	0	183	309562	7079	309562	6896	0.0	44.89008120649652
chr13	NEK5	52108317	52108404	0	88	309562	7079	309562	6991	0.0	44.28007438134745
chr13	NEK5	52112267	52112365	0	99	309562	7079	309562	6980	0.0	44.349856733524355
chr13	NEK5	52127594	52127662	0	69	309562	7079	309562	7010	0.0	44.16005706134094
chr13	NEK5	52127365	52127504	0	140	309562	7079	309562	6939	0.0	44.6119037325263
chr13	NEK3	52135728	52135863	0	136	3767	4289	3767	4153	0.0	0.9070551408620274
chr13	NEK3	52141019	52141069	0	51	3767	4289	3767	4238	0.0	0.88886267107126
chr13	NEK3	52154079	52154173	0	95	3767	4289	3767	4194	0.0	0.8981878874582737
chr13	MRPS31P5	52183975	52184114	0	140	918	3514	918	3374	0.0	0.2720806164789567
chr13	TPTE2P2	52258528	52258590	0	63	90789	4148	90789	4085	0.0	22.2249694002448
chr13	MRPS31P5	52184272	52184408	0	137	918	3514	918	3377	0.0	0.27183891027539236
chr13	TPTE2P2	52221735	52221806	0	72	90789	4148	90789	4076	0.0	22.27404317958783
chr13	THSD1	52386027	52386186	0	160	26783	3711	26783	3551	0.0	7.542382427485215
chr13	VPS36	52417436	52417679	0	244	0	6014	0	5770	0.0	0.0
chr13	LINC01065	53110860	53110940	0	81	99	3128	99	3047	0.0	0.032490974729241874
chr13	LINC01065	53149356	53149504	0	149	99	3128	99	2979	0.0	0.03323262839879154
chr13	LINC01065	53137209	53137345	0	137	99	3128	99	2991	0.0	0.033099297893681046
chr13	LINC00458	54130873	54131071	0	199	6	2502	6	2303	0.0	0.0026052974381241857
chr13	DIAPH3	60093627	60093732	0	106	0	7262	0	7156	0.0	0.0
chr13	DIAPH3	60132956	60132989	0	34	0	7262	0	7228	0.0	0.0
chr13	DIAPH3	60112009	60112186	0	178	0	7262	0	7084	0.0	0.0
chr13	LINC00448	62742222	62742405	0	184	0	1274	0	1090	0.0	0.0
chr13	LINC00448	62740300	62740460	0	161	0	1274	0	1113	0.0	0.0
chr13	LINC00448	62733046	62733146	0	101	0	1274	0	1173	0.0	0.0
chr13	LINC00448	62742222	62742400	0	179	0	1274	0	1095	0.0	0.0
chr13	PCDH9	66903503	66903605	0	103	0	30951	0	30848	0.0	0.0
chr13	PCDH9	66782713	66782797	0	85	0	30951	0	30866	0.0	0.0
chr13	KLHL1	69975619	69975802	0	184	0	4160	0	3976	0.0	0.0
chr13	DACH1	71630555	71630717	0	163	0	5413	0	5250	0.0	0.0
chr13	DACH1	71573417	71573573	0	157	0	5413	0	5256	0.0	0.0
chr13	DIS3	72770903	72770988	0	86	51	3982	51	3896	0.0	0.013090349075975359
chr13	DIS3	72780845	72781003	0	159	51	3982	51	3823	0.0	0.013340308658121894
chr13	DIS3	72781288	72781356	0	69	51	3982	51	3913	0.0	0.01303347814975722
chr13	LINC00393	73546799	73546841	1	43	1419	5042	1418	4999	0.023255813953488372	0.28365673134626923
chr13	LINC00393	73564162	73564288	0	127	1419	5042	1419	4915	0.0	0.28870803662258393
chr13	TBC1D4	75320013	75320037	0	25	306	8057	306	8032	0.0	0.03809760956175299
chr13	TBC1D4	75324236	75324401	0	166	306	8057	306	7891	0.0	0.03877835508807502
chr13	COMMD6	75527812	75527851	0	40	0	2499	0	2459	0.0	0.0
chr13	LMO7-AS1	75622259	75622303	0	45	0	2136	0	2091	0.0	0.0
chr13	SCEL-AS1	77604270	77604390	0	121	151	574	151	453	0.0	0.3333333333333333
chr13	EDNRB	77900520	77900654	1123	135	1429	4631	306	4496	8.318518518518518	0.06806049822064057
chr13	LINC01069	77990337	77990646	0	310	0	3687	0	3377	0.0	0.0
chr13	LINC01069	77987913	77988078	0	166	0	3687	0	3521	0.0	0.0
chr13	LINC00331	78787305	78787479	0	175	0	1833	0	1658	0.0	0.0
chr13	LINC00331	78824743	78824856	0	114	0	1833	0	1719	0.0	0.0
chr13	LINC00331	78792353	78792492	0	140	0	1833	0	1693	0.0	0.0
chr13	LINC00331	78790898	78790986	0	89	0	1833	0	1744	0.0	0.0
chr13	LINC00331	78794618	78794650	0	33	0	1833	0	1800	0.0	0.0
chr13	LINC00331	78792160	78792302	0	143	0	1833	0	1690	0.0	0.0
chr13	LINC00331	78795974	78796099	0	126	0	1833	0	1707	0.0	0.0
chr13	RBM26	79353152	79353224	0	73	0	10145	0	10072	0.0	0.0
chr13	AL158064.1	80054731	80054819	0	89	50476	10299	50476	10210	0.0	4.943780607247796
chr13	AL158064.1	80054669	80054819	0	151	50476	10299	50476	10148	0.0	4.973985021679149
chr13	AL158064.1	80070301	80070437	0	137	50476	10299	50476	10162	0.0	4.967132454241291
chr13	AL590807.1	81012052	81012189	0	138	153	10995	153	10857	0.0	0.014092290688035369
chr13	MIR4500HG	87445010	87445130	0	121	432	16086	432	15965	0.0	0.027059191982461636
chr13	MIR4500HG	87615562	87615755	0	194	432	16086	432	15892	0.0	0.027183488547696956
chr13	MIR4500HG	87560170	87560417	0	248	432	16086	432	15838	0.0	0.027276171233741636
chr13	MIR4500HG	87619262	87619393	0	132	432	16086	432	15954	0.0	0.027077848815344113
chr13	MIR4500HG	87621007	87621158	0	152	432	16086	432	15934	0.0	0.027111836324839964
chr13	MIR4500HG	87600955	87601060	0	106	432	16086	432	15980	0.0	0.027033792240300374
chr13	LINC01047	89219570	89219709	0	140	0	952	0	812	0.0	0.0
chr13	LINC01047	89215973	89216141	0	169	0	952	0	783	0.0	0.0
chr13	LINC00559	90068750	90068950	0	201	0	2089	0	1888	0.0	0.0
chr13	LINC00559	90107853	90108661	0	809	0	2089	0	1280	0.0	0.0
chr13	LINC00559	90106582	90108661	0	2080	0	2089	0	9	0.0	0.0
chr13	LINC00379	91130678	91130792	0	115	0	548	0	433	0.0	0.0
chr13	DCT	94452606	94452662	0	57	102	5822	102	5765	0.0	0.01769297484822203
chr13	ABCC4	95164377	95164518	0	142	44404	8667	44404	8525	0.0	5.208680351906159
chr13	ABCC4	95234609	95234834	3202	226	44404	8667	41202	8441	14.168141592920353	4.881175216206611
chr13	ABCC4	95266098	95266264	111	167	44404	8667	44293	8500	0.6646706586826348	5.210941176470588
chr13	ABCC4	95055569	95055855	30884	287	44404	8667	13520	8380	107.60975609756098	1.6133651551312649
chr13	ABCC4	95161764	95161792	0	29	44404	8667	44404	8638	0.0	5.140541792081501
chr13	ABCC4	95266111	95266264	111	154	44404	8667	44293	8513	0.7207792207792207	5.202983672031011
chr13	ABCC4	95269309	95269422	375	114	44404	8667	44029	8553	3.289473684210526	5.147784403133404
chr13	DZIP1	95609456	95609513	0	58	0	8497	0	8439	0.0	0.0
chr13	DZIP1	95630713	95630813	0	101	0	8497	0	8396	0.0	0.0
chr13	UGGT2	95989972	95990073	0	102	1183	7773	1183	7671	0.0	0.15421718159301265
chr13	STK24	98460371	98460440	0	70	306	11532	306	11462	0.0	0.026696911533763742
chr13	STK24	98482264	98482321	0	58	306	11532	306	11474	0.0	0.026668990761722154
chr13	DOCK9	98808639	98808675	0	37	1750	10506	1750	10469	0.0	0.16716018721940967
chr13	DOCK9	98796205	98796213	0	9	1750	10506	1750	10497	0.0	0.16671429932361628
chr13	DOCK9	98809122	98809128	0	7	1750	10506	1750	10499	0.0	0.16668254119439946
chr13	DOCK9	98825871	98825940	0	70	1750	10506	1750	10436	0.0	0.1676887696435416
chr13	DOCK9	98846519	98846556	0	38	1750	10506	1750	10468	0.0	0.16717615590370655
chr13	DOCK9	98854533	98854740	0	208	1750	10506	1750	10298	0.0	0.16993590988541465
chr13	DOCK9	98959402	98959534	0	133	1750	10506	1750	10373	0.0	0.16870722066904464
chr13	UBAC2-AS1	99182584	99182702	0	119	255	2596	255	2477	0.0	0.10294711344368188
chr13	GPR18	99256327	99256519	0	193	14	2023	14	1830	0.0	0.007650273224043716
chr13	LINC01232	99497248	99497336	0	89	5865	6199	5865	6110	0.0	0.9599018003273322
chr13	AL137139.2	99844237	99845970	4531	1734	23133	8877	18602	7143	2.613033448673587	2.604227915441691
chr13	GGACT	100533562	100533774	0	213	2458	3482	2458	3269	0.0	0.7519118996635057
chr13	GGACT	100533286	100533368	0	83	2458	3482	2458	3399	0.0	0.7231538687849367
chr13	TMTC4	100670359	100670569	102	211	1091713	6368	1091611	6157	0.4834123222748815	177.2959233392886
chr13	TMTC4	100665968	100666107	0	140	1091713	6368	1091713	6228	0.0	175.29110468850354
chr13	TMTC4	100670282	100670569	102	288	1091713	6368	1091611	6080	0.3541666666666667	179.54128289473684
chr13	NALCN	101283932	101284019	0	88	189771	19504	189771	19416	0.0	9.773949320148331
chr13	NALCN	101378569	101378653	0	85	189771	19504	189771	19419	0.0	9.772439363509964
chr13	NALCN	101067509	101067698	0	190	189771	19504	189771	19314	0.0	9.825566946256602
chr13	NALCN	101116919	101117006	222	88	189771	19504	189549	19416	2.522727272727273	9.76251545117429
chr13	NALCN	101347487	101347599	0	113	189771	19504	189771	19391	0.0	9.786550461554329
chr13	FGF14-IT1	102354109	102354222	0	114	0	2385	0	2271	0.0	0.0
chr13	TEX30	102767272	102767478	0	207	0	1794	0	1587	0.0	0.0
chr13	TEX30	102770011	102770086	0	76	0	1794	0	1718	0.0	0.0
chr13	POGLUT2	102789011	102789221	0	211	0	2227	0	2016	0.0	0.0
chr13	AL390755.1	110045432	110045629	0	198	306	4212	306	4014	0.0	0.07623318385650224
chr13	AL390755.1	110045196	110045629	0	434	306	4212	306	3778	0.0	0.08099523557437797
chr13	CARS2	110644064	110644182	0	119	44	8121	44	8002	0.0	0.005498625343664084
chr13	CARS2	110651033	110651100	0	68	44	8121	44	8053	0.0	0.005463802309698249
chr13	CARS2	110697917	110697967	0	51	44	8121	44	8070	0.0	0.005452292441140025
chr13	CARS2	110688784	110688904	0	121	44	8121	44	8000	0.0	0.0055
chr13	CARS2	110705520	110705571	0	52	44	8121	44	8069	0.0	0.005452968149708762
chr13	CARS2	110707337	110707643	0	307	44	8121	44	7814	0.0	0.005630918863578193
chr13	ANKRD10	110894108	110894202	0	95	0	4241	0	4146	0.0	0.0
chr13	ANKRD10	110900529	110900661	0	133	0	4241	0	4108	0.0	0.0
chr13	TUBGCP3	112521662	112521864	0	203	0	7274	0	7071	0.0	0.0
chr13	PCID2	113185484	113185560	0	77	6425	4056	6425	3979	0.0	1.614727318421714
chr13	PCID2	113190871	113190975	0	105	6425	4056	6425	3951	0.0	1.6261705897241205
chr13	DCUN1D2	113462739	113462891	0	153	19775	4355	19775	4202	0.0	4.7060923369823895
chr13	DCUN1D2	113483839	113484056	0	218	19775	4355	19775	4137	0.0	4.780033840947547
chr13	DCUN1D2	113480574	113480743	0	170	19775	4355	19775	4185	0.0	4.72520908004779
chr13	LINC00454	113880698	113880895	3758	198	74013	2845	70255	2647	18.97979797979798	26.541367585946354
chr13	FO681491.1	18417178	18417341	0	164	0	3454	0	3290	0.0	0.0
chr13	LINC00408	18907634	18907802	0	169	0	2363	0	2194	0.0	0.0
chr13	LINC00408	18907634	18907817	0	184	0	2363	0	2179	0.0	0.0
chr13	LINC00408	18906026	18906110	0	85	0	2363	0	2278	0.0	0.0
chr13	LINC00408	18908969	18909086	0	118	0	2363	0	2245	0.0	0.0
chr13	MPHOSPH8	19670839	19670964	0	126	0	4924	0	4798	0.0	0.0
chr13	ZMYM2	19970024	19970071	377	48	734	12671	357	12623	7.854166666666667	0.028281707993345482
chr13	ZMYM2	19965219	19965281	0	63	734	12671	734	12608	0.0	0.05821700507614213
chr13	IFT88	20567669	20567997	22872	329	82700	6077	59828	5748	69.51975683890578	10.40848990953375
chr13	IL17D	20717097	20717369	1003	273	1003	3332	0	3059	3.673992673992674	0.0
chr13	SAP18	21146804	21146927	0	124	12874	3381	12874	3257	0.0	3.9527172244396684
chr13	LINC00540	22263212	22263311	0	100	2754	3107	2754	3007	0.0	0.915862986365148
chr13	LINC00327	23482348	23482499	0	152	1020	5213	1020	5061	0.0	0.2015411973918198
chr13	SPATA13	24286764	24286950	0	187	114282	9963	114282	9776	0.0	11.690057283142389
chr13	SPATA13	24249476	24249842	21821	367	114282	9963	92461	9596	59.45776566757493	9.63536890370988
chr13	SPATA13	24222818	24224582	0	1765	114282	9963	114282	8198	0.0	13.94022932422542
chr13	SPATA13	24278613	24278821	0	209	114282	9963	114282	9754	0.0	11.716424031166701
chr13	TPTE2P6	24589255	24589347	0	93	0	1827	0	1734	0.0	0.0
chr13	TPTE2P6	24595788	24595859	0	72	0	1827	0	1755	0.0	0.0
chr13	TPTE2P6	24586461	24586794	0	334	0	1827	0	1493	0.0	0.0
chr13	TPTE2P6	24597101	24597277	0	177	0	1827	0	1650	0.0	0.0
chr13	RNF17	24864872	24864998	1417	127	15782	5656	14365	5529	11.15748031496063	2.598119008862362
chr13	NUP58	25302926	25303008	24	83	24	5763	0	5680	0.2891566265060241	0.0
chr13	NUP58	25309959	25310015	0	57	24	5763	24	5706	0.0	0.004206098843322818
chr13	NUP58	25303101	25303155	0	55	24	5763	24	5708	0.0	0.004204625087596356
chr13	NUP58	25309246	25309282	0	37	24	5763	24	5726	0.0	0.0041914076143905
chr13	NUP58	25320529	25320595	0	67	24	5763	24	5696	0.0	0.004213483146067416
chr13	ATP8A2	25705162	25705353	0	192	1089	10555	1089	10363	0.0	0.10508539998070057
chr13	CDK8	26393366	26393510	0	145	100	3551	100	3406	0.0	0.029359953024075163
chr13	CDK8	26401465	26401624	0	160	100	3551	100	3391	0.0	0.029489826010026542
chr13	CDK8	26382813	26382871	0	59	100	3551	100	3492	0.0	0.0286368843069874
chr13	CDK8	26401468	26401624	0	157	100	3551	100	3394	0.0	0.02946375957572186
chr13	RPL21	27254219	27254281	2775	63	16787	1957	14012	1894	44.04761904761905	7.3980992608236535
chr13	GTF3A	27432730	27432804	0	75	0	2790	0	2715	0.0	0.0
chr13	POLR1D	27621336	27621437	0	102	16728	9742	16728	9640	0.0	1.7352697095435685
chr13	POLR1D	27650041	27650241	0	201	16728	9742	16728	9541	0.0	1.7532753380148831
chr13	POLR1D	27646193	27646218	575	26	16728	9742	16153	9716	22.115384615384617	1.662515438452038
chr13	PAN3	28197184	28197346	278663	163	543607	6372	264944	6209	1709.5889570552147	42.67096150748913
chr13	POMP	28659821	28659919	0	99	51	1469	51	1370	0.0	0.03722627737226277
chr13	MTUS2	29439982	29440049	0	68	224	8464	224	8396	0.0	0.0266793711291091
chr13	LINC00544	29937201	29937281	0	81	0	1970	0	1889	0.0	0.0
chr13	USPL1	30621072	30621239	0	168	0	5134	0	4966	0.0	0.0
chr13	USPL1	30630834	30631474	0	641	0	5134	0	4493	0.0	0.0
chr13	MEDAG	30921560	30921846	0	287	589	2299	589	2012	0.0	0.2927435387673956
chr13	TEX26	30952659	30952825	0	167	0	1713	0	1546	0.0	0.0
chr13	RXFP2	31782675	31782747	0	73	10093	3354	10093	3281	0.0	3.0761962816214568
chr13	FRY	32257963	32257972	0	10	437	17261	437	17251	0.0	0.02533186481943076
chr13	BRCA2	32374961	32375210	0	250	1478	12439	1478	12189	0.0	0.1212568709492165
chr13	BRCA2	32375342	32375406	0	65	1478	12439	1478	12374	0.0	0.11944399547438177
chr13	BRCA2	32395990	32396116	0	127	1478	12439	1478	12312	0.0	0.1200454840805718
chr13	BRCA2	32383892	32384031	0	140	1478	12439	1478	12299	0.0	0.12017237173753964
chr13	STARD13-AS	33279532	33279656	0	125	10100	3839	10100	3714	0.0	2.719439956919763
chr13	STARD13-AS	33273935	33274058	4536	124	10100	3839	5564	3715	36.58064516129032	1.4977119784656796
chr13	STARD13-AS	33279460	33279656	0	197	10100	3839	10100	3642	0.0	2.773201537616694
chr13	STARD13-AS	33272605	33272894	0	290	10100	3839	10100	3549	0.0	2.8458720766413075
chr13	STARD13-AS	33275686	33275850	0	165	10100	3839	10100	3674	0.0	2.749047359825803
chr13	STARD13-AS	33276670	33276747	0	78	10100	3839	10100	3761	0.0	2.685455995745812
chr13	STARD13-AS	33276076	33276189	0	114	10100	3839	10100	3725	0.0	2.7114093959731544
chr13	STARD13-AS	33279460	33279570	0	111	10100	3839	10100	3728	0.0	2.709227467811159
chr13	STARD13-AS	33279896	33280076	0	181	10100	3839	10100	3658	0.0	2.7610716238381627
chr13	STARD13-AS	33273935	33273976	3261	42	10100	3839	6839	3797	77.64285714285714	1.8011588095865156
chr13	STARD13-AS	33279532	33279570	0	39	10100	3839	10100	3800	0.0	2.6578947368421053
chr13	STARD13-AS	33275781	33275850	0	70	10100	3839	10100	3769	0.0	2.6797559034226586
chr13	STARD13-AS	33278375	33278669	0	295	10100	3839	10100	3544	0.0	2.849887133182844
chr13	STARD13-AS	33280422	33280583	224	162	10100	3839	9876	3677	1.382716049382716	2.685885232526516
chr13	STARD13-AS	33278495	33278669	0	175	10100	3839	10100	3664	0.0	2.756550218340611
chr13	STARD13-AS	33280789	33280920	0	132	10100	3839	10100	3707	0.0	2.724575128135959
chr13	STARD13-AS	33279472	33279656	0	185	10100	3839	10100	3654	0.0	2.7640941434044883
chr13	STARD13-AS	33280422	33280479	71	58	10100	3839	10029	3781	1.2241379310344827	2.6524728907696375
chr13	LINC02343	34608475	34608619	0	145	153	2680	153	2535	0.0	0.06035502958579882
chr13	NBEA	35168986	35168995	0	10	153	11830	153	11820	0.0	0.012944162436548223
chr13	NBEA	35645868	35645931	0	64	153	11830	153	11766	0.0	0.013003569607343193
chr13	LINC00445	35697706	35697851	0	146	102	1560	102	1414	0.0	0.07213578500707214
chr13	SPART-AS1	36360653	36360740	0	88	778	5035	778	4947	0.0	0.15726703052354962
chr13	EXOSC8	37002272	37002309	0	38	2766	1913	2766	1875	0.0	1.4752
chr13	LINC02334	37987898	37988042	0	145	51	6006	51	5861	0.0	0.008701586759938576
chr13	LINC00366	38577604	38577710	0	107	51	1529	51	1422	0.0	0.035864978902953586
chr13	NHLRC3	39042104	39042305	0	202	102	6410	102	6208	0.0	0.01643041237113402
chr13	AL354809.1	39082440	39082528	0	89	0	15941	0	15852	0.0	0.0
chr13	AL354809.1	39081227	39081363	0	137	0	15941	0	15804	0.0	0.0
chr13	AL354809.1	39081259	39081363	0	105	0	15941	0	15836	0.0	0.0
chr13	COG6	39679537	39679620	0	84	816	8068	816	7984	0.0	0.10220440881763528
chr13	COG6	39656116	39656275	51	160	816	8068	765	7908	0.31875	0.09673748103186647
chr13	COG6	39656825	39656890	0	66	816	8068	816	8002	0.0	0.10197450637340665
chr13	SLC25A15	40805117	40805255	0	139	0	4194	0	4055	0.0	0.0
chr13	AL354696.2	41146426	41146507	0	82	1060	2932	1060	2850	0.0	0.3719298245614035
chr13	AL354696.2	41134708	41134762	490	55	1060	2932	570	2877	8.909090909090908	0.1981230448383733
chr13	NAA16	41336649	41336756	0	108	27391	5826	27391	5718	0.0	4.790311297656523
chr13	NAA16	41362730	41362873	0	144	27391	5826	27391	5682	0.0	4.820661738824358
chr13	AL354833.1	41554177	41554270	0	94	7316	5902	7316	5808	0.0	1.2596418732782368
chr13	DGKH	42221263	42221394	0	132	5845	19782	5845	19650	0.0	0.2974554707379135
chr13	DGKH	42221161	42221394	0	234	5845	19782	5845	19548	0.0	0.29900757110701864
chr13	DGKH	42225289	42225337	0	49	5845	19782	5845	19733	0.0	0.296204327775807
chr13	NRAD1	43941591	43941684	0	94	0	3248	0	3154	0.0	0.0
chr13	NRAD1	44027696	44027755	0	60	0	3248	0	3188	0.0	0.0
chr13	NRAD1	43919384	43919433	0	50	0	3248	0	3198	0.0	0.0
chr13	NRAD1	43942422	43942613	0	192	0	3248	0	3056	0.0	0.0
chr13	NRAD1	44026822	44026894	0	73	0	3248	0	3175	0.0	0.0
chr13	NRAD1	44026831	44026894	0	64	0	3248	0	3184	0.0	0.0
chr13	NRAD1	44027678	44027755	0	78	0	3248	0	3170	0.0	0.0
chr13	SMIM2-AS1	44172698	44172873	0	176	510	5189	510	5013	0.0	0.10173548773189707
chr13	SERP2	44395783	44396083	714	301	3554	1951	2840	1650	2.372093023255814	1.7212121212121212
chr13	SERP2	44390356	44390578	0	223	3554	1951	3554	1728	0.0	2.056712962962963
chr13	GPALPP1	45029238	45032107	1020	2870	66345	10844	65325	7974	0.3554006968641115	8.192249811888638
chr13	TPT1-AS1	45370079	45370182	0	104	51	8229	51	8125	0.0	0.006276923076923077
chr13	TPT1-AS1	45378529	45378671	0	143	51	8229	51	8086	0.0	0.0063071976255256
chr13	TPT1-AS1	45379194	45379335	0	142	51	8229	51	8087	0.0	0.006306417707431681
chr13	TPT1-AS1	45379925	45380001	0	77	51	8229	51	8152	0.0	0.0062561334641805695
chr13	TPT1-AS1	45369958	45370182	0	225	51	8229	51	8004	0.0	0.006371814092953523
chr13	TPT1-AS1	45381072	45381217	0	146	51	8229	51	8083	0.0	0.006309538537671656
chr13	TPT1-AS1	45383759	45383838	0	80	51	8229	51	8149	0.0	0.006258436617989937
chr13	TPT1-AS1	45390757	45390902	0	146	51	8229	51	8083	0.0	0.006309538537671656
chr13	TPT1-AS1	45381141	45381217	0	77	51	8229	51	8152	0.0	0.0062561334641805695
chr13	TPT1-AS1	45390713	45390902	0	190	51	8229	51	8039	0.0	0.006344072645851474
chr13	TPT1-AS1	45383159	45383235	0	77	51	8229	51	8152	0.0	0.0062561334641805695
chr13	TPT1-AS1	45351896	45352014	0	119	51	8229	51	8110	0.0	0.006288532675709001
chr13	TPT1-AS1	45360140	45360239	0	100	51	8229	51	8129	0.0	0.006273834419977857
chr13	TPT1-AS1	45344328	45344446	0	119	51	8229	51	8110	0.0	0.006288532675709001
chr13	TPT1-AS1	45383090	45383235	0	146	51	8229	51	8083	0.0	0.006309538537671656
chr13	TPT1-AS1	45390713	45390858	0	146	51	8229	51	8083	0.0	0.006309538537671656
chr13	TPT1-AS1	45344304	45344446	0	143	51	8229	51	8086	0.0	0.0063071976255256
chr13	TPT1-AS1	45378529	45380001	0	1473	51	8229	51	6756	0.0	0.007548845470692718
chr13	TPT1-AS1	45379898	45380001	0	104	51	8229	51	8125	0.0	0.006276923076923077
chr13	CBY2	45702774	45702855	0	82	44	2121	44	2039	0.0	0.02157920549288867
chr13	CPB2-AS1	46097109	46097399	204	291	39674	17234	39470	16943	0.7010309278350515	2.329575635955852
chr13	CPB2-AS1	46098397	46098781	180	385	39674	17234	39494	16849	0.4675324675324675	2.343996676360615
chr13	CPB2-AS1	46098397	46098810	180	414	39674	17234	39494	16820	0.43478260869565216	2.348038049940547
chr13	CPB2-AS1	46113183	46113507	51	325	39674	17234	39623	16909	0.15692307692307692	2.343308297356437
chr13	CPB2-AS1	46098397	46098667	180	271	39674	17234	39494	16963	0.6642066420664207	2.3282438247951425
chr13	LRRC63	46212875	46213119	0	245	0	5177	0	4932	0.0	0.0
chr13	LRRC63	46227511	46228189	0	679	0	5177	0	4498	0.0	0.0
chr13	LRRC63	46213001	46213119	0	119	0	5177	0	5058	0.0	0.0
chr13	LRRC63	46250354	46250491	0	138	0	5177	0	5039	0.0	0.0
chr13	LRRC63	46252999	46253232	0	234	0	5177	0	4943	0.0	0.0
chr13	LRRC63	46254332	46254489	0	158	0	5177	0	5019	0.0	0.0
chr13	LRRC63	46252028	46252293	0	266	0	5177	0	4911	0.0	0.0
chr13	LRRC63	46253899	46254119	0	221	0	5177	0	4956	0.0	0.0
chr13	LRCH1	46715559	46715664	0	106	1480	8633	1480	8527	0.0	0.1735663187521989
chr13	HTR2A-AS1	46853938	46854082	0	145	0	606	0	461	0.0	0.0
chr13	ITM2B	48239225	48239332	0	108	153	10168	153	10060	0.0	0.015208747514910536
chr13	ITM2B	48254899	48254970	0	72	153	10168	153	10096	0.0	0.015154516640253565
chr13	CYSLTR2	48694670	48694799	0	130	16574	5116	16574	4986	0.0	3.324107501002808
chr13	FNDC3A	49201132	49201229	0	98	393	7727	393	7629	0.0	0.05151395988989382
chr13	CDADC1	49259345	49259523	0	179	0	3874	0	3695	0.0	0.0
chr13	CDADC1	49265878	49266003	0	126	0	3874	0	3748	0.0	0.0
chr13	CDADC1	49259485	49259523	0	39	0	3874	0	3835	0.0	0.0
chr13	SETDB2	49464020	49464056	0	37	38	6696	38	6659	0.0	0.005706562546928968
chr13	PHF11	49506634	49506756	0	123	0	4736	0	4613	0.0	0.0
chr13	PHF11	49497055	49497217	0	163	0	4736	0	4573	0.0	0.0
chr13	PHF11	49525772	49525937	0	166	0	4736	0	4570	0.0	0.0
chr13	TRIM13	50000994	50001108	493	115	16354	8102	15861	7987	4.28695652173913	1.9858520095154626
chr13	TRIM13	50018822	50018920	1824	99	16354	8102	14530	8003	18.424242424242426	1.8155691615644134
chr13	DLEU1	50083141	50083194	0	54	233640	22973	233640	22919	0.0	10.194162048955015
chr13	DLEU1	50274931	50275046	13050	116	233640	22973	220590	22857	112.5	9.650872817955113
chr13	DLEU1	50433412	50433550	0	139	233640	22973	233640	22834	0.0	10.23211001138653
chr13	DLEU1	50458002	50458113	0	112	233640	22973	233640	22861	0.0	10.220025370718691
chr13	DLEU1	50492650	50492761	135	112	233640	22973	233505	22861	1.2053571428571428	10.214120117230218
chr13	DLEU1	50390197	50390291	0	95	233640	22973	233640	22878	0.0	10.21243115656963
chr13	DLEU1	50415088	50415202	0	115	233640	22973	233640	22858	0.0	10.221366698748797
chr13	DLEU1	50527865	50528064	0	200	233640	22973	233640	22773	0.0	10.259517850085627
chr13	DLEU1	50425577	50425729	51	153	233640	22973	233589	22820	0.3333333333333333	10.23615249780894
chr13	DLEU1	50401464	50401639	0	176	233640	22973	233640	22797	0.0	10.248716936439004
chr13	RNASEH2B	50929474	50929582	0	109	6273	19088	6273	18979	0.0	0.3305232098635334
chr13	RNASEH2B	50930682	50930759	0	78	6273	19088	6273	19010	0.0	0.3299842188321936
chr13	RNASEH2B	50934884	50934999	0	116	6273	19088	6273	18972	0.0	0.33064516129032256
chr13	RNASEH2B	50953904	50953985	0	82	6273	19088	6273	19006	0.0	0.3300536672629696
chr13	RNASEH2B	50915274	50915475	0	202	6273	19088	6273	18886	0.0	0.33215079953404636
chr13	RNASEH2B	50956357	50956421	0	65	6273	19088	6273	19023	0.0	0.3297587131367292
chr13	RNASEH2B	50912994	50913131	0	138	6273	19088	6273	18950	0.0	0.33102902374670184
chr13	RNASEH2B	50929460	50929582	0	123	6273	19088	6273	18965	0.0	0.330767202741893
chr13	RNASEH2B	50960144	50960171	0	28	6273	19088	6273	19060	0.0	0.32911857292759705
chr13	RNASEH2B	50929515	50929582	0	68	6273	19088	6273	19020	0.0	0.3298107255520505
chr13	RNASEH2B	50949996	50950318	0	323	6273	19088	6273	18765	0.0	0.3342925659472422
chr13	RNASEH2B	50950070	50950318	0	249	6273	19088	6273	18839	0.0	0.33297945750836033
chr13	RNASEH2B	50921177	50921331	0	155	6273	19088	6273	18933	0.0	0.33132625574393915
chr13	RNASEH2B	50960148	50960171	0	24	6273	19088	6273	19064	0.0	0.3290495174150231
chr13	RNASEH2B	50956357	50956441	0	85	6273	19088	6273	19003	0.0	0.3301057727727201
chr13	FAM124A	51245311	51245419	0	109	0	6707	0	6598	0.0	0.0
chr13	INTS6-AS1	51551124	51551188	0	65	22626	14164	22626	14099	0.0	1.6047946662883892
chr13	INTS6-AS1	51468267	51468367	0	101	22626	14164	22626	14063	0.0	1.6089027945673042
chr13	INTS6-AS1	51454149	51454329	0	181	22626	14164	22626	13983	0.0	1.6181077022098262
chr13	INTS6-AS1	51479008	51479064	0	57	22626	14164	22626	14107	0.0	1.6038845962997093
chr13	INTS6-AS1	51549118	51549230	0	113	22626	14164	22626	14051	0.0	1.6102768486228738
chr13	INTS6-AS1	51467537	51467684	0	148	22626	14164	22626	14016	0.0	1.6142979452054795
chr13	INTS6-AS1	51506542	51506638	30	97	22626	14164	22596	14067	0.30927835051546393	1.6063126466197484
chr13	INTS6-AS1	51454002	51454329	0	328	22626	14164	22626	13836	0.0	1.6352992194275802
chr13	INTS6-AS1	51467508	51467684	0	177	22626	14164	22626	13987	0.0	1.6176449560305999
chr13	INTS6-AS1	51467595	51467684	0	90	22626	14164	22626	14074	0.0	1.6076453033963336
chr13	INTS6-AS1	51462265	51462419	0	155	22626	14164	22626	14009	0.0	1.6151045756299522
chr13	INTS6-AS1	51468771	51468894	0	124	22626	14164	22626	14040	0.0	1.6115384615384616
chr13	ALG11	52024005	52024937	32001	933	150243	11770	118242	10837	34.29903536977492	10.91095321583464
chr13	ALG11	52024585	52024937	18604	353	150243	11770	131639	11417	52.70254957507082	11.530086712796706
chr13	CKAP2	52460898	52460974	0	77	240	4557	240	4480	0.0	0.05357142857142857
chr13	CKAP2	52460895	52460974	0	80	240	4557	240	4477	0.0	0.05360732633459906
chr13	AL137058.1	52497561	52497674	0	114	6863	4551	6863	4437	0.0	1.5467658327698897
chr13	AL137058.1	52577070	52577176	0	107	6863	4551	6863	4444	0.0	1.5443294329432944
chr13	AL137058.2	52632421	52632494	102	74	134	954	32	880	1.3783783783783783	0.03636363636363636
chr13	AL137058.2	52621988	52622264	0	277	134	954	134	677	0.0	0.19793205317577547
chr13	AL137058.2	52629218	52629359	0	142	134	954	134	812	0.0	0.16502463054187191
chr13	SUGT1	52661474	52661570	0	97	4539	14527	4539	14430	0.0	0.31455301455301454
chr13	LINC00558	53870464	53870527	0	64	255	4098	255	4034	0.0	0.06321269211700545
chr13	AL390964.1	54980380	54980424	0	45	0	4150	0	4105	0.0	0.0
chr13	AL390964.1	54952300	54952393	0	94	0	4150	0	4056	0.0	0.0
chr13	AL390964.1	54980380	54980446	0	67	0	4150	0	4083	0.0	0.0
chr13	AL390964.1	54970742	54970897	0	156	0	4150	0	3994	0.0	0.0
chr13	AL390964.1	54953651	54953889	0	239	0	4150	0	3911	0.0	0.0
chr13	AL390964.1	54960587	54960653	0	67	0	4150	0	4083	0.0	0.0
chr13	AL390964.1	54941758	54941799	0	42	0	4150	0	4108	0.0	0.0
chr13	PCDH17	57709668	57709752	0	85	0	8397	0	8312	0.0	0.0
chr13	DIAPH3-AS1	60020920	60021008	0	89	0	972	0	883	0.0	0.0
chr13	TDRD3	60444686	60444748	0	63	7545	7840	7545	7777	0.0	0.9701684454159701
chr13	TDRD3	60484692	60484757	0	66	7545	7840	7545	7774	0.0	0.9705428350913301
chr13	TDRD3	60444682	60444748	0	67	7545	7840	7545	7773	0.0	0.9706676958703203
chr13	LINC00378	60690772	60690864	0	93	0	3415	0	3322	0.0	0.0
chr13	AL354810.1	63052272	63052408	0	137	0	680	0	543	0.0	0.0
chr13	AL359208.1	63441408	63441495	0	88	51	9268	51	9180	0.0	0.005555555555555556
chr13	LINC00383	69269890	69269951	0	62	0	2347	0	2285	0.0	0.0
chr13	LINC00383	69311953	69312086	0	134	0	2347	0	2213	0.0	0.0
chr13	LINC00348	71041467	71041554	0	88	0	1793	0	1705	0.0	0.0
chr13	LINC00348	71101144	71101273	0	130	0	1793	0	1663	0.0	0.0
chr13	LINC00348	71145195	71145289	0	95	0	1793	0	1698	0.0	0.0
chr13	LINC00348	71143185	71143236	0	52	0	1793	0	1741	0.0	0.0
chr13	LINC00348	71157578	71157764	0	187	0	1793	0	1606	0.0	0.0
chr13	LINC00348	71023488	71023588	0	101	0	1793	0	1692	0.0	0.0
chr13	LINC00348	71157578	71157799	0	222	0	1793	0	1571	0.0	0.0
chr13	LINC00348	71145209	71145289	0	81	0	1793	0	1712	0.0	0.0
chr13	BORA	72731280	72731387	0	108	0	3201	0	3093	0.0	0.0
chr13	BORA	72734959	72735005	0	47	0	3201	0	3154	0.0	0.0
chr13	BORA	72728925	72729093	0	169	0	3201	0	3032	0.0	0.0
chr13	PIBF1	72783422	72783721	0	300	0	4201	0	3901	0.0	0.0
chr13	PIBF1	72827732	72827914	0	183	0	4201	0	4018	0.0	0.0
chr13	AL353660.1	74331951	74332013	0	63	0	3166	0	3103	0.0	0.0
chr13	AL353660.1	74399266	74399305	0	40	0	3166	0	3126	0.0	0.0
chr13	AL353660.1	74399995	74400168	0	174	0	3166	0	2992	0.0	0.0
chr13	AL353660.1	74356146	74356322	0	177	0	3166	0	2989	0.0	0.0
chr13	LINC00381	74419442	74419539	0	98	1989	1512	1989	1414	0.0	1.4066478076379068
chr13	LINC00347	74553167	74553248	0	82	0	3684	0	3602	0.0	0.0
chr13	UCHL3	75589937	75590129	0	193	0	1913	0	1720	0.0	0.0
chr13	LMO7	75623270	75623320	0	51	119331	12803	119331	12752	0.0	9.357826223337515
chr13	LMO7	75805478	75805760	0	283	119331	12803	119331	12520	0.0	9.531230031948882
chr13	LMO7	75838139	75838196	0	58	119331	12803	119331	12745	0.0	9.362965868968223
chr13	LMO7	75855259	75855368	0	110	119331	12803	119331	12693	0.0	9.401323564169227
chr13	LMO7	75809153	75809183	0	31	119331	12803	119331	12772	0.0	9.343172564985906
chr13	LMO7	75807479	75808199	0	721	119331	12803	119331	12082	0.0	9.876758814765767
chr13	LMO7	75838346	75838388	0	43	119331	12803	119331	12760	0.0	9.351959247648903
chr13	CLN5	76998042	76998085	0	44	102	21845	102	21801	0.0	0.004678684464015412
chr13	CLN5	76995456	76995513	0	58	102	21845	102	21787	0.0	0.004681690916601643
chr13	CLN5	76999929	76999995	0	67	102	21845	102	21778	0.0	0.004683625677289007
chr13	MYCBP2-AS1	77083009	77083112	0	104	0	4097	0	3993	0.0	0.0
chr13	SCEL	77567679	77567748	0	70	6819	3709	6819	3639	0.0	1.873866446826051
chr13	SCEL	77593513	77593573	0	61	6819	3709	6819	3648	0.0	1.8692434210526316
chr13	SCEL	77599328	77599388	102	61	6819	3709	6717	3648	1.6721311475409837	1.841282894736842
chr13	SCEL	77572123	77572189	144	67	6819	3709	6675	3642	2.1492537313432836	1.8327841845140034
chr13	SCEL	77604355	77604415	0	61	6819	3709	6819	3648	0.0	1.8692434210526316
chr13	SLAIN1	77746513	77746855	306	343	357	4111	51	3768	0.892128279883382	0.013535031847133758
chr13	SLAIN1	77743015	77743165	0	151	357	4111	357	3960	0.0	0.09015151515151515
chr13	LINC00446	78037195	78037250	0	56	28	1059	28	1003	0.0	0.027916251246261216
chr13	OBI1-AS1	78189607	78189696	0	90	0	8801	0	8711	0.0	0.0
chr13	OBI1-AS1	78363571	78363731	0	161	0	8801	0	8640	0.0	0.0
chr13	OBI1-AS1	78274252	78274337	0	86	0	8801	0	8715	0.0	0.0
chr13	OBI1-AS1	78606971	78607210	0	240	0	8801	0	8561	0.0	0.0
chr13	OBI1-AS1	78188308	78188436	0	129	0	8801	0	8672	0.0	0.0
chr13	OBI1-AS1	78578476	78578663	0	188	0	8801	0	8613	0.0	0.0
chr13	RBM26-AS1	79412681	79412907	0	227	2040	6758	2040	6531	0.0	0.3123564538355535
chr13	RBM26-AS1	79415110	79415364	0	255	2040	6758	2040	6503	0.0	0.3137013685991081
chr13	RBM26-AS1	79415261	79415364	0	104	2040	6758	2040	6654	0.0	0.3065825067628494
chr13	NDFIP2	79543557	79543682	0	126	0	5004	0	4878	0.0	0.0
chr13	NDFIP2	79534391	79534554	0	164	0	5004	0	4840	0.0	0.0
chr13	NDFIP2	79543617	79543682	0	66	0	5004	0	4938	0.0	0.0
chr13	LINC00382	79908811	79908875	0	65	0	1525	0	1460	0.0	0.0
chr13	LINC00382	79914715	79914860	0	146	0	1525	0	1379	0.0	0.0
chr13	LINC00382	79916533	79916622	0	90	0	1525	0	1435	0.0	0.0
chr13	LINC00382	79903499	79903641	0	143	0	1525	0	1382	0.0	0.0
chr13	AL355481.1	83886281	83886340	0	60	0	4199	0	4139	0.0	0.0
chr13	LINC00430	86935621	86935770	0	150	0	780	0	630	0.0	0.0
chr13	DNAJC3	95757643	95757796	0	154	102	5602	102	5448	0.0	0.018722466960352423
chr13	MBNL2	97365135	97365171	0	37	0	4919	0	4882	0.0	0.0
chr13	MBNL2	97356795	97356849	0	55	0	4919	0	4864	0.0	0.0
chr13	MBNL2	97366458	97366553	0	96	0	4919	0	4823	0.0	0.0
chr13	RAP2A	97441767	97441850	0	84	0	5626	0	5542	0.0	0.0
chr13	IPO5	97982502	97982583	0	82	5111	9701	5111	9619	0.0	0.5313442145753197
chr13	IPO5	97954102	97954198	0	97	5111	9701	5111	9604	0.0	0.5321740941274469
chr13	IPO5	97954118	97954198	0	81	5111	9701	5111	9620	0.0	0.5312889812889813
chr13	IPO5	97963159	97963282	0	124	5111	9701	5111	9577	0.0	0.5336744283178448
chr13	IPO5	97981241	97981400	0	160	5111	9701	5111	9541	0.0	0.5356880830101667
chr13	IPO5	97960346	97960403	0	58	5111	9701	5111	9643	0.0	0.5300217774551488
chr13	IPO5	97975890	97975997	0	108	5111	9701	5111	9593	0.0	0.5327843219013865
chr13	IPO5	97982054	97982143	0	90	5111	9701	5111	9611	0.0	0.5317864946415566
chr13	IPO5	97987989	97988101	0	113	5111	9701	5111	9588	0.0	0.5330621610346267
chr13	FARP1	98377820	98377918	0	99	1291	25118	1291	25019	0.0	0.051600783404612494
chr13	FARP1	98437765	98437858	0	94	1291	25118	1291	25024	0.0	0.05159047314578005
chr13	FARP1	98438803	98438872	0	70	1291	25118	1291	25048	0.0	0.05154104120089428
chr13	UBAC2	99201428	99201567	0	140	0	4688	0	4548	0.0	0.0
chr13	CLYBL	99862990	99863092	0	103	111792	6129	111792	6026	0.0	18.551609691337536
chr13	CLYBL	99884976	99885105	0	130	111792	6129	111792	5999	0.0	18.63510585097516
chr13	PCCA	100102882	100102960	0	79	9444	7321	9444	7242	0.0	1.304059652029826
chr13	PCCA	100515426	100515567	1819	142	9444	7321	7625	7179	12.809859154929578	1.0621256442401448
chr13	PCCA	100104463	100104560	0	98	9444	7321	9444	7223	0.0	1.3074899626194103
chr13	PCCA	100527296	100527344	0	49	9444	7321	9444	7272	0.0	1.2986798679867986
chr13	ITGBL1	101453882	101454100	0	219	306	6189	306	5970	0.0	0.05125628140703518
chr13	ITGBL1	101567698	101567845	0	148	306	6189	306	6041	0.0	0.05065386525409701
chr13	TPP2	102651358	102651397	0	40	9	8266	9	8226	0.0	0.0010940919037199124
chr13	TPP2	102616955	102617051	0	97	9	8266	9	8169	0.0	0.0011017260374586854
chr13	TPP2	102644908	102646390	0	1483	9	8266	9	6783	0.0	0.0013268465280849183
chr13	TPP2	102651338	102651397	0	60	9	8266	9	8206	0.0	0.0010967584694126249
chr13	BIVM	102831564	102831697	0	134	52	7930	52	7796	0.0	0.006670087224217547
chr13	BIVM	102834465	102834552	0	88	52	7930	52	7842	0.0	0.0066309614894159655
chr13	BIVM	102806276	102806350	0	75	52	7930	52	7855	0.0	0.006619987269255252
chr13	BIVM	102805306	102805390	0	85	52	7930	52	7845	0.0	0.0066284257488846395
chr13	BIVM	102824033	102824094	0	62	52	7930	52	7868	0.0	0.0066090493136756485
chr13	BIVM	102807283	102807745	52	463	52	7930	0	7467	0.11231101511879049	0.0
chr13	BIVM	102801690	102801767	0	78	52	7930	52	7852	0.0	0.006622516556291391
chr13	DAOA	105474976	105475070	0	95	0	1584	0	1489	0.0	0.0
chr13	DAOA	105467609	105467722	0	114	0	1584	0	1470	0.0	0.0
chr13	LINC00343	105728589	105728727	0	139	153	12772	153	12633	0.0	0.012111137497031584
chr13	LINC00343	105758080	105758187	0	108	153	12772	153	12664	0.0	0.01208149084017688
chr13	LINC00343	105729843	105729959	0	117	153	12772	153	12655	0.0	0.012090082971157646
chr13	LINC00343	105718647	105718852	0	206	153	12772	153	12566	0.0	0.012175712239376094
chr13	LINC00343	105730314	105730458	0	145	153	12772	153	12627	0.0	0.012116892373485389
chr13	LINC00343	105707713	105707837	0	125	153	12772	153	12647	0.0	0.012097730687119475
chr13	LINC00343	105761262	105761560	0	299	153	12772	153	12473	0.0	0.012266495630562015
chr13	LINC00343	105729826	105729959	0	134	153	12772	153	12638	0.0	0.01210634594081342
chr13	LINC00343	105718474	105718852	0	379	153	12772	153	12393	0.0	0.012345679012345678
chr13	LINC00343	105728650	105728727	0	78	153	12772	153	12694	0.0	0.012052938396092642
chr13	LINC00343	105718474	105718559	0	86	153	12772	153	12686	0.0	0.012060539177045563
chr13	LINC00343	105761262	105761437	0	176	153	12772	153	12596	0.0	0.012146713242299143
chr13	LINC00343	105719046	105719106	0	61	153	12772	153	12711	0.0	0.012036818503658248
chr13	LINC00343	105761262	105761386	0	125	153	12772	153	12647	0.0	0.012097730687119475
chr13	LINC00343	105733919	105734205	0	287	153	12772	153	12485	0.0	0.012254705646776132
chr13	LINC00460	106382090	106382173	0	84	0	4088	0	4004	0.0	0.0
chr13	LINC00551	106628018	106628141	0	124	0	6132	0	6008	0.0	0.0
chr13	LINC00443	106669149	106669268	0	120	0	1500	0	1380	0.0	0.0
chr13	TNFSF13B	108286802	108286859	0	58	156	2978	156	2920	0.0	0.05342465753424658
chr13	TNFSF13B	108303252	108303365	0	114	156	2978	156	2864	0.0	0.05446927374301676
chr13	LINC00370	109286356	109286417	0	62	0	1341	0	1279	0.0	0.0
chr13	NAXD	110625189	110625278	0	90	0	2858	0	2768	0.0	0.0
chr13	ARHGEF7	111153904	111153991	0	88	560170	11306	560170	11218	0.0	49.934926011766805
chr13	ARHGEF7	111209871	111210002	0	132	560170	11306	560170	11174	0.0	50.13155539645606
chr13	ARHGEF7	111273813	111273952	348	140	560170	11306	559822	11166	2.4857142857142858	50.136306645172844
chr13	ARHGEF7	111280271	111280350	2102	80	560170	11306	558068	11226	26.275	49.71209691786923
chr13	ARHGEF7	111159026	111159089	0	64	560170	11306	560170	11242	0.0	49.82832236256894
chr13	ARHGEF7	111292117	111292294	79540	178	560170	11306	480630	11128	446.85393258426967	43.191049604601005
chr13	ARHGEF7	111209265	111209346	6	82	560170	11306	560164	11224	0.07317073170731707	49.907697790449035
chr13	TEX29	111339293	111339438	459	146	14946	964	14487	818	3.143835616438356	17.71026894865526
chr13	LINC00354	111894271	111894952	0	682	0	1978	0	1296	0.0	0.0
chr13	SOX1-OT	112088045	112088260	0	216	0	3410	0	3194	0.0	0.0
chr13	SPACA7	112382277	112382507	0	231	0	1087	0	856	0.0	0.0
chr13	SPACA7	112393020	112393077	0	58	0	1087	0	1029	0.0	0.0
chr13	SPACA7	112378642	112378731	0	90	0	1087	0	997	0.0	0.0
chr13	ATP11A	112851036	112851218	0	183	153	12639	153	12456	0.0	0.012283236994219654
chr13	ATP11A	112860286	112860414	0	129	153	12639	153	12510	0.0	0.01223021582733813
chr13	MCF2L	113091120	113091195	0	76	765	16966	765	16890	0.0	0.0452930728241563
chr13	MCF2L	113090067	113090151	0	85	765	16966	765	16881	0.0	0.045317220543806644
chr13	MCF2L	113090067	113090160	0	94	765	16966	765	16872	0.0	0.04534139402560455
chr13	F7	113115659	113115800	0	142	51	3809	51	3667	0.0	0.013907826561221708
chr13	F7	113106844	113106910	0	67	51	3809	51	3742	0.0	0.013629075360769643
chr13	PROZ	113159198	113159264	0	67	716	1686	716	1619	0.0	0.44224830142063004
chr13	CUL4A	113260606	113260759	707	154	95201	7698	94494	7544	4.590909090909091	12.525715800636267
chr13	CUL4A	113209972	113210088	0	117	95201	7698	95201	7581	0.0	12.557841973354439
chr13	TMCO3	113503495	113503588	0	94	75351	9767	75351	9673	0.0	7.789827354491885
chr13	TMCO3	113534044	113534240	2211	197	75351	9767	73140	9570	11.223350253807107	7.6426332288401255
chr13	TFDP1	113585579	113585677	0	99	0	3759	0	3660	0.0	0.0
chr13	TFDP1	113631622	113631744	0	123	0	3759	0	3636	0.0	0.0
chr13	CFAP97D2	114211911	114212101	495	191	14527	2188	14032	1997	2.5916230366492146	7.0265398097145715
chr13	CDC16	114257077	114257230	459	154	14852	3902	14393	3748	2.9805194805194803	3.840181430096051
chr13	CDC16	114269562	114269620	0	59	14852	3902	14852	3843	0.0	3.864689045016914
chr13	UPF3A	114282020	114282127	0	108	248189	5735	248189	5627	0.0	44.10680646881109
chr13	UPF3A	114286301	114286400	1322	100	248189	5735	246867	5635	13.22	43.80958296362023
chr13	UPF3A	114298839	114299000	0	162	248189	5735	248189	5573	0.0	44.53418266642742
chr13	UPF3A	114286518	114286629	91	112	248189	5735	248098	5623	0.8125	44.121998932953936
chr13	CHAMP1	114321109	114321232	0	124	102	4274	102	4150	0.0	0.02457831325301205
chr14	POTEM	18974760	18975016	0	257	0	6984	0	6727	0.0	0.0
chr14	POTEM	18992394	18992443	0	50	0	6984	0	6934	0.0	0.0
chr14	DUXAP9	19064582	19064693	0	112	51	4785	51	4673	0.0	0.01091375989728226
chr14	DUXAP9	19068432	19068568	0	137	51	4785	51	4648	0.0	0.010972461273666093
chr14	DUXAP9	19066000	19066115	0	116	51	4785	51	4669	0.0	0.010923109873634611
chr14	AL512310.11	19653096	19653139	6	44	167	643	161	599	0.13636363636363635	0.2687813021702838
chr14	OR4K1	19931213	19931359	0	147	0	1528	0	1381	0.0	0.0
chr14	OR4K17	20111909	20112091	0	183	51	5071	51	4888	0.0	0.010433715220949264
chr14	PARP2	20357395	20357520	0	126	146	3806	146	3680	0.0	0.03967391304347826
chr14	APEX1	20455577	20455703	0	127	765	1679	765	1552	0.0	0.49291237113402064
chr14	APEX1	20455577	20455773	0	197	765	1679	765	1482	0.0	0.5161943319838057
chr14	APEX1	20455737	20455773	0	37	765	1679	765	1642	0.0	0.4658952496954933
chr14	APEX1	20455734	20455773	0	40	765	1679	765	1639	0.0	0.46674801708358754
chr14	AL163195.2	20596670	20596819	0	150	0	2755	0	2605	0.0	0.0
chr14	ANG	20693546	20693650	0	105	100	1443	100	1338	0.0	0.07473841554559044
chr14	AL161668.4	21028445	21028534	0	90	0	596	0	506	0.0	0.0
chr14	TPPP2	21032319	21032380	0	62	0	2314	0	2252	0.0	0.0
chr14	TPPP2	21035793	21036092	0	300	0	2314	0	2014	0.0	0.0
chr14	ARHGEF40	21087319	21087463	0	145	0	8078	0	7933	0.0	0.0
chr14	TMEM253	21101864	21101975	0	112	0	2166	0	2054	0.0	0.0
chr14	RPGRIP1	21318126	21318201	0	76	240	4850	240	4774	0.0	0.050272308336824466
chr14	RPGRIP1	21324874	21325070	0	197	240	4850	240	4653	0.0	0.05157962604771115
chr14	TOX4	21477495	21477564	0	70	0	6373	0	6303	0.0	0.0
chr14	TOX4	21482551	21482611	0	61	0	6373	0	6312	0.0	0.0
chr14	TOX4	21477495	21477592	0	98	0	6373	0	6275	0.0	0.0
chr14	ABHD4	22603924	22604079	0	156	0	3045	0	2889	0.0	0.0
chr14	OXA1L	22769790	22769934	0	145	0	4326	0	4181	0.0	0.0
chr14	OXA1L	22771267	22771348	0	82	0	4326	0	4244	0.0	0.0
chr14	OXA1L	22769796	22769934	0	139	0	4326	0	4187	0.0	0.0
chr14	MRPL52	22830049	22830110	0	62	102	2769	102	2707	0.0	0.03768008865903214
chr14	MRPL52	22833417	22833482	0	66	102	2769	102	2703	0.0	0.03773584905660377
chr14	MRPL52	22830052	22830110	0	59	102	2769	102	2710	0.0	0.037638376383763834
chr14	MRPL52	22833417	22833489	0	73	102	2769	102	2696	0.0	0.037833827893175076
chr14	MRPL52	22830963	22831037	0	75	102	2769	102	2694	0.0	0.0378619153674833
chr14	REM2	22885265	22885339	0	75	0	2244	0	2169	0.0	0.0
chr14	PRMT5-AS1	22923078	22923204	0	127	0	2524	0	2397	0.0	0.0
chr14	PRMT5-AS1	22924300	22924441	0	142	0	2524	0	2382	0.0	0.0
chr14	PRMT5-AS1	22922968	22923204	0	237	0	2524	0	2287	0.0	0.0
chr14	AL132780.1	22933642	22933692	0	51	0	1807	0	1756	0.0	0.0
chr14	RNF212B	23262927	23262970	0	44	23811	1689	23811	1645	0.0	14.474772036474164
chr14	RNF212B	23264173	23264234	0	62	23811	1689	23811	1627	0.0	14.634910878918255
chr14	RNF212B	23264622	23264671	36	50	23811	1689	23775	1639	0.72	14.505796217205614
chr14	RNF212B	23268923	23268963	0	41	23811	1689	23811	1648	0.0	14.448422330097088
chr14	BCL2L2-PABPN1	23319734	23319830	102	97	19547	2380	19445	2283	1.0515463917525774	8.517301795882611
chr14	BCL2L2	23308815	23308932	2296	118	1278798	2991	1276502	2873	19.45762711864407	444.30978071702054
chr14	CMTM5	23378348	23378501	136	154	54514	2586	54378	2432	0.8831168831168831	22.359375
chr14	CMTM5	23379030	23379123	2015	94	54514	2586	52499	2492	21.43617021276596	21.06701444622793
chr14	CMTM5	23378668	23378869	37109	202	54514	2586	17405	2384	183.70792079207922	7.300755033557047
chr14	CMTM5	23378462	23378501	85	40	54514	2586	54429	2546	2.125	21.37824037706206
chr14	ZFHX2-AS1	23513216	23513334	0	119	75318	5104	75318	4985	0.0	15.108926780341022
chr14	THTPA	23556742	23557304	1248	563	73483	2498	72235	1935	2.216696269982238	37.33074935400517
chr14	THTPA	23556742	23557039	408	298	73483	2498	73075	2200	1.3691275167785235	33.21590909090909
chr14	THTPA	23556742	23557034	408	293	73483	2498	73075	2205	1.3924914675767919	33.140589569160994
chr14	DHRS4	23965931	23965983	0	53	382	2042	382	1989	0.0	0.19205630970336854
chr14	DHRS4	23959901	23960003	0	103	382	2042	382	1939	0.0	0.19700876740587933
chr14	DHRS4	23965761	23965832	0	72	382	2042	382	1970	0.0	0.19390862944162437
chr14	DHRS4	23966282	23966417	0	136	382	2042	382	1906	0.0	0.20041972717733472
chr14	DHRS4	23967390	23967455	0	66	382	2042	382	1976	0.0	0.19331983805668015
chr14	DHRS4L2	23995031	23995133	457	103	17532	2428	17075	2325	4.436893203883495	7.344086021505376
chr14	DHRS4L2	24001383	24001517	0	135	17532	2428	17532	2293	0.0	7.645878761447885
chr14	DHRS4L2	24004336	24004392	0	57	17532	2428	17532	2371	0.0	7.394348376212569
chr14	DHRS4L2	23990774	23990952	7527	179	17532	2428	10005	2249	42.05027932960894	4.448643841707425
chr14	DHRS4L1	24048676	24048811	0	136	11998	1281	11998	1145	0.0	10.478602620087337
chr14	CARMIL3	24065621	24065750	152	130	382	6523	230	6393	1.1692307692307693	0.03597684967933677
chr14	CPNE6	24072932	24073104	0	173	0	3677	0	3504	0.0	0.0
chr14	CPNE6	24074290	24074365	0	76	0	3677	0	3601	0.0	0.0
chr14	CPNE6	24072888	24073104	0	217	0	3677	0	3460	0.0	0.0
chr14	CPNE6	24073498	24073678	0	181	0	3677	0	3496	0.0	0.0
chr14	CPNE6	24072932	24073119	0	188	0	3677	0	3489	0.0	0.0
chr14	PCK2	24099048	24099236	0	189	0	3751	0	3562	0.0	0.0
chr14	PCK2	24094765	24094845	0	81	0	3751	0	3670	0.0	0.0
chr14	PCK2	24096891	24097137	0	247	0	3751	0	3504	0.0	0.0
chr14	PCK2	24103159	24103255	0	97	0	3751	0	3654	0.0	0.0
chr14	PCK2	24095142	24095378	0	237	0	3751	0	3514	0.0	0.0
chr14	PCK2	24099048	24099247	0	200	0	3751	0	3551	0.0	0.0
chr14	DCAF11	24115205	24115293	0	89	7849	5675	7849	5586	0.0	1.4051199427139276
chr14	DCAF11	24115381	24115392	0	12	7849	5675	7849	5663	0.0	1.3860144799576197
chr14	DCAF11	24116916	24117044	0	129	7849	5675	7849	5546	0.0	1.4152542372881356
chr14	DCAF11	24117667	24117732	0	66	7849	5675	7849	5609	0.0	1.3993581743626315
chr14	DCAF11	24116971	24117044	0	74	7849	5675	7849	5601	0.0	1.4013569005534725
chr14	RNF31	24147831	24147890	0	60	0	5009	0	4949	0.0	0.0
chr14	RNF31	24147697	24147890	0	194	0	5009	0	4815	0.0	0.0
chr14	RNF31	24157897	24158011	0	115	0	5009	0	4894	0.0	0.0
chr14	RNF31	24159863	24159960	0	98	0	5009	0	4911	0.0	0.0
chr14	IRF9	24162143	24162324	0	182	0	3101	0	2919	0.0	0.0
chr14	IRF9	24163877	24163959	0	83	0	3101	0	3018	0.0	0.0
chr14	IRF9	24164613	24164955	0	343	0	3101	0	2758	0.0	0.0
chr14	RNF31	24157831	24158011	0	181	0	5009	0	4828	0.0	0.0
chr14	IRF9	24165056	24165183	0	128	0	3101	0	2973	0.0	0.0
chr14	IRF9	24162143	24162280	0	138	0	3101	0	2963	0.0	0.0
chr14	TSSK4	24207115	24207509	0	395	528	1855	528	1460	0.0	0.36164383561643837
chr14	TSSK4	24207145	24207509	0	365	528	1855	528	1490	0.0	0.35436241610738256
chr14	TSSK4	24206508	24206723	402	216	528	1855	126	1639	1.8611111111111112	0.07687614399023796
chr14	GMPR2	24238245	24238405	0	161	0	2910	0	2749	0.0	0.0
chr14	GMPR2	24233218	24233340	0	123	0	2910	0	2787	0.0	0.0
chr14	GMPR2	24235736	24235820	0	85	0	2910	0	2825	0.0	0.0
chr14	GMPR2	24234106	24234241	0	136	0	2910	0	2774	0.0	0.0
chr14	GMPR2	24234112	24234241	0	130	0	2910	0	2780	0.0	0.0
chr14	NFATC4	24376293	24376554	0	262	6525	7075	6525	6813	0.0	0.9577278731836195
chr14	NFATC4	24376293	24376878	0	586	6525	7075	6525	6489	0.0	1.0055478502080444
chr14	LINC02588	26637194	26637333	0	140	0	5137	0	4997	0.0	0.0
chr14	LINC02588	26724747	26724794	0	48	0	5137	0	5089	0.0	0.0
chr14	LINC02588	26797913	26798030	0	118	0	5137	0	5019	0.0	0.0
chr14	LINC02293	26815735	26815842	0	108	0	4217	0	4109	0.0	0.0
chr14	LINC02293	26818703	26818780	0	78	0	4217	0	4139	0.0	0.0
chr14	MIR4307HG	26873396	26873542	0	147	3197	3583	3197	3436	0.0	0.930442374854482
chr14	MIR4307HG	26880369	26880455	0	87	3197	3583	3197	3496	0.0	0.9144736842105263
chr14	MIR4307HG	26873396	26873471	0	76	3197	3583	3197	3507	0.0	0.9116053607071571
chr14	MIR4307HG	26880369	26880635	0	267	3197	3583	3197	3316	0.0	0.9641133896260555
chr14	AL110292.1	26916820	26916922	2381	103	0	5264	-2381	5161	23.116504854368934	-0.46134470063941097
chr14	MIR4307HG	26873396	26873531	0	136	3197	3583	3197	3447	0.0	0.9274731650710762
chr14	MIR4307HG	26901044	26901177	0	134	3197	3583	3197	3449	0.0	0.9269353435778487
chr14	MIR4307HG	26873396	26874043	0	648	3197	3583	3197	2935	0.0	1.089267461669506
chr14	MIR4307HG	26873396	26873439	0	44	3197	3583	3197	3539	0.0	0.9033625317886409
chr14	MIR4307HG	26896245	26896380	0	136	3197	3583	3197	3447	0.0	0.9274731650710762
chr14	MIR4307HG	26873396	26873488	0	93	3197	3583	3197	3490	0.0	0.9160458452722063
chr14	LINC00645	27634243	27634344	0	102	204	4537	204	4435	0.0	0.045997745208568204
chr14	LINC00645	27619822	27619873	0	52	204	4537	204	4485	0.0	0.04548494983277592
chr14	LINC01551	28789999	28790041	0	43	0	9600	0	9557	0.0	0.0
chr14	LINC02327	28881090	28881141	0	52	0	5076	0	5024	0.0	0.0
chr14	LINC02327	28837252	28837330	0	79	0	5076	0	4997	0.0	0.0
chr14	LINC02327	28870302	28870416	0	115	0	5076	0	4961	0.0	0.0
chr14	LINC02327	28965203	28965302	0	100	0	5076	0	4976	0.0	0.0
chr14	LINC02327	28834796	28834904	0	109	0	5076	0	4967	0.0	0.0
chr14	LINC02327	28834796	28834820	0	25	0	5076	0	5051	0.0	0.0
chr14	LINC02327	28857995	28858080	0	86	0	5076	0	4990	0.0	0.0
chr14	AL135878.1	29007680	29007854	0	175	867	7946	867	7771	0.0	0.11156865268305237
chr14	AL135878.1	29061795	29061922	0	128	867	7946	867	7818	0.0	0.11089792785878741
chr14	AL158058.1	29408847	29408965	0	119	23	1120	23	1001	0.0	0.022977022977022976
chr14	G2E3	30580863	30580947	0	85	0	9341	0	9256	0.0	0.0
chr14	G2E3	30597419	30597526	0	108	0	9341	0	9233	0.0	0.0
chr14	G2E3	30598482	30598599	0	118	0	9341	0	9223	0.0	0.0
chr14	G2E3	30605504	30605812	0	309	0	9341	0	9032	0.0	0.0
chr14	G2E3	30581075	30581116	0	42	0	9341	0	9299	0.0	0.0
chr14	G2E3	30602630	30602889	0	260	0	9341	0	9081	0.0	0.0
chr14	SCFD1	30628208	30628279	0	72	51	20324	51	20252	0.0	0.0025182698005135297
chr14	SCFD1	30630476	30630565	0	90	51	20324	51	20234	0.0	0.002520510032618365
chr14	SCFD1	30633946	30634037	0	92	51	20324	51	20232	0.0	0.0025207591933570582
chr14	SCFD1	30638124	30638247	0	124	51	20324	51	20200	0.0	0.002524752475247525
chr14	SCFD1	30639776	30639864	0	89	51	20324	51	20235	0.0	0.002520385470719051
chr14	SCFD1	30643315	30643405	0	91	51	20324	51	20233	0.0	0.0025206346068304256
chr14	SCFD1	30676783	30676855	0	73	51	20324	51	20251	0.0	0.0025183941533751418
chr14	SCFD1	30702295	30702375	0	81	51	20324	51	20243	0.0	0.002519389418564442
chr14	SCFD1	30707989	30708065	0	77	51	20324	51	20247	0.0	0.0025188916876574307
chr14	SCFD1	30722493	30722559	0	67	51	20324	51	20257	0.0	0.002517648220368268
chr14	SCFD1	30707816	30707914	0	99	51	20324	51	20225	0.0	0.0025216316440049443
chr14	SCFD1	30643879	30644018	51	140	51	20324	0	20184	0.36428571428571427	0.0
chr14	SCFD1	30633929	30634037	0	109	51	20324	51	20215	0.0	0.00252287905021024
chr14	SCFD1	30707816	30707876	0	61	51	20324	51	20263	0.0	0.002516902729112175
chr14	SCFD1	30638183	30638247	0	65	51	20324	51	20259	0.0	0.0025173996742188657
chr14	SCFD1	30634794	30635034	0	241	51	20324	51	20083	0.0	0.002539461235871135
chr14	SCFD1	30638106	30638247	0	142	51	20324	51	20182	0.0	0.0025270042612228717
chr14	SCFD1	30634921	30635034	0	114	51	20324	51	20210	0.0	0.002523503216229589
chr14	COCH	30875055	30875298	0	244	0	3999	0	3755	0.0	0.0
chr14	COCH	30878810	30878944	0	135	0	3999	0	3864	0.0	0.0
chr14	COCH	30875055	30875103	0	49	0	3999	0	3950	0.0	0.0
chr14	COCH	30877571	30877728	0	158	0	3999	0	3841	0.0	0.0
chr14	COCH	30884984	30885041	0	58	0	3999	0	3941	0.0	0.0
chr14	COCH	30889615	30889793	0	179	0	3999	0	3820	0.0	0.0
chr14	COCH	30879422	30879485	0	64	0	3999	0	3935	0.0	0.0
chr14	COCH	30884909	30885041	0	133	0	3999	0	3866	0.0	0.0
chr14	AP4S1	31032970	31033006	0	37	44589	9348	44589	9311	0.0	4.788851895607346
chr14	AP4S1	31080572	31080644	494	73	44589	9348	44095	9275	6.767123287671233	4.754177897574124
chr14	AP4S1	31124828	31124969	0	142	44589	9348	44589	9206	0.0	4.843471648924615
chr14	AP4S1	31083525	31083647	463	123	44589	9348	44126	9225	3.7642276422764227	4.783306233062331
chr14	NUBPL	31787779	31787873	51	95	7296	7613	7245	7518	0.5368421052631579	0.9636871508379888
chr14	NUBPL	31562791	31562885	0	95	7296	7613	7296	7518	0.0	0.9704708699122107
chr14	NUBPL	31654069	31654134	0	66	7296	7613	7296	7547	0.0	0.966741751689413
chr14	ARHGAP5	32117142	32117287	0	146	4633	10287	4633	10141	0.0	0.456858297998225
chr14	ARHGAP5	32117139	32117287	0	149	4633	10287	4633	10138	0.0	0.45699348984020516
chr14	AKAP6	32821401	32824815	51	3415	10566	19253	10515	15838	0.01493411420204978	0.663909584543503
chr14	AKAP6	32401997	32402141	0	145	10566	19253	10566	19108	0.0	0.5529621101109483
chr14	NPAS3	33055904	33055994	0	91	0	9801	0	9710	0.0	0.0
chr14	NPAS3	33215536	33215587	0	52	0	9801	0	9749	0.0	0.0
chr14	SRP54	34999557	34999649	714	93	16402	8450	15688	8357	7.67741935483871	1.8772286705755654
chr14	SRP54	35000935	35001020	0	86	16402	8450	16402	8364	0.0	1.9610234337637493
chr14	SRP54	35013345	35013494	0	150	16402	8450	16402	8300	0.0	1.976144578313253
chr14	SRP54	35018691	35018765	0	75	16402	8450	16402	8375	0.0	1.9584477611940299
chr14	SRP54	35022909	35023080	0	172	16402	8450	16402	8278	0.0	1.9813964725779174
chr14	SRP54	34983129	34983215	0	87	16402	8450	16402	8363	0.0	1.9612579217983976
chr14	SRP54	34999557	34999644	714	88	16402	8450	15688	8362	8.113636363636363	1.8761061946902655
chr14	FAM177A1	35050783	35050868	26988	86	90481	8320	63493	8234	313.8139534883721	7.711076026232694
chr14	PRORP	35126734	35126782	0	49	12350	7001	12350	6952	0.0	1.7764672036823936
chr14	PSMA6	35312880	35313059	0	180	972	2284	972	2104	0.0	0.4619771863117871
chr14	PSMA6	35314360	35314455	0	96	972	2284	972	2188	0.0	0.44424131627056673
chr14	PSMA6	35307993	35308088	0	96	972	2284	972	2188	0.0	0.44424131627056673
chr14	PSMA6	35310216	35310299	51	84	972	2284	921	2200	0.6071428571428571	0.41863636363636364
chr14	PSMA6	35312862	35313059	0	198	972	2284	972	2086	0.0	0.46596356663470756
chr14	PSMA6	35292952	35293277	0	326	972	2284	972	1958	0.0	0.4964249233912155
chr14	PSMA6	35312880	35312921	0	42	972	2284	972	2242	0.0	0.4335414808206958
chr14	BRMS1L	35829794	35829907	0	114	546448	3890	546448	3776	0.0	144.71610169491527
chr14	MIPOL1	37219552	37219691	0	140	0	20276	0	20136	0.0	0.0
chr14	MIPOL1	37227725	37227838	0	114	0	20276	0	20162	0.0	0.0
chr14	MIPOL1	37247102	37247240	0	139	0	20276	0	20137	0.0	0.0
chr14	MIPOL1	37265206	37265281	0	76	0	20276	0	20200	0.0	0.0
chr14	MIPOL1	37212229	37212356	0	128	0	20276	0	20148	0.0	0.0
chr14	TTC6	37837321	37837542	0	222	1275	8407	1275	8185	0.0	0.15577275503970678
chr14	AL355835.1	38277949	38278046	0	98	0	1874	0	1776	0.0	0.0
chr14	GEMIN2	39124991	39125036	0	46	4	2501	4	2455	0.0	0.001629327902240326
chr14	GEMIN2	39128279	39128348	0	70	4	2501	4	2431	0.0	0.0016454134101192926
chr14	GEMIN2	39133660	39133719	0	60	4	2501	4	2441	0.0	0.0016386726751331422
chr14	GEMIN2	39121906	39122024	0	119	4	2501	4	2382	0.0	0.0016792611251049538
chr14	GEMIN2	39135930	39136155	0	226	4	2501	4	2275	0.0	0.0017582417582417582
chr14	PNN	39177592	39177687	0	96	84	2497	84	2401	0.0	0.03498542274052478
chr14	MIA2	39279336	39279358	0	23	55	9868	55	9845	0.0	0.00558659217877095
chr14	MIA2	39291018	39291096	0	79	55	9868	55	9789	0.0	0.005618551435284503
chr14	MIA2	39320927	39321056	0	130	55	9868	55	9738	0.0	0.005647976997330047
chr14	MIA2	39252747	39252966	0	220	55	9868	55	9648	0.0	0.005700663349917081
chr14	MIA2	39292679	39292706	0	28	55	9868	55	9840	0.0	0.005589430894308943
chr14	MIA2	39291018	39291111	0	94	55	9868	55	9774	0.0	0.005627174135461428
chr14	AL049828.1	39433487	39433729	0	243	2062	12973	2062	12730	0.0	0.1619795758051846
chr14	AL049828.1	39485016	39485257	0	242	2062	12973	2062	12731	0.0	0.16196685256460608
chr14	AL049828.1	39436645	39436766	0	122	2062	12973	2062	12851	0.0	0.16045443934324177
chr14	AL049828.1	40371520	40371578	0	59	2062	12973	2062	12914	0.0	0.159671674152083
chr14	AL049828.1	40262615	40262755	0	141	2062	12973	2062	12832	0.0	0.1606920199501247
chr14	AL390800.1	40889121	40889174	0	54	0	5110	0	5056	0.0	0.0
chr14	LRFN5	41891249	41891962	0	714	0	6151	0	5437	0.0	0.0
chr14	LRFN5	41898916	41898960	0	45	0	6151	0	6106	0.0	0.0
chr14	C14ORF28	44903206	44903296	0	91	51	3053	51	2962	0.0	0.017218095881161376
chr14	TOGARAM1	45004060	45004366	0	307	0	10314	0	10007	0.0	0.0
chr14	TOGARAM1	45008912	45009145	0	234	0	10314	0	10080	0.0	0.0
chr14	TOGARAM1	45046544	45046703	0	160	0	10314	0	10154	0.0	0.0
chr14	TOGARAM1	45071711	45071798	0	88	0	10314	0	10226	0.0	0.0
chr14	TOGARAM1	45022909	45022973	0	65	0	10314	0	10249	0.0	0.0
chr14	PRPF39	45107450	45107616	0	167	98	4642	98	4475	0.0	0.021899441340782123
chr14	PRPF39	45096423	45096758	0	336	98	4642	98	4306	0.0	0.02275894101254064
chr14	PRPF39	45096423	45096492	0	70	98	4642	98	4572	0.0	0.021434820647419073
chr14	PRPF39	45109893	45109993	0	101	98	4642	98	4541	0.0	0.021581149526536007
chr14	PRPF39	45096595	45096758	0	164	98	4642	98	4478	0.0	0.02188476998660116
chr14	FANCM	45140631	45140709	0	79	255	8294	255	8215	0.0	0.0310407790626902
chr14	FANCM	45164358	45164565	0	208	255	8294	255	8086	0.0	0.031535988127628
chr14	FANCM	45195480	45195585	0	106	255	8294	255	8188	0.0	0.03114313629702003
chr14	LINC00871	46471361	46471511	0	151	0	1761	0	1610	0.0	0.0
chr14	LINC00871	46490191	46490287	0	97	0	1761	0	1664	0.0	0.0
chr14	LRR1	49603551	49603618	0	68	125	2303	125	2235	0.0	0.05592841163310962
chr14	LRR1	49612471	49612624	125	154	125	2303	0	2149	0.8116883116883117	0.0
chr14	LRR1	49607399	49608121	0	723	125	2303	125	1580	0.0	0.07911392405063292
chr14	LRR1	49601541	49601649	0	109	125	2303	125	2194	0.0	0.05697356426618049
chr14	KLHDC1	49723873	49723952	0	80	0	3019	0	2939	0.0	0.0
chr14	KLHDC1	49725685	49725769	0	85	0	3019	0	2934	0.0	0.0
chr14	KLHDC1	49700049	49700189	0	141	0	3019	0	2878	0.0	0.0
chr14	KLHDC2	49780702	49780775	0	74	0	6332	0	6258	0.0	0.0
chr14	KLHDC2	49782369	49782457	0	89	0	6332	0	6243	0.0	0.0
chr14	KLHDC2	49782541	49782594	0	54	0	6332	0	6278	0.0	0.0
chr14	DMAC2L	50323944	50324116	0	173	9562	4575	9562	4402	0.0	2.1721944570649705
chr14	DMAC2L	50314590	50314626	0	37	9562	4575	9562	4538	0.0	2.107095636844425
chr14	ATL1	50587830	50588078	96	249	11685	6261	11589	6012	0.3855421686746988	1.9276447105788423
chr14	ATL1	50620598	50620726	0	129	11685	6261	11685	6132	0.0	1.9055772994129159
chr14	ATL1	50629994	50630009	0	16	11685	6261	11685	6245	0.0	1.8710968775020016
chr14	ATL1	50630931	50631077	0	147	11685	6261	11685	6114	0.0	1.9111874386653582
chr14	ABHD12B	50877951	50878079	144	129	34193	2623	34049	2494	1.1162790697674418	13.652365677626303
chr14	ABHD12B	50878744	50878847	90	104	34193	2623	34103	2519	0.8653846153846154	13.538308852719332
chr14	GNG2	51877616	51877657	0	42	1389	6394	1389	6352	0.0	0.2186712846347607
chr14	GNG2	51841505	51841572	0	68	1389	6394	1389	6326	0.0	0.21957002845399937
chr14	GNG2	51873881	51874082	0	202	1389	6394	1389	6192	0.0	0.2243217054263566
chr14	GNG2	51939780	51940091	0	312	1389	6394	1389	6082	0.0	0.22837882275567248
chr14	GNG2	51913008	51913128	0	121	1389	6394	1389	6273	0.0	0.22142515542802488
chr14	GNG2	51914109	51914274	0	166	1389	6394	1389	6228	0.0	0.22302504816955684
chr14	RTRAF	51993722	51993822	0	101	102	8295	102	8194	0.0	0.012448132780082987
chr14	RTRAF	52004193	52004242	0	50	102	8295	102	8245	0.0	0.012371134020618556
chr14	RTRAF	52004239	52004242	0	4	102	8295	102	8291	0.0	0.012302496683150404
chr14	PTGDR	52269450	52269541	0	92	0	3051	0	2959	0.0	0.0
chr14	GPR137C	52613670	52613718	0	49	53	6514	53	6465	0.0	0.00819798917246713
chr14	GPR137C	52596916	52596982	0	67	53	6514	53	6447	0.0	0.008220877927718319
chr14	PSMC6	52708308	52708388	0	81	357	7350	357	7269	0.0	0.049112670243499794
chr14	PSMC6	52711100	52711168	0	69	357	7350	357	7281	0.0	0.04903172641120725
chr14	PSMC6	52708482	52708522	0	41	357	7350	357	7309	0.0	0.0488438910931728
chr14	PSMC6	52718976	52719038	0	63	357	7350	357	7287	0.0	0.04899135446685879
chr14	AL139317.5	52921589	52921676	0	88	31421	6856	31421	6768	0.0	4.642582742316785
chr14	AL139317.5	52832236	52832488	0	253	31421	6856	31421	6603	0.0	4.75859457822202
chr14	AL139317.5	52793640	52793710	0	71	31421	6856	31421	6785	0.0	4.630950626381725
chr14	AL365295.1	53170433	53170501	0	69	76819	14298	76819	14229	0.0	5.398763089465176
chr14	AL365295.1	53188031	53188153	510	123	76819	14298	76309	14175	4.146341463414634	5.383350970017637
chr14	AL365295.1	53304807	53305053	0	247	76819	14298	76819	14051	0.0	5.4671553626076435
chr14	AL365295.1	53313715	53313790	0	76	76819	14298	76819	14222	0.0	5.401420334692729
chr14	AL365295.1	53318030	53318138	0	109	76819	14298	76819	14189	0.0	5.413982662625978
chr14	AL365295.1	53510724	53510879	246	156	76819	14298	76573	14142	1.5769230769230769	5.414580681657474
chr14	CDKN3	54415898	54415930	0	33	9595	1842	9595	1809	0.0	5.3040353786622445
chr14	CDKN3	54399893	54399976	0	84	9595	1842	9595	1758	0.0	5.457906712172924
chr14	CDKN3	54418213	54418306	71	94	9595	1842	9524	1748	0.7553191489361702	5.448512585812357
chr14	CGRRF1	54522453	54522593	0	141	357	4555	357	4414	0.0	0.08087902129587675
chr14	CGRRF1	54523149	54523245	0	97	357	4555	357	4458	0.0	0.0800807537012113
chr14	SAMD4A	54737023	54737287	0	265	153	12348	153	12083	0.0	0.012662418273607548
chr14	SAMD4A	54784339	54784447	0	109	153	12348	153	12239	0.0	0.012501021325271672
chr14	SAMD4A	54784339	54784381	0	43	153	12348	153	12305	0.0	0.012433969930922389
chr14	SOCS4	55031862	55031991	0	130	14824	7048	14824	6918	0.0	2.1428158427291124
chr14	MAPK1IP1L	55061679	55061701	0	23	6352	4079	6352	4056	0.0	1.5660749506903353
chr14	LGALS3	55137369	55137391	0	23	2307	1442	2307	1419	0.0	1.6257928118393234
chr14	KTN1	55629956	55630097	0	142	29033	13937	29033	13795	0.0	2.104603117071403
chr14	KTN1	55650568	55650637	410	70	29033	13937	28623	13867	5.857142857142857	2.0641090358404846
chr14	KTN1	55663954	55664041	0	88	29033	13937	29033	13849	0.0	2.0963968517582496
chr14	KTN1	55673171	55673255	0	85	29033	13937	29033	13852	0.0	2.095942824140918
chr14	KTN1	55607345	55607460	0	116	29033	13937	29033	13821	0.0	2.100643947615947
chr14	KTN1	55601756	55601880	45	125	29033	13937	28988	13812	0.36	2.098754706052708
chr14	KTN1	55680685	55680741	0	57	29033	13937	29033	13880	0.0	2.09171469740634
chr14	KTN1	55651286	55651375	0	90	29033	13937	29033	13847	0.0	2.0966996461327363
chr14	KTN1	55680664	55680741	0	78	29033	13937	29033	13859	0.0	2.0948841907785556
chr14	AL163952.1	55957154	55957290	0	137	1161	3766	1161	3629	0.0	0.3199228437586112
chr14	AL163952.1	55962171	55962277	39	107	1161	3766	1122	3659	0.3644859813084112	0.3066411587865537
chr14	LINC02284	56317891	56318086	0	196	51	4445	51	4249	0.0	0.012002824193927984
chr14	LINC02284	56326179	56326225	0	47	51	4445	51	4398	0.0	0.011596180081855388
chr14	TMEM260	56603814	56603992	0	179	0	8026	0	7847	0.0	0.0
chr14	TMEM260	56617182	56617297	0	116	0	8026	0	7910	0.0	0.0
chr14	TMEM260	56621530	56621702	0	173	0	8026	0	7853	0.0	0.0
chr14	AP5M1	57274243	57274889	0	647	153	12111	153	11464	0.0	0.013346127006280531
chr14	AP5M1	57273708	57273750	0	43	153	12111	153	12068	0.0	0.012678157109711635
chr14	NAA30	57399827	57399883	0	57	0	7303	0	7246	0.0	0.0
chr14	NAA30	57390956	57391728	0	773	0	7303	0	6530	0.0	0.0
chr14	ACTR10	58202854	58202927	0	74	0	3657	0	3583	0.0	0.0
chr14	ACTR10	58223782	58223856	0	75	0	3657	0	3582	0.0	0.0
chr14	ACTR10	58207048	58207183	0	136	0	3657	0	3521	0.0	0.0
chr14	ACTR10	58231079	58231153	0	75	0	3657	0	3582	0.0	0.0
chr14	ACTR10	58230398	58230480	0	83	0	3657	0	3574	0.0	0.0
chr14	PSMA3	58247749	58247832	0	84	102	3041	102	2957	0.0	0.034494420020290836
chr14	PSMA3	58252118	58252242	0	125	102	3041	102	2916	0.0	0.03497942386831276
chr14	PSMA3	58252123	58252242	0	120	102	3041	102	2921	0.0	0.034919548099965766
chr14	ARID4A	58301579	58301690	0	112	0	7475	0	7363	0.0	0.0
chr14	ARID4A	58366023	58366230	0	208	0	7475	0	7267	0.0	0.0
chr14	ARID4A	58366023	58366068	0	46	0	7475	0	7429	0.0	0.0
chr14	ARID4A	58303537	58303761	0	225	0	7475	0	7250	0.0	0.0
chr14	TOMM20L	58402679	58402761	0	83	0	614	0	531	0.0	0.0
chr14	KIAA0586	58428237	58428463	0	227	204	17469	204	17242	0.0	0.01183157406333372
chr14	KIAA0586	58441220	58441343	0	124	204	17469	204	17345	0.0	0.011761314499855867
chr14	KIAA0586	58448339	58448493	0	155	204	17469	204	17314	0.0	0.011782372646413308
chr14	KIAA0586	58459842	58460070	0	229	204	17469	204	17240	0.0	0.011832946635730859
chr14	KIAA0586	58472198	58472279	0	82	204	17469	204	17387	0.0	0.011732903893713694
chr14	KIAA0586	58492143	58492275	0	133	204	17469	204	17336	0.0	0.011767420396862021
chr14	KIAA0586	58543882	58543967	0	86	204	17469	204	17383	0.0	0.011735603750791003
chr14	KIAA0586	58428271	58428463	0	193	204	17469	204	17276	0.0	0.0118082889557768
chr14	KIAA0586	58540070	58540136	0	67	204	17469	204	17402	0.0	0.01172279048385243
chr14	KIAA0586	58440069	58440160	0	92	204	17469	204	17377	0.0	0.011739655866950567
chr14	KIAA0586	58459842	58459909	0	68	204	17469	204	17401	0.0	0.011723464168725935
chr14	KIAA0586	58476688	58476810	0	123	204	17469	204	17346	0.0	0.01176063645797302
chr14	KIAA0586	58495482	58495614	0	133	204	17469	204	17336	0.0	0.011767420396862021
chr14	KIAA0586	58520710	58520861	0	152	204	17469	204	17317	0.0	0.011780331466189294
chr14	KIAA0586	58494454	58494524	0	71	204	17469	204	17398	0.0	0.011725485688010117
chr14	LINC01500	58957007	58957115	0	109	33152	6780	33152	6671	0.0	4.969569779643232
chr14	LINC01500	58948312	58948341	60	30	33152	6780	33092	6750	2.0	4.9025185185185185
chr14	LINC01500	58890323	58890520	4682	198	33152	6780	28470	6582	23.646464646464647	4.325432999088423
chr14	LINC01500	58888797	58888922	0	126	33152	6780	33152	6654	0.0	4.982266305981365
chr14	LINC01500	59077030	59077099	0	70	33152	6780	33152	6710	0.0	4.940685543964232
chr14	LINC01500	59094554	59094640	0	87	33152	6780	33152	6693	0.0	4.953234722844763
chr14	LINC01500	59077003	59077099	0	97	33152	6780	33152	6683	0.0	4.960646416280114
chr14	LINC01500	59125171	59125402	51	232	33152	6780	33101	6548	0.21982758620689655	5.055131337813073
chr14	LINC01500	59009030	59009150	0	121	33152	6780	33152	6659	0.0	4.978525304099715
chr14	LINC01500	58958535	58958619	0	85	33152	6780	33152	6695	0.0	4.95175504107543
chr14	LINC01500	58912520	58912654	0	135	33152	6780	33152	6645	0.0	4.989014296463506
chr14	LINC01500	58848593	58848742	0	150	33152	6780	33152	6630	0.0	5.0003016591251885
chr14	LINC01500	58899707	58899856	0	150	33152	6780	33152	6630	0.0	5.0003016591251885
chr14	LINC01500	58989533	58989633	0	101	33152	6780	33152	6679	0.0	4.963617307980236
chr14	LINC01500	58877608	58877692	27068	85	33152	6780	6084	6695	318.4470588235294	0.9087378640776699
chr14	LINC01500	58913762	58913861	0	100	33152	6780	33152	6680	0.0	4.962874251497006
chr14	DAAM1	59360801	59360862	0	62	51	10736	51	10674	0.0	0.00477796514896009
chr14	DAAM1	59338384	59338414	0	31	51	10736	51	10705	0.0	0.004764128911723494
chr14	JKAMP	59484989	59485116	0	128	102	4049	102	3921	0.0	0.026013771996939557
chr14	JKAMP	59486730	59486804	0	75	102	4049	102	3974	0.0	0.025666834423754403
chr14	JKAMP	59486712	59486804	0	93	102	4049	102	3956	0.0	0.02578361981799798
chr14	LRRC9	60062010	60062179	0	170	8905	5408	8905	5238	0.0	1.7000763650248187
chr14	LRRC9	60053874	60054019	0	146	8905	5408	8905	5262	0.0	1.6923223109083998
chr14	LRRC9	60059060	60059116	0	57	8905	5408	8905	5351	0.0	1.6641749205755934
chr14	PCNX4	60107585	60108327	0	743	19	9442	19	8699	0.0	0.0021841590987469826
chr14	PCNX4	60133655	60133785	0	131	19	9442	19	9311	0.0	0.0020405971431639996
chr14	PPM1A	60277004	60277091	0	88	0	11920	0	11832	0.0	0.0
chr14	PPM1A	60250379	60250481	0	103	0	11920	0	11817	0.0	0.0
chr14	PPM1A	60277312	60277365	0	54	0	11920	0	11866	0.0	0.0
chr14	MNAT1	60818721	60818847	0	127	8455	3886	8455	3759	0.0	2.24926842245278
chr14	MNAT1	60968228	60968397	0	170	8455	3886	8455	3716	0.0	2.27529601722282
chr14	SLC38A6	61037058	61037141	0	84	91	4924	91	4840	0.0	0.018801652892561985
chr14	SLC38A6	61043449	61043503	0	55	91	4924	91	4869	0.0	0.01868966933661943
chr14	SLC38A6	60987051	60987157	0	107	91	4924	91	4817	0.0	0.01889142619887897
chr14	SLC38A6	61034018	61034113	0	96	91	4924	91	4828	0.0	0.018848384424192212
chr14	SLC38A6	61052348	61052985	0	638	91	4924	91	4286	0.0	0.021231917872141858
chr14	SLC38A6	61048247	61048297	0	51	91	4924	91	4873	0.0	0.018674327929406938
chr14	SLC38A6	61048150	61048297	0	148	91	4924	91	4776	0.0	0.0190536013400335
chr14	PRKCH	61443110	61443261	2193	152	51239	8398	49046	8246	14.427631578947368	5.947853504729566
chr14	HIF1A	61720381	61720572	0	192	158	4883	158	4691	0.0	0.03368151780004264
chr14	HIF1A	61745690	61745817	0	128	158	4883	158	4755	0.0	0.03322818086225026
chr14	HIF1A	61720378	61720572	0	195	158	4883	158	4688	0.0	0.03370307167235495
chr14	SYT16	62079339	62079428	0	90	81	15193	81	15103	0.0	0.005363172879560352
chr14	LINC00643	62118690	62118814	0	125	0	4644	0	4519	0.0	0.0
chr14	SYNE2	64034493	64034592	0	100	42515	32202	42515	32102	0.0	1.3243723132515108
chr14	SYNE2	64120926	64121061	0	136	42515	32202	42515	32066	0.0	1.3258591654712155
chr14	SYNE2	64188859	64189009	0	151	42515	32202	42515	32051	0.0	1.3264796730211226
chr14	SYNE2	64128451	64128553	0	103	42515	32202	42515	32099	0.0	1.324496090220879
chr14	SYNE2	64165284	64165410	15031	127	42515	32202	27484	32075	118.35433070866142	0.8568667186282152
chr14	SYNE2	64186423	64186579	0	157	42515	32202	42515	32045	0.0	1.3267280386955844
chr14	SYNE2	64190070	64190237	24	168	42515	32202	42491	32034	0.14285714285714285	1.3264344134357244
chr14	SYNE2	64215285	64215354	0	70	42515	32202	42515	32132	0.0	1.3231358147640981
chr14	SYNE2	64207957	64208192	80	236	42515	32202	42435	31966	0.3389830508474576	1.3275042232371894
chr14	SYNE2	64202837	64202963	2856	127	42515	32202	39659	32075	22.488188976377952	1.2364458300857366
chr14	MTHFD1	64411089	64411149	0	61	6268	12243	6268	12182	0.0	0.5145296338860614
chr14	MTHFD1	64417887	64418024	0	138	6268	12243	6268	12105	0.0	0.5178025609252375
chr14	MTHFD1	64439095	64439172	928	78	6268	12243	5340	12165	11.897435897435898	0.43896424167694204
chr14	MTHFD1	64453753	64453861	0	109	6268	12243	6268	12134	0.0	0.5165650238997858
chr14	MTHFD1	64390336	64390467	0	132	6268	12243	6268	12111	0.0	0.5175460325324086
chr14	MTHFD1	64389000	64389125	0	126	6268	12243	6268	12117	0.0	0.5172897581909713
chr14	MTHFD1	64458213	64458307	0	95	6268	12243	6268	12148	0.0	0.5159697069476457
chr14	MTHFD1	64390336	64390791	0	456	6268	12243	6268	11787	0.0	0.5317722915075931
chr14	MTHFD1	64458428	64458597	0	170	6268	12243	6268	12073	0.0	0.5191750186366272
chr14	ZBTB1	64511248	64511384	0	137	816	4941	816	4804	0.0	0.16985845129059118
chr14	ZBTB1	64516599	64516751	0	153	816	4941	816	4788	0.0	0.17042606516290726
chr14	PPP1R36	64561787	64562028	0	242	1263	2373	1263	2131	0.0	0.5926794931956828
chr14	PPP1R36	64551633	64551687	0	55	1263	2373	1263	2318	0.0	0.5448662640207075
chr14	PLEKHG3	64730242	64730312	0	71	2195	11824	2195	11753	0.0	0.18676082702288777
chr14	PLEKHG3	64728995	64729093	0	99	2195	11824	2195	11725	0.0	0.18720682302771854
chr14	CHURC1	64926009	64926080	218	72	15413	5410	15195	5338	3.0277777777777777	2.8465717497189957
chr14	CHURC1	64926006	64926080	224	75	15413	5410	15189	5335	2.986666666666667	2.8470477975632615
chr14	CHURC1-FNTB	65012316	65012389	780	74	2835	2091	2055	2017	10.54054054054054	1.0188398611799703
chr14	CHURC1	64932137	64932292	0	156	15413	5410	15413	5254	0.0	2.9335744194899123
chr14	FUT8	65455620	65455718	5982	99	52863	6997	46881	6898	60.42424242424242	6.796317773267614
chr14	FUT8	65561336	65561766	0	431	52863	6997	52863	6566	0.0	8.051020408163266
chr14	FUT8	65430215	65430309	0	95	52863	6997	52863	6902	0.0	7.659084323384526
chr14	FUT8	65479706	65479784	0	79	52863	6997	52863	6918	0.0	7.6413703382480485
chr14	FUT8	65516242	65516388	0	147	52863	6997	52863	6850	0.0	7.717226277372263
chr14	FUT8	65617089	65617191	0	103	52863	6997	52863	6894	0.0	7.667972149695387
chr14	LINC02290	66120035	66120292	0	258	238	4521	238	4263	0.0	0.05582922824302135
chr14	LINC02290	66125768	66125889	0	122	238	4521	238	4399	0.0	0.05410320527392589
chr14	LINC02290	66126466	66126509	0	44	238	4521	238	4477	0.0	0.05316059861514407
chr14	LINC02290	66117907	66118054	0	148	238	4521	238	4373	0.0	0.05442487994511777
chr14	LINC02290	66123143	66123313	0	171	238	4521	238	4350	0.0	0.05471264367816092
chr14	LINC02290	66122639	66122878	0	240	238	4521	238	4281	0.0	0.0555944872693296
chr14	LINC02290	66120188	66120292	0	105	238	4521	238	4416	0.0	0.05389492753623189
chr14	LINC02290	66112584	66112725	0	142	238	4521	238	4379	0.0	0.054350308289563824
chr14	LINC02290	66123143	66123180	0	38	238	4521	238	4483	0.0	0.05308944902966763
chr14	CCDC196	66496826	66496867	0	42	459	2841	459	2799	0.0	0.1639871382636656
chr14	CCDC196	66486656	66486809	0	154	459	2841	459	2687	0.0	0.1708224786006699
chr14	CCDC196	66488986	66489037	0	52	459	2841	459	2789	0.0	0.16457511652922194
chr14	CCDC196	66491020	66491104	0	85	459	2841	459	2756	0.0	0.1665457184325109
chr14	CCDC196	66495661	66495771	0	111	459	2841	459	2730	0.0	0.16813186813186815
chr14	CCDC196	66493772	66493943	0	172	459	2841	459	2669	0.0	0.17197452229299362
chr14	CCDC196	66490741	66490819	0	79	459	2841	459	2762	0.0	0.166183924692252
chr14	CCDC196	66492811	66492900	0	90	459	2841	459	2751	0.0	0.1668484187568157
chr14	GPHN	66776463	66776521	0	59	3366	5667	3366	5608	0.0	0.6002139800285307
chr14	GPHN	67159414	67159488	0	75	3366	5667	3366	5592	0.0	0.601931330472103
chr14	GPHN	66924193	66924292	0	100	3366	5667	3366	5567	0.0	0.6046344530267649
chr14	GPHN	66824473	66824566	0	94	3366	5667	3366	5573	0.0	0.6039834918356362
chr14	GPHN	66842677	66842716	0	40	3366	5667	3366	5627	0.0	0.5981873111782477
chr14	GPHN	66996176	66996218	0	43	3366	5667	3366	5624	0.0	0.59850640113798
chr14	GPHN	66709356	66709458	0	103	3366	5667	3366	5564	0.0	0.604960460100647
chr14	GPHN	66551040	66551181	0	142	3366	5667	3366	5525	0.0	0.6092307692307692
chr14	GPHN	66985681	66985738	0	58	3366	5667	3366	5609	0.0	0.6001069709395614
chr14	FAM71D	67189697	67189754	0	58	1938	4520	1938	4462	0.0	0.4343343792021515
chr14	FAM71D	67208201	67208449	0	249	1938	4520	1938	4271	0.0	0.45375790213064854
chr14	FAM71D	67196953	67197029	0	77	1938	4520	1938	4443	0.0	0.4361917623227549
chr14	FAM71D	67198971	67199130	0	160	1938	4520	1938	4360	0.0	0.4444954128440367
chr14	FAM71D	67201430	67201747	0	318	1938	4520	1938	4202	0.0	0.4612089481199429
chr14	MPP5	67254203	67254310	0	108	111	14613	111	14505	0.0	0.0076525336091003105
chr14	MPP5	67269700	67269783	0	84	111	14613	111	14529	0.0	0.007639892628536031
chr14	ARG2	67645642	67645802	0	161	13437	2292	13437	2131	0.0	6.305490380103238
chr14	RAD51B	67864787	67864885	0	99	1987	7510	1987	7411	0.0	0.2681149642423425
chr14	RAD51B	68468171	68468250	0	80	1987	7510	1987	7430	0.0	0.26742934051144013
chr14	EXD2	69209423	69209803	0	381	51	6278	51	5897	0.0	0.008648465321349838
chr14	EXD2	69203916	69204000	0	85	51	6278	51	6193	0.0	0.0082351041498466
chr14	EXD2	69210111	69210201	0	91	51	6278	51	6187	0.0	0.008243090350735413
chr14	SLC39A9	69441831	69441972	0	142	2063	7148	2063	7006	0.0	0.2944618898087354
chr14	SLC39A9	69442068	69442266	0	199	2063	7148	2063	6949	0.0	0.2968772485249676
chr14	SLC39A9	69453240	69453309	0	70	2063	7148	2063	7078	0.0	0.29146651596496187
chr14	SLC39A9	69458362	69458729	0	368	2063	7148	2063	6780	0.0	0.3042772861356932
chr14	AL160191.1	70229301	70229569	0	269	0	1116	0	847	0.0	0.0
chr14	AL160191.1	70224006	70224197	0	192	0	1116	0	924	0.0	0.0
chr14	PCNX1	71057508	71057724	0	217	3686	16758	3686	16541	0.0	0.22284021522277975
chr14	SIPA1L1	71528698	71528740	0	43	4744	12451	4744	12408	0.0	0.38233397807865893
chr14	SIPA1L1	71529311	71529370	0	60	4744	12451	4744	12391	0.0	0.38285852634976997
chr14	SIPA1L1	71698980	71699127	0	148	4744	12451	4744	12303	0.0	0.3855970088596277
chr14	SIPA1L1	71704720	71704783	0	64	4744	12451	4744	12387	0.0	0.38298215871478164
chr14	RGS6	72495151	72495262	0	112	31	8860	31	8748	0.0	0.0035436671239140374
chr14	RGS6	72540040	72540094	0	55	31	8860	31	8805	0.0	0.0035207268597387846
chr14	RGS6	72553289	72553356	0	68	31	8860	31	8792	0.0	0.0035259326660600546
chr14	RGS6	72464693	72464717	0	25	31	8860	31	8835	0.0	0.0035087719298245615
chr14	RGS6	72464690	72464717	0	28	31	8860	31	8832	0.0	0.003509963768115942
chr14	DCAF4	72937970	72938070	0	101	0	5555	0	5454	0.0	0.0
chr14	RBM25	73069852	73069920	0	69	2320	11083	2320	11014	0.0	0.21064100236063193
chr14	RBM25	73083493	73083551	34	59	2320	11083	2286	11024	0.576271186440678	0.2073657474600871
chr14	RBM25	73064971	73065093	0	123	2320	11083	2320	10960	0.0	0.2116788321167883
chr14	RBM25	73088369	73088474	0	106	2320	11083	2320	10977	0.0	0.21135100665026874
chr14	PSEN1	73137124	73137223	4461	100	27020	9942	22559	9842	44.61	2.292115423694371
chr14	PSEN1	73138106	73138152	0	47	27020	9942	27020	9895	0.0	2.7306720565942397
chr14	PSEN1	73211768	73211942	0	175	27020	9942	27020	9767	0.0	2.7664584826456435
chr14	PSEN1	73139296	73139398	34	103	27020	9942	26986	9839	0.3300970873786408	2.742758410407562
chr14	PSEN1	73138111	73138152	0	42	27020	9942	27020	9900	0.0	2.7292929292929293
chr14	PSEN1	73160008	73160138	0	131	27020	9942	27020	9811	0.0	2.754051574763021
chr14	PSEN1	73146077	73146126	0	50	27020	9942	27020	9892	0.0	2.731500202183583
chr14	PSEN1	73208823	73208915	0	93	27020	9942	27020	9849	0.0	2.7434257285003554
chr14	PAPLN	73262349	73262827	182	479	1493	7427	1311	6948	0.37995824634655534	0.18868739205526772
chr14	PAPLN	73251485	73251566	0	82	1493	7427	1493	7345	0.0	0.20326752893124575
chr14	PAPLN	73264009	73264044	0	36	1493	7427	1493	7391	0.0	0.2020024353943986
chr14	PAPLN	73263941	73264044	0	104	1493	7427	1493	7323	0.0	0.2038781919978151
chr14	PAPLN	73262397	73262827	182	431	1493	7427	1311	6996	0.4222737819025522	0.1873927958833619
chr14	DNAL1	73671541	73671597	0	57	12445	8895	12445	8838	0.0	1.4081240099570038
chr14	DNAL1	73658846	73658956	0	111	12445	8895	12445	8784	0.0	1.416780510018215
chr14	DNAL1	73689374	73689515	4210	142	12445	8895	8235	8753	29.64788732394366	0.9408202901862218
chr14	DNAL1	73653169	73653215	0	47	12445	8895	12445	8848	0.0	1.4065325497287522
chr14	DNAL1	73654846	73654885	0	40	12445	8895	12445	8855	0.0	1.4054206662902315
chr14	DNAL1	73651166	73651327	32	162	12445	8895	12413	8733	0.19753086419753085	1.4213901293942517
chr14	DNAL1	73672944	73673091	357	148	12445	8895	12088	8747	2.4121621621621623	1.381959528981365
chr14	PTGR2	73879095	73879305	0	211	663	6154	663	5943	0.0	0.11155981827359919
chr14	ZNF410	73903959	73904110	0	152	226	5246	226	5094	0.0	0.04436592069100903
chr14	ZNF410	73920979	73921105	51	127	226	5246	175	5119	0.4015748031496063	0.03418636452432116
chr14	ZNF410	73892026	73892208	0	183	226	5246	226	5063	0.0	0.04463756666008296
chr14	ZNF410	73922065	73922206	0	142	226	5246	226	5104	0.0	0.044278996865203764
chr14	ZNF410	73896315	73896534	0	220	226	5246	226	5026	0.0	0.04496617588539594
chr14	ZNF410	73896347	73896534	0	188	226	5246	226	5058	0.0	0.04468169236852511
chr14	ZNF410	73892026	73892107	0	82	226	5246	226	5164	0.0	0.04376452362509682
chr14	ZNF410	73894358	73894409	0	52	226	5246	226	5194	0.0	0.04351174432036966
chr14	ZNF410	73924701	73924819	0	119	226	5246	226	5127	0.0	0.04408035888433782
chr14	ZNF410	73927106	73927228	0	123	226	5246	226	5123	0.0	0.044114776498145616
chr14	COQ6	73955450	73955509	0	60	151961	5835	151961	5775	0.0	26.313593073593072
chr14	COQ6	73961736	73961903	0	168	151961	5835	151961	5667	0.0	26.81506970178225
chr14	BBOF1	74022915	74023144	0	230	6142	4373	6142	4143	0.0	1.482500603427468
chr14	BBOF1	74034027	74034171	0	145	6142	4373	6142	4228	0.0	1.4526963103122044
chr14	BBOF1	74046059	74046130	0	72	6142	4373	6142	4301	0.0	1.4280399906998373
chr14	LIN52	74101154	74101238	0	85	2601	3699	2601	3614	0.0	0.7197011621472054
chr14	ISCA2	74494274	74494390	0	117	3073	3028	3073	2911	0.0	1.0556509790450017
chr14	YLPM1	74797579	74799697	204	2119	21640	14959	21436	12840	0.09627182633317603	1.6694704049844238
chr14	YLPM1	74824255	74824307	0	53	21640	14959	21640	14906	0.0	1.4517643901784516
chr14	DLST	74882590	74882624	0	35	0	4551	0	4516	0.0	0.0
chr14	DLST	74885585	74885634	0	50	0	4551	0	4501	0.0	0.0
chr14	DLST	74889094	74889147	0	54	0	4551	0	4497	0.0	0.0
chr14	DLST	74889896	74889952	0	57	0	4551	0	4494	0.0	0.0
chr14	DLST	74889877	74889952	0	76	0	4551	0	4475	0.0	0.0
chr14	ZC2HC1C	75070554	75071738	561	1185	58090	7841	57529	6656	0.47341772151898737	8.643179086538462
chr14	ZC2HC1C	75070554	75071396	561	843	58090	7841	57529	6998	0.6654804270462633	8.220777364961418
chr14	ZC2HC1C	75070554	75071911	561	1358	58090	7841	57529	6483	0.41310751104565535	8.87382384698442
chr14	ZC2HC1C	75073570	75073635	0	66	58090	7841	58090	7775	0.0	7.471382636655949
chr14	FOS	75280559	75280667	0	109	11811	3005	11811	2896	0.0	4.078383977900552
chr14	LINC01220	75294676	75294737	336	62	6500	1982	6164	1920	5.419354838709677	3.2104166666666667
chr14	FLVCR2	75624611	75624752	0	142	2224	4925	2224	4783	0.0	0.46498013798871
chr14	FLVCR2	75633628	75633696	0	69	2224	4925	2224	4856	0.0	0.45799011532125206
chr14	FLVCR2	75634909	75635013	0	105	2224	4925	2224	4820	0.0	0.46141078838174276
chr14	TTLL5	75737565	75737607	0	43	854	12313	854	12270	0.0	0.06960065199674001
chr14	TTLL5	75757830	75757869	0	40	854	12313	854	12273	0.0	0.06958363888209891
chr14	IFT43	75986125	75986308	0	184	102	3897	102	3713	0.0	0.02747104767034743
chr14	IFT43	76076596	76076691	0	96	102	3897	102	3801	0.0	0.026835043409629045
chr14	IFT43	75986125	75986282	0	158	102	3897	102	3739	0.0	0.027280021396095214
chr14	GPATCH2L	76178207	76178322	0	116	6316	20948	6316	20832	0.0	0.30318740399385563
chr14	GPATCH2L	76152535	76152580	0	46	6316	20948	6316	20902	0.0	0.30217204095301886
chr14	ESRRB	76498725	76498912	0	188	408	4153	408	3965	0.0	0.10290037831021438
chr14	LRRC74A	76837874	76837971	0	98	0	2320	0	2222	0.0	0.0
chr14	LRRC74A	76829090	76829163	0	74	0	2320	0	2246	0.0	0.0
chr14	CIPC	77109811	77109981	0	171	112	5238	112	5067	0.0	0.022103808959936848
chr14	CIPC	77099883	77099961	10	79	112	5238	102	5159	0.12658227848101267	0.019771273502616787
chr14	TMEM63C	77212253	77212313	0	61	50583	6216	50583	6155	0.0	8.218196588139724
chr14	GSTZ1	77322546	77322732	0	187	51	5473	51	5286	0.0	0.009648127128263337
chr14	GSTZ1	77327471	77327552	0	82	51	5473	51	5391	0.0	0.009460211463550361
chr14	GSTZ1	77327911	77328037	0	127	51	5473	51	5346	0.0	0.009539842873176206
chr14	GSTZ1	77324869	77324921	0	53	51	5473	51	5420	0.0	0.009409594095940959
chr14	GSTZ1	77327471	77327510	0	40	51	5473	51	5433	0.0	0.009387078961899503
chr14	AHSA1	77468456	77468508	0	53	132	2865	132	2812	0.0	0.04694167852062589
chr14	SLIRP	77715771	77715879	0	109	323	2452	323	2343	0.0	0.13785744771660263
chr14	SLIRP	77710554	77710665	0	112	323	2452	323	2340	0.0	0.13803418803418804
chr14	SLIRP	77733936	77734046	0	111	323	2452	323	2341	0.0	0.1379752242631354
chr14	C14ORF178	77768451	77768465	0	15	357	703	357	688	0.0	0.5188953488372093
chr14	C14ORF178	77768451	77768523	0	73	357	703	357	630	0.0	0.5666666666666667
chr14	ADCK1	77859075	77859279	86	205	214072	4083	213986	3878	0.4195121951219512	55.17947395564724
chr14	ADCK1	77887090	77887249	0	160	214072	4083	214072	3923	0.0	54.56844251848076
chr14	ADCK1	77907802	77907919	720	118	214072	4083	213352	3965	6.101694915254237	53.80882723833543
chr14	ADCK1	77827853	77827971	0	119	214072	4083	214072	3964	0.0	54.00403632694248
chr14	ADCK1	77900558	77900674	4886	117	214072	4083	209186	3966	41.76068376068376	52.74483106404438
chr14	NRXN3	78278644	78278662	0	19	2586	14947	2586	14928	0.0	0.17323151125401928
chr14	NRXN3	78300679	78300691	0	13	2586	14947	2586	14934	0.0	0.17316191241462434
chr14	NRXN3	78810317	78810344	0	28	2586	14947	2586	14919	0.0	0.17333601447818217
chr14	NRXN3	79692172	79692262	0	91	2586	14947	2586	14856	0.0	0.17407108239095315
chr14	NRXN3	79853538	79854217	0	680	2586	14947	2586	14267	0.0	0.18125744725590523
chr14	NRXN3	78649267	78649291	0	25	2586	14947	2586	14922	0.0	0.17330116606353035
chr14	NRXN3	78972882	78972909	0	28	2586	14947	2586	14919	0.0	0.17333601447818217
chr14	NRXN3	79854069	79854217	0	149	2586	14947	2586	14798	0.0	0.17475334504662793
chr14	AL355838.1	81777757	81777914	0	158	0	2374	0	2216	0.0	0.0
chr14	AL355838.1	81768419	81768548	0	130	0	2374	0	2244	0.0	0.0
chr14	AL355838.1	81795667	81795729	0	63	0	2374	0	2311	0.0	0.0
chr14	LINC02301	82654347	82654400	0	54	0	6218	0	6164	0.0	0.0
chr14	LINC02301	82656425	82656457	0	33	0	6218	0	6185	0.0	0.0
chr14	LINC02301	82685379	82685431	0	53	0	6218	0	6165	0.0	0.0
chr14	LINC02301	82680150	82680368	0	219	0	6218	0	5999	0.0	0.0
chr14	LINC00911	85407902	85408036	0	135	0	1755	0	1620	0.0	0.0
chr14	LINC02328	86035713	86035815	0	103	0	4788	0	4685	0.0	0.0
chr14	LINC02328	86128664	86128773	0	110	0	4788	0	4678	0.0	0.0
chr14	LINC02328	86028368	86028458	0	91	0	4788	0	4697	0.0	0.0
chr14	LINC02328	86041725	86041833	0	109	0	4788	0	4679	0.0	0.0
chr14	LINC02328	86128714	86128773	0	60	0	4788	0	4728	0.0	0.0
chr14	LINC02328	86000860	86000953	0	94	0	4788	0	4694	0.0	0.0
chr14	LINC01146	88025406	88025481	0	76	0	9300	0	9224	0.0	0.0
chr14	LINC01146	88079103	88079368	0	266	0	9300	0	9034	0.0	0.0
chr14	LINC01146	88084036	88084155	0	120	0	9300	0	9180	0.0	0.0
chr14	LINC01146	88044614	88044848	0	235	0	9300	0	9065	0.0	0.0
chr14	LINC01146	88044685	88044848	0	164	0	9300	0	9136	0.0	0.0
chr14	LINC01146	88086827	88087023	0	197	0	9300	0	9103	0.0	0.0
chr14	LINC01146	88090022	88090210	0	189	0	9300	0	9111	0.0	0.0
chr14	LINC01146	88086873	88087037	0	165	0	9300	0	9135	0.0	0.0
chr14	LINC01146	88037350	88037439	0	90	0	9300	0	9210	0.0	0.0
chr14	LINC01146	88086827	88087037	0	211	0	9300	0	9089	0.0	0.0
chr14	LINC01146	88084983	88085036	0	54	0	9300	0	9246	0.0	0.0
chr14	LINC01146	88091335	88091652	0	318	0	9300	0	8982	0.0	0.0
chr14	LINC01146	88091335	88091449	0	115	0	9300	0	9185	0.0	0.0
chr14	LINC01146	88084986	88085036	0	51	0	9300	0	9249	0.0	0.0
chr14	LINC01146	88084036	88084483	0	448	0	9300	0	8852	0.0	0.0
chr14	AL133279.1	88178466	88178601	0	136	0	612	0	476	0.0	0.0
chr14	SPATA7	88391380	88391455	0	76	1667	6106	1667	6030	0.0	0.27645107794361523
chr14	SPATA7	88415204	88415266	0	63	1667	6106	1667	6043	0.0	0.27585636273374153
chr14	SPATA7	88393392	88393488	0	97	1667	6106	1667	6009	0.0	0.27741720752205024
chr14	SPATA7	88391597	88391758	0	162	1667	6106	1667	5944	0.0	0.2804508748317631
chr14	SPATA7	88414673	88414732	0	60	1667	6106	1667	6046	0.0	0.2757194839563348
chr14	SPATA7	88406682	88406736	0	55	1667	6106	1667	6051	0.0	0.27549165427202116
chr14	ZC3H14	88563650	88563693	0	44	0	20176	0	20132	0.0	0.0
chr14	ZC3H14	88568038	88568153	0	116	0	20176	0	20060	0.0	0.0
chr14	ZC3H14	88571083	88571124	0	42	0	20176	0	20134	0.0	0.0
chr14	ZC3H14	88567857	88568153	0	297	0	20176	0	19879	0.0	0.0
chr14	ZC3H14	88596733	88596808	0	76	0	20176	0	20100	0.0	0.0
chr14	ZC3H14	88567857	88567916	0	60	0	20176	0	20116	0.0	0.0
chr14	TTC8	88836907	88837066	0	160	2340	6251	2340	6091	0.0	0.38417337054670825
chr14	TTC8	88841424	88841514	0	91	2340	6251	2340	6160	0.0	0.37987012987012986
chr14	TTC8	88843805	88843850	0	46	2340	6251	2340	6205	0.0	0.37711522965350525
chr14	TTC8	88852970	88853056	0	87	2340	6251	2340	6164	0.0	0.3796236210253082
chr14	TTC8	88875025	88875109	0	85	2340	6251	2340	6166	0.0	0.3795004865390853
chr14	TTC8	88833692	88833722	0	31	2340	6251	2340	6220	0.0	0.3762057877813505
chr14	TTC8	88846597	88846675	0	79	2340	6251	2340	6172	0.0	0.37913156189241737
chr14	TDP1	89964850	89964938	0	89	151	6245	151	6156	0.0	0.02452891487979207
chr14	TDP1	89975780	89975815	0	36	151	6245	151	6209	0.0	0.024319536157191173
chr14	TDP1	90033105	90033214	0	110	151	6245	151	6135	0.0	0.024612876935615324
chr14	TDP1	89956577	89956800	0	224	151	6245	151	6021	0.0	0.025078890549742567
chr14	TDP1	89963107	89963673	0	567	151	6245	151	5678	0.0	0.02659387108136668
chr14	TDP1	90023031	90023077	0	47	151	6245	151	6198	0.0	0.02436269764440142
chr14	TDP1	89983113	89983276	0	164	151	6245	151	6081	0.0	0.024831442197007073
chr14	TDP1	89986985	89987042	0	58	151	6245	151	6187	0.0	0.02440601260707936
chr14	TDP1	89981462	89981560	45	99	151	6245	106	6146	0.45454545454545453	0.017246989912137977
chr14	PSMC1	90260114	90260211	0	98	33652	5390	33652	5292	0.0	6.3590325018896445
chr14	CALM1	90403861	90403968	0	108	3936	7087	3936	6979	0.0	0.5639776472273965
chr14	CALM1	90398990	90399087	136	98	3936	7087	3800	6989	1.3877551020408163	0.5437115467162684
chr14	LINC00642	90456441	90456551	1909	111	25892	5124	23983	5013	17.1981981981982	4.784161180929583
chr14	LINC00642	90456130	90456254	0	125	25892	5124	25892	4999	0.0	5.179435887177435
chr14	DGLUCY	91147780	91147858	0	79	15811	7243	15811	7164	0.0	2.207007258514796
chr14	DGLUCY	91170002	91170186	0	185	15811	7243	15811	7058	0.0	2.2401530178520828
chr14	DGLUCY	91145220	91145313	0	94	15811	7243	15811	7149	0.0	2.2116379913274584
chr14	DGLUCY	91170002	91170201	0	200	15811	7243	15811	7043	0.0	2.2449240380519666
chr14	DGLUCY	91157638	91157690	0	53	15811	7243	15811	7190	0.0	2.1990264255910987
chr14	DGLUCY	91204705	91204825	0	121	15811	7243	15811	7122	0.0	2.2200224655995506
chr14	DGLUCY	91158855	91158972	0	118	15811	7243	15811	7125	0.0	2.2190877192982454
chr14	DGLUCY	91185469	91185575	0	107	15811	7243	15811	7136	0.0	2.215667040358744
chr14	DGLUCY	91165246	91165337	0	92	15811	7243	15811	7151	0.0	2.2110194378408616
chr14	DGLUCY	91173663	91173753	0	91	15811	7243	15811	7152	0.0	2.2107102908277403
chr14	DGLUCY	91148573	91148852	0	280	15811	7243	15811	6963	0.0	2.270716645124228
chr14	DGLUCY	91128777	91128912	0	136	15811	7243	15811	7107	0.0	2.224708034332348
chr14	DGLUCY	91223678	91223795	0	118	15811	7243	15811	7125	0.0	2.2190877192982454
chr14	DGLUCY	91204705	91204867	0	163	15811	7243	15811	7080	0.0	2.2331920903954803
chr14	AL135818.1	91247489	91247659	0	171	1143	2091	1143	1920	0.0	0.5953125
chr14	AL135818.1	91243912	91243981	0	70	1143	2091	1143	2021	0.0	0.5655616031667491
chr14	CPSF2	92134010	92134170	0	161	47	13579	47	13418	0.0	0.003502757489938888
chr14	CPSF2	92156478	92156631	0	154	47	13579	47	13425	0.0	0.0035009310986964617
chr14	SLC24A4	92492826	92492924	19605	99	51896	14801	32291	14702	198.03030303030303	2.196367841110053
chr14	RIN3	92615406	92615479	0	74	8810	5916	8810	5842	0.0	1.5080451900034235
chr14	GOLGA5	92837385	92837449	0	65	75	3218	75	3153	0.0	0.023786869647954328
chr14	CHGA	92924198	92924245	0	48	0	3033	0	2985	0.0	0.0
chr14	CHGA	92926604	92926698	0	95	0	3033	0	2938	0.0	0.0
chr14	CHGA	92931249	92931702	0	454	0	3033	0	2579	0.0	0.0
chr14	UBR7	93212031	93212127	0	97	5984	3520	5984	3423	0.0	1.7481741162722757
chr14	AL110118.1	93186259	93186482	306	224	6396	929	6090	705	1.3660714285714286	8.638297872340425
chr14	UBR7	93209823	93209957	0	135	5984	3520	5984	3385	0.0	1.7677991137370754
chr14	UBR7	93219211	93219361	0	151	5984	3520	5984	3369	0.0	1.7761947165330958
chr14	UNC79	93634520	93634637	0	118	72025	11440	72025	11322	0.0	6.361508567390921
chr14	UNC79	93604895	93604961	0	67	72025	11440	72025	11373	0.0	6.332981623142531
chr14	FAM181A	93925047	93925370	0	324	0	2123	0	1799	0.0	0.0
chr14	CCDC197	93999336	93999460	0	125	0	2717	0	2592	0.0	0.0
chr14	CCDC197	94000830	94000930	0	101	0	2717	0	2616	0.0	0.0
chr14	IFI27L1	94101813	94101975	0	163	0	2366	0	2203	0.0	0.0
chr14	IFI27L1	94097491	94097678	0	188	0	2366	0	2178	0.0	0.0
chr14	IFI27L1	94101813	94102059	0	247	0	2366	0	2119	0.0	0.0
chr14	IFI27L1	94088247	94088303	0	57	0	2366	0	2309	0.0	0.0
chr14	IFI27L1	94097494	94097678	0	185	0	2366	0	2181	0.0	0.0
chr14	IFI27L1	94100738	94100771	0	34	0	2366	0	2332	0.0	0.0
chr14	IFI27L1	94094749	94094899	0	151	0	2366	0	2215	0.0	0.0
chr14	IFI27	94111658	94111773	0	116	0	3825	0	3709	0.0	0.0
chr14	IFI27	94114850	94114880	0	31	0	3825	0	3794	0.0	0.0
chr14	IFI27	94110925	94110978	0	54	0	3825	0	3771	0.0	0.0
chr14	IFI27	94111624	94111773	0	150	0	3825	0	3675	0.0	0.0
chr14	IFI27	94116073	94116294	0	222	0	3825	0	3603	0.0	0.0
chr14	PPP4R4	94227274	94227378	0	105	0	5004	0	4899	0.0	0.0
chr14	SERPINA5	94581614	94581638	0	25	2625	3760	2625	3735	0.0	0.7028112449799196
chr14	SERPINA5	94581614	94581710	0	97	2625	3760	2625	3663	0.0	0.7166257166257166
chr14	SERPINA5	94586845	94586983	0	139	2625	3760	2625	3621	0.0	0.7249378624689312
chr14	SERPINA3	94619194	94619468	0	275	51	5005	51	4730	0.0	0.010782241014799155
chr14	SERPINA3	94614433	94615084	0	652	51	5005	51	4353	0.0	0.01171605789110958
chr14	LINC02292	95332644	95332784	0	141	0	3162	0	3021	0.0	0.0
chr14	LINC02292	95321079	95321179	0	101	0	3162	0	3061	0.0	0.0
chr14	LINC02292	95331262	95331517	0	256	0	3162	0	2906	0.0	0.0
chr14	LINC02292	95331262	95331645	0	384	0	3162	0	2778	0.0	0.0
chr14	LINC02318	95577428	95577605	0	178	4794	2840	4794	2662	0.0	1.800901577761082
chr14	LINC02318	95580469	95580611	0	143	4794	2840	4794	2697	0.0	1.7775305895439377
chr14	LINC02318	95580469	95580651	0	183	4794	2840	4794	2657	0.0	1.8042905532555513
chr14	LINC02318	95577428	95577696	15	269	4794	2840	4779	2571	0.055762081784386616	1.8588098016336057
chr14	LINC02318	95577432	95577605	0	174	4794	2840	4794	2666	0.0	1.7981995498874719
chr14	AL133467.2	95639952	95640148	1188	197	6198	1929	5010	1732	6.030456852791878	2.892609699769053
chr14	AL133467.2	95626219	95626344	1836	126	6198	1929	4362	1803	14.571428571428571	2.4193011647254576
chr14	TCL6	95662479	95662664	0	186	2955	10388	2955	10202	0.0	0.28964908841403647
chr14	TCL6	95663255	95663635	0	381	2955	10388	2955	10007	0.0	0.2952932946937144
chr14	TCL6	95670441	95670577	0	137	2955	10388	2955	10251	0.0	0.28826455955516533
chr14	TCL6	95668125	95668580	0	456	2955	10388	2955	9932	0.0	0.29752315747080144
chr14	TCL6	95669550	95669617	95	68	2955	10388	2860	10320	1.3970588235294117	0.2771317829457364
chr14	AL133467.3	95688178	95688274	0	97	95	3681	95	3584	0.0	0.026506696428571428
chr14	TUNAR	95895810	95895943	0	134	25063	3636	25063	3502	0.0	7.156767561393489
chr14	C14ORF132	96051123	96051222	0	100	0	1112	0	1012	0.0	0.0
chr14	C14ORF132	96040274	96040367	0	94	0	1112	0	1018	0.0	0.0
chr14	BDKRB2	96239695	96239861	0	167	0	4328	0	4161	0.0	0.0
chr14	GSKIP	96378937	96379059	0	123	0	4558	0	4435	0.0	0.0
chr14	GSKIP	96379687	96379755	0	69	0	4558	0	4489	0.0	0.0
chr14	GSKIP	96379687	96379788	0	102	0	4558	0	4456	0.0	0.0
chr14	PAPOLA	96525309	96525391	0	83	32390	10053	32390	9970	0.0	3.2487462387161483
chr14	PAPOLA	96527429	96527539	0	111	32390	10053	32390	9942	0.0	3.2578957956145644
chr14	PAPOLA	96547796	96547918	0	123	32390	10053	32390	9930	0.0	3.2618328298086605
chr14	PAPOLA	96560648	96560711	0	64	32390	10053	32390	9989	0.0	3.2425668235058565
chr14	PAPOLA	96562818	96562893	0	76	32390	10053	32390	9977	0.0	3.2464668738097626
chr14	PAPOLA	96527952	96528006	0	55	32390	10053	32390	9998	0.0	3.2396479295859173
chr14	AL137786.1	96593489	96593699	0	211	0	2863	0	2652	0.0	0.0
chr14	AL137786.1	96593120	96593249	0	130	0	2863	0	2733	0.0	0.0
chr14	AL137786.1	96593489	96593579	0	91	0	2863	0	2772	0.0	0.0
chr14	AL137786.1	96594663	96594881	0	219	0	2863	0	2644	0.0	0.0
chr14	AL137786.1	96594663	96594949	0	287	0	2863	0	2576	0.0	0.0
chr14	AL137786.1	96593489	96593695	0	207	0	2863	0	2656	0.0	0.0
chr14	LINC02299	96781511	96781615	2079	105	6006	1611	3927	1506	19.8	2.6075697211155378
chr14	LINC02299	96790371	96790460	0	90	6006	1611	6006	1521	0.0	3.948717948717949
chr14	VRK1	96877501	96877573	0	73	16040	2678	16040	2605	0.0	6.157389635316699
chr14	LINC02325	97525673	97525818	0	146	0	5246	0	5100	0.0	0.0
chr14	LINC02325	97580446	97580635	0	190	0	5246	0	5056	0.0	0.0
chr14	LINC02325	97536637	97536678	0	42	0	5246	0	5204	0.0	0.0
chr14	LINC02325	97557416	97557481	0	66	0	5246	0	5180	0.0	0.0
chr14	LINC02325	97466495	97466618	0	124	0	5246	0	5122	0.0	0.0
chr14	C14ORF177	98712325	98712495	0	171	0	1421	0	1250	0.0	0.0
chr14	C14ORF177	98715000	98715132	0	133	0	1421	0	1288	0.0	0.0
chr14	CCNK	99501355	99501413	0	59	0	5576	0	5517	0.0	0.0
chr14	CCNK	99491945	99492320	0	376	0	5576	0	5200	0.0	0.0
chr14	CYP46A1	99695431	99695474	0	44	41	9376	41	9332	0.0	0.0043934847835405055
chr14	EML1	99907637	99907733	0	97	1880	8834	1880	8737	0.0	0.21517683415359964
chr14	EML1	99874930	99874987	0	58	1880	8834	1880	8776	0.0	0.21422060164083864
chr14	EML1	99850123	99850332	0	210	1880	8834	1880	8624	0.0	0.21799628942486085
chr14	EVL	100123538	100123602	0	65	11678	8146	11678	8081	0.0	1.445118178443262
chr14	EVL	100137739	100137802	0	64	11678	8146	11678	8082	0.0	1.4449393714427121
chr14	EVL	100074502	100074615	0	114	11678	8146	11678	8032	0.0	1.4539342629482073
chr14	EVL	100102303	100102379	0	77	11678	8146	11678	8069	0.0	1.44726731937043
chr14	EVL	100134652	100134867	0	216	11678	8146	11678	7930	0.0	1.4726355611601514
chr14	EVL	100139333	100139369	0	37	11678	8146	11678	8109	0.0	1.4401282525588852
chr14	YY1	100274697	100274758	0	62	2601	7106	2601	7044	0.0	0.3692504258943782
chr14	YY1	100276489	100276648	0	160	2601	7106	2601	6946	0.0	0.37446012093291103
chr14	YY1	100275942	100276074	0	133	2601	7106	2601	6973	0.0	0.373010182131077
chr14	WDR25	100468020	100468168	0	149	17342	4230	17342	4081	0.0	4.249448664543004
chr14	WDR25	100380909	100381746	5862	838	17342	4230	11480	3392	6.995226730310263	3.384433962264151
chr14	LINC00523	100669320	100669446	133	127	5868	3347	5735	3220	1.047244094488189	1.781055900621118
chr14	LINC00523	100667230	100667531	0	302	5868	3347	5868	3045	0.0	1.9270935960591133
chr14	MEG3	100832511	100832641	329	131	70319	9744	69990	9613	2.5114503816793894	7.28076562987621
chr14	MEG3	100831420	100831534	87	115	70319	9744	70232	9629	0.7565217391304347	7.293799979229411
chr14	MEG3	100859790	100859884	0	95	70319	9744	70319	9649	0.0	7.28769820706809
chr14	MEG3	100831015	100831094	981	80	70319	9744	69338	9664	12.2625	7.17487582781457
chr14	MEG3	100857338	100857388	0	51	70319	9744	70319	9693	0.0	7.254616733725369
chr14	MEG3	100835735	100835879	571	145	70319	9744	69748	9599	3.9379310344827587	7.266173559745807
chr14	MEG3	100835738	100835879	550	142	70319	9744	69769	9602	3.8732394366197185	7.266090397833785
chr14	MEG3	100855890	100856268	102	379	70319	9744	70217	9365	0.2691292875989446	7.4978109983982915
chr14	MEG3	100834631	100834751	213	121	70319	9744	70106	9623	1.7603305785123966	7.285254078769614
chr14	MEG3	100836041	100836075	108	35	70319	9744	70211	9709	3.085714285714286	7.2315377484807914
chr14	MEG3	100832511	100832559	23	49	70319	9744	70296	9695	0.46938775510204084	7.25074780814853
chr14	MEG3	100834683	100834751	0	69	70319	9744	70319	9675	0.0	7.268113695090439
chr14	MEG3	100835369	100835549	14800	181	70319	9744	55519	9563	81.76795580110497	5.8056049356896375
chr14	MEG3	100857647	100857797	0	151	70319	9744	70319	9593	0.0	7.330240800583759
chr14	MEG3	100830967	100831094	1611	128	70319	9744	68708	9616	12.5859375	7.145174708818636
chr14	MEG3	100836044	100836075	72	32	70319	9744	70247	9712	2.25	7.233010708401977
chr14	MEG8	100897592	100897732	0	141	12150	24817	12150	24676	0.0	0.4923812611444318
chr14	MEG8	100936177	100936310	0	134	12150	24817	12150	24683	0.0	0.4922416237896528
chr14	MEG8	100977604	100977722	0	119	12150	24817	12150	24698	0.0	0.49194266742246334
chr14	MEG8	100989693	100989780	0	88	12150	24817	12150	24729	0.0	0.491325973553318
chr14	MEG8	100991490	100991565	0	76	12150	24817	12150	24741	0.0	0.49108766824299743
chr14	MEG8	100970735	100970814	0	80	12150	24817	12150	24737	0.0	0.4911670776569511
chr14	MEG8	100999026	100999113	0	88	12150	24817	12150	24729	0.0	0.491325973553318
chr14	MEG8	100977604	100977694	0	91	12150	24817	12150	24726	0.0	0.49138558602281
chr14	MEG9	101071804	101071991	0	188	0	3139	0	2951	0.0	0.0
chr14	PPP2R5C	101883256	101883349	0	94	306	13164	306	13070	0.0	0.0234123947972456
chr14	PPP2R5C	101883431	101883562	0	132	306	13164	306	13032	0.0	0.023480662983425413
chr14	PPP2R5C	101906401	101906529	0	129	306	13164	306	13035	0.0	0.023475258918296892
chr14	PPP2R5C	101917830	101917947	0	118	306	13164	306	13046	0.0	0.023455465276713168
chr14	PPP2R5C	101831700	101831804	0	105	306	13164	306	13059	0.0	0.02343211578221916
chr14	PPP2R5C	101824013	101824169	0	157	306	13164	306	13007	0.0	0.023525793803336664
chr14	PPP2R5C	101909588	101909690	0	103	306	13164	306	13061	0.0	0.02342852767781946
chr14	PPP2R5C	101914174	101914572	0	399	306	13164	306	12765	0.0	0.023971797884841363
chr14	DYNC1H1	102027173	102027288	0	116	108125	31680	108125	31564	0.0	3.425579774426562
chr14	DYNC1H1	102038459	102038606	0	148	108125	31680	108125	31532	0.0	3.4290561968793605
chr14	WDR20	102194937	102195120	0	184	0	7270	0	7086	0.0	0.0
chr14	WDR20	102208602	102209862	0	1261	0	7270	0	6009	0.0	0.0
chr14	WDR20	102197754	102197847	0	94	0	7270	0	7176	0.0	0.0
chr14	WDR20	102193462	102193514	0	53	0	7270	0	7217	0.0	0.0
chr14	WDR20	102193462	102193475	0	14	0	7270	0	7256	0.0	0.0
chr14	ZNF839	102331621	102331846	102	226	11232	5405	11130	5179	0.45132743362831856	2.149063525777177
chr14	ZNF839	102335688	102335838	464	151	11232	5405	10768	5254	3.0728476821192054	2.049486105824134
chr14	ZNF839	102336634	102336719	696	86	11232	5405	10536	5319	8.093023255813954	1.9808234630569657
chr14	RCOR1	102721319	102721377	0	59	62446	6211	62446	6152	0.0	10.150520156046815
chr14	TRAF3	102830333	102830472	612	140	22927	8305	22315	8165	4.371428571428571	2.7330067360685852
chr14	TRAF3	102889559	102889634	0	76	22927	8305	22927	8229	0.0	2.7861222505772267
chr14	TRAF3	102886188	102886269	38	82	22927	8305	22889	8223	0.4634146341463415	2.7835339900279705
chr14	TRAF3	102895072	102895199	0	128	22927	8305	22927	8177	0.0	2.803840039134157
chr14	TRAF3	102891324	102891417	2996	94	22927	8305	19931	8211	31.872340425531913	2.4273535501156984
chr14	EXOC3L4	103102117	103102772	0	656	1245	3142	1245	2486	0.0	0.500804505229284
chr14	EXOC3L4	103104737	103104838	0	102	1245	3142	1245	3040	0.0	0.4095394736842105
chr14	TNFAIP2	103127004	103127629	0	626	3149	3893	3149	3267	0.0	0.9638812366085093
chr14	TNFAIP2	103129739	103129854	0	116	3149	3893	3149	3777	0.0	0.8337304739211014
chr14	TNFAIP2	103133361	103133517	0	157	3149	3893	3149	3736	0.0	0.8428800856531049
chr14	TNFAIP2	103124374	103124506	0	133	3149	3893	3149	3760	0.0	0.8375
chr14	EIF5	103334388	103334597	736	210	36624	6699	35888	6489	3.5047619047619047	5.530590229619356
chr14	EIF5	103336035	103336117	0	83	36624	6699	36624	6616	0.0	5.535671100362757
chr14	MARK3	103405075	103405267	0	193	83139	15808	83139	15615	0.0	5.324303554274736
chr14	MARK3	103428386	103428440	48	55	83139	15808	83091	15753	0.8727272727272727	5.274614359169682
chr14	MARK3	103448918	103448967	0	50	83139	15808	83139	15758	0.0	5.275986800355375
chr14	MARK3	103451917	103451983	0	67	83139	15808	83139	15741	0.0	5.28168477225081
chr14	MARK3	103457141	103457212	0	72	83139	15808	83139	15736	0.0	5.283362989323844
chr14	MARK3	103465556	103465793	0	238	83139	15808	83139	15570	0.0	5.339691714836223
chr14	MARK3	103490951	103491107	0	157	83139	15808	83139	15651	0.0	5.3120567375886525
chr14	MARK3	103500155	103500200	0	46	83139	15808	83139	15762	0.0	5.274647887323944
chr14	MARK3	103441469	103441563	0	95	83139	15808	83139	15713	0.0	5.291096544262713
chr14	MARK3	103411644	103411749	542	106	83139	15808	82597	15702	5.113207547169812	5.260285313972743
chr14	MARK3	103491776	103492034	0	259	83139	15808	83139	15549	0.0	5.34690333783523
chr14	MARK3	103498501	103498528	0	28	83139	15808	83139	15780	0.0	5.268631178707224
chr14	MARK3	103498826	103498901	0	76	83139	15808	83139	15732	0.0	5.284706331045004
chr14	MARK3	103490977	103491107	0	131	83139	15808	83139	15677	0.0	5.303246794667347
chr14	MARK3	103489052	103491107	0	2056	83139	15808	83139	13752	0.0	6.0455933682373475
chr14	MARK3	103487378	103487707	51	330	83139	15808	83088	15478	0.15454545454545454	5.368135418012663
chr14	MARK3	103438020	103438333	14340	314	83139	15808	68799	15494	45.6687898089172	4.440364011875565
chr14	MARK3	103386040	103386080	635	41	83139	15808	82504	15767	15.487804878048781	5.2327012113908795
chr14	MARK3	103438024	103438333	14340	310	83139	15808	68799	15498	46.25806451612903	4.439217963608208
chr14	MARK3	103438184	103438333	14340	150	83139	15808	68799	15658	95.6	4.3938561757568015
chr14	MARK3	103429192	103429373	0	182	83139	15808	83139	15626	0.0	5.320555484448995
chr14	MARK3	103411644	103411765	558	122	83139	15808	82581	15686	4.573770491803279	5.264630881040418
chr14	MARK3	103458726	103458795	0	70	83139	15808	83139	15738	0.0	5.282691574532977
chr14	MARK3	103398950	103399041	33853	92	83139	15808	49286	15716	367.9673913043478	3.136039704759481
chr14	TRMT61A	103529949	103530309	0	361	153	3221	153	2860	0.0	0.0534965034965035
chr14	COA8	103574106	103574170	0	65	721	3927	721	3862	0.0	0.18669083376488865
chr14	KLC1	103684985	103685036	0	52	51	18950	51	18898	0.0	0.0026986982749497303
chr14	COA8	103571622	103571820	49	199	721	3927	672	3728	0.24623115577889448	0.18025751072961374
chr14	COA8	103581568	103581656	0	89	721	3927	721	3838	0.0	0.18785825951016155
chr14	COA8	103563214	103563379	0	166	721	3927	721	3761	0.0	0.1917043339537357
chr14	COA8	103588233	103588283	0	51	721	3927	721	3876	0.0	0.18601651186790505
chr14	COA8	103579370	103579491	0	122	721	3927	721	3805	0.0	0.1894875164257556
chr14	KLC1	103692358	103692425	0	68	51	18950	51	18882	0.0	0.0027009850651414044
chr14	KLC1	103687080	103687211	0	132	51	18950	51	18818	0.0	0.0027101711127643746
chr14	KLC1	103693552	103693634	0	83	51	18950	51	18867	0.0	0.002703132453490221
chr14	ZFYVE21	103728907	103728983	0	77	4	5715	4	5638	0.0	0.000709471443774388
chr14	ZFYVE21	103729792	103729846	0	55	4	5715	4	5660	0.0	0.0007067137809187279
chr14	AL132712.2	103877394	103877595	0	202	1098	1687	1098	1485	0.0	0.7393939393939394
chr14	AL132712.2	103873877	103873946	0	70	1098	1687	1098	1617	0.0	0.6790352504638218
chr14	ASPG	104106798	104106894	48	97	11122	6135	11074	6038	0.4948453608247423	1.8340510102683008
chr14	ASPG	104111501	104111601	0	101	11122	6135	11122	6034	0.0	1.843221743453762
chr14	INF2	104689151	104689245	0	95	51	13399	51	13304	0.0	0.0038334335538184007
chr14	INF2	104703104	104703220	0	117	51	13399	51	13282	0.0	0.003839783165185966
chr14	INF2	104703915	104703949	0	35	51	13399	51	13364	0.0	0.0038162226878180184
chr14	INF2	104706909	104707051	0	143	51	13399	51	13256	0.0	0.003847314423657212
chr14	INF2	104707252	104708002	0	751	51	13399	51	12648	0.0	0.004032258064516129
chr14	INF2	104708670	104708732	0	63	51	13399	51	13336	0.0	0.0038242351529694063
chr14	INF2	104710087	104710188	0	102	51	13399	51	13297	0.0	0.003835451605625329
chr14	INF2	104710936	104711007	0	72	51	13399	51	13327	0.0	0.003826817738425752
chr14	INF2	104711078	104711186	0	109	51	13399	51	13290	0.0	0.003837471783295711
chr14	INF2	104715283	104715340	14	58	51	13399	37	13341	0.2413793103448276	0.0027734052919571248
chr14	INF2	104695989	104696490	0	502	51	13399	51	12897	0.0	0.003954408001860898
chr14	INF2	104711083	104711186	0	104	51	13399	51	13295	0.0	0.0038360285821737493
chr14	INF2	104707847	104708002	0	156	51	13399	51	13243	0.0	0.0038510911424903724
chr14	INF2	104710881	104711007	0	127	51	13399	51	13272	0.0	0.0038426763110307413
chr14	INF2	104710918	104711007	0	90	51	13399	51	13309	0.0	0.0038319933879329775
chr14	INF2	104710936	104711011	0	76	51	13399	51	13323	0.0	0.003827966674172484
chr14	INF2	104717562	104717646	0	85	51	13399	51	13314	0.0	0.0038305543037404238
chr14	INF2	104715832	104716017	0	186	51	13399	51	13213	0.0	0.0038598350109740405
chr14	INF2	104717547	104717646	0	100	51	13399	51	13299	0.0	0.003834874802616738
chr14	SIVA1	104755629	104755824	0	196	0	1662	0	1466	0.0	0.0
chr14	CEP170B	104868423	104868555	0	133	70	7230	70	7097	0.0	0.009863322530646753
chr14	CLBA1	104989631	104989707	0	77	153	5232	153	5155	0.0	0.02967992240543162
chr14	PACS2	105352377	105352467	1906	91	14595	12388	12689	12297	20.945054945054945	1.0318776937464422
chr14	PACS2	105385684	105385717	0	34	14595	12388	14595	12354	0.0	1.1813987372510928
chr14	MTA1	105445417	105445511	0	95	141642	6787	141642	6692	0.0	21.1658696951584
chr14	MTA1	105449358	105449409	0	52	141642	6787	141642	6735	0.0	21.030734966592426
chr14	MTA1	105463183	105463258	1647	76	141642	6787	139995	6711	21.67105263157895	20.860527492177024
chr14	MTA1	105468337	105468349	104	13	141642	6787	141538	6774	8.0	20.894301741954532
chr14	MTA1	105466706	105466742	0	37	141642	6787	141642	6750	0.0	20.984
chr14	MTA1	105445666	105445852	0	187	141642	6787	141642	6600	0.0	21.46090909090909
chr14	CRIP2	105478265	105478360	2828	96	468913	3532	466085	3436	29.458333333333332	135.6475552968568
chr14	AL928654.3	105488662	105488794	0	133	1871	1416	1871	1283	0.0	1.4583008573655496
chr14	AL928654.3	105488662	105488947	0	286	1871	1416	1871	1130	0.0	1.6557522123893806
chr14	AL928654.3	105489258	105489625	408	368	1871	1416	1463	1048	1.108695652173913	1.3959923664122138
chr14	TEDC1	105492578	105492734	0	157	8337	3476	8337	3319	0.0	2.511901175052727
chr14	TEDC1	105493834	105493933	1020	100	8337	3476	7317	3376	10.2	2.1673578199052135
chr14	TEDC1	105495879	105496086	0	208	8337	3476	8337	3268	0.0	2.5511015911872703
chr14	LINC00221	106490382	106491213	0	832	0	4637	0	3805	0.0	0.0
chr14	MED15P1	18914425	18914579	0	155	0	1190	0	1035	0.0	0.0
chr14	POTEG	19409332	19409381	0	50	12	2522	12	2472	0.0	0.0048543689320388345
chr14	POTEG	19426732	19426988	0	257	12	2522	12	2265	0.0	0.005298013245033113
chr14	CCNB1IP1	20329173	20329373	0	201	0	3695	0	3494	0.0	0.0
chr14	CCNB1IP1	20317793	20317974	0	182	0	3695	0	3513	0.0	0.0
chr14	CCNB1IP1	20317794	20317974	0	181	0	3695	0	3514	0.0	0.0
chr14	CCNB1IP1	20318255	20318470	0	216	0	3695	0	3479	0.0	0.0
chr14	CCNB1IP1	20315780	20315850	0	71	0	3695	0	3624	0.0	0.0
chr14	CCNB1IP1	20315484	20315618	0	135	0	3695	0	3560	0.0	0.0
chr14	CCNB1IP1	20320287	20320392	0	106	0	3695	0	3589	0.0	0.0
chr14	TEP1	20372732	20372857	0	126	184	11420	184	11294	0.0	0.016291836373295555
chr14	TEP1	20381552	20381686	36	135	184	11420	148	11285	0.26666666666666666	0.013114754098360656
chr14	RNASE9	20558539	20558650	0	112	0	2714	0	2602	0.0	0.0
chr14	RNASE9	20560336	20560371	0	36	0	2714	0	2678	0.0	0.0
chr14	RNASE9	20559581	20559633	0	53	0	2714	0	2661	0.0	0.0
chr14	RNASE9	20558614	20558650	0	37	0	2714	0	2677	0.0	0.0
chr14	RNASE11	20585026	20585130	0	105	0	1739	0	1634	0.0	0.0
chr14	RNASE1	20802248	20802319	0	72	0	920	0	848	0.0	0.0
chr14	RNASE1	20802248	20802331	0	84	0	920	0	836	0.0	0.0
chr14	NDRG2	21018456	21018504	0	49	153	5997	153	5948	0.0	0.025722932078009415
chr14	NDRG2	21020495	21020582	0	88	153	5997	153	5909	0.0	0.025892706041631408
chr14	NDRG2	21022863	21022905	0	43	153	5997	153	5954	0.0	0.025697010413167617
chr14	NDRG2	21024029	21024096	0	68	153	5997	153	5929	0.0	0.02580536346770113
chr14	NDRG2	21022391	21022497	0	107	153	5997	153	5890	0.0	0.02597623089983022
chr14	NDRG2	21023985	21024096	0	112	153	5997	153	5885	0.0	0.025998300764655907
chr14	NDRG2	21024029	21024139	0	111	153	5997	153	5886	0.0	0.02599388379204893
chr14	NDRG2	21018456	21018471	0	16	153	5997	153	5981	0.0	0.025581006520648722
chr14	NDRG2	21023975	21024096	0	122	153	5997	153	5875	0.0	0.026042553191489362
chr14	ZNF219	21097327	21097412	0	86	0	5150	0	5064	0.0	0.0
chr14	ZNF219	21093428	21093492	0	65	0	5150	0	5085	0.0	0.0
chr14	HNRNPC	21211405	21211566	0	162	612	5164	612	5002	0.0	0.12235105957616953
chr14	HNRNPC	21263310	21263336	0	27	612	5164	612	5137	0.0	0.11913568230484718
chr14	HNRNPC	21263666	21263829	0	164	612	5164	612	5000	0.0	0.1224
chr14	HNRNPC	21211405	21211563	0	159	612	5164	612	5005	0.0	0.12227772227772228
chr14	HNRNPC	21262600	21262768	0	169	612	5164	612	4995	0.0	0.12252252252252252
chr14	HNRNPC	21268622	21268668	0	47	612	5164	612	5117	0.0	0.11960132890365449
chr14	HNRNPC	21236372	21236460	0	89	612	5164	612	5075	0.0	0.1205911330049261
chr14	HNRNPC	21234768	21234831	0	64	612	5164	612	5100	0.0	0.12
chr14	HNRNPC	21254546	21254593	0	48	612	5164	612	5116	0.0	0.11962470680218922
chr14	HNRNPC	21263310	21263582	0	273	612	5164	612	4891	0.0	0.1251277857288898
chr14	SUPT16H	21372468	21372717	0	250	1078	6927	1078	6677	0.0	0.1614497528830313
chr14	CHD8	21391462	21391642	0	181	459	13518	459	13337	0.0	0.03441553572767489
chr14	CHD8	21430800	21431858	0	1059	459	13518	459	12459	0.0	0.036840837948470984
chr14	CHD8	21436900	21436965	0	66	459	13518	459	13452	0.0	0.03412132024977699
chr14	CHD8	21430800	21431643	0	844	459	13518	459	12674	0.0	0.036215875019725424
chr14	CHD8	21431810	21431858	0	49	459	13518	459	13469	0.0	0.0340782537679115
chr14	CHD8	21430800	21431724	0	925	459	13518	459	12593	0.0	0.036448820773445564
chr14	METTL3	21501727	21501903	0	177	0	4373	0	4196	0.0	0.0
chr14	METTL3	21499305	21499371	0	67	0	4373	0	4306	0.0	0.0
chr14	METTL3	21500494	21500682	0	189	0	4373	0	4184	0.0	0.0
chr14	METTL3	21501727	21501824	0	98	0	4373	0	4275	0.0	0.0
chr14	SALL2	21522832	21524931	510	2100	1019	4770	509	2670	0.24285714285714285	0.19063670411985018
chr14	OR10G3	21574825	21574932	0	108	1938	2643	1938	2535	0.0	0.7644970414201183
chr14	AC244502.1	22381843	22381980	0	138	153	8937	153	8799	0.0	0.017388339584043642
chr14	AC244502.1	22427688	22427822	0	135	153	8937	153	8802	0.0	0.017382413087934562
chr14	AC244502.1	22418663	22418935	0	273	153	8937	153	8664	0.0	0.017659279778393353
chr14	DAD1	22575058	22575233	0	176	0	765	0	589	0.0	0.0
chr14	AL160314.2	22764122	22764242	0	121	0	2810	0	2689	0.0	0.0
chr14	AL160314.2	22706278	22706415	0	138	0	2810	0	2672	0.0	0.0
chr14	AL160314.2	22762024	22762143	0	120	0	2810	0	2690	0.0	0.0
chr14	SLC7A7	22774353	22774503	0	151	146	4786	146	4635	0.0	0.03149946062567422
chr14	SLC7A7	22775832	22775936	0	105	146	4786	146	4681	0.0	0.031189916684469132
chr14	SLC7A7	22815313	22815451	0	139	146	4786	146	4647	0.0	0.031418119216698945
chr14	SLC7A7	22815319	22815451	0	133	146	4786	146	4653	0.0	0.03137760584569095
chr14	SLC7A7	22812899	22813440	0	542	146	4786	146	4244	0.0	0.03440150801131008
chr14	SLC7A7	22814694	22814883	0	190	146	4786	146	4596	0.0	0.03176675369886858
chr14	SLC7A7	22821121	22821232	96	112	146	4786	50	4674	0.8571428571428571	0.01069747539580659
chr14	SLC7A7	22819637	22819756	0	120	146	4786	146	4666	0.0	0.031290184312044576
chr14	RBM23	22905605	22905659	0	55	0	12458	0	12403	0.0	0.0
chr14	RBM23	22908332	22908380	0	49	0	12458	0	12409	0.0	0.0
chr14	RBM23	22909482	22909595	0	114	0	12458	0	12344	0.0	0.0
chr14	RBM23	22911327	22911403	0	77	0	12458	0	12381	0.0	0.0
chr14	RBM23	22911785	22911903	0	119	0	12458	0	12339	0.0	0.0
chr14	RBM23	22913723	22913845	0	123	0	12458	0	12335	0.0	0.0
chr14	RBM23	22917027	22917166	0	140	0	12458	0	12318	0.0	0.0
chr14	RBM23	22913723	22913821	0	99	0	12458	0	12359	0.0	0.0
chr14	RBM23	22913914	22914016	0	103	0	12458	0	12355	0.0	0.0
chr14	PRMT5	22927525	22927660	0	136	0	3100	0	2964	0.0	0.0
chr14	PRMT5	22928496	22928615	0	120	0	3100	0	2980	0.0	0.0
chr14	HAUS4	22947867	22948013	0	147	0	2413	0	2266	0.0	0.0
chr14	HAUS4	22951554	22951689	0	136	0	2413	0	2277	0.0	0.0
chr14	HAUS4	22952540	22952683	0	144	0	2413	0	2269	0.0	0.0
chr14	HAUS4	22950313	22950410	0	98	0	2413	0	2315	0.0	0.0
chr14	AJUBA	22975706	22975844	0	139	51	5251	51	5112	0.0	0.009976525821596244
chr14	C14ORF93	23000958	23001037	0	80	0	3210	0	3130	0.0	0.0
chr14	C14ORF93	23000958	23001031	0	74	0	3210	0	3136	0.0	0.0
chr14	C14ORF93	22999956	23000117	0	162	0	3210	0	3048	0.0	0.0
chr14	C14ORF93	23000958	23001060	0	103	0	3210	0	3107	0.0	0.0
chr14	PSMB5	23033367	23033674	920	308	1672	1347	752	1039	2.987012987012987	0.7237728585178056
chr14	PSMB5	23027744	23027829	51	86	1672	1347	1621	1261	0.5930232558139535	1.2854877081681206
chr14	CDH24	23051969	23052083	918	115	9083	3762	8165	3647	7.982608695652174	2.238826432684398
chr14	ACIN1	23067313	23068671	3621	1359	62647	7290	59026	5931	2.664459161147903	9.952116000674422
chr14	ACIN1	23071124	23071186	0	63	62647	7290	62647	7227	0.0	8.668465476684656
chr14	ACIN1	23089981	23090101	0	121	62647	7290	62647	7169	0.0	8.738596735946436
chr14	ACIN1	23076469	23076548	0	80	62647	7290	62647	7210	0.0	8.68890429958391
chr14	LMLN2	23101291	23101564	0	274	0	2784	0	2510	0.0	0.0
chr14	LMLN2	23102925	23103051	0	127	0	2784	0	2657	0.0	0.0
chr14	SLC7A8	23140470	23140624	0	155	0	4274	0	4119	0.0	0.0
chr14	PPP1R3E	23300106	23300325	10298	220	137241	4258	126943	4038	46.80909090909091	31.43709757305597
chr14	PPP1R3E	23300106	23300139	1106	34	137241	4258	136135	4224	32.529411764705884	32.22892992424242
chr14	SLC22A17	23347890	23347996	6636	107	390628	4288	383992	4181	62.018691588785046	91.84214302798374
chr14	SLC22A17	23351751	23351855	0	105	390628	4288	390628	4183	0.0	93.38465216351901
chr14	EFS	23360554	23360833	51	280	4507	3242	4456	2962	0.18214285714285713	1.5043889264010804
chr14	AP1G2	23561961	23562066	0	106	328187	5143	328187	5037	0.0	65.15525114155251
chr14	AP1G2	23565815	23565892	2057	78	328187	5143	326130	5065	26.371794871794872	64.38894373149063
chr14	AP1G2	23566561	23566686	8961	126	328187	5143	319226	5017	71.11904761904762	63.62886186964321
chr14	JPH4	23577868	23577994	0	127	8803	5305	8803	5178	0.0	1.7000772499034376
chr14	AL160237.1	23729276	23729424	0	149	203	2800	203	2651	0.0	0.07657487740475293
chr14	AL160237.1	23715257	23715436	0	180	203	2800	203	2620	0.0	0.07748091603053435
chr14	DHRS4-AS1	23953773	23954033	255	261	34949	7706	34694	7445	0.9770114942528736	4.660040295500336
chr14	DHRS4-AS1	23953308	23953419	0	112	34949	7706	34949	7594	0.0	4.602185936265473
chr14	NRL	24084519	24084745	0	227	3316	4561	3316	4334	0.0	0.7651130595293032
chr14	PSME2	24143974	24144029	0	56	0	2984	0	2928	0.0	0.0
chr14	PSME2	24146207	24146240	0	34	0	2984	0	2950	0.0	0.0
chr14	IPO4	24181512	24181617	0	106	556	4634	556	4528	0.0	0.12279151943462897
chr14	IPO4	24184866	24184980	0	115	556	4634	556	4519	0.0	0.123036069926975
chr14	IPO4	24187666	24187796	0	131	556	4634	556	4503	0.0	0.12347324006218077
chr14	IPO4	24187666	24187813	0	148	556	4634	556	4486	0.0	0.12394115024520731
chr14	MDP1	24214309	24214395	0	87	0	1029	0	942	0.0	0.0
chr14	NEDD8	24217185	24217223	0	39	102	3793	102	3754	0.0	0.02717101758124667
chr14	MDP1	24215736	24215797	0	62	0	1029	0	967	0.0	0.0
chr14	TINF2	24241203	24241311	0	109	0	2610	0	2501	0.0	0.0
chr14	TINF2	24241889	24241994	0	106	0	2610	0	2504	0.0	0.0
chr14	TINF2	24241019	24241116	0	98	0	2610	0	2512	0.0	0.0
chr14	TINF2	24241889	24241921	0	33	0	2610	0	2577	0.0	0.0
chr14	TGM1	24263088	24263192	0	105	0	3450	0	3345	0.0	0.0
chr14	RABGGTA	24270836	24270947	0	112	0	3090	0	2978	0.0	0.0
chr14	RABGGTA	24271112	24271169	0	58	0	3090	0	3032	0.0	0.0
chr14	RABGGTA	24266664	24266683	0	20	0	3090	0	3070	0.0	0.0
chr14	RABGGTA	24271112	24271248	0	137	0	3090	0	2953	0.0	0.0
chr14	DHRS1	24291555	24291625	0	71	0	4668	0	4597	0.0	0.0
chr14	DHRS1	24292651	24292784	0	134	0	4668	0	4534	0.0	0.0
chr14	CIDEB	24305946	24306137	256	192	256	3127	0	2935	1.3333333333333333	0.0
chr14	CIDEB	24310406	24310548	0	143	256	3127	256	2984	0.0	0.08579088471849866
chr14	ADCY4	24330167	24330295	0	129	0	7362	0	7233	0.0	0.0
chr14	ADCY4	24334493	24334678	0	186	0	7362	0	7176	0.0	0.0
chr14	ADCY4	24334493	24334682	0	190	0	7362	0	7172	0.0	0.0
chr14	ADCY4	24330167	24330327	0	161	0	7362	0	7201	0.0	0.0
chr14	ADCY4	24334493	24334635	0	143	0	7362	0	7219	0.0	0.0
chr14	SDR39U1	24441673	24441795	0	123	564	2120	564	1997	0.0	0.2824236354531798
chr14	SDR39U1	24442177	24442260	23	84	564	2120	541	2036	0.27380952380952384	0.26571709233791746
chr14	SDR39U1	24442097	24442260	513	164	564	2120	51	1956	3.1280487804878048	0.02607361963190184
chr14	SDR39U1	24442108	24442260	282	153	564	2120	282	1967	1.8431372549019607	0.14336553126588714
chr14	SDR39U1	24441677	24441795	0	119	564	2120	564	2001	0.0	0.2818590704647676
chr14	CMA1	24507355	24507506	0	152	0	942	0	790	0.0	0.0
chr14	GZMH	24607148	24607406	108961	259	629689	956	520728	697	420.6988416988417	747.0989956958393
chr14	GZMB	24632323	24632459	7338	137	53508	1418	46170	1281	53.56204379562044	36.04215456674473
chr14	GZMB	24632718	24632719	30	2	53508	1418	53478	1416	15.0	37.766949152542374
chr14	GZMB	24632914	24633062	583	149	53508	1418	52925	1269	3.912751677852349	41.70606776989756
chr14	GZMB	24633909	24634016	12624	108	53508	1418	40884	1310	116.88888888888889	31.209160305343513
chr14	STXBP6	25010524	25010640	0	117	7213	8079	7213	7962	0.0	0.9059281587540818
chr14	STXBP6	24994863	24994984	0	122	7213	8079	7213	7957	0.0	0.9064974236521302
chr14	STXBP6	24878651	24878813	700	163	7213	8079	6513	7916	4.294478527607362	0.8227640222334512
chr14	STXBP6	24987885	24987972	0	88	7213	8079	7213	7991	0.0	0.9026404705293455
chr14	LINC02286	25128208	25128288	0	81	0	1011	0	930	0.0	0.0
chr14	LINC02306	26127481	26127732	0	252	79	3603	79	3351	0.0	0.02357505222321695
chr14	NOVA1	26472319	26472391	0	73	0	10340	0	10267	0.0	0.0
chr14	NOVA1	26549679	26549781	0	103	0	10340	0	10237	0.0	0.0
chr14	NOVA1	26568419	26568465	0	47	0	10340	0	10293	0.0	0.0
chr14	AL133166.1	29307380	29307470	0	91	7769	11324	7769	11233	0.0	0.6916228968218642
chr14	AL133166.1	29346444	29346525	0	82	7769	11324	7769	11242	0.0	0.691069204767835
chr14	AL133166.1	29379990	29380059	0	70	7769	11324	7769	11254	0.0	0.6903323262839879
chr14	PRKD1	29724469	29724545	0	77	18	5242	18	5165	0.0	0.0034849951597289448
chr14	PRKD1	29656475	29656499	0	25	18	5242	18	5217	0.0	0.0034502587694077054
chr14	PRKD1	29657576	29657697	0	122	18	5242	18	5120	0.0	0.003515625
chr14	STRN3	30913523	30913657	0	135	0	4985	0	4850	0.0	0.0
chr14	STRN3	30918965	30919106	0	142	0	4985	0	4843	0.0	0.0
chr14	STRN3	30929200	30929311	0	112	0	4985	0	4873	0.0	0.0
chr14	HECTD1	31128611	31129448	0	838	48561	11639	48561	10801	0.0	4.49597259513008
chr14	HECTD1	31128611	31129307	0	697	48561	11639	48561	10942	0.0	4.438036921952111
chr14	HECTD1	31123515	31123624	16	110	48561	11639	48545	11529	0.14545454545454545	4.210686095931997
chr14	HEATR5A	31302294	31302519	0	226	129177	10252	129177	10026	0.0	12.884201077199283
chr14	HEATR5A	31340449	31340476	0	28	129177	10252	129177	10224	0.0	12.63468309859155
chr14	HEATR5A	31402849	31403049	0	201	129177	10252	129177	10051	0.0	12.852154014525917
chr14	EGLN3	34199486	34199820	0	335	0	4709	0	4374	0.0	0.0
chr14	SNX6	34581560	34581600	0	41	102	4099	102	4058	0.0	0.025135534746180386
chr14	SNX6	34608029	34608140	0	112	102	4099	102	3987	0.0	0.025583145221971408
chr14	SNX6	34604134	34604268	0	135	102	4099	102	3964	0.0	0.025731584258324926
chr14	SNX6	34604134	34604174	0	41	102	4099	102	4058	0.0	0.025135534746180386
chr14	CFL2	34713673	34713904	0	232	0	4948	0	4716	0.0	0.0
chr14	BAZ1A	34758703	34758846	0	144	0	7728	0	7584	0.0	0.0
chr14	BAZ1A	34786125	34786221	0	97	0	7728	0	7631	0.0	0.0
chr14	BAZ1A	34768689	34768780	0	92	0	7728	0	7636	0.0	0.0
chr14	BAZ1A	34816714	34816856	0	143	0	7728	0	7585	0.0	0.0
chr14	SRP54-AS1	34965560	34965682	0	123	110	1535	110	1412	0.0	0.07790368271954674
chr14	SRP54-AS1	34971941	34972213	0	273	110	1535	110	1262	0.0	0.08716323296354993
chr14	PPP2R3C	35107303	35107374	0	72	62821	3757	62821	3685	0.0	17.04776119402985
chr14	PPP2R3C	35109818	35109931	0	114	62821	3757	62821	3643	0.0	17.244304144935494
chr14	PPP2R3C	35091069	35091207	342	139	62821	3757	62479	3618	2.460431654676259	17.268933112216693
chr14	PPP2R3C	35095047	35095184	3043	138	62821	3757	59778	3619	22.05072463768116	16.517822602928987
chr14	PPP2R3C	35116609	35116737	115	129	62821	3757	62706	3628	0.8914728682170543	17.283902976846747
chr14	PPP2R3C	35109847	35109931	0	85	62821	3757	62821	3672	0.0	17.108115468409586
chr14	PPP2R3C	35109818	35109901	0	84	62821	3757	62821	3673	0.0	17.10345766403485
chr14	PPP2R3C	35109818	35109847	0	30	62821	3757	62821	3727	0.0	16.855647974242018
chr14	PPP2R3C	35117073	35117176	168	104	62821	3757	62653	3653	1.6153846153846154	17.15110867779907
chr14	NFKBIA	35402770	35402859	0	90	1269	2170	1269	2080	0.0	0.6100961538461539
chr14	NFKBIA	35403689	35403798	0	110	1269	2170	1269	2060	0.0	0.6160194174757282
chr14	RALGAPA1	35541739	35541804	0	66	16038	14305	16038	14239	0.0	1.126343142074584
chr14	RALGAPA1	35548507	35548538	9	32	16038	14305	16029	14273	0.28125	1.123029496251664
chr14	RALGAPA1	35542026	35542029	0	4	16038	14305	16038	14301	0.0	1.1214600377595971
chr14	RALGAPA1	35700161	35700302	0	142	16038	14305	16038	14163	0.0	1.1323872061004026
chr14	MBIP	36308091	36308189	25	99	2435	3431	2410	3332	0.25252525252525254	0.7232893157262905
chr14	MBIP	36316692	36316812	0	121	2435	3431	2435	3310	0.0	0.7356495468277946
chr14	MBIP	36305088	36305304	0	217	2435	3431	2435	3214	0.0	0.7576228998133168
chr14	NKX2-1	36519467	36519612	0	146	0	3073	0	2927	0.0	0.0
chr14	FOXA1	37594075	37594176	0	102	0	4217	0	4115	0.0	0.0
chr14	LINC00639	38761109	38761253	0	145	0	9470	0	9325	0.0	0.0
chr14	LINC00639	38762101	38762174	0	74	0	9470	0	9396	0.0	0.0
chr14	LINC00639	38762923	38763045	0	123	0	9470	0	9347	0.0	0.0
chr14	LINC00639	38760181	38760248	0	68	0	9470	0	9402	0.0	0.0
chr14	LINC00639	38890740	38890798	0	59	0	9470	0	9411	0.0	0.0
chr14	LINC00639	38916781	38916882	0	102	0	9470	0	9368	0.0	0.0
chr14	LINC00639	38941519	38941695	0	177	0	9470	0	9293	0.0	0.0
chr14	LINC00639	38941353	38941373	0	21	0	9470	0	9449	0.0	0.0
chr14	LINC00639	38946691	38946882	0	192	0	9470	0	9278	0.0	0.0
chr14	SEC23A	39092540	39092627	0	88	51	7049	51	6961	0.0	0.00732653354403103
chr14	SEC23A	39103031	39103228	0	198	51	7049	51	6851	0.0	0.007444168734491315
chr14	TRAPPC6B	39154210	39154294	0	85	0	4538	0	4453	0.0	0.0
chr14	AL121821.2	41597199	41597266	0	68	0	4936	0	4868	0.0	0.0
chr14	KLHL28	44953622	44953709	0	88	0	7833	0	7745	0.0	0.0
chr14	KLHL28	44959340	44959514	0	175	0	7833	0	7658	0.0	0.0
chr14	FKBP3	45133322	45133439	0	118	204	2272	204	2154	0.0	0.0947075208913649
chr14	MIS18BP1	45235813	45235944	0	132	258	6270	258	6138	0.0	0.042033235581622676
chr14	MIS18BP1	45232508	45232627	0	120	258	6270	258	6150	0.0	0.041951219512195125
chr14	MIS18BP1	45250030	45250138	0	109	258	6270	258	6161	0.0	0.04187631877941893
chr14	LINC02303	45707835	45707898	29	64	4036	1149	4007	1085	0.453125	3.6930875576036866
chr14	LINC02303	45714283	45714431	74	149	4036	1149	3962	1000	0.4966442953020134	3.962
chr14	LINC02303	45711898	45711953	0	56	4036	1149	4036	1093	0.0	3.6925892040256176
chr14	MDGA2	46877488	46877509	0	22	0	8746	0	8724	0.0	0.0
chr14	LINC00648	47768830	47768910	0	81	0	1389	0	1308	0.0	0.0
chr14	RPS29	49586284	49586478	0	195	0	8593	0	8398	0.0	0.0
chr14	DNAAF2	49628011	49628155	0	145	51	2980	51	2835	0.0	0.01798941798941799
chr14	POLE2	49647292	49647360	0	69	0	2976	0	2907	0.0	0.0
chr14	POLE2	49654783	49654838	0	56	0	2976	0	2920	0.0	0.0
chr14	POLE2	49674349	49674427	0	79	0	2976	0	2897	0.0	0.0
chr14	NEMF	49813987	49814050	0	64	10654	8972	10654	8908	0.0	1.1960035922766052
chr14	NEMF	49833422	49833496	0	75	10654	8972	10654	8897	0.0	1.1974822974036192
chr14	NEMF	49840717	49840866	10557	150	10654	8972	97	8822	70.38	0.010995239174790297
chr14	NEMF	49846139	49846265	0	127	10654	8972	10654	8845	0.0	1.2045223289994347
chr14	LINC01588	50047466	50047589	0	124	284004	13032	284004	12908	0.0	22.002169197396963
chr14	LINC01588	50002748	50002987	0	240	284004	13032	284004	12792	0.0	22.201688555347094
chr14	LINC01588	49999926	50000058	0	133	284004	13032	284004	12899	0.0	22.017520738041707
chr14	LINC01588	50010605	50010685	0	81	284004	13032	284004	12951	0.0	21.92911744266852
chr14	VCPKMT	50112614	50112719	2294	106	40874	2061	38580	1955	21.641509433962263	19.734015345268542
chr14	SOS2	50174453	50174552	0	100	45236	6973	45236	6873	0.0	6.581696493525389
chr14	SOS2	50188496	50188700	0	205	45236	6973	45236	6768	0.0	6.683806146572104
chr14	SOS2	50215373	50215432	6	60	45236	6973	45230	6913	0.1	6.5427455518588165
chr14	L2HGDH	50293204	50293283	0	80	180455	3357	180455	3277	0.0	55.06713457430577
chr14	L2HGDH	50311369	50311433	0	65	180455	3357	180455	3292	0.0	54.81622114216282
chr14	CDKL1	50332261	50332432	0	172	117294	6021	117294	5849	0.0	20.0536843904941
chr14	SAV1	50640749	50640893	0	145	4790	5612	4790	5467	0.0	0.8761660874336931
chr14	SAV1	50667381	50667500	0	120	4790	5612	4790	5492	0.0	0.872177713037145
chr14	NIN	50756491	50758630	1580	2140	31969	13565	30389	11425	0.7383177570093458	2.659868708971554
chr14	NIN	50766306	50766396	0	91	31969	13565	31969	13474	0.0	2.3726436099153925
chr14	NIN	50730922	50730983	153	62	31969	13565	31816	13503	2.467741935483871	2.3562171369325333
chr14	NIN	50792459	50792513	5923	55	31969	13565	26046	13510	107.69090909090909	1.9279052553663953
chr14	NIN	50806207	50806276	0	70	31969	13565	31969	13495	0.0	2.368951463505002
chr14	NIN	50794435	50794525	7090	91	31969	13565	24879	13474	77.91208791208791	1.8464450051951908
chr14	PYGL	50937735	50937837	0	103	29147	4567	29147	4464	0.0	6.5293458781362
chr14	NID2	52027200	52027344	0	145	102	6413	102	6268	0.0	0.016273133375877474
chr14	TXNDC16	52462811	52462970	0	160	1495	4755	1495	4595	0.0	0.3253536452665941
chr14	ERO1A	52646153	52646287	0	135	136	7564	136	7429	0.0	0.018306636155606407
chr14	ERO1A	52683787	52683907	0	121	136	7564	136	7443	0.0	0.018272202069058177
chr14	GNPNAT1	52784496	52784664	0	169	260	2721	260	2552	0.0	0.10188087774294671
chr14	GNPNAT1	52784496	52784654	0	159	260	2721	260	2562	0.0	0.1014832162373146
chr14	GNPNAT1	52787832	52787871	0	40	260	2721	260	2681	0.0	0.0969787392763894
chr14	FERMT2	52861013	52861034	0	22	0	6261	0	6239	0.0	0.0
chr14	FERMT2	52881795	52881828	0	34	0	6261	0	6227	0.0	0.0
chr14	FERMT2	52861586	52861610	0	25	0	6261	0	6236	0.0	0.0
chr14	FERMT2	52948561	52948580	0	20	0	6261	0	6241	0.0	0.0
chr14	DDHD1	53051843	53051927	234	85	33344	16629	33110	16544	2.7529411764705882	2.0013297872340425
chr14	DDHD1	53058476	53058626	0	151	33344	16629	33344	16478	0.0	2.023546546911033
chr14	DDHD1	53103030	53103051	293	22	33344	16629	33051	16607	13.318181818181818	1.9901848618052629
chr14	DDHD1	53096116	53096218	0	103	33344	16629	33344	16526	0.0	2.017669127435556
chr14	CNIH1	54430260	54430404	0	145	26	5026	26	4881	0.0	0.005326777299733661
chr14	CNIH1	54432107	54432220	0	114	26	5026	26	4912	0.0	0.005293159609120521
chr14	CNIH1	54436368	54436437	0	70	26	5026	26	4956	0.0	0.005246166263115416
chr14	CNIH1	54436078	54436126	0	49	26	5026	26	4977	0.0	0.005224030540486237
chr14	CNIH1	54436669	54436785	26	117	26	5026	0	4909	0.2222222222222222	0.0
chr14	GMFB	54482152	54482202	0	51	215	5165	215	5114	0.0	0.04204145482987876
chr14	GCH1	54844000	54844143	0	144	740	2205	740	2061	0.0	0.35904900533721495
chr14	GCH1	54843781	54843869	0	89	740	2205	740	2116	0.0	0.3497164461247637
chr14	WDHD1	54989027	54989212	1924	186	80252	6411	78328	6225	10.344086021505376	12.58281124497992
chr14	WDHD1	55026710	55026803	0	94	80252	6411	80252	6317	0.0	12.704131708089283
chr14	DLGAP5	55148593	55148684	0	92	624	3618	624	3526	0.0	0.17697107203630175
chr14	DLGAP5	55191068	55191176	0	109	624	3618	624	3509	0.0	0.17782844115132515
chr14	TBPL2	55438794	55438905	0	112	867	2416	867	2304	0.0	0.3763020833333333
chr14	KTN1-AS1	55578605	55578737	0	133	73864	8122	73864	7989	0.0	9.245712855175867
chr14	LINC00520	55794283	55794345	0	63	32	2977	32	2914	0.0	0.01098146877144818
chr14	LINC00520	55793045	55793110	32	66	32	2977	0	2911	0.48484848484848486	0.0
chr14	OTX2	56804187	56804339	0	153	0	2555	0	2402	0.0	0.0
chr14	OTX2	56804187	56804363	0	177	0	2555	0	2378	0.0	0.0
chr14	OTX2	56806703	56806723	0	21	0	2555	0	2534	0.0	0.0
chr14	AL161757.4	56881393	56881455	0	63	0	2256	0	2193	0.0	0.0
chr14	AL137100.3	56967911	56967965	0	55	1554	4378	1554	4323	0.0	0.35947258848022207
chr14	EXOC5	57244164	57244359	0	196	102	12071	102	11875	0.0	0.008589473684210527
chr14	CCDC198	57475581	57475704	0	124	0	4116	0	3992	0.0	0.0
chr14	SLC35F4	57580438	57580539	51	102	51	4288	0	4186	0.5	0.0
chr14	PSMA3-AS1	58285590	58285756	0	167	0	6704	0	6537	0.0	0.0
chr14	PSMA3-AS1	58293765	58295811	0	2047	0	6704	0	4657	0.0	0.0
chr14	PSMA3-AS1	58293065	58293138	0	74	0	6704	0	6630	0.0	0.0
chr14	PSMA3-AS1	58293313	58293544	0	232	0	6704	0	6472	0.0	0.0
chr14	PSMA3-AS1	58288717	58288813	0	97	0	6704	0	6607	0.0	0.0
chr14	TIMM9	58411906	58411971	0	66	0	1038	0	972	0.0	0.0
chr14	TIMM9	58424007	58424095	0	89	0	1038	0	949	0.0	0.0
chr14	TIMM9	58423827	58423849	0	23	0	1038	0	1015	0.0	0.0
chr14	CCDC175	59545162	59545299	0	138	437	3037	437	2899	0.0	0.1507416350465678
chr14	RTN1	59605367	59605506	0	140	102	4362	102	4222	0.0	0.024159166271909047
chr14	RTN1	59610121	59610232	0	112	102	4362	102	4250	0.0	0.024
chr14	DHRS7	60152938	60153178	0	241	0	3008	0	2767	0.0	0.0
chr14	DHRS7	60165176	60165605	0	430	0	3008	0	2578	0.0	0.0
chr14	C14ORF39	60485029	60485086	0	58	168	3454	168	3396	0.0	0.04946996466431095
chr14	AL355916.2	61542622	61542717	0	96	17820	4009	17820	3913	0.0	4.5540506005622285
chr14	AL355916.2	61538972	61539187	805	216	17820	4009	17015	3793	3.7268518518518516	4.485895069865542
chr14	KCNH5	62779727	62779924	0	198	44	12326	44	12128	0.0	0.0036279683377308707
chr14	PPP2R5E	63453688	63453885	0	198	102	6784	102	6586	0.0	0.01548739750986942
chr14	ESR2	64249545	64249679	0	135	1140	7242	1140	7107	0.0	0.16040523427606584
chr14	ESR2	64257225	64257364	0	140	1140	7242	1140	7102	0.0	0.16051816389749365
chr14	ESR2	64279980	64280153	0	174	1140	7242	1140	7068	0.0	0.16129032258064516
chr14	TEX21P	64353952	64354074	0	123	204	3094	204	2971	0.0	0.06866374957926624
chr14	TEX21P	64354000	64354074	0	75	204	3094	204	3019	0.0	0.06757204372308712
chr14	TEX21P	64358768	64358859	0	92	204	3094	204	3002	0.0	0.06795469686875416
chr14	TEX21P	64375237	64375386	0	150	204	3094	204	2944	0.0	0.06929347826086957
chr14	ZBTB25	64487113	64487196	0	84	311	3167	311	3083	0.0	0.10087577035355173
chr14	SPTB	64752210	64752315	0	106	5537	14834	5537	14728	0.0	0.3759505703422053
chr14	GPX2	64939992	64940198	8	207	1436	1444	1428	1237	0.03864734299516908	1.154405820533549
chr14	GPX2	64941316	64941521	0	206	1436	1444	1436	1238	0.0	1.1599353796445881
chr14	RAB15	64957939	64958159	0	221	61330	4909	61330	4688	0.0	13.082337883959044
chr14	RAB15	64971952	64972100	0	149	61330	4909	61330	4760	0.0	12.884453781512605
chr14	MAX	65101545	65101572	0	28	102	5511	102	5483	0.0	0.018602954586904977
chr14	MAX	65077327	65077428	0	102	102	5511	102	5409	0.0	0.018857459789240156
chr14	MAX	65093707	65093815	0	109	102	5511	102	5402	0.0	0.01888189559422436
chr14	MAX	65077343	65077428	0	86	102	5511	102	5425	0.0	0.018801843317972352
chr14	MAX	65077562	65077643	0	82	102	5511	102	5429	0.0	0.018787990421808804
chr14	AL359232.1	66504874	66504990	0	117	2028	6071	2028	5954	0.0	0.3406113537117904
chr14	ATP6V1D	67343371	67343438	0	68	0	3686	0	3618	0.0	0.0
chr14	ATP6V1D	67349036	67349104	0	69	0	3686	0	3617	0.0	0.0
chr14	ATP6V1D	67352922	67353040	0	119	0	3686	0	3567	0.0	0.0
chr14	ATP6V1D	67340439	67340518	0	80	0	3686	0	3606	0.0	0.0
chr14	ATP6V1D	67353698	67353959	0	262	0	3686	0	3424	0.0	0.0
chr14	PLEK2	67390662	67390746	0	85	0	1579	0	1494	0.0	0.0
chr14	PLEK2	67392325	67392427	0	103	0	1579	0	1476	0.0	0.0
chr14	PLEK2	67395401	67395583	0	183	0	1579	0	1396	0.0	0.0
chr14	TMEM229B	67503486	67503551	0	66	1476	6390	1476	6324	0.0	0.2333965844402277
chr14	PIGH	67592634	67592718	0	85	0	2424	0	2339	0.0	0.0
chr14	PIGH	67592314	67592436	0	123	0	2424	0	2301	0.0	0.0
chr14	PIGH	67592634	67592715	0	82	0	2424	0	2342	0.0	0.0
chr14	VTI1B	67653436	67653498	0	63	78634	5775	78634	5712	0.0	13.766456582633053
chr14	AL049779.1	67662476	67662535	0	60	0	809	0	749	0.0	0.0
chr14	AL049779.1	67663028	67663190	0	163	0	809	0	646	0.0	0.0
chr14	RDH11	67685014	67685204	0	191	51	3089	51	2898	0.0	0.017598343685300208
chr14	RDH11	67690211	67690421	0	211	51	3089	51	2878	0.0	0.017720639332870047
chr14	RDH11	67692437	67692593	0	157	51	3089	51	2932	0.0	0.017394270122783082
chr14	RDH11	67692933	67693052	51	120	51	3089	0	2969	0.425	0.0
chr14	RDH11	67692972	67693052	39	81	51	3089	12	3008	0.48148148148148145	0.003989361702127659
chr14	RDH11	67691139	67691244	0	106	51	3089	51	2983	0.0	0.01709688233322159
chr14	ZFYVE26	67802078	67802282	9438	205	68756	15344	59318	15139	46.0390243902439	3.918224453398507
chr14	ZFYVE26	67805216	67805305	19062	90	68756	15344	49694	15254	211.8	3.2577684541759537
chr14	ZFYVE26	67804100	67804264	729	165	68756	15344	68027	15179	4.418181818181818	4.481652282759075
chr14	ZFYVE26	67805901	67806018	0	118	68756	15344	68756	15226	0.0	4.515696834362275
chr14	ZFP36L1	68792881	68793070	0	190	1938	4219	1938	4029	0.0	0.4810126582278481
chr14	ACTN1	68878457	68878523	0	67	2737	9387	2737	9320	0.0	0.2936695278969957
chr14	ACTN1	68878988	68879069	0	82	2737	9387	2737	9305	0.0	0.29414293390650187
chr14	ACTN1	68882872	68883055	0	184	2737	9387	2737	9203	0.0	0.2974030207541019
chr14	DCAF5	69062383	69062511	1066	129	2082	8307	1016	8178	8.263565891472869	0.12423575446319393
chr14	DCAF5	69122216	69122360	0	145	2082	8307	2082	8162	0.0	0.25508453810340603
chr14	ERH	69386962	69387083	0	122	0	1117	0	995	0.0	0.0
chr14	ERH	69394824	69394912	0	89	0	1117	0	1028	0.0	0.0
chr14	SLC8A3	70060835	70060939	0	105	101	8457	101	8352	0.0	0.012092911877394636
chr14	SLC8A3	70055795	70055813	0	19	101	8457	101	8438	0.0	0.01196966105712254
chr14	COX16	70342657	70342729	0	73	0	1924	0	1851	0.0	0.0
chr14	SYNJ2BP-COX16	70388469	70388606	0	138	0	1412	0	1274	0.0	0.0
chr14	SYNJ2BP-COX16	70373032	70373131	0	100	0	1412	0	1312	0.0	0.0
chr14	MED6	70591265	70591381	0	117	0	3828	0	3711	0.0	0.0
chr14	MAP3K9	70733756	70733798	0	43	38782	12402	38782	12359	0.0	3.1379561453192006
chr14	MAP3K9	70735960	70736029	0	70	38782	12402	38782	12332	0.0	3.1448264677262405
chr14	MAP3K9	70765441	70765487	0	47	38782	12402	38782	12355	0.0	3.1389720760825575
chr14	DPF3	72879803	72879947	102	145	102	6912	0	6767	0.7034482758620689	0.0
chr14	ZFYVE1	72978136	72978234	0	99	51	5233	51	5134	0.0	0.009933774834437087
chr14	NUMB	73284080	73284374	0	295	5990	8593	5990	8298	0.0	0.7218606893227284
chr14	NUMB	73323129	73323204	0	76	5990	8593	5990	8517	0.0	0.7032992837853704
chr14	NUMB	73366896	73366981	0	86	5990	8593	5990	8507	0.0	0.7041260138709298
chr14	NUMB	73279280	73279424	0	145	5990	8593	5990	8448	0.0	0.7090435606060606
chr14	NUMB	73316389	73316422	0	34	5990	8593	5990	8559	0.0	0.6998481130973244
chr14	NUMB	73457628	73457733	0	106	5990	8593	5990	8487	0.0	0.7057853187227524
chr14	NUMB	73282358	73282505	0	148	5990	8593	5990	8445	0.0	0.709295441089402
chr14	AC005280.2	73459033	73459305	3573	273	5112	1417	1539	1144	13.087912087912088	1.3452797202797202
chr14	HEATR4	73530165	73530244	0	80	510	4197	510	4117	0.0	0.1238766091814428
chr14	HEATR4	73527228	73527397	0	170	510	4197	510	4027	0.0	0.12664514526943133
chr14	MIDEAS	73730069	73730179	0	111	23457	7346	23457	7235	0.0	3.242156185210781
chr14	ENTPD5	74007695	74007812	0	118	114290	8498	114290	8380	0.0	13.638424821002387
chr14	ALDH6A1	74072536	74072611	0	76	40563	6675	40563	6599	0.0	6.146840430368238
chr14	ABCD4	74290026	74290118	0	93	102	8153	102	8060	0.0	0.012655086848635236
chr14	ABCD4	74293153	74293248	0	96	102	8153	102	8057	0.0	0.012659798932605187
chr14	ABCD4	74295147	74295198	0	52	102	8153	102	8101	0.0	0.012591038143439082
chr14	ABCD4	74295853	74295979	0	127	102	8153	102	8026	0.0	0.01270869673560927
chr14	ABCD4	74297929	74298069	0	141	102	8153	102	8012	0.0	0.0127309036445332
chr14	ABCD4	74299547	74299675	0	129	102	8153	102	8024	0.0	0.012711864406779662
chr14	ABCD4	74300149	74300268	0	120	102	8153	102	8033	0.0	0.012697622307979585
chr14	ABCD4	74293153	74293279	0	127	102	8153	102	8026	0.0	0.01270869673560927
chr14	ABCD4	74293153	74293310	0	158	102	8153	102	7995	0.0	0.01275797373358349
chr14	ABCD4	74297638	74298069	0	432	102	8153	102	7721	0.0	0.013210723999481932
chr14	NPC2	74484414	74484587	0	174	10930	2591	10930	2417	0.0	4.522134877947869
chr14	NPC2	74480701	74480779	0	79	10930	2591	10930	2512	0.0	4.351114649681529
chr14	NPC2	74480710	74480779	0	70	10930	2591	10930	2521	0.0	4.335581118603729
chr14	NPC2	74480685	74480779	0	95	10930	2591	10930	2496	0.0	4.379006410256411
chr14	LTBP2	74507178	74507310	489	133	23804	9114	23315	8981	3.6766917293233083	2.5960360761607837
chr14	LTBP2	74507972	74508095	0	124	23804	9114	23804	8990	0.0	2.6478309232480535
chr14	AREL1	74663511	74663822	0	312	11649	7250	11649	6938	0.0	1.6790141251081003
chr14	AREL1	74670761	74670871	0	111	11649	7250	11649	7139	0.0	1.6317411402157165
chr14	AREL1	74683295	74683533	0	239	11649	7250	11649	7011	0.0	1.6615318784766795
chr14	AREL1	74684453	74684680	0	228	11649	7250	11649	7022	0.0	1.6589290800341783
chr14	AREL1	74692040	74692328	0	289	11649	7250	11649	6961	0.0	1.67346645596897
chr14	AREL1	74671968	74672020	0	53	11649	7250	11649	7197	0.0	1.6185910796165068
chr14	AREL1	74678178	74678329	0	152	11649	7250	11649	7098	0.0	1.6411665257819104
chr14	PROX2	74865255	74865332	0	78	0	4834	0	4756	0.0	0.0
chr14	RPS6KL1	74907434	74907530	0	97	171	4369	171	4272	0.0	0.04002808988764045
chr14	RPS6KL1	74909542	74910148	0	607	171	4369	171	3762	0.0	0.045454545454545456
chr14	RPS6KL1	74918512	74918605	0	94	171	4369	171	4275	0.0	0.04
chr14	RPS6KL1	74921977	74922485	102	509	171	4369	69	3860	0.20039292730844793	0.017875647668393783
chr14	RPS6KL1	74922340	74922485	0	146	171	4369	171	4223	0.0	0.040492540847738574
chr14	RPS6KL1	74921977	74922442	102	466	171	4369	69	3903	0.21888412017167383	0.017678708685626442
chr14	PGF	74946212	74946275	0	64	1013498	5487	1013498	5423	0.0	186.88880693343168
chr14	PGF	74953903	74953946	0	44	1013498	5487	1013498	5443	0.0	186.20209443321698
chr14	PGF	74953903	74953943	0	41	1013498	5487	1013498	5446	0.0	186.09952258538377
chr14	PGF	74946732	74946948	672483	217	1013498	5487	341015	5270	3099.0	64.70872865275142
chr14	MLH3	75038339	75038412	0	74	69277	6620	69277	6546	0.0	10.583104185762297
chr14	MLH3	75039910	75040015	0	106	69277	6620	69277	6514	0.0	10.63509364445809
chr14	MLH3	75042378	75042477	0	100	69277	6620	69277	6520	0.0	10.625306748466258
chr14	MLH3	75033418	75033490	0	73	69277	6620	69277	6547	0.0	10.581487704292043
chr14	MLH3	75041614	75041700	0	87	69277	6620	69277	6533	0.0	10.604163477728456
chr14	MLH3	75036592	75036742	96	151	69277	6620	69181	6469	0.6357615894039735	10.694234039264183
chr14	MLH3	75050851	75051023	714	173	69277	6620	68563	6447	4.127167630057803	10.634868931285869
chr14	ACYP1	75061683	75061762	0	80	1742	1809	1742	1729	0.0	1.0075187969924813
chr14	NEK9	75095371	75095431	0	61	14785	13134	14785	13073	0.0	1.1309569341390653
chr14	NEK9	75121118	75121174	76	57	14785	13134	14709	13077	1.3333333333333333	1.1247992658866712
chr14	NEK9	75124045	75124223	71	179	14785	13134	14714	12955	0.39664804469273746	1.1357776920108067
chr14	NEK9	75086647	75086921	0	275	14785	13134	14785	12859	0.0	1.1497783653472275
chr14	NEK9	75086780	75086921	0	142	14785	13134	14785	12992	0.0	1.1380080049261083
chr14	NEK9	75116191	75116410	0	220	14785	13134	14785	12914	0.0	1.1448815239275205
chr14	NEK9	75120871	75121007	0	137	14785	13134	14785	12997	0.0	1.1375702085096562
chr14	TMED10	75139073	75139171	0	99	39254	4963	39254	4864	0.0	8.0703125
chr14	VASH1-AS1	76783692	76783851	0	160	612	1846	612	1686	0.0	0.36298932384341637
chr14	ANGEL1	76804374	76804415	31	42	1528	6078	1497	6036	0.7380952380952381	0.24801192842942346
chr14	ANGEL1	76810088	76810254	0	167	1528	6078	1528	5911	0.0	0.25850109964473017
chr14	LINC02289	77071709	77071772	0	64	0	3491	0	3427	0.0	0.0
chr14	POMT2	77278728	77278869	0	142	273	7097	273	6955	0.0	0.03925233644859813
chr14	POMT2	77311948	77312033	0	86	273	7097	273	7011	0.0	0.03893881044073599
chr14	POMT2	77278728	77278961	0	234	273	7097	273	6863	0.0	0.039778522512020985
chr14	VIPAS39	77457094	77457365	0	272	584	3451	584	3179	0.0	0.18370556778861277
chr14	VIPAS39	77451186	77451333	0	148	584	3451	584	3303	0.0	0.17680896155010598
chr14	VIPAS39	77457094	77457413	0	320	584	3451	584	3131	0.0	0.18652187799425105
chr14	ISM2	77482321	77482667	0	347	0	4104	0	3757	0.0	0.0
chr14	ISM2	77484322	77484565	0	244	0	4104	0	3860	0.0	0.0
chr14	ISM2	77498223	77498328	0	106	0	4104	0	3998	0.0	0.0
chr14	ALKBH1	77694737	77694900	0	164	0	2854	0	2690	0.0	0.0
chr14	DIO2	80205601	80205735	0	135	0	2204	0	2069	0.0	0.0
chr14	DIO2	80206230	80206338	0	109	0	2204	0	2095	0.0	0.0
chr14	CEP128	80527168	80527261	0	94	638	9385	638	9291	0.0	0.06866860402540093
chr14	CEP128	80939384	80939540	0	157	638	9385	638	9228	0.0	0.06913740788903337
chr14	CEP128	80942283	80942380	0	98	638	9385	638	9287	0.0	0.06869818025196511
chr14	AC007262.2	81099398	81099526	0	129	83	5177	83	5048	0.0	0.01644215530903328
chr14	GTF2A1	81209869	81209936	0	68	0	6833	0	6765	0.0	0.0
chr14	STON2	81324016	81324187	0	172	653	7827	653	7655	0.0	0.0853037230568256
chr14	STON2	81427101	81427212	0	112	653	7827	653	7715	0.0	0.0846403110823072
chr14	LINC02311	81734700	81734854	53	155	204	2521	151	2366	0.3419354838709677	0.06382079459002536
chr14	LINC02311	81735936	81735998	0	63	204	2521	204	2458	0.0	0.08299430431244914
chr14	LINC02316	86054533	86054675	0	143	1530	3279	1530	3136	0.0	0.48788265306122447
chr14	LINC02316	86054533	86054602	0	70	1530	3279	1530	3209	0.0	0.47678404487379245
chr14	LINC02316	86060108	86060378	0	271	1530	3279	1530	3008	0.0	0.5086436170212766
chr14	GALC	87945552	87945733	0	182	0	5661	0	5479	0.0	0.0
chr14	GALC	87988454	87988523	0	70	0	5661	0	5591	0.0	0.0
chr14	GALC	87981413	87981447	0	35	0	5661	0	5626	0.0	0.0
chr14	GALC	87986968	87987056	0	89	0	5661	0	5572	0.0	0.0
chr14	GALC	87992303	87992405	0	103	0	5661	0	5558	0.0	0.0
chr14	PTPN21	88547528	88547651	0	124	102	7692	102	7568	0.0	0.013477801268498943
chr14	EML5	88622603	88622718	0	116	40	11046	40	10930	0.0	0.0036596523330283625
chr14	EML5	88705719	88705873	0	155	40	11046	40	10891	0.0	0.003672757322559912
chr14	FOXN3	89190383	89190449	0	67	0	11177	0	11110	0.0	0.0
chr14	FOXN3	89190386	89190449	0	64	0	11177	0	11113	0.0	0.0
chr14	FOXN3	89284427	89284522	0	96	0	11177	0	11081	0.0	0.0
chr14	FOXN3	89333113	89333259	0	147	0	11177	0	11030	0.0	0.0
chr14	FOXN3	89486568	89486671	0	104	0	11177	0	11073	0.0	0.0
chr14	EFCAB11	89924512	89924677	0	166	54	7113	54	6947	0.0	0.007773139484669641
chr14	NRDE2	90302719	90303125	0	407	0	17314	0	16907	0.0	0.0
chr14	NRDE2	90301773	90301803	0	31	0	17314	0	17283	0.0	0.0
chr14	TTC7B	90578105	90578308	0	204	13427	21297	13427	21093	0.0	0.6365618925709952
chr14	TTC7B	90602005	90602200	0	196	13427	21297	13427	21101	0.0	0.6363205535282688
chr14	TTC7B	90603252	90603303	0	52	13427	21297	13427	21245	0.0	0.6320075311838079
chr14	TTC7B	90605596	90605758	0	163	13427	21297	13427	21134	0.0	0.6353269612945964
chr14	TTC7B	90699157	90699223	0	67	13427	21297	13427	21230	0.0	0.6324540744229863
chr14	RPS6KA5	90947434	90947550	0	117	1828437	28004	1828437	27887	0.0	65.56592677591709
chr14	RPS6KA5	90919279	90919466	0	188	1828437	28004	1828437	27816	0.0	65.73328300258844
chr14	RPS6KA5	90939536	90939599	0	64	1828437	28004	1828437	27940	0.0	65.4415533285612
chr14	RPS6KA5	91052322	91052462	0	141	1828437	28004	1828437	27863	0.0	65.62240246922443
chr14	CCDC88C	91285394	91285836	0	443	14771	11557	14771	11114	0.0	1.3290444484434047
chr14	PPP4R3A	91466260	91466416	255	157	510	5929	255	5772	1.624203821656051	0.04417879417879418
chr14	CATSPERB	91659836	91659981	0	146	23317	5666	23317	5520	0.0	4.22409420289855
chr14	CATSPERB	91723048	91723189	0	142	23317	5666	23317	5524	0.0	4.22103548153512
chr14	CATSPERB	91736693	91736849	0	157	23317	5666	23317	5509	0.0	4.232528589580686
chr14	CATSPERB	91778974	91779070	0	97	23317	5666	23317	5569	0.0	4.186927635123002
chr14	TC2N	91792366	91792558	400	193	26210	6166	25810	5973	2.0725388601036268	4.321111669177967
chr14	TC2N	91797784	91797901	0	118	26210	6166	26210	6048	0.0	4.333664021164021
chr14	FBLN5	91938329	91938452	0	124	24543	4991	24543	4867	0.0	5.042736798849394
chr14	FBLN5	91939849	91939950	3449	102	24543	4991	21094	4889	33.81372549019608	4.314583759460012
chr14	FBLN5	91942036	91942174	1483	139	24543	4991	23060	4852	10.66906474820144	4.752679307502061
chr14	FBLN5	91942036	91942180	1763	145	24543	4991	22780	4846	12.158620689655173	4.700784151877837
chr14	TRIP11	92010985	92011072	0	88	4816	10396	4816	10308	0.0	0.46720993403181993
chr14	TRIP11	91977125	91977248	0	124	4816	10396	4816	10272	0.0	0.4688473520249221
chr14	ATXN3	92047895	92048089	0	195	102	9265	102	9070	0.0	0.011245865490628445
chr14	ATXN3	92046274	92046308	0	35	102	9265	102	9230	0.0	0.01105092091007584
chr14	ATXN3	92047895	92047987	0	93	102	9265	102	9172	0.0	0.011120802442215439
chr14	ATXN3	92047895	92047997	0	103	102	9265	102	9162	0.0	0.011132940406024885
chr14	ATXN3	92082299	92082466	0	168	102	9265	102	9097	0.0	0.011212487633285698
chr14	ATXN3	92088729	92088817	0	89	102	9265	102	9176	0.0	0.011115954664341761
chr14	ATXN3	92093251	92093318	0	68	102	9265	102	9197	0.0	0.011090573012939002
chr14	ATXN3	92093745	92093831	0	87	102	9265	102	9178	0.0	0.011113532359991284
chr14	ATXN3	92096092	92096137	0	46	102	9265	102	9219	0.0	0.011064106736088514
chr14	ATXN3	92096673	92096838	0	166	102	9265	102	9099	0.0	0.01121002307945928
chr14	ATXN3	92080540	92080567	0	28	102	9265	102	9237	0.0	0.01104254628126015
chr14	ATXN3	92096092	92096134	0	43	102	9265	102	9222	0.0	0.011060507482108002
chr14	ATXN3	92080964	92081061	0	98	102	9265	102	9167	0.0	0.011126868113886768
chr14	ATXN3	92079414	92079468	0	55	102	9265	102	9210	0.0	0.011074918566775244
chr14	ATXN3	92083416	92083503	0	88	102	9265	102	9177	0.0	0.011114743380189604
chr14	ATXN3	92093745	92093850	0	106	102	9265	102	9159	0.0	0.011136586963642319
chr14	NDUFB1	92118848	92118966	0	119	0	2268	0	2149	0.0	0.0
chr14	LGMN	92716135	92716221	0	87	0	3797	0	3710	0.0	0.0
chr14	LGMN	92706482	92706653	0	172	0	3797	0	3625	0.0	0.0
chr14	LGMN	92704639	92704707	0	69	0	3797	0	3728	0.0	0.0
chr14	LGMN	92741061	92741179	0	119	0	3797	0	3678	0.0	0.0
chr14	LGMN	92733681	92733810	0	130	0	3797	0	3667	0.0	0.0
chr14	LGMN	92741717	92741859	0	143	0	3797	0	3654	0.0	0.0
chr14	LGMN	92741704	92741859	0	156	0	3797	0	3641	0.0	0.0
chr14	LGMN	92742908	92743021	0	114	0	3797	0	3683	0.0	0.0
chr14	ITPK1	92993879	92993997	100	119	2177	6805	2077	6686	0.8403361344537815	0.31064911755907865
chr14	ITPK1	93016675	93016801	0	127	2177	6805	2177	6678	0.0	0.3259958071278826
chr14	ITPK1	93076594	93076619	0	26	2177	6805	2177	6779	0.0	0.3211388110340758
chr14	BTBD7	93261601	93261677	48	77	19527	11346	19479	11269	0.6233766233766234	1.7285473422663946
chr14	BTBD7	93263784	93263993	13888	210	19527	11346	5639	11136	66.13333333333334	0.5063757183908046
chr14	PRIMA1	93725835	93726006	0	172	3611	3902	3611	3730	0.0	0.9680965147453083
chr14	ASB2	93953351	93953507	0	157	0	4762	0	4605	0.0	0.0
chr14	ASB2	93956765	93956870	0	106	0	4762	0	4656	0.0	0.0
chr14	ASB2	93964333	93964612	0	280	0	4762	0	4482	0.0	0.0
chr14	DDX24	94079024	94079747	0	724	0	4993	0	4269	0.0	0.0
chr14	DDX24	94079024	94079621	0	598	0	4993	0	4395	0.0	0.0
chr14	IFI27L2	94128513	94128675	0	163	0	1313	0	1150	0.0	0.0
chr14	SERPINA1	94388559	94388663	0	105	0	4706	0	4601	0.0	0.0
chr14	SERPINA1	94388818	94389010	0	193	0	4706	0	4513	0.0	0.0
chr14	SERPINA1	94388800	94389010	0	211	0	4706	0	4495	0.0	0.0
chr14	SERPINA1	94388559	94388660	0	102	0	4706	0	4604	0.0	0.0
chr14	DICER1	95091202	95091365	0	164	63	10278	63	10114	0.0	0.006228989519477951
chr14	DICER1	95092568	95092694	0	127	63	10278	63	10151	0.0	0.0062062850950645254
chr14	DICER1	95134360	95134503	0	144	63	10278	63	10134	0.0	0.006216696269982238
chr14	DICER1	95141153	95141187	0	35	63	10278	63	10243	0.0	0.006150541833447232
chr14	CLMN	95222402	95222599	0	198	241081	5891	241081	5693	0.0	42.3469172668189
chr14	TCL1A	95711748	95711802	0	55	0	1869	0	1814	0.0	0.0
chr14	TCL1A	95711753	95711802	0	50	0	1869	0	1819	0.0	0.0
chr14	TCL1A	95712550	95712774	0	225	0	1869	0	1644	0.0	0.0
chr14	LINC02291	97637482	97637635	0	154	51	1828	51	1674	0.0	0.03046594982078853
chr14	LINC01550	97969272	97969470	0	199	0	6919	0	6720	0.0	0.0
chr14	LINC01550	97969272	97969547	0	276	0	6919	0	6643	0.0	0.0
chr14	LINC01550	97960262	97960417	0	156	0	6919	0	6763	0.0	0.0
chr14	BCL11B	99257470	99257839	0	370	0	8532	0	8162	0.0	0.0
chr14	BCL11B	99231344	99231557	0	214	0	8532	0	8318	0.0	0.0
chr14	SETD3	99461191	99461340	0	150	0	5201	0	5051	0.0	0.0
chr14	CCDC85C	99517087	99517183	0	97	0	17631	0	17534	0.0	0.0
chr14	DEGS2	100148967	100149710	362	744	13470	3952	13108	3208	0.48655913978494625	4.086034912718205
chr14	SLC25A29	100298841	100298885	0	45	1836	5646	1836	5601	0.0	0.3277986073915372
chr14	SLC25A29	100295625	100295697	0	73	1836	5646	1836	5573	0.0	0.32944554100125606
chr14	SLC25A29	100295625	100295993	0	369	1836	5646	1836	5277	0.0	0.3479249573621376
chr14	WARS1	100360553	100360662	0	110	32313	6022	32313	5912	0.0	5.465663058186739
chr14	WARS1	100369086	100369258	0	173	32313	6022	32313	5849	0.0	5.524534108394597
chr14	WARS1	100374135	100374265	0	131	32313	6022	32313	5891	0.0	5.485146834153794
chr14	WARS1	100375282	100375350	0	69	32313	6022	32313	5953	0.0	5.428019485973459
chr14	WARS1	100375282	100375406	0	125	32313	6022	32313	5897	0.0	5.479565880956419
chr14	WARS1	100373979	100374064	9734	86	32313	6022	22579	5936	113.18604651162791	3.8037398921832883
chr14	WARS1	100374135	100374179	0	45	32313	6022	32313	5977	0.0	5.406223858122804
chr14	WARS1	100374135	100374244	0	110	32313	6022	32313	5912	0.0	5.465663058186739
chr14	WARS1	100365474	100365576	0	103	32313	6022	32313	5919	0.0	5.459199189052205
chr14	WARS1	100365953	100366067	0	115	32313	6022	32313	5907	0.0	5.470289487049263
chr14	WARS1	100375282	100375403	0	122	32313	6022	32313	5900	0.0	5.476779661016949
chr14	WARS1	100374135	100374149	0	15	32313	6022	32313	6007	0.0	5.379224238388547
chr14	WARS1	100368373	100368465	0	93	32313	6022	32313	5929	0.0	5.449991566874684
chr14	WARS1	100374135	100374220	0	86	32313	6022	32313	5936	0.0	5.443564690026954
chr14	WARS1	100375282	100375546	0	265	32313	6022	32313	5757	0.0	5.612819176654508
chr14	BEGAIN	100550419	100550509	215	91	3233	6502	3018	6411	2.3626373626373627	0.47075339260645765
chr14	AL132709.7	101076054	101076138	0	85	51	2750	51	2665	0.0	0.019136960600375234
chr14	AL132709.7	101074480	101074561	0	82	51	2750	51	2668	0.0	0.01911544227886057
chr14	AL132709.7	101076054	101076333	0	280	51	2750	51	2470	0.0	0.020647773279352227
chr14	DIO3OS	101559799	101560025	0	227	0	4042	0	3815	0.0	0.0
chr14	HSP90AA1	102085757	102086124	0	368	102	4954	102	4586	0.0	0.022241604884430877
chr14	HSP90AA1	102101874	102102085	0	212	102	4954	102	4742	0.0	0.021509911429776464
chr14	HSP90AA1	102085964	102086124	0	161	102	4954	102	4793	0.0	0.021281034842478615
chr14	MOK	102225094	102226408	0	1315	47925	7725	47925	6410	0.0	7.476599063962558
chr14	MOK	102232534	102232708	9635	175	47925	7725	38290	7550	55.05714285714286	5.071523178807947
chr14	MOK	102232534	102232671	7302	138	47925	7725	40623	7587	52.91304347826087	5.354290233293792
chr14	MOK	102231706	102231821	8392	116	47925	7725	39533	7609	72.34482758620689	5.195557891970036
chr14	MOK	102251755	102251804	0	50	47925	7725	47925	7675	0.0	6.244299674267101
chr14	MOK	102238317	102238364	0	48	47925	7725	47925	7677	0.0	6.242672919109027
chr14	MOK	102251443	102251610	0	168	47925	7725	47925	7557	0.0	6.341802302500993
chr14	MOK	102263545	102263616	0	72	47925	7725	47925	7653	0.0	6.262250098000784
chr14	MOK	102265822	102265912	0	91	47925	7725	47925	7634	0.0	6.27783599685617
chr14	MOK	102278605	102278694	0	90	47925	7725	47925	7635	0.0	6.277013752455796
chr14	CINP	102349918	102350048	976	131	75713	3837	74737	3706	7.450381679389313	20.166486778197516
chr14	CINP	102352418	102352555	7	138	75713	3837	75706	3699	0.050724637681159424	20.46661259799946
chr14	ANKRD9	102508640	102508846	81096	207	800225	7211	719129	7004	391.768115942029	102.67404340376928
chr14	CDC42BPB	102954197	102954275	0	79	61162	8038	61162	7959	0.0	7.684633747958286
chr14	CKB	103520468	103520592	0	125	2821	2363	2821	2238	0.0	1.2605004468275245
chr14	CKB	103520501	103520592	0	92	2821	2363	2821	2271	0.0	1.242184059885513
chr14	XRCC3	103712874	103712968	0	95	0	6309	0	6214	0.0	0.0
chr14	XRCC3	103712874	103712931	0	58	0	6309	0	6251	0.0	0.0
chr14	PPP1R13B	103737693	103737860	0	168	1673	8263	1673	8095	0.0	0.20667078443483633
chr14	PPP1R13B	103742653	103742823	0	171	1673	8263	1673	8092	0.0	0.20674740484429066
chr14	PPP1R13B	103784794	103784914	41	121	1673	8263	1632	8142	0.33884297520661155	0.20044215180545322
chr14	PPP1R13B	103763862	103764479	1224	618	1673	8263	449	7645	1.9805825242718447	0.058731196860693266
chr14	PPP1R13B	103794576	103794663	0	88	1673	8263	1673	8175	0.0	0.20464831804281344
chr14	ATP5MPL	103915065	103915189	0	125	407	3421	407	3296	0.0	0.12348300970873786
chr14	ATP5MPL	103914478	103914633	0	156	407	3421	407	3265	0.0	0.12465543644716692
chr14	ATP5MPL	103920939	103921208	204	270	407	3421	203	3151	0.7555555555555555	0.06442399238337036
chr14	ATP5MPL	103918004	103918124	0	121	407	3421	407	3300	0.0	0.12333333333333334
chr14	RD3L	103941396	103941702	25540	307	26935	1457	1395	1150	83.19218241042346	1.2130434782608697
chr14	AKT1	104793126	104793304	0	179	51	7131	51	6952	0.0	0.007336018411967779
chr14	AKT1	104793126	104793210	0	85	51	7131	51	7046	0.0	0.007238149304569968
chr14	AKT1	104771721	104771816	0	96	51	7131	51	7035	0.0	0.007249466950959489
chr14	GPR132	105055386	105056166	0	781	459	4200	459	3419	0.0	0.13424978063761334
chr14	GPR132	105057166	105057280	150	115	459	4200	309	4085	1.3043478260869565	0.07564259485924113
chr14	GPR132	105053932	105054165	0	234	459	4200	459	3966	0.0	0.1157337367624811
chr14	GPR132	105057937	105058027	0	91	459	4200	459	4109	0.0	0.11170601119493793
chr14	JAG2	105150990	105151104	0	115	87592	6057	87592	5942	0.0	14.741164591046786
chr14	NUDT14	105177122	105177325	7428	204	103660	1924	96232	1720	36.411764705882355	55.948837209302326
chr14	BRF1	105286295	105286376	0	82	329275	12275	329275	12193	0.0	27.005248913310915
chr14	BRF1	105241264	105241414	53294	151	329275	12275	275981	12124	352.94039735099335	22.76319696469812
chr14	AL928654.1	105418681	105418816	45501	136	427549	2368	382048	2232	334.56617647058823	171.168458781362
chr15	CHEK2P2	20290979	20291018	0	40	0	952	0	912	0.0	0.0
chr15	LINC01193	20942600	20942740	0	141	1224	6672	1224	6531	0.0	0.1874138723013321
chr15	LINC01193	20990619	20990728	0	110	1224	6672	1224	6562	0.0	0.18652849740932642
chr15	LINC01193	20996854	20997026	0	173	1224	6672	1224	6499	0.0	0.1883366671795661
chr15	LINC01193	20981822	20981980	0	159	1224	6672	1224	6513	0.0	0.1879318286503915
chr15	LINC01193	20991290	20991437	0	148	1224	6672	1224	6524	0.0	0.18761496014714898
chr15	LINC01193	20981822	20981968	0	147	1224	6672	1224	6525	0.0	0.18758620689655173
chr15	LINC01193	20979275	20979357	0	83	1224	6672	1224	6589	0.0	0.18576415237517074
chr15	LINC01193	20999988	21000032	0	45	1224	6672	1224	6627	0.0	0.1846989588048891
chr15	AC134980.1	22044436	22044825	0	390	0	2337	0	1947	0.0	0.0
chr15	AC134980.1	22051534	22051687	0	154	0	2337	0	2183	0.0	0.0
chr15	HERC2P2	22579347	22579477	0	131	2244	7002	2244	6871	0.0	0.32659001600931453
chr15	WHAMMP3	22672306	22672465	0	160	130	5719	130	5559	0.0	0.02338550098938658
chr15	WHAMMP3	22676804	22676934	51	131	130	5719	79	5588	0.3893129770992366	0.014137437365783823
chr15	NIPA1	22813632	22813714	0	83	153	8696	153	8613	0.0	0.017763845350052248
chr15	NIPA1	22814082	22814153	0	72	153	8696	153	8624	0.0	0.017741187384044527
chr15	NIPA2	22839654	22839790	0	137	36720	4741	36720	4604	0.0	7.975673327541268
chr15	NIPA2	22845145	22845267	95	123	36720	4741	36625	4618	0.7723577235772358	7.930922477262884
chr15	NIPA2	22853211	22853268	83	58	36720	4741	36637	4683	1.4310344827586208	7.823403800982276
chr15	NIPA2	22839061	22839174	0	114	36720	4741	36720	4627	0.0	7.936027663712989
chr15	MKRN3	23566807	23566984	0	178	357	7026	357	6848	0.0	0.05213200934579439
chr15	PWRN4	24087732	24087830	60	99	132	4181	72	4082	0.6060606060606061	0.017638412542871143
chr15	PWRN4	23977386	23977491	21	106	132	4181	111	4075	0.19811320754716982	0.027239263803680983
chr15	PWRN1	24159895	24160045	0	151	51	22178	51	22027	0.0	0.002315340264221183
chr15	PWRN1	24507953	24508140	0	188	51	22178	51	21990	0.0	0.002319236016371078
chr15	PWRN1	24513622	24513737	0	116	51	22178	51	22062	0.0	0.0023116671199347296
chr15	PWRN1	24227202	24227268	0	67	51	22178	51	22111	0.0	0.0023065442539912263
chr15	PWRN1	24225295	24225627	0	333	51	22178	51	21845	0.0	0.0023346303501945525
chr15	PWRN1	24276466	24276658	0	193	51	22178	51	21985	0.0	0.0023197634750966568
chr15	PWRN1	24257116	24257257	0	142	51	22178	51	22036	0.0	0.0023143946269740426
chr15	PWRN1	24287563	24287670	0	108	51	22178	51	22070	0.0	0.002310829179882193
chr15	PWRN1	24287558	24287670	0	113	51	22178	51	22065	0.0	0.0023113528212100613
chr15	PWRN1	24276466	24276710	0	245	51	22178	51	21933	0.0	0.0023252633018738885
chr15	PWRN1	24473052	24473193	0	142	51	22178	51	22036	0.0	0.0023143946269740426
chr15	PWRN1	24493136	24493328	0	193	51	22178	51	21985	0.0	0.0023197634750966568
chr15	PWRN1	24291181	24291279	0	99	51	22178	51	22079	0.0	0.0023098872231532225
chr15	PWRN1	24277378	24277410	0	33	51	22178	51	22145	0.0	0.0023030029351998192
chr15	PWRN1	24280015	24280287	0	273	51	22178	51	21905	0.0	0.0023282355626569277
chr15	PWRN1	24512979	24513173	0	195	51	22178	51	21983	0.0	0.002319974525769913
chr15	PWRN1	24396189	24396304	0	116	51	22178	51	22062	0.0	0.0023116671199347296
chr15	PWRN1	24469151	24469168	0	18	51	22178	51	22160	0.0	0.0023014440433213
chr15	PWRN1	24521631	24521830	0	200	51	22178	51	21978	0.0	0.0023205023205023203
chr15	PWRN1	24535199	24535306	0	108	51	22178	51	22070	0.0	0.002310829179882193
chr15	PWRN1	24568530	24568563	0	34	51	22178	51	22144	0.0	0.002303106936416185
chr15	PWRN1	24567891	24568182	0	292	51	22178	51	21886	0.0	0.002330256785159463
chr15	PWRN1	24587566	24587735	0	170	51	22178	51	22008	0.0	0.002317339149400218
chr15	AC090983.2	24811062	24811218	0	157	102	2917	102	2760	0.0	0.03695652173913044
chr15	PWRN1	24580226	24580330	0	105	51	22178	51	22073	0.0	0.002310515108956644
chr15	PWRN1	24567896	24568182	0	287	51	22178	51	21891	0.0	0.0023297245443332877
chr15	PWRN1	24569782	24569809	0	28	51	22178	51	22150	0.0	0.0023024830699774268
chr15	PWRN1	24566088	24566212	0	125	51	22178	51	22053	0.0	0.0023126105291797036
chr15	SNRPN	24974310	24974456	0	147	0	3407	0	3260	0.0	0.0
chr15	SNRPN	24829797	24829905	0	109	0	3407	0	3298	0.0	0.0
chr15	SNRPN	24912362	24912530	0	169	0	3407	0	3238	0.0	0.0
chr15	SNRPN	24958737	24958868	0	132	0	3407	0	3275	0.0	0.0
chr15	SNRPN	24942274	24942462	0	189	0	3407	0	3218	0.0	0.0
chr15	SNRPN	24967028	24967240	0	213	0	3407	0	3194	0.0	0.0
chr15	SNRPN	24974386	24974456	0	71	0	3407	0	3336	0.0	0.0
chr15	SNRPN	24967028	24967152	0	125	0	3407	0	3282	0.0	0.0
chr15	SNRPN	24974641	24974957	0	317	0	3407	0	3090	0.0	0.0
chr15	SNRPN	24974397	24974456	0	60	0	3407	0	3347	0.0	0.0
chr15	SNRPN	24974287	24974456	0	170	0	3407	0	3237	0.0	0.0
chr15	AC124312.1	24981774	24982437	0	664	0	1600	0	936	0.0	0.0
chr15	SNHG14	25051101	25051236	0	136	1269	110104	1269	109968	0.0	0.011539720646006111
chr15	SNHG14	25079825	25080079	0	255	1269	110104	1269	109849	0.0	0.011552221686132782
chr15	SNHG14	25085189	25085322	0	134	1269	110104	1269	109970	0.0	0.011539510775666091
chr15	SNHG14	25095626	25095828	0	203	1269	110104	1269	109901	0.0	0.011546755716508494
chr15	SNHG14	25111764	25111894	0	131	1269	110104	1269	109973	0.0	0.011539195984468915
chr15	SNHG14	25115298	25115656	0	359	1269	110104	1269	109745	0.0	0.011563169164882228
chr15	SNHG14	25053265	25053363	0	99	1269	110104	1269	110005	0.0	0.011535839280032725
chr15	SNHG14	25061305	25061413	0	109	1269	110104	1269	109995	0.0	0.011536888040365472
chr15	SNHG14	25091589	25091719	0	131	1269	110104	1269	109973	0.0	0.011539195984468915
chr15	SNHG14	25095718	25095828	0	111	1269	110104	1269	109993	0.0	0.01153709781531552
chr15	SNHG14	25067411	25067531	0	121	1269	110104	1269	109983	0.0	0.011538146804506152
chr15	SNHG14	25100778	25100890	0	113	1269	110104	1269	109991	0.0	0.011537307597894373
chr15	SNHG14	25101822	25101931	0	110	1269	110104	1269	109994	0.0	0.01153699292688692
chr15	SNHG14	25095626	25095728	0	103	1269	110104	1269	110001	0.0	0.011536258761283988
chr15	SNHG14	25067408	25067531	0	124	1269	110104	1269	109980	0.0	0.011538461538461539
chr15	SNHG14	25055073	25055230	0	158	1269	110104	1269	109946	0.0	0.011542029723682535
chr15	SNHG14	25080124	25080229	0	106	1269	110104	1269	109998	0.0	0.011536573392243496
chr15	SNHG14	25077218	25077316	0	99	1269	110104	1269	110005	0.0	0.011535839280032725
chr15	SNHG14	25086509	25086614	0	106	1269	110104	1269	109998	0.0	0.011536573392243496
chr15	SNHG14	25110385	25110536	0	152	1269	110104	1269	109952	0.0	0.011541399883585565
chr15	SNHG14	25115265	25115656	0	392	1269	110104	1269	109712	0.0	0.011566647221817121
chr15	SNHG14	25086330	25086464	0	135	1269	110104	1269	109969	0.0	0.011539615709881875
chr15	SNHG14	25112214	25112336	0	123	1269	110104	1269	109981	0.0	0.011538356625235268
chr15	SNHG14	25105699	25105824	0	126	1269	110104	1269	109978	0.0	0.011538671370637764
chr15	SNHG14	25181809	25181895	0	87	1269	110104	1269	110017	0.0	0.011534581019297017
chr15	SNHG14	25239649	25239781	0	133	1269	110104	1269	109971	0.0	0.011539405843358703
chr15	SNHG14	25244134	25244271	0	138	1269	110104	1269	109966	0.0	0.011539930523980139
chr15	SNHG14	25249013	25249147	0	135	1269	110104	1269	109969	0.0	0.011539615709881875
chr15	SNHG14	25234057	25234203	0	147	1269	110104	1269	109957	0.0	0.011540875069345289
chr15	SNHG14	25232867	25233681	0	815	1269	110104	1269	109289	0.0	0.011611415604498165
chr15	SNHG14	25209731	25209861	0	131	1269	110104	1269	109973	0.0	0.011539195984468915
chr15	SNHG14	25381268	25381389	0	122	1269	110104	1269	109982	0.0	0.011538251713916823
chr15	SNHG14	25391595	25391791	0	197	1269	110104	1269	109907	0.0	0.011546125360532086
chr15	SNHG14	25247866	25248003	0	138	1269	110104	1269	109966	0.0	0.011539930523980139
chr15	SNHG14	25227431	25227476	0	46	1269	110104	1269	110058	0.0	0.011530284032055825
chr15	SNHG14	25233590	25233681	0	92	1269	110104	1269	110012	0.0	0.011535105261244228
chr15	SNHG14	25264642	25264720	0	79	1269	110104	1269	110025	0.0	0.011533742331288344
chr15	LINC02346	26049124	26049242	0	119	255	8364	255	8245	0.0	0.030927835051546393
chr15	LINC02346	26035211	26035342	0	132	255	8364	255	8232	0.0	0.03097667638483965
chr15	LINC02346	26051704	26051783	0	80	255	8364	255	8284	0.0	0.030782230806373732
chr15	LINC00929	26125610	26126022	0	413	0	3665	0	3252	0.0	0.0
chr15	LINC00929	26132290	26132360	0	71	0	3665	0	3594	0.0	0.0
chr15	LINC00929	26125208	26125313	0	106	0	3665	0	3559	0.0	0.0
chr15	LINC00929	26132306	26132360	0	55	0	3665	0	3610	0.0	0.0
chr15	LINC00929	26118691	26118828	0	138	0	3665	0	3527	0.0	0.0
chr15	LINC02248	26445556	26445643	0	88	0	2812	0	2724	0.0	0.0
chr15	GABRA5	26869174	26869334	0	161	0	3621	0	3460	0.0	0.0
chr15	GABRA5	26868728	26868793	0	66	0	3621	0	3555	0.0	0.0
chr15	HERC2P9	28655494	28655691	0	198	38	8168	38	7970	0.0	0.004767879548306148
chr15	HERC2P9	28673671	28673781	0	111	38	8168	38	8057	0.0	0.004716395680774482
chr15	HERC2P9	28618218	28618378	0	161	38	8168	38	8007	0.0	0.0047458473835394034
chr15	WHAMMP2	28745596	28745755	0	160	102	6666	102	6506	0.0	0.01567783584383646
chr15	APBA2	29094277	29094313	14	37	6027	6889	6013	6852	0.3783783783783784	0.8775539988324577
chr15	APBA2	28895519	28895609	0	91	6027	6889	6027	6798	0.0	0.8865842894969108
chr15	APBA2	28893873	28894044	209	172	6027	6889	5818	6717	1.2151162790697674	0.8661604883132351
chr15	ULK4P3	30116891	30116938	0	48	904	1460	904	1412	0.0	0.6402266288951841
chr15	AC127502.1	30480741	30480907	0	167	0	2339	0	2172	0.0	0.0
chr15	ULK4P2	30584400	30584574	0	175	102	1570	102	1395	0.0	0.07311827956989247
chr15	AC091057.1	30748575	30748670	0	96	22594	5642	22594	5546	0.0	4.0739271547060945
chr15	FAN1	30910613	30910815	0	203	141866	15722	141866	15519	0.0	9.141439525742639
chr15	FAN1	30912443	30913705	1224	1263	141866	15722	140642	14459	0.9691211401425178	9.72695207137423
chr15	FAN1	30906370	30906504	0	135	141866	15722	141866	15587	0.0	9.101558991467249
chr15	FAN1	30905724	30905897	0	174	141866	15722	141866	15548	0.0	9.124388988937485
chr15	AC009562.1	31035569	31035656	0	88	4917	2141	4917	2053	0.0	2.395031660983926
chr15	CHRNA7	32111789	32111899	0	111	612	13012	612	12901	0.0	0.04743818308658244
chr15	CHRNA7	32153906	32153986	0	81	612	13012	612	12931	0.0	0.047328126208336554
chr15	CHRNA7	32159568	32159655	0	88	612	13012	612	12924	0.0	0.04735376044568245
chr15	CHRNA7	32163225	32163335	0	111	612	13012	612	12901	0.0	0.04743818308658244
chr15	CHRNA7	32159577	32159655	0	79	612	13012	612	12933	0.0	0.04732080723729993
chr15	CHRNA7	32112239	32112363	0	125	612	13012	612	12887	0.0	0.04748971832078839
chr15	CHRNA7	32167359	32167556	51	198	612	13012	561	12814	0.25757575757575757	0.04378024036210395
chr15	CHRNA7	32112236	32112363	0	128	612	13012	612	12884	0.0	0.04750077615647315
chr15	CHRNA7	32111799	32111899	0	101	612	13012	612	12911	0.0	0.04740144063201921
chr15	GOLGA8N	32599419	32599527	0	109	2193	6366	2193	6257	0.0	0.35048745405146237
chr15	SCG5	32691709	32691763	0	55	1409	2204	1409	2149	0.0	0.65565379246161
chr15	RYR3	33473418	33473538	0	121	205	19804	205	19683	0.0	0.010415079002184626
chr15	RYR3	33826251	33826269	0	19	205	19804	205	19785	0.0	0.010361384887541066
chr15	RYR3	33836905	33836987	0	83	205	19804	205	19721	0.0	0.010395010395010396
chr15	RYR3	33843487	33843574	0	88	205	19804	205	19716	0.0	0.010397646581456685
chr15	RYR3	33807554	33807569	0	16	205	19804	205	19788	0.0	0.010359814028704265
chr15	RYR3	33807554	33807800	0	247	205	19804	205	19557	0.0	0.010482180293501049
chr15	RYR3	33855883	33856051	0	169	205	19804	205	19635	0.0	0.010440539852304559
chr15	CHRM5	34046539	34046871	0	333	1275	6045	1275	5712	0.0	0.22321428571428573
chr15	EMC4	34225535	34225650	0	116	15	2766	15	2650	0.0	0.005660377358490566
chr15	EMC4	34227692	34227846	0	155	15	2766	15	2611	0.0	0.005744925315970892
chr15	EMC4	34228428	34228589	0	162	15	2766	15	2604	0.0	0.00576036866359447
chr15	EMC4	34225563	34225650	0	88	15	2766	15	2678	0.0	0.005601194921583271
chr15	EMC4	34225514	34225650	0	137	15	2766	15	2629	0.0	0.005705591479650057
chr15	EMC4	34225535	34225658	0	124	15	2766	15	2642	0.0	0.005677517032551098
chr15	EMC4	34228436	34228589	0	154	15	2766	15	2612	0.0	0.005742725880551302
chr15	NUTM1	34345941	34346035	0	95	0	4204	0	4109	0.0	0.0
chr15	NUTM1	34345856	34346035	0	180	0	4204	0	4024	0.0	0.0
chr15	AC087457.1	34777270	34777431	296	162	3560	4720	3264	4558	1.8271604938271604	0.7161035541904344
chr15	DPH6-DT	35857121	35857203	0	83	0	2857	0	2774	0.0	0.0
chr15	CDIN1	36644277	36644323	0	47	51	9162	51	9115	0.0	0.005595172792100932
chr15	CDIN1	36709855	36709961	0	107	51	9162	51	9055	0.0	0.005632247377139702
chr15	CDIN1	36709837	36709961	0	125	51	9162	51	9037	0.0	0.005643465751908819
chr15	CDIN1	36645222	36645287	0	66	51	9162	51	9096	0.0	0.005606860158311346
chr15	CDIN1	36591782	36591896	0	115	51	9162	51	9047	0.0	0.005637227810323864
chr15	CDIN1	36658260	36658294	0	35	51	9162	51	9127	0.0	0.00558781636901501
chr15	CDIN1	36668110	36668219	0	110	51	9162	51	9052	0.0	0.005634114007954044
chr15	CDIN1	36640604	36640659	0	56	51	9162	51	9106	0.0	0.0056007028332967276
chr15	TMCO5A	37936018	37936193	0	176	51	4376	51	4200	0.0	0.012142857142857143
chr15	LINC02345	38021228	38021272	0	45	0	2302	0	2257	0.0	0.0
chr15	SPRED1	38268173	38268237	0	65	0	7759	0	7694	0.0	0.0
chr15	LINC02694	38689237	38689314	0	78	1005	8497	1005	8419	0.0	0.1193728471314883
chr15	AC113146.1	39168735	39168842	0	108	0	1654	0	1546	0.0	0.0
chr15	AC113146.1	39179140	39179294	0	155	0	1654	0	1499	0.0	0.0
chr15	AC109630.1	39480331	39480380	0	50	2428	3057	2428	3007	0.0	0.8074492850016628
chr15	AC109630.1	39477756	39477967	0	212	2428	3057	2428	2845	0.0	0.853427065026362
chr15	EIF2AK4	39985804	39985888	0	85	0	8943	0	8858	0.0	0.0
chr15	EIF2AK4	40016501	40016672	0	172	0	8943	0	8771	0.0	0.0
chr15	SRP14-AS1	40064295	40064601	0	307	7617	5059	7617	4752	0.0	1.6029040404040404
chr15	SRP14-AS1	40046861	40047221	0	361	7617	5059	7617	4698	0.0	1.6213282247765006
chr15	SRP14-AS1	40064460	40064601	0	142	7617	5059	7617	4917	0.0	1.5491153142159853
chr15	BUB1B	40165052	40165196	51	145	3919	4281	3868	4136	0.35172413793103446	0.9352030947775629
chr15	BUB1B	40166358	40166482	60	125	3919	4281	3859	4156	0.48	0.9285370548604427
chr15	PAK6	40274141	40274276	0	136	10384	6404	10384	6268	0.0	1.656668793873644
chr15	PAK6	40240598	40240681	0	84	10384	6404	10384	6320	0.0	1.6430379746835444
chr15	PAK6	40263798	40263919	1122	122	10384	6404	9262	6282	9.19672131147541	1.4743712193568927
chr15	PAK6	40263803	40263919	1122	117	10384	6404	9262	6287	9.58974358974359	1.4731986639096548
chr15	PAK6	40256842	40257086	0	245	10384	6404	10384	6159	0.0	1.6859879850625101
chr15	KNSTRN	40391492	40391554	0	63	42631	3389	42631	3326	0.0	12.817498496692725
chr15	KNSTRN	40384456	40384519	0	64	42631	3389	42631	3325	0.0	12.821353383458646
chr15	KNSTRN	40389165	40389291	0	127	42631	3389	42631	3262	0.0	13.068976088289393
chr15	IVD	40414888	40414982	0	95	51	6598	51	6503	0.0	0.007842534214977702
chr15	IVD	40407635	40407725	0	91	51	6598	51	6507	0.0	0.007837713231904103
chr15	IVD	40407635	40407812	0	178	51	6598	51	6420	0.0	0.00794392523364486
chr15	IVD	40424134	40424216	0	83	51	6598	51	6515	0.0	0.00782808902532617
chr15	KNL1	40605109	40605149	0	41	80166	8770	80166	8729	0.0	9.183869859090388
chr15	KNL1	40610798	40610876	0	79	80166	8770	80166	8691	0.0	9.224024853296514
chr15	KNL1	40618958	40619011	0	54	80166	8770	80166	8716	0.0	9.197567691601652
chr15	KNL1	40629272	40629371	204	100	80166	8770	79962	8670	2.04	9.222837370242214
chr15	RAD51	40706176	40706294	91	119	9327	2952	9236	2833	0.7647058823529411	3.260148252735616
chr15	RAD51	40718804	40718899	663	96	9327	2952	8664	2856	6.90625	3.033613445378151
chr15	RAD51	40729852	40729974	48	123	9327	2952	9279	2829	0.3902439024390244	3.2799575821845175
chr15	RAD51	40701805	40701926	1541	122	9327	2952	7786	2830	12.631147540983607	2.751236749116608
chr15	GCHFR	40765826	40765921	257	96	64123	1485	63866	1389	2.6770833333333335	45.97984161267099
chr15	GCHFR	40765859	40765921	257	63	64123	1485	63866	1422	4.079365079365079	44.91279887482419
chr15	ZFYVE19	40809118	40809240	17	123	374	3308	357	3185	0.13821138211382114	0.11208791208791209
chr15	ZFYVE19	40809407	40809458	0	52	374	3308	374	3256	0.0	0.11486486486486487
chr15	ZFYVE19	40812698	40812902	0	205	374	3308	374	3103	0.0	0.1205285207863358
chr15	ZFYVE19	40808043	40808075	0	33	374	3308	374	3275	0.0	0.11419847328244274
chr15	ZFYVE19	40809155	40809240	17	86	374	3308	357	3222	0.19767441860465115	0.11080074487895716
chr15	SPINT1	40854059	40854086	0	28	1929	3461	1929	3433	0.0	0.5618992135158754
chr15	SPINT1	40854396	40854522	382	127	1929	3461	1547	3334	3.0078740157480315	0.46400719856028794
chr15	VPS18	40899143	40901014	1173	1872	2665	4035	1492	2163	0.6266025641025641	0.6897827092001849
chr15	VPS18	40898657	40898811	856	155	2665	4035	1809	3880	5.52258064516129	0.46623711340206186
chr15	AC020661.1	40908418	40908545	0	128	810	1714	810	1586	0.0	0.510718789407314
chr15	CHP1	41264164	41264235	0	72	30608	3959	30608	3887	0.0	7.874453305891433
chr15	CHP1	41278766	41278889	0	124	30608	3959	30608	3835	0.0	7.98122555410691
chr15	CHP1	41270556	41270618	0	63	30608	3959	30608	3896	0.0	7.856262833675565
chr15	CHP1	41243666	41243739	0	74	30608	3959	30608	3885	0.0	7.878507078507078
chr15	NUSAP1	41375711	41375828	0	118	3261	3040	3261	2922	0.0	1.1160164271047228
chr15	OIP5-AS1	41290304	41290416	0	113	9163	12683	9163	12570	0.0	0.7289578361177407
chr15	AC087721.2	41332155	41333050	102	896	3318	3467	3216	2571	0.11383928571428571	1.250875145857643
chr15	NUSAP1	41342385	41342454	0	70	3261	3040	3261	2970	0.0	1.097979797979798
chr15	NUSAP1	41345485	41345602	0	118	3261	3040	3261	2922	0.0	1.1160164271047228
chr15	NUSAP1	41365815	41365863	0	49	3261	3040	3261	2991	0.0	1.090270812437312
chr15	TYRO3	41568877	41569022	1071	146	436869	10012	435798	9866	7.335616438356165	44.17170079059396
chr15	TYRO3	41574655	41574712	0	58	436869	10012	436869	9954	0.0	43.888788426763114
chr15	MGA	41742545	41743172	0	628	435307	16128	435307	15500	0.0	28.08432258064516
chr15	MAPKBP1	41799822	41799914	0	93	269455	9752	269455	9659	0.0	27.896780204990165
chr15	MAPKBP1	41814549	41814739	255	191	269455	9752	269200	9561	1.3350785340314135	28.156050622319842
chr15	MAPKBP1	41815258	41815405	0	148	269455	9752	269455	9604	0.0	28.056538942107455
chr15	MAPKBP1	41813329	41813347	1752	19	269455	9752	267703	9733	92.21052631578948	27.50467481763074
chr15	JMJD7-PLA2G4B	41847336	41847523	0	188	123	7884	123	7696	0.0	0.015982328482328483
chr15	JMJD7	41828393	41828501	6150	109	28817	1974	22667	1865	56.42201834862385	12.153887399463807
chr15	JMJD7-PLA2G4B	41842553	41842591	0	39	123	7884	123	7845	0.0	0.015678776290630976
chr15	AC020659.1	41895226	41895336	0	111	459	4463	459	4352	0.0	0.10546875
chr15	GANC	42280916	42281133	0	218	0	10932	0	10714	0.0	0.0
chr15	GANC	42278024	42278088	0	65	0	10932	0	10867	0.0	0.0
chr15	CAPN3	42389952	42390096	0	145	290	10244	290	10099	0.0	0.028715714427171007
chr15	CAPN3	42408210	42408324	0	115	290	10244	290	10129	0.0	0.028630664428867608
chr15	CAPN3	42410427	42410496	0	70	290	10244	290	10174	0.0	0.028504029880086493
chr15	CAPN3	42405925	42405943	0	19	290	10244	290	10225	0.0	0.028361858190709046
chr15	CAPN3	42405931	42405943	0	13	290	10244	290	10231	0.0	0.02834522529567002
chr15	CAPN3	42409302	42409380	188	79	290	10244	102	10165	2.3797468354430378	0.010034431874077718
chr15	CAPN3	42407866	42408324	0	459	290	10244	290	9785	0.0	0.02963719979560552
chr15	CAPN3	42409473	42409617	0	145	290	10244	290	10099	0.0	0.028715714427171007
chr15	CAPN3	42408470	42408774	0	305	290	10244	290	9939	0.0	0.029177985712848374
chr15	CAPN3	42408210	42408437	0	228	290	10244	290	10016	0.0	0.028953674121405752
chr15	CAPN3	42410431	42410496	0	66	290	10244	290	10178	0.0	0.028492827667518178
chr15	CAPN3	42411746	42411979	0	234	290	10244	290	10010	0.0	0.028971028971028972
chr15	SNAP23	42521613	42521708	800	96	38154	5373	37354	5277	8.333333333333334	7.0786431684669315
chr15	SNAP23	42528261	42528420	0	160	38154	5373	38154	5213	0.0	7.319010166890466
chr15	SNAP23	42511832	42511903	4155	72	38154	5373	33999	5301	57.708333333333336	6.4136955291454445
chr15	SNAP23	42529674	42529819	6547	146	38154	5373	31607	5227	44.842465753424655	6.046872010713602
chr15	HAUS2	42560781	42560870	0	90	28347	4312	28347	4222	0.0	6.714116532449077
chr15	HAUS2	42561269	42561402	0	134	28347	4312	28347	4178	0.0	6.7848252752513165
chr15	HAUS2	42558197	42558290	0	94	28347	4312	28347	4218	0.0	6.720483641536273
chr15	HAUS2	42559338	42559408	0	71	28347	4312	28347	4241	0.0	6.684036783777411
chr15	STARD9	42674826	42674964	0	139	18155	20421	18155	20282	0.0	0.895128685533971
chr15	STARD9	42717976	42718179	0	204	18155	20421	18155	20217	0.0	0.8980066280852748
chr15	STARD9	42673924	42673963	0	40	18155	20421	18155	20381	0.0	0.8907806290172219
chr15	TMEM62	43138573	43138619	0	47	3571	4393	3571	4346	0.0	0.8216751035434883
chr15	TMEM62	43146492	43146634	0	143	3571	4393	3571	4250	0.0	0.8402352941176471
chr15	TMEM62	43134256	43134368	0	113	3571	4393	3571	4280	0.0	0.8343457943925233
chr15	TMEM62	43178606	43178711	0	106	3571	4393	3571	4287	0.0	0.8329834383018427
chr15	CCNDBP1	43190054	43190151	0	98	102	5916	102	5818	0.0	0.017531797868683398
chr15	CCNDBP1	43186153	43186233	0	81	102	5916	102	5835	0.0	0.017480719794344474
chr15	CCNDBP1	43194080	43194137	0	58	102	5916	102	5858	0.0	0.017412086036189826
chr15	CCNDBP1	43185819	43185879	0	61	102	5916	102	5855	0.0	0.017421007685738683
chr15	ADAL	43331899	43332000	520	102	7310	5746	6790	5644	5.098039215686274	1.2030474840538625
chr15	ADAL	43334944	43335170	0	227	7310	5746	7310	5519	0.0	1.3245153107447
chr15	ADAL	43336625	43336686	0	62	7310	5746	7310	5684	0.0	1.2860661505981703
chr15	ADAL	43347015	43347096	0	82	7310	5746	7310	5664	0.0	1.2906073446327684
chr15	TUBGCP4	43403682	43403799	0	118	154381	9091	154381	8973	0.0	17.205059623314387
chr15	TUBGCP4	43399111	43399174	0	64	154381	9091	154381	9027	0.0	17.102138030353384
chr15	TUBGCP4	43385367	43385508	0	142	154381	9091	154381	8949	0.0	17.251201251536486
chr15	TUBGCP4	43403682	43403842	0	161	154381	9091	154381	8930	0.0	17.287905935050393
chr15	CKMT1B	43594971	43595170	0	200	0	3278	0	3078	0.0	0.0
chr15	CKMT1B	43594878	43595170	0	293	0	3278	0	2985	0.0	0.0
chr15	PDIA3	43753823	43753902	0	80	24442	4235	24442	4155	0.0	5.8825511432009625
chr15	PDIA3	43752801	43752946	0	146	24442	4235	24442	4089	0.0	5.9775006113964295
chr15	PDIA3	43751583	43751758	0	176	24442	4235	24442	4059	0.0	6.021680216802168
chr15	SERF2	43798943	43799107	983	165	11305	8388	10322	8223	5.957575757575758	1.2552596376018486
chr15	HYPK	43801131	43801187	0	57	15627	7451	15627	7394	0.0	2.1134703813903166
chr15	GOLM2	44322964	44323019	0	56	510	6143	510	6087	0.0	0.08378511582060127
chr15	GOLM2	44331987	44332078	0	92	510	6143	510	6051	0.0	0.0842835894893406
chr15	GOLM2	44338236	44338317	0	82	510	6143	510	6061	0.0	0.08414453060551064
chr15	GOLM2	44402886	44403054	0	169	510	6143	510	5974	0.0	0.08536993639102779
chr15	GOLM2	44319406	44319553	0	148	510	6143	510	5995	0.0	0.08507089241034195
chr15	CTDSPL2	44490783	44490999	0	217	854	9295	854	9078	0.0	0.09407358448997577
chr15	CTDSPL2	44501961	44502048	0	88	854	9295	854	9207	0.0	0.09275551211035082
chr15	CTDSPL2	44518653	44518864	45	212	854	9295	809	9083	0.21226415094339623	0.0890674887151822
chr15	EIF3J	44557488	44557650	0	163	101	3136	101	2973	0.0	0.0339724184325597
chr15	TRIM69	44754899	44755376	0	478	4488	6935	4488	6457	0.0	0.6950596252129472
chr15	TRIM69	44758620	44758854	204	235	4488	6935	4284	6700	0.8680851063829788	0.6394029850746269
chr15	TRIM69	44758612	44758803	202	192	4488	6935	4286	6743	1.0520833333333333	0.6356221266498591
chr15	TRIM69	44758612	44758854	204	243	4488	6935	4284	6692	0.8395061728395061	0.6401673640167364
chr15	TERB2	44961522	44961584	0	63	144	1509	144	1446	0.0	0.0995850622406639
chr15	TERB2	44976080	44976173	0	94	144	1509	144	1415	0.0	0.10176678445229682
chr15	SORD	45061066	45061226	0	161	3213	8966	3213	8805	0.0	0.3649063032367973
chr15	SORD	45060981	45061226	0	246	3213	8966	3213	8720	0.0	0.36846330275229355
chr15	DUOX1	45131470	45131662	2594	193	33293	8173	30699	7980	13.44041450777202	3.8469924812030074
chr15	DUOX1	45139426	45139599	88	174	33293	8173	33205	7999	0.5057471264367817	4.151143892986624
chr15	DUOX1	45131470	45131647	1152	178	33293	8173	32141	7995	6.47191011235955	4.020137585991245
chr15	SLC28A2	45263880	45264022	0	143	15	4685	15	4542	0.0	0.0033025099075297227
chr15	SLC28A2	45253199	45253296	0	98	15	4685	15	4587	0.0	0.0032701111837802484
chr15	SPATA5L1	45414570	45414780	0	211	0	3407	0	3196	0.0	0.0
chr15	SPATA5L1	45407028	45407223	0	196	0	3407	0	3211	0.0	0.0
chr15	HMGN2P46	45512372	45512449	0	78	1223	3103	1223	3025	0.0	0.40429752066115704
chr15	HMGN2P46	45515772	45515892	0	121	1223	3103	1223	2982	0.0	0.4101274312541918
chr15	BLOC1S6	45603099	45603187	0	89	0	6784	0	6695	0.0	0.0
chr15	BLOC1S6	45605427	45605514	0	88	0	6784	0	6696	0.0	0.0
chr15	BLOC1S6	45597879	45597891	0	13	0	6784	0	6771	0.0	0.0
chr15	BLOC1S6	45603103	45603187	0	85	0	6784	0	6699	0.0	0.0
chr15	BLOC1S6	45597879	45597996	0	118	0	6784	0	6666	0.0	0.0
chr15	BLOC1S6	45592134	45592276	0	143	0	6784	0	6641	0.0	0.0
chr15	BLOC1S6	45591457	45591575	0	119	0	6784	0	6665	0.0	0.0
chr15	BLOC1S6	45602356	45602375	0	20	0	6784	0	6764	0.0	0.0
chr15	BLOC1S6	45601233	45601407	0	175	0	6784	0	6609	0.0	0.0
chr15	SEMA6D	47603374	47603458	0	85	0	8530	0	8445	0.0	0.0
chr15	SEMA6D	47768580	47768615	0	36	0	8530	0	8494	0.0	0.0
chr15	SEMA6D	47767036	47767093	0	58	0	8530	0	8472	0.0	0.0
chr15	SEMA6D	47768580	47768748	0	169	0	8530	0	8361	0.0	0.0
chr15	SLC24A5	48121856	48122036	0	181	0	4769	0	4588	0.0	0.0
chr15	SLC12A1	48207533	48208139	0	607	0	8819	0	8212	0.0	0.0
chr15	SLC12A1	48217831	48217969	0	139	0	8819	0	8680	0.0	0.0
chr15	GALK2	49161763	49161861	0	99	121881	7192	121881	7093	0.0	17.183279289440293
chr15	GALK2	49161739	49161861	0	123	121881	7192	121881	7069	0.0	17.241618333569104
chr15	GALK2	49281986	49282085	11607	100	121881	7192	110274	7092	116.07	15.549069373942471
chr15	GALK2	49158844	49158968	0	125	121881	7192	121881	7067	0.0	17.246497806707232
chr15	GALK2	49195084	49195214	0	131	121881	7192	121881	7061	0.0	17.26115281121654
chr15	GALK2	49225204	49225349	0	146	121881	7192	121881	7046	0.0	17.297899517456713
chr15	GALK2	49185613	49185674	0	62	121881	7192	121881	7130	0.0	17.094109396914448
chr15	GALK2	49235624	49235739	0	116	121881	7192	121881	7076	0.0	17.22456189937818
chr15	GALK2	49318971	49319116	0	146	121881	7192	121881	7046	0.0	17.297899517456713
chr15	GALK2	49327951	49328130	0	180	121881	7192	121881	7012	0.0	17.381774101540216
chr15	DTWD1	49631000	49631058	98	59	6964	14874	6866	14815	1.6610169491525424	0.4634492068849139
chr15	DTWD1	49623670	49623798	306	129	6964	14874	6658	14745	2.372093023255814	0.4515428958969142
chr15	DTWD1	49630955	49631058	196	104	6964	14874	6768	14770	1.8846153846153846	0.45822613405551793
chr15	DTWD1	49633519	49633612	51	94	6964	14874	6913	14780	0.5425531914893617	0.46772665764546684
chr15	SLC27A2	50202486	50202645	0	160	0	2804	0	2644	0.0	0.0
chr15	SLC27A2	50198234	50198482	0	249	0	2804	0	2555	0.0	0.0
chr15	USP8	50432337	50432499	0	163	1082	20665	1082	20502	0.0	0.05277533899131792
chr15	USP8	50441348	50441493	0	146	1082	20665	1082	20519	0.0	0.052731614601101415
chr15	USP8	50449399	50449485	0	87	1082	20665	1082	20578	0.0	0.05258042569734668
chr15	USP8	50458999	50459162	0	164	1082	20665	1082	20501	0.0	0.05277791327252329
chr15	USP8	50484274	50484361	0	88	1082	20665	1082	20577	0.0	0.05258298099820188
chr15	USP8	50439008	50439177	0	170	1082	20665	1082	20495	0.0	0.05279336423517931
chr15	USP8	50424595	50424654	0	60	1082	20665	1082	20605	0.0	0.05251152632856103
chr15	AP4E1	50934623	50934697	0	75	70766	7376	70766	7301	0.0	9.692644843172168
chr15	AP4E1	50934535	50934697	0	163	70766	7376	70766	7213	0.0	9.810896991543046
chr15	AP4E1	50999071	50999262	16126	192	70766	7376	54640	7184	83.98958333333333	7.605790645879733
chr15	GLDN	51377448	51377500	0	53	0	7022	0	6969	0.0	0.0
chr15	GLDN	51383435	51383453	0	19	0	7022	0	7003	0.0	0.0
chr15	AC066613.1	51458719	51458929	0	211	0	3284	0	3073	0.0	0.0
chr15	SCG3	51688259	51688402	0	144	51	3183	51	3039	0.0	0.01678183613030602
chr15	SCG3	51682516	51682569	0	54	51	3183	51	3129	0.0	0.016299137104506232
chr15	TMOD2	51767070	51767152	0	83	8199	11560	8199	11477	0.0	0.714385292323778
chr15	TMOD2	51782720	51782828	0	109	8199	11560	8199	11451	0.0	0.7160073356038774
chr15	TMOD3	51834993	51835058	0	66	2217	8470	2217	8404	0.0	0.26380295097572587
chr15	TMOD3	51934249	51934354	0	106	2217	8470	2217	8364	0.0	0.26506456241033
chr15	UNC13C	54236429	54236435	0	7	102	14477	102	14470	0.0	0.007049067035245335
chr15	UNC13C	54512347	54512377	0	31	102	14477	102	14446	0.0	0.007060778070053994
chr15	PIGB	55327530	55327635	0	106	0	3377	0	3271	0.0	0.0
chr15	TEX9	56427604	56427739	204	136	18634	8304	18430	8168	1.5	2.256366307541626
chr15	TCF12	57063749	57063823	0	75	360	9218	360	9143	0.0	0.039374384775237886
chr15	TCF12	57232290	57232430	0	141	360	9218	360	9077	0.0	0.039660680841687786
chr15	TCF12	57252420	57252492	0	73	360	9218	360	9145	0.0	0.03936577364680153
chr15	TCF12	57072652	57072714	0	63	360	9218	360	9155	0.0	0.03932277444019661
chr15	LINC01413	57320792	57320959	0	168	0	991	0	823	0.0	0.0
chr15	GCOM1	57621607	57621700	0	94	0	8788	0	8694	0.0	0.0
chr15	GCOM1	57661449	57661533	0	85	0	8788	0	8703	0.0	0.0
chr15	GCOM1	57674967	57675068	0	102	0	8788	0	8686	0.0	0.0
chr15	GCOM1	57711983	57712188	0	206	0	8788	0	8582	0.0	0.0
chr15	GCOM1	57708713	57709358	0	646	0	8788	0	8142	0.0	0.0
chr15	GCOM1	57625778	57625892	0	115	0	8788	0	8673	0.0	0.0
chr15	GCOM1	57684401	57684674	0	274	0	8788	0	8514	0.0	0.0
chr15	GCOM1	57701552	57701714	0	163	0	8788	0	8625	0.0	0.0
chr15	GCOM1	57691898	57691972	0	75	0	8788	0	8713	0.0	0.0
chr15	GCOM1	57646136	57646669	0	534	0	8788	0	8254	0.0	0.0
chr15	LIPC	58430826	58431151	0	326	102	5004	102	4678	0.0	0.021804189824711415
chr15	LIPC	58538332	58538517	0	186	102	5004	102	4818	0.0	0.021170610211706103
chr15	LIPC	58541784	58541967	0	184	102	5004	102	4820	0.0	0.02116182572614108
chr15	MINDY2	58831773	58831916	0	144	0	9464	0	9320	0.0	0.0
chr15	RNF111	59004001	59004174	0	174	2174	7191	2174	7017	0.0	0.30981901097335046
chr15	CCNB2	59117227	59117368	204	142	4341	1785	4137	1643	1.4366197183098592	2.5179549604382228
chr15	FAM81A	59439023	59439064	0	42	3840	5589	3840	5547	0.0	0.6922660897782585
chr15	FAM81A	59439954	59440123	0	170	3840	5589	3840	5419	0.0	0.7086178261671895
chr15	RORA-AS1	60488523	60488591	0	69	0	2155	0	2086	0.0	0.0
chr15	RORA-AS1	60519965	60520269	0	305	0	2155	0	1850	0.0	0.0
chr15	RORA-AS1	60528579	60528727	0	149	0	2155	0	2006	0.0	0.0
chr15	RORA-AS2	60682358	60682433	1434	76	6892	1032	5458	956	18.86842105263158	5.7092050209205025
chr15	LINC02349	61730427	61730478	0	52	0	1102	0	1050	0.0	0.0
chr15	TPM1	63059562	63059680	280	119	18439	12357	18159	12238	2.3529411764705883	1.483820885765648
chr15	TPM1	63064063	63064190	0	128	18439	12357	18439	12229	0.0	1.5078093057486304
chr15	TPM1	63061712	63061788	51	77	18439	12357	18388	12280	0.6623376623376623	1.4973941368078176
chr15	TPM1	63064063	63064142	0	80	18439	12357	18439	12277	0.0	1.5019141484075915
chr15	TPM1	63043705	63043831	0	127	18439	12357	18439	12230	0.0	1.5076860179885527
chr15	TPM1	63044026	63044152	0	127	18439	12357	18439	12230	0.0	1.5076860179885527
chr15	TPM1	63061197	63061273	60	77	18439	12357	18379	12280	0.7792207792207793	1.4966612377850164
chr15	TPM1	63056984	63057118	0	135	18439	12357	18439	12222	0.0	1.5086728849615447
chr15	TPM1	63065895	63066085	0	191	18439	12357	18439	12166	0.0	1.5156172940983068
chr15	TPM1	63064063	63064982	0	920	18439	12357	18439	11437	0.0	1.61222348517968
chr15	AC087612.1	63106969	63107033	0	65	51	2049	51	1984	0.0	0.025705645161290324
chr15	RAB8B	63223041	63223073	0	33	0	5114	0	5081	0.0	0.0
chr15	RAB8B	63251283	63251342	0	60	0	5114	0	5054	0.0	0.0
chr15	RAB8B	63223847	63223979	0	133	0	5114	0	4981	0.0	0.0
chr15	APH1B	63287423	63287546	0	124	408	5418	408	5294	0.0	0.07706837929731772
chr15	APH1B	63302344	63302472	0	129	408	5418	408	5289	0.0	0.07714123652864435
chr15	APH1B	63278290	63278354	0	65	408	5418	408	5353	0.0	0.07621894264898188
chr15	USP3	63537024	63537156	0	133	49614	4757	49614	4624	0.0	10.729671280276817
chr15	USP3	63530497	63530590	0	94	49614	4757	49614	4663	0.0	10.639931374651512
chr15	USP3	63529013	63529166	0	154	49614	4757	49614	4603	0.0	10.778622637410384
chr15	USP3	63533802	63533918	338	117	49614	4757	49276	4640	2.888888888888889	10.619827586206897
chr15	USP3	63562894	63563008	0	115	49614	4757	49614	4642	0.0	10.688065489013356
chr15	USP3	63542054	63542192	90	139	49614	4757	49524	4618	0.6474820143884892	10.724122996968385
chr15	FBXL22	63599153	63599196	5901	44	168061	3617	162160	3573	134.11363636363637	45.38483067450322
chr15	SNX1	64115588	64115706	0	119	102	6495	102	6376	0.0	0.015997490589711418
chr15	SNX1	64126078	64126220	0	143	102	6495	102	6352	0.0	0.01605793450881612
chr15	SNX1	64123502	64123546	0	45	102	6495	102	6450	0.0	0.01581395348837209
chr15	SNX22	64152242	64152326	0	85	153	4065	153	3980	0.0	0.038442211055276385
chr15	TRIP4	64395397	64395531	0	135	677278	2870	677278	2735	0.0	247.63363802559414
chr15	TRIP4	64406329	64406459	51	131	677278	2870	677227	2739	0.3893129770992366	247.2533771449434
chr15	TRIP4	64414084	64414211	0	128	677278	2870	677278	2742	0.0	247.00145878920495
chr15	PLEKHO2	64848592	64848742	0	151	4891	3727	4891	3576	0.0	1.3677293064876956
chr15	ANKDD1A	64944651	64944747	0	97	1574	5051	1574	4954	0.0	0.317723052079128
chr15	ANKDD1A	64950953	64951233	0	281	1574	5051	1574	4770	0.0	0.329979035639413
chr15	HACD3	65534348	65534434	0	87	21088	7025	21088	6938	0.0	3.0394926491784378
chr15	HACD3	65556738	65556903	0	166	21088	7025	21088	6859	0.0	3.074500656072314
chr15	HACD3	65535720	65535834	0	115	21088	7025	21088	6910	0.0	3.051808972503618
chr15	SLC24A1	65645611	65645703	0	93	255	5844	255	5751	0.0	0.04434011476264997
chr15	SLC24A1	65651669	65651759	0	91	255	5844	255	5753	0.0	0.04432470015644012
chr15	SLC24A1	65638127	65638181	0	55	255	5844	255	5789	0.0	0.044049058559336676
chr15	RAB11A	65879670	65879751	357	82	311878	5691	311521	5609	4.353658536585366	55.539490105188094
chr15	RAB11A	65879724	65879751	0	28	311878	5691	311878	5663	0.0	55.07292954264524
chr15	DIS3L	66318448	66318618	0	171	0	5320	0	5149	0.0	0.0
chr15	ZWILCH	66508745	66508892	0	148	0	4786	0	4638	0.0	0.0
chr15	ZWILCH	66513987	66514083	0	97	0	4786	0	4689	0.0	0.0
chr15	ZWILCH	66508840	66508892	0	53	0	4786	0	4733	0.0	0.0
chr15	SMAD6	66717008	66717140	0	133	27301	8561	27301	8428	0.0	3.2393213099193168
chr15	SMAD6	66717011	66717140	0	130	27301	8561	27301	8431	0.0	3.2381686632665163
chr15	SMAD3	67184726	67184864	0	139	9416	7224	9416	7085	0.0	1.3290049400141144
chr15	SMAD3	67187019	67187130	0	112	9416	7224	9416	7112	0.0	1.3239595050618673
chr15	IQCH	67359846	67359885	48	40	32608	7149	32560	7109	1.2	4.580109720073147
chr15	IQCH	67395290	67395563	102	274	32608	7149	32506	6875	0.3722627737226277	4.728145454545454
chr15	IQCH	67490002	67490064	0	63	32608	7149	32608	7086	0.0	4.601749929438329
chr15	IQCH	67261271	67261394	0	124	32608	7149	32608	7025	0.0	4.641708185053381
chr15	IQCH	67344062	67344191	0	130	32608	7149	32608	7019	0.0	4.645676022225389
chr15	IQCH	67371427	67371533	16	107	32608	7149	32592	7042	0.14953271028037382	4.6282306163021865
chr15	MAP2K5	67727915	67727945	0	31	2746	5062	2746	5031	0.0	0.5458159411647784
chr15	MAP2K5	67748230	67748257	0	28	2746	5062	2746	5034	0.0	0.5454906634882797
chr15	PIAS1	68087841	68087890	0	50	0	5997	0	5947	0.0	0.0
chr15	PIAS1	68183629	68183667	0	39	0	5997	0	5958	0.0	0.0
chr15	NOX5	68974728	68974832	0	105	108	12548	108	12443	0.0	0.008679578879691393
chr15	NOX5	69038856	69038989	0	134	108	12548	108	12414	0.0	0.008699855002416627
chr15	EWSAT1	69089537	69089597	444	61	30054	3583	29610	3522	7.278688524590164	8.407155025553664
chr15	EWSAT1	69081185	69081376	2156	192	30054	3583	27898	3391	11.229166666666666	8.227071660277204
chr15	PAQR5	69359965	69360131	0	167	0	6270	0	6103	0.0	0.0
chr15	KIF23	69421991	69422128	0	138	0	6339	0	6201	0.0	0.0
chr15	KIF23	69440767	69441079	0	313	0	6339	0	6026	0.0	0.0
chr15	KIF23	69444789	69445041	0	253	0	6339	0	6086	0.0	0.0
chr15	KIF23	69444810	69445041	0	232	0	6339	0	6107	0.0	0.0
chr15	KIF23	69440307	69440487	0	181	0	6339	0	6158	0.0	0.0
chr15	KIF23	69425281	69425323	0	43	0	6339	0	6296	0.0	0.0
chr15	KIF23	69427369	69427499	0	131	0	6339	0	6208	0.0	0.0
chr15	KIF23	69439903	69440077	0	175	0	6339	0	6164	0.0	0.0
chr15	RPLP1	69455169	69455287	0	119	4117	3254	4117	3135	0.0	1.313237639553429
chr15	RPLP1	69453646	69453721	0	76	4117	3254	4117	3178	0.0	1.2954688483322845
chr15	DRAIC	69563589	69563804	16472	216	131161	25376	114689	25160	76.25925925925925	4.558386327503975
chr15	DRAIC	69464832	69464891	0	60	131161	25376	131161	25316	0.0	5.180952757149629
chr15	DRAIC	69467429	69467620	0	192	131161	25376	131161	25184	0.0	5.2081083227446
chr15	DRAIC	69548353	69548631	6845	279	131161	25376	124316	25097	24.53405017921147	4.953420727577001
chr15	DRAIC	69548353	69548485	3353	133	131161	25376	127808	25243	25.210526315789473	5.063106603810957
chr15	DRAIC	69466099	69466235	0	137	131161	25376	131161	25239	0.0	5.196758984111891
chr15	DRAIC	69619508	69619671	0	164	131161	25376	131161	25212	0.0	5.202324290020625
chr15	DRAIC	69684296	69684442	0	147	131161	25376	131161	25229	0.0	5.198818819612351
chr15	DRAIC	69548353	69548627	6701	275	131161	25376	124460	25101	24.367272727272727	4.958368192502291
chr15	DRAIC	69624927	69625192	0	266	131161	25376	131161	25110	0.0	5.223456790123457
chr15	DRAIC	69554228	69554374	0	147	131161	25376	131161	25229	0.0	5.198818819612351
chr15	DRAIC	69563601	69563804	15003	204	131161	25376	116158	25172	73.54411764705883	4.614571746384872
chr15	DRAIC	69578325	69578461	0	137	131161	25376	131161	25239	0.0	5.196758984111891
chr15	DRAIC	69671725	69671907	0	183	131161	25376	131161	25193	0.0	5.206247767236931
chr15	DRAIC	69681146	69681308	101	163	131161	25376	131060	25213	0.6196319018404908	5.198112085035498
chr15	LRRC49	70872907	70873223	0	317	7240	9178	7240	8861	0.0	0.8170635368468571
chr15	LRRC49	70900921	70901024	0	104	7240	9178	7240	9074	0.0	0.797884064359709
chr15	LRRC49	70911531	70911598	0	68	7240	9178	7240	9110	0.0	0.7947310647639956
chr15	LRRC49	70963784	70963932	0	149	7240	9178	7240	9029	0.0	0.8018606711706723
chr15	LRRC49	70980100	70980184	1830	85	7240	9178	5410	9093	21.529411764705884	0.5949631584735511
chr15	LRRC49	70898366	70898455	0	90	7240	9178	7240	9088	0.0	0.7966549295774648
chr15	LRRC49	70894571	70894669	0	99	7240	9178	7240	9079	0.0	0.7974446524947681
chr15	LRRC49	70895848	70895936	0	89	7240	9178	7240	9089	0.0	0.796567279128617
chr15	LRRC49	70894571	70894755	0	185	7240	9178	7240	8993	0.0	0.8050706104748138
chr15	LRRC49	70900456	70900582	0	127	7240	9178	7240	9051	0.0	0.7999116119765771
chr15	LRRC49	70900353	70900582	0	230	7240	9178	7240	8948	0.0	0.8091193562807332
chr15	LRRC49	70908603	70908676	0	74	7240	9178	7240	9104	0.0	0.7952548330404218
chr15	SENP8	72139311	72139435	0	125	7884	4933	7884	4808	0.0	1.639767054908486
chr15	TMEM202	72405969	72406039	0	71	476	1397	476	1326	0.0	0.358974358974359
chr15	TMEM202	72407085	72407217	476	133	476	1397	0	1264	3.5789473684210527	0.0
chr15	TMEM202	72398652	72398908	0	257	476	1397	476	1140	0.0	0.41754385964912283
chr15	ARIH1	72544819	72544964	0	146	36523	22087	36523	21941	0.0	1.6646005195752245
chr15	ARIH1	72572262	72572380	0	119	36523	22087	36523	21968	0.0	1.6625546249089584
chr15	BBS4	72715290	72715402	0	113	218	4162	218	4049	0.0	0.05384045443319338
chr15	BBS4	72729615	72729684	0	70	218	4162	218	4092	0.0	0.05327468230694037
chr15	BBS4	72695176	72695228	0	53	218	4162	218	4109	0.0	0.05305427111219275
chr15	BBS4	72686461	72686564	0	104	218	4162	218	4058	0.0	0.05372104484967965
chr15	BBS4	72697991	72698037	0	47	218	4162	218	4115	0.0	0.05297691373025516
chr15	BBS4	72704423	72704481	55	59	218	4162	163	4103	0.9322033898305084	0.039727029003168414
chr15	BBS4	72727939	72727994	0	56	218	4162	218	4106	0.0	0.053093034583536286
chr15	NEO1	73274691	73274724	0	34	35110	8169	35110	8135	0.0	4.315918869084204
chr15	NEO1	73293389	73293548	0	160	35110	8169	35110	8009	0.0	4.383818204519915
chr15	REC114	73540484	73540568	0	85	0	926	0	841	0.0	0.0
chr15	CD276	73699585	73699718	0	134	0	5220	0	5086	0.0	0.0
chr15	CD276	73697595	73697702	0	108	0	5220	0	5112	0.0	0.0
chr15	CD276	73690670	73690776	0	107	0	5220	0	5113	0.0	0.0
chr15	TBC1D21	73881398	73881506	0	109	480	1281	480	1172	0.0	0.40955631399317405
chr15	TBC1D21	73884780	73884891	0	112	480	1281	480	1169	0.0	0.41060735671514115
chr15	LOXL1	73941874	73942058	0	185	0	3644	0	3459	0.0	0.0
chr15	PML	74032571	74032715	0	145	30510	10347	30510	10202	0.0	2.9905900803763967
chr15	PML	74033155	74033414	0	260	30510	10347	30510	10087	0.0	3.0246852384256964
chr15	PML	74033155	74033422	0	268	30510	10347	30510	10079	0.0	3.0270860204385355
chr15	CCDC33	74331202	74331296	440	95	39229	6959	38789	6864	4.631578947368421	5.651078088578089
chr15	CCDC33	74333220	74333322	714	103	39229	6959	38515	6856	6.932038834951456	5.617707117852976
chr15	PPIAP46	74356282	74356475	0	194	2080	3706	2080	3512	0.0	0.592255125284738
chr15	UBL7-AS1	74466035	74466130	64	96	13523	2142	13459	2046	0.6666666666666666	6.578201368523949
chr15	UBL7-AS1	74480620	74480914	3856	295	13523	2142	9667	1847	13.071186440677966	5.233892799133731
chr15	CLK3	74606242	74606415	0	174	0	14732	0	14558	0.0	0.0
chr15	CLK3	74622119	74622216	0	98	0	14732	0	14634	0.0	0.0
chr15	CLK3	74627969	74628052	0	84	0	14732	0	14648	0.0	0.0
chr15	CLK3	74622493	74622560	0	68	0	14732	0	14664	0.0	0.0
chr15	CLK3	74619196	74619348	0	153	0	14732	0	14579	0.0	0.0
chr15	CLK3	74626988	74627066	0	79	0	14732	0	14653	0.0	0.0
chr15	CSK	74798232	74798312	0	81	3638	4066	3638	3985	0.0	0.9129234629861982
chr15	CSK	74798211	74798312	0	102	3638	4066	3638	3964	0.0	0.9177598385469223
chr15	LMAN1L	74816426	74816534	0	109	867	4050	867	3941	0.0	0.21999492514590205
chr15	LMAN1L	74813419	74813479	0	61	867	4050	867	3989	0.0	0.2173477061920281
chr15	LMAN1L	74813336	74813479	0	144	867	4050	867	3906	0.0	0.22196620583717358
chr15	MPI	74890552	74890654	0	103	23569	7175	23569	7072	0.0	3.332720588235294
chr15	MPI	74893137	74893320	1020	184	23569	7175	22549	6991	5.543478260869565	3.225432699184666
chr15	MPI	74890526	74890654	0	129	23569	7175	23569	7046	0.0	3.3450184501845017
chr15	MPI	74890978	74891035	0	58	23569	7175	23569	7117	0.0	3.3116481663622315
chr15	MPI	74890555	74890654	0	100	23569	7175	23569	7075	0.0	3.3313074204946997
chr15	MPI	74890437	74890654	261	218	23569	7175	23308	6957	1.1972477064220184	3.350294667241627
chr15	MPI	74897010	74897219	0	210	23569	7175	23569	6965	0.0	3.3839195979899497
chr15	SCAMP5	75009890	75009940	0	51	10627	4634	10627	4583	0.0	2.3187868208596987
chr15	SCAMP5	75016592	75016749	0	158	10627	4634	10627	4476	0.0	2.374218051831993
chr15	SCAMP5	75007587	75007728	0	142	10627	4634	10627	4492	0.0	2.3657613535173643
chr15	SCAMP5	75007660	75007728	0	69	10627	4634	10627	4565	0.0	2.3279299014238775
chr15	SCAMP5	74997233	74997316	0	84	10627	4634	10627	4550	0.0	2.3356043956043955
chr15	PPCDC	75028246	75028453	0	208	153	3493	153	3285	0.0	0.04657534246575343
chr15	PPCDC	75043440	75043536	0	97	153	3493	153	3396	0.0	0.045053003533568906
chr15	PPCDC	75044385	75044514	0	130	153	3493	153	3363	0.0	0.045495093666369314
chr15	C15ORF39	75201960	75202059	0	100	28455	5813	28455	5713	0.0	4.980745667775249
chr15	COMMD4	75338354	75338420	1634	67	110505	4643	108871	4576	24.388059701492537	23.79173951048951
chr15	COMMD4	75339701	75339878	1434	178	110505	4643	109071	4465	8.0561797752809	24.427995520716685
chr15	COMMD4	75339263	75339344	865	82	110505	4643	109640	4561	10.548780487804878	24.03858802894102
chr15	NEIL1	75347958	75348026	2	69	16767	6176	16765	6107	0.028985507246376812	2.7452104142786964
chr15	NEIL1	75347958	75347999	0	42	16767	6176	16767	6134	0.0	2.7334528855559177
chr15	NEIL1	75352110	75352230	51	121	16767	6176	16716	6055	0.4214876033057851	2.7606936416184973
chr15	NEIL1	75353738	75353866	816	129	16767	6176	15951	6047	6.325581395348837	2.6378369439391434
chr15	NEIL1	75351300	75351376	0	77	16767	6176	16767	6099	0.0	2.749139203148057
chr15	NEIL1	75347834	75347999	51	166	16767	6176	16716	6010	0.3072289156626506	2.7813643926788685
chr15	NEIL1	75348420	75348646	81	227	16767	6176	16686	5949	0.3568281938325991	2.804841149773071
chr15	AC019294.2	75762022	75762129	252	108	340767	6185	340515	6077	2.3333333333333335	56.03340464044759
chr15	AC019294.2	75762654	75762749	0	96	340767	6185	340767	6089	0.0	55.964361964197735
chr15	AC019294.2	75762674	75762749	0	76	340767	6185	340767	6109	0.0	55.781142576526435
chr15	AC019294.2	75761168	75761347	49331	180	340767	6185	291436	6005	274.06111111111113	48.53222314737719
chr15	AC019294.2	75761461	75761519	0	59	340767	6185	340767	6126	0.0	55.62634671890304
chr15	AC019294.1	75782579	75782659	18767	81	19379	2130	612	2049	231.69135802469137	0.2986822840409956
chr15	UBE2Q2	75859877	75859982	0	106	71035	3845	71035	3739	0.0	18.998395292859055
chr15	UBE2Q2	75896994	75897061	96	68	71035	3845	70939	3777	1.411764705882353	18.781837437119407
chr15	FBXO22	75904490	75904629	51	140	185925	11121	185874	10981	0.36428571428571427	16.926873690920683
chr15	FBXO22	75917229	75917394	16	166	185925	11121	185909	10955	0.0963855421686747	16.970241898676402
chr15	TMEM266	76156603	76156652	15	50	53891	5159	53876	5109	0.3	10.545312194167156
chr15	TMEM266	76156603	76156758	780	156	53891	5159	53111	5003	5.0	10.61583050169898
chr15	ISL2	76338251	76338514	0	264	39	2177	39	1913	0.0	0.020386826973340304
chr15	RCN2	76941636	76941690	0	55	480	8781	480	8726	0.0	0.0550080220032088
chr15	RCN2	76938725	76938815	0	91	480	8781	480	8690	0.0	0.05523590333716916
chr15	PSTPIP1	77032861	77032952	0	92	1530	4597	1530	4505	0.0	0.33962264150943394
chr15	PSTPIP1	77007846	77008065	0	220	1530	4597	1530	4377	0.0	0.34955448937628514
chr15	PSTPIP1	76999460	76999614	0	155	1530	4597	1530	4442	0.0	0.3444394416929311
chr15	PSTPIP1	77026115	77026172	0	58	1530	4597	1530	4539	0.0	0.33707865168539325
chr15	HMG20A	77447718	77447811	0	94	0	5473	0	5379	0.0	0.0
chr15	LINGO1-AS1	77647838	77647961	0	124	726	2553	726	2429	0.0	0.29888843145327293
chr15	IDH3A	78164991	78165076	0	86	0	5879	0	5793	0.0	0.0
chr15	IDH3A	78157547	78157631	0	85	0	5879	0	5794	0.0	0.0
chr15	IDH3A	78156907	78157162	0	256	0	5879	0	5623	0.0	0.0
chr15	IDH3A	78160091	78160206	0	116	0	5879	0	5763	0.0	0.0
chr15	IDH3A	78151288	78151544	0	257	0	5879	0	5622	0.0	0.0
chr15	IDH3A	78157572	78157631	0	60	0	5879	0	5819	0.0	0.0
chr15	IDH3A	78154434	78154819	0	386	0	5879	0	5493	0.0	0.0
chr15	IDH3A	78150803	78150960	0	158	0	5879	0	5721	0.0	0.0
chr15	DNAJA4	78270496	78270677	0	182	0	5692	0	5510	0.0	0.0
chr15	IREB2	78462921	78463087	0	167	2369	8021	2369	7854	0.0	0.3016297428062134
chr15	IREB2	78470531	78470601	0	71	2369	8021	2369	7950	0.0	0.2979874213836478
chr15	HYKK	78518587	78518773	0	187	0	5714	0	5527	0.0	0.0
chr15	PSMA4	78542575	78542645	102	71	102	5745	0	5674	1.4366197183098592	0.0
chr15	PSMA4	78544189	78544267	0	79	102	5745	102	5666	0.0	0.018002117896223083
chr15	PSMA4	78546574	78546698	0	125	102	5745	102	5620	0.0	0.018149466192170817
chr15	PSMA4	78542176	78542219	0	44	102	5745	102	5701	0.0	0.017891597965269252
chr15	PSMA4	78542482	78542645	102	164	102	5745	0	5581	0.6219512195121951	0.0
chr15	MORF4L1	78887268	78887349	12	82	14290	6570	14278	6488	0.14634146341463414	2.200678175092478
chr15	MORF4L1	78878212	78878259	0	48	14290	6570	14290	6522	0.0	2.191045691505673
chr15	MORF4L1	78884966	78885083	894	118	14290	6570	13396	6452	7.576271186440678	2.0762554246745197
chr15	MORF4L1	78880511	78880579	0	69	14290	6570	14290	6501	0.0	2.198123365636056
chr15	MORF4L1	78884969	78885083	894	115	14290	6570	13396	6455	7.773913043478261	2.0752904725019365
chr15	TMED3	79314540	79314655	0	116	152	19420	152	19304	0.0	0.007874015748031496
chr15	MINAR1	79463694	79463760	0	67	0	6999	0	6932	0.0	0.0
chr15	ZFAND6	80075163	80075242	0	80	109021	3588	109021	3508	0.0	31.07782212086659
chr15	ZFAND6	80131179	80131293	0	115	109021	3588	109021	3473	0.0	31.39101641232364
chr15	ZFAND6	80115026	80115070	0	45	109021	3588	109021	3543	0.0	30.77081569291561
chr15	ZFAND6	80112775	80112854	0	80	109021	3588	109021	3508	0.0	31.07782212086659
chr15	ZFAND6	80098415	80098578	0	164	109021	3588	109021	3424	0.0	31.840245327102803
chr15	ZFAND6	80111427	80111559	0	133	109021	3588	109021	3455	0.0	31.55455861070912
chr15	ZFAND6	80073265	80073330	0	66	109021	3588	109021	3522	0.0	30.95428733674049
chr15	ZFAND6	80075163	80075315	0	153	109021	3588	109021	3435	0.0	31.738282387190683
chr15	ARNT2	80442836	80443025	0	190	1001	7678	1001	7488	0.0	0.13368055555555555
chr15	CEMIP	80941848	80942053	0	206	37809	7651	37809	7445	0.0	5.078441907320349
chr15	CEMIP	80873537	80873696	6018	160	37809	7651	31791	7491	37.6125	4.2438926712054466
chr15	CEMIP	80873537	80873636	3833	100	37809	7651	33976	7551	38.33	4.499536485233744
chr15	IL16	81289903	81290045	312	143	54470	11081	54158	10938	2.1818181818181817	4.9513622234412145
chr15	IL16	81188352	81188403	546	52	54470	11081	53924	11029	10.5	4.8892918668963645
chr15	IL16	81295331	81295520	29303	190	54470	11081	25167	10891	154.2263157894737	2.3108070884216327
chr15	AC103858.3	81319267	81319542	0	276	918	4001	918	3725	0.0	0.24644295302013422
chr15	TMC3-AS1	81332344	81332541	0	198	3389	12395	3389	12197	0.0	0.2778552102976142
chr15	TMC3-AS1	81341561	81341708	0	148	3389	12395	3389	12247	0.0	0.2767208295909202
chr15	TMC3-AS1	81380208	81380260	0	53	3389	12395	3389	12342	0.0	0.2745908280667639
chr15	TMC3-AS1	81341149	81341219	0	71	3389	12395	3389	12324	0.0	0.2749918857513794
chr15	TMC3-AS1	81380208	81380254	0	47	3389	12395	3389	12348	0.0	0.2744574020084224
chr15	TMC3-AS1	81388864	81388991	0	128	3389	12395	3389	12267	0.0	0.2762696665851471
chr15	SAXO2	82263358	82263438	0	81	0	4166	0	4085	0.0	0.0
chr15	SAXO2	82263138	82263188	0	51	0	4166	0	4115	0.0	0.0
chr15	SAXO2	82265568	82265748	0	181	0	4166	0	3985	0.0	0.0
chr15	UBE2Q2P2	82407130	82407305	0	176	48	1868	48	1692	0.0	0.028368794326241134
chr15	UBE2Q2P6	82446655	82446834	0	180	84	460	84	280	0.0	0.3
chr15	CSPG4P10	82469273	82469472	0	200	51	7192	51	6992	0.0	0.007294050343249428
chr15	CSPG4P10	82465234	82465428	0	195	51	7192	51	6997	0.0	0.007288838073460055
chr15	SNHG21	82756729	82756785	150	57	714	1055	564	998	2.6315789473684212	0.5651302605210421
chr15	TM6SF1	83121920	83122003	0	84	8557	2508	8557	2424	0.0	3.530115511551155
chr15	TM6SF1	83126754	83126847	0	94	8557	2508	8557	2414	0.0	3.544739022369511
chr15	ADAMTSL3	83885100	83885212	0	113	26590	9724	26590	9611	0.0	2.766621579440225
chr15	EFL1P1	84102874	84103012	0	139	47	1770	47	1631	0.0	0.028816676885346414
chr15	LINC00933	84573021	84573251	0	231	357	3006	357	2775	0.0	0.12864864864864864
chr15	ZSCAN2	84603819	84604200	0	382	0	4531	0	4149	0.0	0.0
chr15	ZSCAN2	84602186	84602250	0	65	0	4531	0	4466	0.0	0.0
chr15	ZSCAN2	84603819	84604333	0	515	0	4531	0	4016	0.0	0.0
chr15	ZSCAN2	84601998	84602250	0	253	0	4531	0	4278	0.0	0.0
chr15	ZSCAN2	84601973	84602250	0	278	0	4531	0	4253	0.0	0.0
chr15	ZSCAN2	84603819	84604330	0	512	0	4531	0	4019	0.0	0.0
chr15	ZSCAN2	84622577	84622714	0	138	0	4531	0	4393	0.0	0.0
chr15	SCAND2P	84635851	84635912	0	62	102	9041	102	8979	0.0	0.011359839625793518
chr15	SLC28A1	84886671	84886787	0	117	724	3467	724	3350	0.0	0.21611940298507462
chr15	PDE8A	85089337	85089416	13	80	7454	8029	7441	7949	0.1625	0.9360925902629261
chr15	PDE8A	85091043	85091181	1326	139	7454	8029	6128	7890	9.53956834532374	0.776679340937896
chr15	PDE8A	85090717	85090915	138	199	7454	8029	7316	7830	0.6934673366834171	0.9343550446998723
chr15	PDE8A	85097947	85098036	0	90	7454	8029	7454	7939	0.0	0.9389091825166898
chr15	AKAP13	85658536	85658590	0	55	101279	16938	101279	16883	0.0	5.998874607593438
chr15	AKAP13	85662387	85662453	1528	67	101279	16938	99751	16871	22.80597014925373	5.91257186888744
chr15	AKAP13	85480872	85481026	51	155	101279	16938	101228	16783	0.32903225806451614	6.031579574569505
chr15	MRPS11	88476988	88477054	0	67	2841	5633	2841	5566	0.0	0.5104204096298958
chr15	MRPS11	88472626	88472725	20	100	2841	5633	2821	5533	0.2	0.5098499909633111
chr15	ACAN	88860325	88860439	0	115	0	10933	0	10818	0.0	0.0
chr15	ACAN	88868215	88868329	0	115	0	10933	0	10818	0.0	0.0
chr15	ACAN	88873841	88874024	0	184	0	10933	0	10749	0.0	0.0
chr15	ACAN	88873841	88874059	0	219	0	10933	0	10714	0.0	0.0
chr15	ABHD2	89102499	89102576	8	78	10891	10080	10883	10002	0.10256410256410256	1.0880823835232953
chr15	ABHD2	89104181	89104270	0	90	10891	10080	10891	9990	0.0	1.0901901901901903
chr15	ABHD2	89103902	89104044	0	143	10891	10080	10891	9937	0.0	1.0960048304317198
chr15	FANCI	89294914	89295094	0	181	0	11868	0	11687	0.0	0.0
chr15	FANCI	89306006	89306194	0	189	0	11868	0	11679	0.0	0.0
chr15	FANCI	89311646	89311778	0	133	0	11868	0	11735	0.0	0.0
chr15	FANCI	89245606	89245708	0	103	0	11868	0	11765	0.0	0.0
chr15	FANCI	89294956	89295094	0	139	0	11868	0	11729	0.0	0.0
chr15	FANCI	89245755	89245839	0	85	0	11868	0	11783	0.0	0.0
chr15	FANCI	89306009	89306194	0	186	0	11868	0	11682	0.0	0.0
chr15	MIR9-3HG	89379047	89379269	0	223	0	8103	0	7880	0.0	0.0
chr15	MIR9-3HG	89388503	89388581	0	79	0	8103	0	8024	0.0	0.0
chr15	MIR9-3HG	89388500	89388581	0	82	0	8103	0	8021	0.0	0.0
chr15	MIR9-3HG	89368046	89368235	0	190	0	8103	0	7913	0.0	0.0
chr15	MIR9-3HG	89387430	89387538	0	109	0	8103	0	7994	0.0	0.0
chr15	MIR9-3HG	89387430	89387497	0	68	0	8103	0	8035	0.0	0.0
chr15	MIR9-3HG	89386788	89386902	0	115	0	8103	0	7988	0.0	0.0
chr15	MIR9-3HG	89388041	89388091	0	51	0	8103	0	8052	0.0	0.0
chr15	MIR9-3HG	89379752	89379917	0	166	0	8103	0	7937	0.0	0.0
chr15	MIR9-3HG	89388483	89388581	0	99	0	8103	0	8004	0.0	0.0
chr15	MIR9-3HG	89388503	89388746	0	244	0	8103	0	7859	0.0	0.0
chr15	MESP2	89764799	89764920	0	122	471	1813	471	1691	0.0	0.2785334121821407
chr15	SEMA4B	90201457	90201735	0	279	28673	5402	28673	5123	0.0	5.596915869607652
chr15	SEMA4B	90220981	90221093	0	113	28673	5402	28673	5289	0.0	5.421251654377009
chr15	SEMA4B	90214936	90214964	0	29	28673	5402	28673	5373	0.0	5.336497301321422
chr15	GDPGP1	90236062	90236181	0	120	2521	5771	2521	5651	0.0	0.4461157317288975
chr15	TTLL13P	90262491	90262669	0	179	52	3011	52	2832	0.0	0.018361581920903956
chr15	ZNF774	90354641	90354764	8801	124	43809	6373	35008	6249	70.9758064516129	5.602176348215714
chr15	ZNF774	90355350	90355416	4600	67	43809	6373	39209	6306	68.65671641791045	6.217729146844276
chr15	IQGAP1	90390773	90390873	90	101	109421	10694	109331	10593	0.8910891089108911	10.321061078070423
chr15	IQGAP1	90482701	90482749	0	49	109421	10694	109421	10645	0.0	10.279098168154063
chr15	IQGAP1	90431220	90431252	0	33	109421	10694	109421	10661	0.0	10.263671325391615
chr15	CRTC3	90614452	90614488	0	37	45602	10839	45602	10802	0.0	4.221625624884281
chr15	CRTC3	90617882	90617968	6261	87	45602	10839	39341	10752	71.96551724137932	3.6589471726190474
chr15	LINC01585	90661392	90661483	0	92	0	1507	0	1415	0.0	0.0
chr15	BLM	90760146	90760279	2123	134	658966	6681	656843	6547	15.843283582089553	100.32732549259202
chr15	BLM	90765295	90765414	0	120	658966	6681	658966	6561	0.0	100.43682365493065
chr15	BLM	90811677	90811800	945	124	658966	6681	658021	6557	7.620967741935484	100.35397285343907
chr15	BLM	90759980	90760279	2248	300	658966	6681	656718	6381	7.493333333333333	102.91772449459333
chr15	FES	90893935	90894058	0	124	4677	4121	4677	3997	0.0	1.1701275956967725
chr15	FES	90885411	90885585	0	175	4677	4121	4677	3946	0.0	1.185250886974151
chr15	FES	90890981	90891191	0	211	4677	4121	4677	3910	0.0	1.1961636828644502
chr15	MAN2A2	90903230	90903734	212	505	12145	9354	11933	8849	0.4198019801980198	1.3485139563792519
chr15	MAN2A2	90903230	90903432	45	203	12145	9354	12100	9151	0.22167487684729065	1.32225986231013
chr15	MAN2A2	90910089	90910292	0	204	12145	9354	12145	9150	0.0	1.3273224043715848
chr15	MAN2A2	90912541	90912664	0	124	12145	9354	12145	9230	0.0	1.3158179848320692
chr15	MAN2A2	90913272	90913374	0	103	12145	9354	12145	9251	0.0	1.3128310452924008
chr15	MAN2A2	90912516	90912664	0	149	12145	9354	12145	9205	0.0	1.3193916349809887
chr15	MAN2A2	90913272	90913406	0	135	12145	9354	12145	9219	0.0	1.3173880030372058
chr15	MAN2A2	90910215	90910292	0	78	12145	9354	12145	9276	0.0	1.3092927986200948
chr15	MAN2A2	90916585	90916660	0	76	12145	9354	12145	9278	0.0	1.3090105626212545
chr15	UNC45A	90930952	90931052	0	101	23450	7365	23450	7264	0.0	3.228248898678414
chr15	UNC45A	90942436	90942605	0	170	23450	7365	23450	7195	0.0	3.2592077831827657
chr15	RCCD1	90957112	90957503	0	392	1613	3739	1613	3347	0.0	0.48192411114430833
chr15	RCCD1	90955799	90955883	0	85	1613	3739	1613	3654	0.0	0.44143404488232074
chr15	SV2B	91225872	91226714	153	843	48776	12490	48623	11647	0.18149466192170818	4.174723104662145
chr15	SV2B	91128722	91128810	0	89	48776	12490	48776	12401	0.0	3.933231191032981
chr15	CRAT37	91584590	91584720	0	131	121720	3408	121720	3277	0.0	37.14372902044553
chr15	SLCO3A1	92162755	92162998	0	244	0	7352	0	7108	0.0	0.0
chr15	ST8SIA2	92430048	92430111	0	64	4809	5856	4809	5792	0.0	0.8302831491712708
chr15	ST8SIA2	92434246	92434375	0	130	4809	5856	4809	5726	0.0	0.8398533007334963
chr15	AC091544.2	92599171	92599445	0	275	0	3868	0	3593	0.0	0.0
chr15	CHASERR	92883584	92883778	0	195	37	5803	37	5608	0.0	0.006597717546362339
chr15	CHD2	92937517	92937625	0	109	39341	16852	39341	16743	0.0	2.349698381413128
chr15	CHD2	92901166	92901299	0	134	39341	16852	39341	16718	0.0	2.353212106711329
chr15	CHD2	92945820	92945865	0	46	39341	16852	39341	16806	0.0	2.340890158276806
chr15	CHD2	92972264	92972417	0	154	39341	16852	39341	16698	0.0	2.356030662354773
chr15	CHD2	92991692	92991759	1151	68	39341	16852	38190	16784	16.926470588235293	2.275381315538608
chr15	CHD2	92998148	92998261	0	114	39341	16852	39341	16738	0.0	2.3504002867726133
chr15	CHD2	92998137	92998261	0	125	39341	16852	39341	16727	0.0	2.351945955640581
chr15	AC091078.1	93531421	93531577	0	157	12863	7503	12863	7346	0.0	1.7510209637898175
chr15	AC091078.1	93322222	93322346	9	125	12863	7503	12854	7378	0.072	1.7422065600433723
chr15	AC091078.1	93373509	93373585	0	77	12863	7503	12863	7426	0.0	1.7321572852141125
chr15	AC091078.1	93532772	93532973	0	202	12863	7503	12863	7301	0.0	1.7618134502122997
chr15	AC091078.1	93331266	93331432	1594	167	12863	7503	11269	7336	9.544910179640718	1.536123227917121
chr15	AC091078.1	93483090	93483228	0	139	12863	7503	12863	7364	0.0	1.7467409016838675
chr15	AC091078.1	93496233	93496331	0	99	12863	7503	12863	7404	0.0	1.7373041599135601
chr15	AC091078.1	93323598	93323651	128	54	12863	7503	12735	7449	2.3703703703703702	1.7096254530809505
chr15	LINC02207	93865373	93865648	0	276	448	7807	448	7531	0.0	0.0594874518656221
chr15	LINC02207	93869690	93869833	0	144	448	7807	448	7663	0.0	0.058462743051024404
chr15	LINC02207	93844225	93844861	0	637	448	7807	448	7170	0.0	0.06248256624825663
chr15	LINC02207	93864929	93865045	0	117	448	7807	448	7690	0.0	0.05825747724317295
chr15	LINC02207	93844225	93844338	0	114	448	7807	448	7693	0.0	0.05823475887170155
chr15	LINC02207	93877227	93877294	0	68	448	7807	448	7739	0.0	0.05788861610027135
chr15	LINC02207	93865342	93865648	0	307	448	7807	448	7500	0.0	0.05973333333333333
chr15	LINC02207	93874933	93875110	0	178	448	7807	448	7629	0.0	0.05872329269891204
chr15	LINC02207	93839485	93839660	0	176	448	7807	448	7631	0.0	0.0587079019787708
chr15	LINC02207	93844225	93845206	0	982	448	7807	448	6825	0.0	0.06564102564102564
chr15	LINC02207	93858955	93859332	0	378	448	7807	448	7429	0.0	0.06030421321846816
chr15	LINC01580	93946697	93946755	0	59	19	2674	19	2615	0.0	0.007265774378585086
chr15	LINC01580	93946642	93946755	0	114	19	2674	19	2560	0.0	0.007421875
chr15	LINC01580	93899486	93899603	0	118	19	2674	19	2556	0.0	0.007433489827856025
chr15	LINC01580	93971414	93971436	0	23	19	2674	19	2651	0.0	0.007167106752168993
chr15	MCTP2	94314726	94314864	0	139	258	13201	258	13062	0.0	0.01975195222783647
chr15	AC087633.2	94901911	94902120	0	210	85	3304	85	3094	0.0	0.027472527472527472
chr15	AC087633.2	95018795	95018869	0	75	85	3304	85	3229	0.0	0.026323939300092906
chr15	LINC00924	95498392	95498479	0	88	0	4125	0	4037	0.0	0.0
chr15	LINC00924	95497680	95498000	0	321	0	4125	0	3804	0.0	0.0
chr15	AC015574.1	95712576	95712657	0	82	0	7835	0	7753	0.0	0.0
chr15	AC015574.1	95810078	95810116	0	39	0	7835	0	7796	0.0	0.0
chr15	AC015574.1	95810075	95810116	0	42	0	7835	0	7793	0.0	0.0
chr15	AC015574.1	95652847	95652956	0	110	0	7835	0	7725	0.0	0.0
chr15	AC012409.1	96173403	96173501	0	99	0	760	0	661	0.0	0.0
chr15	AC087477.2	96361141	96361289	0	149	0	4301	0	4152	0.0	0.0
chr15	AC087477.2	96372408	96372608	0	201	0	4301	0	4100	0.0	0.0
chr15	LINC02253	97372327	97372391	0	65	0	1928	0	1863	0.0	0.0
chr15	LINC02253	97429769	97429889	0	121	0	1928	0	1807	0.0	0.0
chr15	LINC02253	97429048	97429204	0	157	0	1928	0	1771	0.0	0.0
chr15	LINC02251	98007043	98007169	0	127	0	2090	0	1963	0.0	0.0
chr15	LINC02251	98003379	98003460	0	82	0	2090	0	2008	0.0	0.0
chr15	IGF1R	98934823	98935053	0	231	336	13877	336	13646	0.0	0.02462260002931262
chr15	LUNAR1	99027564	99027789	0	226	0	1690	0	1464	0.0	0.0
chr15	LUNAR1	99026483	99026578	0	96	0	1690	0	1594	0.0	0.0
chr15	SYNM	99129366	99131813	204	2448	204	6844	0	4396	0.08333333333333333	0.0
chr15	LRRC28	99276575	99276616	0	42	351	6078	351	6036	0.0	0.05815109343936382
chr15	LRRC28	99363105	99363265	0	161	351	6078	351	5917	0.0	0.05932060165624472
chr15	LRRC28	99285767	99285784	0	18	351	6078	351	6060	0.0	0.057920792079207924
chr15	MEF2A	99598429	99598511	0	83	31203	5257	31203	5174	0.0	6.0307305759567065
chr15	MEF2A	99703361	99703385	0	25	31203	5257	31203	5232	0.0	5.963876146788991
chr15	MEF2A	99645560	99645764	1938	205	31203	5257	29265	5052	9.453658536585365	5.792755344418052
chr15	MEF2A	99620890	99621080	0	191	31203	5257	31203	5066	0.0	6.159297275957363
chr15	AC090825.1	99812972	99813086	0	115	9044	7652	9044	7537	0.0	1.199946928486135
chr15	AC090825.1	99839082	99839134	0	53	9044	7652	9044	7599	0.0	1.1901565995525727
chr15	AC090825.1	99880676	99880827	0	152	9044	7652	9044	7500	0.0	1.2058666666666666
chr15	ASB7	100629436	100630042	51	607	306	5344	255	4737	0.08401976935749589	0.05383153894870171
chr15	AC015712.1	100850210	100850332	0	123	0	1487	0	1364	0.0	0.0
chr15	AC015712.1	100855230	100855348	0	119	0	1487	0	1368	0.0	0.0
chr15	AC015712.1	100854643	100854787	0	145	0	1487	0	1342	0.0	0.0
chr15	ALDH1A3	100892509	100892639	0	131	0	5350	0	5219	0.0	0.0
chr15	LRRK1	100920030	100920255	0	226	102	17485	102	17259	0.0	0.0059099600208586825
chr15	LRRK1	101048493	101048657	0	165	102	17485	102	17320	0.0	0.005889145496535797
chr15	LRRK1	101067239	101067387	0	149	102	17485	102	17336	0.0	0.005883710198431011
chr15	WASH3P	101971822	101972049	0	228	0	2365	0	2137	0.0	0.0
chr15	HERC2P3	20461191	20461342	0	152	2012	9444	2012	9292	0.0	0.21653034868704263
chr15	HERC2P3	20466194	20466370	0	177	2012	9444	2012	9267	0.0	0.2171144922844502
chr15	HERC2P3	20483402	20483517	0	116	2012	9444	2012	9328	0.0	0.21569468267581476
chr15	HERC2P3	20501545	20501714	0	170	2012	9444	2012	9274	0.0	0.21695061462152254
chr15	HERC2P3	20476924	20477056	0	133	2012	9444	2012	9311	0.0	0.21608849747610354
chr15	NBEAP1	20669972	20670095	0	124	15737	3699	15737	3575	0.0	4.401958041958042
chr15	POTEB2	20848492	20848563	0	72	255	1698	255	1626	0.0	0.15682656826568267
chr15	POTEB2	20856635	20856773	0	139	255	1698	255	1559	0.0	0.163566388710712
chr15	POTEB3	21422119	21422190	0	72	0	6321	0	6249	0.0	0.0
chr15	POTEB	21859451	21859522	0	72	0	2308	0	2236	0.0	0.0
chr15	POTEB	21867596	21867734	0	139	0	2308	0	2169	0.0	0.0
chr15	AC011767.1	22773695	22773867	0	173	46	1539	46	1366	0.0	0.03367496339677892
chr15	AC011767.1	22773695	22773725	0	31	46	1539	46	1508	0.0	0.03050397877984085
chr15	CYFIP1	22947910	22948029	908	120	201111	10198	200203	10078	7.566666666666666	19.8653502679103
chr15	CYFIP1	22946708	22946840	0	133	201111	10198	201111	10065	0.0	19.981222056631893
chr15	TUBGCP5	23008457	23008565	581	109	373882	5528	373301	5419	5.330275229357798	68.88743310573906
chr15	GOLGA6L2	23444470	23444500	0	31	153	3047	153	3016	0.0	0.05072944297082228
chr15	UBE3A	25354527	25354683	0	157	0	16169	0	16012	0.0	0.0
chr15	UBE3A	25355891	25356056	0	166	0	16169	0	16003	0.0	0.0
chr15	UBE3A	25393745	25393858	0	114	0	16169	0	16055	0.0	0.0
chr15	UBE3A	25409087	25409207	0	121	0	16169	0	16048	0.0	0.0
chr15	UBE3A	25411907	25411971	0	65	0	16169	0	16104	0.0	0.0
chr15	UBE3A	25421925	25421961	0	37	0	16169	0	16132	0.0	0.0
chr15	UBE3A	25407066	25407212	0	147	0	16169	0	16022	0.0	0.0
chr15	UBE3A	25405460	25405502	0	43	0	16169	0	16126	0.0	0.0
chr15	UBE3A	25407066	25407228	0	163	0	16169	0	16006	0.0	0.0
chr15	UBE3A	25407066	25407262	0	197	0	16169	0	15972	0.0	0.0
chr15	UBE3A	25408619	25408684	0	66	0	16169	0	16103	0.0	0.0
chr15	UBE3A	25407066	25407137	0	72	0	16169	0	16097	0.0	0.0
chr15	UBE3A	25408571	25408684	0	114	0	16169	0	16055	0.0	0.0
chr15	UBE3A	25415709	25415842	0	134	0	16169	0	16035	0.0	0.0
chr15	LINC02250	25516447	25516645	0	199	51	6453	51	6254	0.0	0.008154780940198274
chr15	GABRB3	26642432	26642528	0	97	0	10481	0	10384	0.0	0.0
chr15	GABRB3	26621313	26621534	0	222	0	10481	0	10259	0.0	0.0
chr15	GABRB3	26553382	26553520	0	139	0	10481	0	10342	0.0	0.0
chr15	GABRG3-AS1	27158947	27159047	0	101	51	2872	51	2771	0.0	0.018404907975460124
chr15	GABRG3-AS1	27159808	27159861	0	54	51	2872	51	2818	0.0	0.01809794180269695
chr15	OCA2	27990575	27990647	0	73	0	3280	0	3207	0.0	0.0
chr15	HERC2	28163093	28163285	0	193	446	20131	446	19938	0.0	0.022369344969405156
chr15	HERC2	28298516	28298629	0	114	446	20131	446	20017	0.0	0.022281061098066643
chr15	GOLGA8G	28523942	28524034	0	93	7290	6365	7290	6272	0.0	1.1623086734693877
chr15	TJP1	29719776	29720016	0	241	0	11348	0	11107	0.0	0.0
chr15	CHRFAM7A	30383318	30383382	0	65	153	4049	153	3984	0.0	0.038403614457831324
chr15	CHRFAM7A	30381702	30381876	51	175	153	4049	102	3874	0.2914285714285714	0.02632937532266391
chr15	MTMR10	30967919	30968010	217	92	17346	6396	17129	6304	2.358695652173913	2.7171637055837565
chr15	MTMR10	30976818	30976955	51	138	17346	6396	17295	6258	0.3695652173913043	2.7636625119846596
chr15	MTMR10	30965874	30966040	1683	167	17346	6396	15663	6229	10.077844311377245	2.5145288168245306
chr15	TRPM1	31030982	31031157	0	176	51105	7483	51105	7307	0.0	6.993978376898864
chr15	TRPM1	31081352	31081438	0	87	51105	7483	51105	7396	0.0	6.909816116819902
chr15	OTUD7A	31689358	31689481	0	124	1836	14368	1836	14244	0.0	0.12889637742207244
chr15	OTUD7A	31649678	31649829	714	152	1836	14368	1122	14216	4.697368421052632	0.0789251547552054
chr15	ULK4P1	32423018	32423202	0	185	37	1694	37	1509	0.0	0.024519549370444003
chr15	AC135983.2	32524470	32524600	0	131	171	2691	171	2560	0.0	0.066796875
chr15	AC123768.2	32597638	32597745	0	108	658	1817	658	1709	0.0	0.385020479812756
chr15	FMN1	33193908	33194060	0	153	66417	20297	66417	20144	0.0	3.2971108022239872
chr15	TMCO5B	33245320	33245438	0	119	0	2056	0	1937	0.0	0.0
chr15	AC055874.1	33306331	33306431	0	101	69	2408	69	2307	0.0	0.02990897269180754
chr15	EMC7	34095894	34096014	0	121	0	1458	0	1337	0.0	0.0
chr15	KATNBL1	34152789	34153069	408	281	10998	4853	10590	4572	1.4519572953736655	2.316272965879265
chr15	KATNBL1	34163559	34163690	43	132	10998	4853	10955	4721	0.32575757575757575	2.320482948527854
chr15	KATNBL1	34165929	34166115	0	187	10998	4853	10998	4666	0.0	2.3570510072867554
chr15	KATNBL1	34177820	34177999	0	180	10998	4853	10998	4673	0.0	2.3535202225551037
chr15	KATNBL1	34198259	34198331	0	73	10998	4853	10998	4780	0.0	2.300836820083682
chr15	SLC12A6	34257641	34257788	0	148	5865	9653	5865	9505	0.0	0.6170436612309311
chr15	SLC12A6	34275344	34275389	0	46	5865	9653	5865	9607	0.0	0.6104923493286145
chr15	LPCAT4	34361399	34361532	0	134	208	3593	208	3459	0.0	0.06013298641225788
chr15	GOLGA8B	34552894	34553091	0	198	98145	7660	98145	7462	0.0	13.152640042883945
chr15	GOLGA8B	34574824	34574914	0	91	98145	7660	98145	7569	0.0	12.966706302021404
chr15	ZNF770	34987556	34987673	0	118	0	5442	0	5324	0.0	0.0
chr15	DPH6	35450684	35450803	0	120	6254	8133	6254	8013	0.0	0.7804817172095345
chr15	DPH6	35542412	35542507	0	96	6254	8133	6254	8037	0.0	0.7781510513873335
chr15	MEIS2	36950323	36950400	0	78	27316	10791	27316	10713	0.0	2.549799309250443
chr15	MEIS2	37096288	37096430	0	143	27316	10791	27316	10648	0.0	2.565364387678437
chr15	MEIS2	37099454	37099599	0	146	27316	10791	27316	10645	0.0	2.566087364960075
chr15	MEIS2	36894716	36894812	0	97	27316	10791	27316	10694	0.0	2.554329530577894
chr15	MEIS2	37096288	37096407	0	120	27316	10791	27316	10671	0.0	2.5598350670040295
chr15	AC068875.1	37426663	37426762	0	100	0	3267	0	3167	0.0	0.0
chr15	AC068875.1	37419439	37419574	0	136	0	3267	0	3131	0.0	0.0
chr15	RASGRP1	38494381	38494767	0	387	0	6027	0	5640	0.0	0.0
chr15	RASGRP1	38501142	38501287	0	146	0	6027	0	5881	0.0	0.0
chr15	RASGRP1	38503271	38503376	0	106	0	6027	0	5921	0.0	0.0
chr15	RASGRP1	38498793	38498946	0	154	0	6027	0	5873	0.0	0.0
chr15	RASGRP1	38501374	38501435	0	62	0	6027	0	5965	0.0	0.0
chr15	AC013652.1	39018501	39018581	0	81	51	7014	51	6933	0.0	0.0073561228905235825
chr15	GPR176	39807005	39807258	0	254	0	4526	0	4272	0.0	0.0
chr15	SRP14	40038875	40038948	0	74	0	1924	0	1850	0.0	0.0
chr15	BMF	40104179	40104340	0	162	80531	5238	80531	5076	0.0	15.8650512214342
chr15	BMF	40104242	40104340	0	99	80531	5238	80531	5139	0.0	15.670558474411363
chr15	BMF	40106357	40106438	0	82	80531	5238	80531	5156	0.0	15.6188906128782
chr15	PLCB2	40290024	40290082	0	59	14153	6493	14153	6434	0.0	2.1997202362449486
chr15	PLCB2	40291017	40291183	0	167	14153	6493	14153	6326	0.0	2.2372747391716725
chr15	PLCB2	40291605	40291650	0	46	14153	6493	14153	6447	0.0	2.195284628509384
chr15	CCDC9B	40336573	40336664	0	92	28541	7410	28541	7318	0.0	3.9001093194861984
chr15	CCDC32	40562771	40563027	573	257	13936	8099	13363	7842	2.2295719844357977	1.704029584289722
chr15	CCDC32	40553594	40554127	0	534	13936	8099	13936	7565	0.0	1.8421678783873099
chr15	CCDC32	40553436	40554127	0	692	13936	8099	13936	7407	0.0	1.881463480491427
chr15	CCDC32	40562771	40563022	573	252	13936	8099	13363	7847	2.2738095238095237	1.702943800178412
chr15	RAD51-AS1	40687798	40687844	100	47	88998	2763	88898	2716	2.127659574468085	32.731222385861564
chr15	DNAJC17	40776541	40776627	0	87	58276	5641	58276	5554	0.0	10.492617933021245
chr15	DNAJC17	40780092	40780352	0	261	58276	5641	58276	5380	0.0	10.831970260223049
chr15	PPP1R14D	40817231	40817347	1275	117	3339	872	2064	755	10.897435897435898	2.733774834437086
chr15	SPINT1-AS1	40838542	40838686	0	145	2896	1244	2896	1099	0.0	2.635122838944495
chr15	SPINT1-AS1	40838032	40838125	1006	94	2896	1244	1890	1150	10.702127659574469	1.6434782608695653
chr15	INO80	41016087	41016215	36	129	91979	5943	91943	5814	0.27906976744186046	15.814069487444101
chr15	INO80	41020899	41021125	14779	227	91979	5943	77200	5716	65.10572687224669	13.505948215535339
chr15	INO80	41058638	41058781	560	144	91979	5943	91419	5799	3.888888888888889	15.764614588722193
chr15	INO80	41023225	41023346	21378	122	91979	5943	70601	5821	175.2295081967213	12.128672049476036
chr15	EXD1	41219829	41219898	0	70	91283	3674	91283	3604	0.0	25.32824639289678
chr15	EXD1	41226442	41226628	0	187	91283	3674	91283	3487	0.0	26.17809004875251
chr15	OIP5	41319657	41319780	1887	124	1956	1206	69	1082	15.21774193548387	0.06377079482439926
chr15	NDUFAF1	41394264	41394358	0	95	9325	3613	9325	3518	0.0	2.6506537805571346
chr15	NDUFAF1	41394104	41394358	0	255	9325	3613	9325	3358	0.0	2.776950565812984
chr15	LTK	41505914	41506005	0	92	185	3509	185	3417	0.0	0.05414105940883816
chr15	LTK	41511163	41511346	0	184	185	3509	185	3325	0.0	0.055639097744360905
chr15	LTK	41507561	41507657	0	97	185	3509	185	3412	0.0	0.05422039859320047
chr15	RPAP1	41520390	41521147	1979	758	8954	6765	6975	6007	2.6108179419525066	1.161145330447811
chr15	AC016134.1	41612534	41612734	234	201	937	1392	703	1191	1.164179104477612	0.5902602854743912
chr15	PLA2G4F	42143977	42144144	0	168	46037	6123	46037	5955	0.0	7.730814441645676
chr15	PLA2G4F	42155516	42155589	0	74	46037	6123	46037	6049	0.0	7.61067945114895
chr15	VPS39	42173722	42173852	0	131	82819	7544	82819	7413	0.0	11.172130041818427
chr15	VPS39	42161473	42161590	0	118	82819	7544	82819	7426	0.0	11.152572044169135
chr15	VPS39	42192065	42192098	7074	34	82819	7544	75745	7510	208.05882352941177	10.085885486018642
chr15	TMEM87A	42272062	42272123	0	62	105209	5620	105209	5558	0.0	18.92929111191076
chr15	TMEM87A	42262122	42262243	0	122	105209	5620	105209	5498	0.0	19.135867588213895
chr15	ZNF106	42449770	42451954	149615	2185	168382	9722	18767	7537	68.47368421052632	2.489982751757994
chr15	CDAN1	42726096	42726160	0	65	17274	4961	17274	4896	0.0	3.528186274509804
chr15	CDAN1	42734225	42734346	1448	122	17274	4961	15826	4839	11.868852459016393	3.2705104360405044
chr15	TTBK2	42827927	42828032	410	106	50496	12943	50086	12837	3.8679245283018866	3.9016904261120198
chr15	TTBK2	42840359	42840433	6069	75	50496	12943	44427	12868	80.92	3.4525178737954616
chr15	TTBK2	42872610	42872758	158	149	50496	12943	50338	12794	1.0604026845637584	3.934500547131468
chr15	TTBK2	42840359	42840432	5983	74	50496	12943	44513	12869	80.85135135135135	3.4589323179734244
chr15	UBR1	43027775	43027828	3610	54	66640	9976	63030	9922	66.85185185185185	6.352549889135255
chr15	UBR1	43054741	43054899	0	159	66640	9976	66640	9817	0.0	6.788224508505653
chr15	UBR1	43058340	43058429	0	90	66640	9976	66640	9886	0.0	6.740845640299414
chr15	UBR1	43085983	43086240	0	258	66640	9976	66640	9718	0.0	6.8573780613294915
chr15	UBR1	43091960	43092080	0	121	66640	9976	66640	9855	0.0	6.76204972095383
chr15	EPB42	43210334	43210439	0	106	896	2855	896	2749	0.0	0.3259367042560931
chr15	EPB42	43215094	43215328	0	235	896	2855	896	2620	0.0	0.3419847328244275
chr15	TGM5	43260051	43260297	2448	247	15546	3722	13098	3475	9.910931174089068	3.769208633093525
chr15	TP53BP1	43421024	43421174	0	151	60848	13009	60848	12858	0.0	4.732306735106548
chr15	TP53BP1	43432193	43432677	24276	485	60848	13009	36572	12524	50.05360824742268	2.920153305653146
chr15	TP53BP1	43447365	43447485	124	121	60848	13009	60724	12888	1.024793388429752	4.711669770328988
chr15	TP53BP1	43446765	43446914	4168	150	60848	13009	56680	12859	27.786666666666665	4.407807761101174
chr15	TP53BP1	43412671	43412767	51	97	60848	13009	60797	12912	0.5257731958762887	4.708565675340768
chr15	TP53BP1	43414047	43414116	0	70	60848	13009	60848	12939	0.0	4.70268181466883
chr15	TP53BP1	43446386	43446590	102	205	60848	13009	60746	12804	0.4975609756097561	4.744298656669791
chr15	TP53BP1	43446765	43446910	3496	146	60848	13009	57352	12863	23.945205479452056	4.458679934696416
chr15	PPIP5K1	43536134	43536254	0	121	553	7736	553	7615	0.0	0.07261982928430728
chr15	PPIP5K1	43564102	43564165	0	64	553	7736	553	7672	0.0	0.07208029197080291
chr15	PPIP5K1	43584798	43584892	0	95	553	7736	553	7641	0.0	0.07237272608297343
chr15	PPIP5K1	43564866	43564992	0	127	553	7736	553	7609	0.0	0.07267709291628335
chr15	PPIP5K1	43560412	43560595	354	184	553	7736	199	7552	1.923913043478261	0.026350635593220338
chr15	PPIP5K1	43569185	43569335	0	151	553	7736	553	7585	0.0	0.07290705339485827
chr15	STRC	43603241	43603411	0	171	102	6367	102	6196	0.0	0.01646223369916075
chr15	STRC	43605263	43605399	0	137	102	6367	102	6230	0.0	0.01637239165329053
chr15	STRC	43612376	43612509	0	134	102	6367	102	6233	0.0	0.01636451147120167
chr15	STRC	43610311	43610386	37	76	102	6367	65	6291	0.4868421052631579	0.010332220632649818
chr15	STRC	43604976	43605147	0	172	102	6367	102	6195	0.0	0.01646489104116223
chr15	STRC	43612790	43612906	0	117	102	6367	102	6250	0.0	0.01632
chr15	CATSPER2	43632716	43632934	0	219	2009	5336	2009	5117	0.0	0.39261285909712723
chr15	CATSPER2	43635726	43635826	0	101	2009	5336	2009	5235	0.0	0.3837631327602674
chr15	CATSPER2	43632716	43632928	0	213	2009	5336	2009	5123	0.0	0.3921530353308608
chr15	CATSPER2	43631429	43631538	0	110	2009	5336	2009	5226	0.0	0.384424033677765
chr15	CATSPER2	43648628	43648709	0	82	2009	5336	2009	5254	0.0	0.38237533307955845
chr15	CATSPER2	43635108	43635154	0	47	2009	5336	2009	5289	0.0	0.3798449612403101
chr15	STRCP1	43704456	43704625	0	170	74315	5725	74315	5555	0.0	13.378037803780378
chr15	STRCP1	43702751	43702921	373	171	74315	5725	73942	5554	2.181286549707602	13.313287720561757
chr15	STRCP1	43711838	43711971	561	134	74315	5725	73754	5591	4.186567164179104	13.19155786084779
chr15	CATSPER2P1	43744150	43744219	0	70	470	3212	470	3142	0.0	0.14958625079567156
chr15	SERINC4	43797140	43797356	102	217	3695	2886	3593	2669	0.4700460829493088	1.3461970775571375
chr15	SERINC4	43798424	43798504	0	81	3695	2886	3695	2805	0.0	1.3172905525846703
chr15	SERINC4	43797144	43797356	102	213	3695	2886	3593	2673	0.4788732394366197	1.3441825664047886
chr15	FRMD5	43917724	43917829	0	106	33158	6396	33158	6290	0.0	5.27154213036566
chr15	FRMD5	43891980	43892069	0	90	33158	6396	33158	6306	0.0	5.258166825245798
chr15	FRMD5	43902174	43902262	0	89	33158	6396	33158	6307	0.0	5.257333121928016
chr15	FRMD5	43918977	43919280	102	304	33158	6396	33056	6092	0.3355263157894737	5.42613263296126
chr15	EIF3J-DT	44536042	44536358	0	317	0	3200	0	2883	0.0	0.0
chr15	SPG11	44569397	44569505	0	109	12776	11477	12776	11368	0.0	1.123856439127375
chr15	SPG11	44572682	44572820	0	139	12776	11477	12776	11338	0.0	1.1268301287705063
chr15	SPG11	44570524	44570658	0	135	12776	11477	12776	11342	0.0	1.126432727913948
chr15	SPG11	44588566	44588638	0	73	12776	11477	12776	11404	0.0	1.1203086636267976
chr15	SPG11	44604104	44604197	0	94	12776	11477	12776	11383	0.0	1.1223754721953791
chr15	PATL2	44667105	44667203	0	99	7258	4065	7258	3966	0.0	1.8300554715078163
chr15	PATL2	44675485	44675691	816	207	7258	4065	6442	3858	3.9420289855072466	1.669777086573354
chr15	DUOXA1	45121086	45121221	2253	136	130406	3541	128153	3405	16.566176470588236	37.6367107195301
chr15	DUOXA1	45128836	45128904	0	69	130406	3541	130406	3472	0.0	37.559331797235025
chr15	DUOXA1	45129231	45129323	0	93	130406	3541	130406	3448	0.0	37.8207656612529
chr15	SHF	45173575	45173716	0	142	102	4906	102	4764	0.0	0.021410579345088162
chr15	SHF	45198771	45199120	0	350	102	4906	102	4556	0.0	0.022388059701492536
chr15	SHF	45171882	45172078	82	197	102	4906	20	4709	0.41624365482233505	0.004247186239116585
chr15	AC051619.4	45264626	45264809	0	184	0	4297	0	4113	0.0	0.0
chr15	GATM	45376600	45376819	0	220	148562	6854	148562	6634	0.0	22.394030750678322
chr15	GATM	45363604	45363781	7898	178	148562	6854	140664	6676	44.37078651685393	21.070101857399642
chr15	GATM	45373235	45373331	0	97	148562	6854	148562	6757	0.0	21.986384490158354
chr15	AC023905.1	47380456	47380595	0	140	0	1486	0	1346	0.0	0.0
chr15	AC023905.1	47393321	47393485	0	165	0	1486	0	1321	0.0	0.0
chr15	LINC01491	47793677	47793816	0	140	0	1932	0	1792	0.0	0.0
chr15	LINC01491	47814070	47814176	0	107	0	1932	0	1825	0.0	0.0
chr15	LINC01491	47844837	47844965	0	129	0	1932	0	1803	0.0	0.0
chr15	LINC01491	47791106	47791250	0	145	0	1932	0	1787	0.0	0.0
chr15	LINC01491	47803383	47803435	0	53	0	1932	0	1879	0.0	0.0
chr15	LINC01491	47820117	47820157	0	41	0	1932	0	1891	0.0	0.0
chr15	MYEF2	48151099	48151171	0	73	0	6737	0	6664	0.0	0.0
chr15	MYEF2	48152233	48152284	0	52	0	6737	0	6685	0.0	0.0
chr15	MYEF2	48167348	48167401	0	54	0	6737	0	6683	0.0	0.0
chr15	AC066612.1	48190057	48190157	0	101	0	3119	0	3018	0.0	0.0
chr15	AC066612.1	48190039	48190157	0	119	0	3119	0	3000	0.0	0.0
chr15	FBN1	48427881	48427943	655	63	63312	12734	62657	12671	10.396825396825397	4.944913582195564
chr15	FBN1	48434107	48434212	17128	106	63312	12734	46184	12628	161.58490566037736	3.6572695597085843
chr15	CEP152	48748442	48748610	0	169	31491	8196	31491	8027	0.0	3.923134421328018
chr15	CEP152	48797300	48797579	838	280	31491	8196	30653	7916	2.992857142857143	3.8722839818089945
chr15	SHC4	48851187	48851248	0	62	306	6546	306	6484	0.0	0.04719309068476249
chr15	SECISBP2L	49019417	49019552	0	136	4328	8603	4328	8467	0.0	0.5111609779142553
chr15	FAM227B	49568244	49568346	0	103	34355	5713	34355	5610	0.0	6.123885918003565
chr15	FAM227B	49589775	49590007	0	233	34355	5713	34355	5480	0.0	6.269160583941606
chr15	FAM227B	49620133	49620190	4155	58	34355	5713	30200	5655	71.63793103448276	5.340406719717064
chr15	FAM227B	49577171	49577305	0	135	34355	5713	34355	5578	0.0	6.159017569021154
chr15	FAM227B	49577628	49577664	0	37	34355	5713	34355	5676	0.0	6.052677942212826
chr15	ATP8B4	49901091	49901239	0	149	11479	10908	11479	10759	0.0	1.0669207175388047
chr15	ATP8B4	49931118	49931307	0	190	11479	10908	11479	10718	0.0	1.0710020526217578
chr15	ATP8B4	50018888	50018976	0	89	11479	10908	11479	10819	0.0	1.0610037896293558
chr15	ATP8B4	49922223	49922405	5895	183	11479	10908	5584	10725	32.21311475409836	0.5206526806526807
chr15	HDC	50248244	50248343	0	100	204	3906	204	3806	0.0	0.053599579611140306
chr15	HDC	50257424	50257547	0	124	204	3906	204	3782	0.0	0.053939714436805924
chr15	HDC	50258403	50258517	0	115	204	3906	204	3791	0.0	0.053811659192825115
chr15	GABPB1	50302928	50303123	0	196	51	5585	51	5389	0.0	0.00946372239747634
chr15	GABPB1	50309690	50309798	0	109	51	5585	51	5476	0.0	0.00931336742147553
chr15	GABPB1	50282278	50282391	0	114	51	5585	51	5471	0.0	0.009321878998354963
chr15	GABPB1	50346371	50346395	0	25	51	5585	51	5560	0.0	0.009172661870503597
chr15	GABPB1	50314415	50314670	0	256	51	5585	51	5329	0.0	0.009570275849127416
chr15	USP50	50496220	50496312	0	93	51	3645	51	3552	0.0	0.014358108108108109
chr15	USP50	50541048	50541264	0	217	51	3645	51	3428	0.0	0.014877479579929988
chr15	USP50	50532011	50532227	0	217	51	3645	51	3428	0.0	0.014877479579929988
chr15	SPPL2A	50732602	50732684	0	83	1347	7904	1347	7821	0.0	0.17222861526658995
chr15	SPPL2A	50726072	50726126	0	55	1347	7904	1347	7849	0.0	0.1716142183717671
chr15	CYP19A1	51222348	51222525	0	178	1959	7380	1959	7202	0.0	0.2720077756178839
chr15	CYP19A1	51323815	51323924	0	110	1959	7380	1959	7270	0.0	0.26946354883081153
chr15	CYP19A1	51255517	51255761	0	245	1959	7380	1959	7135	0.0	0.27456201822004206
chr15	CYP19A1	51255517	51255708	0	192	1959	7380	1959	7188	0.0	0.2725375626043406
chr15	CYP19A1	51337817	51337908	0	92	1959	7380	1959	7288	0.0	0.2687980241492865
chr15	CYP19A1	51278007	51278162	0	156	1959	7380	1959	7224	0.0	0.2711794019933555
chr15	DMXL2	51451644	51451697	0	54	0	13771	0	13717	0.0	0.0
chr15	DMXL2	51459597	51459660	0	64	0	13771	0	13707	0.0	0.0
chr15	GNB5	52147458	52147535	0	78	39637	12978	39637	12900	0.0	3.0726356589147286
chr15	GNB5	52128643	52128695	0	53	39637	12978	39637	12925	0.0	3.0666924564796907
chr15	GNB5	52141139	52141272	0	134	39637	12978	39637	12844	0.0	3.0860323886639676
chr15	MYO5C	52213187	52213286	0	100	60940	10094	60940	9994	0.0	6.097658595157094
chr15	MYO5C	52232621	52232685	0	65	60940	10094	60940	10029	0.0	6.076378502343204
chr15	MYO5C	52242047	52242213	4384	167	60940	10094	56556	9927	26.251497005988025	5.697189483227561
chr15	MYO5C	52271762	52271844	0	83	60940	10094	60940	10011	0.0	6.0873039656377985
chr15	MYO5C	52282781	52282892	0	112	60940	10094	60940	9982	0.0	6.104988980164296
chr15	MYO5C	52239732	52239879	0	148	60940	10094	60940	9946	0.0	6.127086265835512
chr15	MYO5C	52265185	52265220	0	36	60940	10094	60940	10058	0.0	6.058858620003977
chr15	MYO5C	52277843	52278027	51	185	60940	10094	60889	9909	0.2756756756756757	6.144817842365526
chr15	MYO5C	52282781	52282884	0	104	60940	10094	60940	9990	0.0	6.1001001001001
chr15	MYO5A	52337809	52337884	225	76	100615	13013	100390	12937	2.960526315789474	7.759913426605859
chr15	MYO5A	52343116	52343197	0	82	100615	13013	100615	12931	0.0	7.780914082437553
chr15	MYO5A	52348817	52348826	10	10	100615	13013	100605	13003	1.0	7.737060678305006
chr15	MYO5A	52428397	52428569	62	173	100615	13013	100553	12840	0.3583815028901734	7.8312305295950155
chr15	ARPP19	52557099	52557222	0	124	349	6840	349	6716	0.0	0.051965455628350206
chr15	ARPP19	52568847	52568902	0	56	349	6840	349	6784	0.0	0.05144457547169811
chr15	ARPP19	52568847	52568900	0	54	349	6840	349	6786	0.0	0.05142941349837902
chr15	ARPP19	52564189	52564246	0	58	349	6840	349	6782	0.0	0.05145974638749631
chr15	FAM214A	52587150	52587219	24	70	22141	9760	22117	9690	0.34285714285714286	2.2824561403508774
chr15	FAM214A	52600126	52600235	5121	110	22141	9760	17020	9650	46.554545454545455	1.7637305699481864
chr15	FAM214A	52613672	52613857	401	186	22141	9760	21740	9574	2.1559139784946235	2.2707332358470858
chr15	FAM214A	52587055	52587219	24	165	22141	9760	22117	9595	0.14545454545454545	2.305054715997916
chr15	AC084759.2	53968001	53968150	0	150	102	3596	102	3446	0.0	0.02959953569355775
chr15	AC084759.2	53959795	53959871	0	77	102	3596	102	3519	0.0	0.028985507246376812
chr15	RSL24D1	55194152	55194183	0	32	0	6103	0	6071	0.0	0.0
chr15	RSL24D1	55193169	55193231	0	63	0	6103	0	6040	0.0	0.0
chr15	RSL24D1	55194295	55194359	0	65	0	6103	0	6038	0.0	0.0
chr15	RAB27A	55238402	55238491	0	90	0	5247	0	5157	0.0	0.0
chr15	RAB27A	55237315	55237442	0	128	0	5247	0	5119	0.0	0.0
chr15	RAB27A	55259920	55260023	0	104	0	5247	0	5143	0.0	0.0
chr15	CCPG1	55359538	55360944	153	1407	204	5580	51	4173	0.10874200426439233	0.012221423436376708
chr15	CCPG1	55365187	55365309	0	123	204	5580	204	5457	0.0	0.037383177570093455
chr15	DNAAF4	55466929	55467161	0	233	6359	2948	6359	2715	0.0	2.342173112338858
chr15	CCPG1	55374154	55374250	0	97	204	5580	204	5483	0.0	0.037205909173809955
chr15	CCPG1	55399784	55399926	0	143	204	5580	204	5437	0.0	0.0375206915578444
chr15	DNAAF4	55432496	55432602	0	107	6359	2948	6359	2841	0.0	2.2382963745160156
chr15	DNAAF4	55495127	55495202	0	76	6359	2948	6359	2872	0.0	2.2141364902506964
chr15	NEDD4	55872414	55872476	0	63	17705	9157	17705	9094	0.0	1.9468880580602594
chr15	NEDD4	55869578	55869681	0	104	17705	9157	17705	9053	0.0	1.9557052910637358
chr15	NEDD4	55873957	55874008	0	52	17705	9157	17705	9105	0.0	1.944535969247666
chr15	NEDD4	55951510	55951589	0	80	17705	9157	17705	9077	0.0	1.9505343175057839
chr15	NEDD4	55905211	55905281	969	71	17705	9157	16736	9086	13.647887323943662	1.8419546555139776
chr15	RFX7	56087907	56087990	0	84	7112	11124	7112	11040	0.0	0.6442028985507247
chr15	RFX7	56179269	56179303	0	35	7112	11124	7112	11089	0.0	0.6413562990350798
chr15	AC090518.1	56548446	56548601	0	156	0	2657	0	2501	0.0	0.0
chr15	AC090518.1	56629385	56629400	0	16	0	2657	0	2641	0.0	0.0
chr15	ZNF280D	56654730	56654842	0	113	704	10430	704	10317	0.0	0.06823689056896384
chr15	ZNF280D	56707081	56707150	0	70	704	10430	704	10360	0.0	0.06795366795366796
chr15	ZNF280D	56707081	56707143	0	63	704	10430	704	10367	0.0	0.06790778431561686
chr15	ZNF280D	56667996	56668241	255	246	704	10430	449	10184	1.0365853658536586	0.044088766692851535
chr15	ZNF280D	56729753	56729782	15	30	704	10430	689	10400	0.5	0.06625
chr15	AC090517.5	56905747	56905865	0	119	204	6477	204	6358	0.0	0.03208556149732621
chr15	ALDH1A2	57992704	57992818	0	115	192	8160	192	8045	0.0	0.02386575512740833
chr15	ALDH1A2	58010648	58010778	0	131	192	8160	192	8029	0.0	0.02391331423589488
chr15	ALDH1A2	58058011	58058108	0	98	192	8160	192	8062	0.0	0.023815430414289258
chr15	ADAM10	58679123	58679282	0	160	51	6078	51	5918	0.0	0.00861777627576884
chr15	ADAM10	58682195	58682314	0	120	51	6078	51	5958	0.0	0.008559919436052367
chr15	ADAM10	58676142	58676293	0	152	51	6078	51	5926	0.0	0.00860614242321971
chr15	SLTM	58890280	58890461	0	182	93768	6192	93768	6010	0.0	15.601996672212978
chr15	SLTM	58899468	58899937	0	470	93768	6192	93768	5722	0.0	16.387277175812653
chr15	SLTM	58913498	58913696	3470	199	93768	6192	90298	5993	17.43718592964824	15.067245119305857
chr15	SLTM	58932355	58932443	0	89	93768	6192	93768	6103	0.0	15.364247091594297
chr15	SLTM	58912562	58912610	0	49	93768	6192	93768	6143	0.0	15.264203158066092
chr15	SLTM	58899468	58899883	0	416	93768	6192	93768	5776	0.0	16.234072022160664
chr15	MYO1E	59188117	59188216	0	100	36330	5176	36330	5076	0.0	7.157210401891253
chr15	MYO1E	59236584	59236672	0	89	36330	5176	36330	5087	0.0	7.141733831334775
chr15	GTF2A2	59642135	59642262	1977	128	3858	2929	1881	2801	15.4453125	0.6715458764726884
chr15	GTF2A2	59650668	59650773	0	106	3858	2929	3858	2823	0.0	1.3666312433581296
chr15	GTF2A2	59656814	59657033	0	220	3858	2929	3858	2709	0.0	1.424141749723145
chr15	GTF2A2	59652205	59652326	912	122	3858	2929	2946	2807	7.475409836065574	1.049519059494122
chr15	GTF2A2	59650668	59650764	0	97	3858	2929	3858	2832	0.0	1.3622881355932204
chr15	BNIP2	59668102	59668138	0	37	4408	7747	4408	7710	0.0	0.5717250324254215
chr15	BNIP2	59678747	59678834	0	88	4408	7747	4408	7659	0.0	0.5755320537929234
chr15	BNIP2	59678775	59678834	0	60	4408	7747	4408	7687	0.0	0.5734356706127228
chr15	ANXA2	60349074	60349197	0	124	0	11528	0	11404	0.0	0.0
chr15	ANXA2	60382341	60382441	0	101	0	11528	0	11427	0.0	0.0
chr15	ANXA2	60390212	60390317	0	106	0	11528	0	11422	0.0	0.0
chr15	ANXA2	60393238	60393440	0	203	0	11528	0	11325	0.0	0.0
chr15	ANXA2	60393012	60393440	0	429	0	11528	0	11099	0.0	0.0
chr15	ANXA2	60397257	60397338	0	82	0	11528	0	11446	0.0	0.0
chr15	ANXA2	60396279	60396427	0	149	0	11528	0	11379	0.0	0.0
chr15	ANXA2	60396372	60396427	0	56	0	11528	0	11472	0.0	0.0
chr15	ANXA2	60364428	60364523	0	96	0	11528	0	11432	0.0	0.0
chr15	ANXA2	60386027	60386086	0	60	0	11528	0	11468	0.0	0.0
chr15	ANXA2	60393037	60393440	0	404	0	11528	0	11124	0.0	0.0
chr15	ANXA2	60396150	60396427	0	278	0	11528	0	11250	0.0	0.0
chr15	ANXA2	60374618	60374682	0	65	0	11528	0	11463	0.0	0.0
chr15	ANXA2	60394573	60394695	0	123	0	11528	0	11405	0.0	0.0
chr15	ICE2	60447969	60448145	0	177	153	10708	153	10531	0.0	0.014528534802013104
chr15	ICE2	60477936	60478069	0	134	153	10708	153	10574	0.0	0.014469453376205787
chr15	ICE2	60478567	60478650	0	84	153	10708	153	10624	0.0	0.014401355421686747
chr15	ICE2	60478567	60478637	0	71	153	10708	153	10637	0.0	0.014383754818087806
chr15	ICE2	60478567	60478660	0	94	153	10708	153	10614	0.0	0.014414923685698135
chr15	RORA	60677150	60677232	593	83	79533	17047	78940	16964	7.144578313253012	4.653383635934921
chr15	VPS13C	61884127	61884269	0	143	389	19787	389	19644	0.0	0.01980248421909998
chr15	VPS13C	61936596	61936750	0	155	389	19787	389	19632	0.0	0.019814588427057866
chr15	VPS13C	61864640	61864820	0	181	389	19787	389	19606	0.0	0.019840865041313882
chr15	AC126323.1	62247513	62247608	0	96	1800	3921	1800	3825	0.0	0.47058823529411764
chr15	RPS27L	63156786	63156973	0	188	12	7259	12	7071	0.0	0.0016970725498515061
chr15	CA12	63328097	63328130	0	34	16695	7011	16695	6977	0.0	2.3928622617170703
chr15	CA12	63346529	63346709	818	181	16695	7011	15877	6830	4.519337016574585	2.324597364568082
chr15	USP3-AS1	63551829	63551876	3432	48	84010	2791	80578	2743	71.5	29.375865840320817
chr15	USP3-AS1	63593748	63593877	0	130	84010	2791	84010	2661	0.0	31.570838030815484
chr15	USP3-AS1	63599182	63599303	7204	122	84010	2791	76806	2669	59.049180327868854	28.777070063694268
chr15	HERC1	63632290	63632605	2303	316	40467	16742	38164	16426	7.287974683544304	2.3233897479605505
chr15	HERC1	63636987	63637134	0	148	40467	16742	40467	16594	0.0	2.4386525250090396
chr15	HERC1	63780461	63780552	0	92	40467	16742	40467	16650	0.0	2.4304504504504503
chr15	HERC1	63779582	63780009	204	428	40467	16742	40263	16314	0.4766355140186916	2.4680029422581833
chr15	DAPK2	63991227	63991351	0	125	13797	11854	13797	11729	0.0	1.176315116378208
chr15	CIAO2A	64081101	64081151	0	51	51	2267	51	2216	0.0	0.023014440433212997
chr15	CIAO2A	64090197	64090315	0	119	51	2267	51	2148	0.0	0.023743016759776536
chr15	PPIB	64162040	64162154	0	115	0	1728	0	1613	0.0	0.0
chr15	CSNK1G1	64251511	64251581	51	71	204	9347	153	9276	0.7183098591549296	0.016494178525226392
chr15	CSNK1G1	64259200	64259241	0	42	204	9347	204	9305	0.0	0.021923696937130574
chr15	CSNK1G1	64188374	64188485	0	112	204	9347	204	9235	0.0	0.0220898754737412
chr15	CSNK1G1	64176261	64176285	0	25	204	9347	204	9322	0.0	0.02188371594078524
chr15	CSNK1G1	64189340	64189480	0	141	204	9347	204	9206	0.0	0.022159461220942863
chr15	CSNK1G1	64195015	64195079	0	65	204	9347	204	9282	0.0	0.02197802197802198
chr15	AC087632.2	64376742	64376905	320	164	82573	3306	82253	3142	1.951219512195122	26.178548695098662
chr15	AC087632.2	64380957	64381038	61638	82	82573	3306	20935	3224	751.6829268292682	6.49348635235732
chr15	AC087632.2	64365973	64366075	2412	103	82573	3306	80161	3203	23.41747572815534	25.026849828285982
chr15	AC087632.2	64365985	64366075	2301	91	82573	3306	80272	3215	25.285714285714285	24.967962674961118
chr15	AC087632.2	64373697	64373764	756	68	82573	3306	81817	3238	11.117647058823529	25.267757875231624
chr15	OAZ2	64689083	64689169	0	87	19730	2806	19730	2719	0.0	7.256344244207429
chr15	OAZ2	64691433	64691591	0	159	19730	2806	19730	2647	0.0	7.453721193804307
chr15	OAZ2	64690907	64691009	0	103	19730	2806	19730	2703	0.0	7.299297077321494
chr15	PIF1	64817945	64818091	0	147	205664	3967	205664	3820	0.0	53.83874345549738
chr15	PIF1	64819846	64819986	210	141	205664	3967	205454	3826	1.4893617021276595	53.69942498693152
chr15	SPG21	64974601	64974747	5503	147	144168	3998	138665	3851	37.435374149659864	36.00753051155544
chr15	SPG21	64976474	64976555	8196	82	144168	3998	135972	3916	99.95121951219512	34.72216547497447
chr15	SPG21	64983506	64983593	1103	88	144168	3998	143065	3910	12.534090909090908	36.589514066496164
chr15	SPG21	64989168	64989273	261	106	144168	3998	143907	3892	2.4622641509433962	36.97507708119219
chr15	SPG21	64988618	64988816	3617	199	144168	3998	140551	3799	18.175879396984925	36.99684127401948
chr15	SPG21	64987171	64987261	3373	91	144168	3998	140795	3907	37.065934065934066	36.03660097261326
chr15	MTFMT	65021513	65021616	0	104	1275	2292	1275	2188	0.0	0.5827239488117002
chr15	MTFMT	65023671	65023794	0	124	1275	2292	1275	2168	0.0	0.5880996309963099
chr15	RASL12	65065216	65065273	0	58	1479	2687	1479	2629	0.0	0.5625713198934956
chr15	PDCD7	65119717	65119954	0	238	4948	3240	4948	3002	0.0	1.648234510326449
chr15	PARP16	65266561	65266768	0	208	22958	3734	22958	3526	0.0	6.5110606920022684
chr15	PARP16	65270934	65271072	0	139	22958	3734	22958	3595	0.0	6.3860917941585535
chr15	DPP8	65454262	65454415	9	154	138779	9869	138770	9715	0.05844155844155844	14.284096757591353
chr15	DPP8	65456224	65456371	435	148	138779	9869	138344	9721	2.939189189189189	14.231457668964099
chr15	DPP8	65463760	65463906	0	147	138779	9869	138779	9722	0.0	14.274737708290475
chr15	DPP8	65500605	65500779	0	175	138779	9869	138779	9694	0.0	14.315968640396122
chr15	DPP8	65515655	65515791	0	137	138779	9869	138779	9732	0.0	14.260069872585285
chr15	DPP8	65455711	65455841	0	131	138779	9869	138779	9738	0.0	14.251283631135756
chr15	INTS14	65605128	65605236	0	109	5019	4223	5019	4114	0.0	1.2199805542051532
chr15	INTS14	65607158	65607442	0	285	5019	4223	5019	3938	0.0	1.2745048247841544
chr15	INTS14	65607158	65607425	0	268	5019	4223	5019	3955	0.0	1.2690265486725665
chr15	INTS14	65607301	65607442	0	142	5019	4223	5019	4081	0.0	1.2298456260720412
chr15	DENND4A	65700543	65700675	0	133	19783	7940	19783	7807	0.0	2.53400794159088
chr15	DENND4A	65665198	65665225	0	28	19783	7940	19783	7912	0.0	2.5003791708796763
chr15	DENND4A	65700543	65700672	0	130	19783	7940	19783	7810	0.0	2.53303457106274
chr15	MEGF11	66119085	66119186	0	102	68980	9387	68980	9285	0.0	7.429186860527733
chr15	MEGF11	66128305	66128433	0	129	68980	9387	68980	9258	0.0	7.450853316050983
chr15	MEGF11	66128305	66128411	0	107	68980	9387	68980	9280	0.0	7.433189655172414
chr15	MEGF11	65912081	65912200	0	120	68980	9387	68980	9267	0.0	7.443617136074242
chr15	MEGF11	65902495	65902537	93	43	68980	9387	68887	9344	2.1627906976744184	7.37232448630137
chr15	MEGF11	65906624	65906670	0	47	68980	9387	68980	9340	0.0	7.385438972162741
chr15	TIPIN	66351524	66351600	0	77	0	2519	0	2442	0.0	0.0
chr15	SNAPC5	66495329	66495419	0	91	0	2480	0	2389	0.0	0.0
chr15	SNAPC5	66494902	66495419	0	518	0	2480	0	1962	0.0	0.0
chr15	RPL4	66501787	66501912	0	126	110	5307	110	5181	0.0	0.021231422505307854
chr15	LCTL	66564675	66564839	0	165	0	3533	0	3368	0.0	0.0
chr15	AC087482.1	66989911	66990043	0	133	41840	3790	41840	3657	0.0	11.441071916871753
chr15	AC087482.1	66985441	66985483	0	43	41840	3790	41840	3747	0.0	11.166266346410461
chr15	IQCH-AS1	67421334	67421498	357	165	4091	9116	3734	8951	2.1636363636363636	0.4171600938442632
chr15	IQCH-AS1	67430320	67430400	0	81	4091	9116	4091	9035	0.0	0.4527946873270614
chr15	CLN6	68218535	68218650	0	116	102	7108	102	6992	0.0	0.014588100686498856
chr15	CALML4	68197439	68197628	0	190	0	5043	0	4853	0.0	0.0
chr15	CALML4	68199540	68199681	0	142	0	5043	0	4901	0.0	0.0
chr15	CALML4	68205120	68205151	0	32	0	5043	0	5011	0.0	0.0
chr15	CLN6	68211674	68211863	0	190	102	7108	102	6918	0.0	0.014744145706851692
chr15	CLN6	68214289	68214388	0	100	102	7108	102	7008	0.0	0.014554794520547944
chr15	CLN6	68211555	68211863	0	309	102	7108	102	6799	0.0	0.015002206206795116
chr15	CLN6	68211674	68211921	0	248	102	7108	102	6860	0.0	0.014868804664723033
chr15	CLN6	68211555	68211741	0	187	102	7108	102	6921	0.0	0.014737754659731253
chr15	CLN6	68211555	68211643	0	89	102	7108	102	7019	0.0	0.014531984613192762
chr15	CLN6	68211648	68211863	0	216	102	7108	102	6892	0.0	0.014799767846778875
chr15	CLN6	68248353	68248481	0	129	102	7108	102	6979	0.0	0.014615274394612408
chr15	TLE3	70066617	70066939	51	323	102	9700	51	9377	0.15789473684210525	0.005438839714194305
chr15	UACA	70677107	70677140	0	34	51	11017	51	10983	0.0	0.004643540016388965
chr15	RPL29P30	70797283	70797392	0	110	0	916	0	806	0.0	0.0
chr15	THSD4-AS1	71185424	71185506	0	83	10509	4037	10509	3954	0.0	2.657814871016692
chr15	THSD4-AS1	71186497	71187592	0	1096	10509	4037	10509	2941	0.0	3.5732743964637876
chr15	THSD4-AS1	71185404	71185506	0	103	10509	4037	10509	3934	0.0	2.6713268937468224
chr15	MYO9A	71850035	71850167	0	133	20367	14410	20367	14277	0.0	1.426560201723051
chr15	MYO9A	71916369	71916492	0	124	20367	14410	20367	14286	0.0	1.4256614867702646
chr15	MYO9A	71951776	71951896	0	121	20367	14410	20367	14289	0.0	1.4253621667016587
chr15	MYO9A	72019038	72019095	0	58	20367	14410	20367	14352	0.0	1.4191053511705685
chr15	MYO9A	72032493	72032588	0	96	20367	14410	20367	14314	0.0	1.4228727120301803
chr15	MYO9A	72045723	72046634	2	912	20367	14410	20365	13498	0.0021929824561403508	1.508742035857164
chr15	MYO9A	71892964	71893177	0	214	20367	14410	20367	14196	0.0	1.4346999154691462
chr15	MYO9A	71847414	71847468	0	55	20367	14410	20367	14355	0.0	1.418808777429467
chr15	MYO9A	71951701	71951896	0	196	20367	14410	20367	14214	0.0	1.4328830730265936
chr15	GRAMD2A	72169416	72169563	0	148	441	2853	441	2705	0.0	0.16303142329020331
chr15	PKM	72217408	72217500	0	93	459	7878	459	7785	0.0	0.058959537572254334
chr15	PKM	72221167	72221284	0	118	459	7878	459	7760	0.0	0.05914948453608247
chr15	PKM	72231323	72231391	0	69	459	7878	459	7809	0.0	0.058778332693046484
chr15	PARP6	72249244	72249314	0	71	2958	7059	2958	6988	0.0	0.4232970807097882
chr15	PARP6	72250844	72250954	0	111	2958	7059	2958	6948	0.0	0.42573402417962003
chr15	PARP6	72250844	72250957	0	114	2958	7059	2958	6945	0.0	0.42591792656587474
chr15	PARP6	72253949	72254070	0	122	2958	7059	2958	6937	0.0	0.4264091105665273
chr15	CELF6	72288537	72288618	0	82	408	3631	408	3549	0.0	0.11496196111580727
chr15	CELF6	72288867	72288930	0	64	408	3631	408	3567	0.0	0.11438183347350715
chr15	CELF6	72289938	72290018	0	81	408	3631	408	3550	0.0	0.11492957746478873
chr15	CELF6	72304745	72304794	0	50	408	3631	408	3581	0.0	0.11393465512426697
chr15	CELF6	72292197	72292265	0	69	408	3631	408	3562	0.0	0.11454239191465469
chr15	HEXA	72346526	72346710	0	185	627	12182	627	11997	0.0	0.05226306576644161
chr15	HEXA	72347685	72347758	343	74	627	12182	284	12108	4.635135135135135	0.02345556656755864
chr15	HEXA	72349078	72349259	0	182	627	12182	627	12000	0.0	0.05225
chr15	HEXA	72353690	72353737	0	48	627	12182	627	12134	0.0	0.05167298500082413
chr15	HEXA	72353067	72353178	0	112	627	12182	627	12070	0.0	0.051946975973487984
chr15	HEXA	72362375	72362466	0	92	627	12182	627	12090	0.0	0.05186104218362283
chr15	HEXA	72355909	72355976	0	68	627	12182	627	12114	0.0	0.05175829618623081
chr15	LINC02259	72616129	72616247	505	119	8165	641	7660	522	4.243697478991597	14.67432950191571
chr15	ADPGK	72755981	72756161	0	181	3061	5311	3061	5130	0.0	0.5966861598440546
chr15	ADPGK	72756250	72756447	0	198	3061	5311	3061	5113	0.0	0.5986700567181694
chr15	ADPGK	72771782	72771845	0	64	3061	5311	3061	5247	0.0	0.5833809796073947
chr15	ADPGK	72774871	72775097	0	227	3061	5311	3061	5084	0.0	0.6020849724626278
chr15	ADPGK	72755555	72755654	0	100	3061	5311	3061	5211	0.0	0.5874112454423335
chr15	NPTN	73597021	73597369	0	349	111	3644	111	3295	0.0	0.03368740515933232
chr15	LOXL1-AS1	73916342	73916447	0	106	8599	4796	8599	4690	0.0	1.8334754797441364
chr15	LOXL1-AS1	73925269	73925505	8599	237	8599	4796	0	4559	36.28270042194093	0.0
chr15	STOML1	73984658	73984871	0	214	13933	8369	13933	8155	0.0	1.708522378908645
chr15	STOML1	73989107	73989257	0	151	13933	8369	13933	8218	0.0	1.6954246775371136
chr15	STOML1	73984658	73984868	0	211	13933	8369	13933	8158	0.0	1.7078940916891394
chr15	STOML1	73990814	73990945	0	132	13933	8369	13933	8237	0.0	1.6915139006919995
chr15	GOLGA6A	74080615	74080735	0	121	0	3522	0	3401	0.0	0.0
chr15	STRA6	74183855	74183989	0	135	10514	6568	10514	6433	0.0	1.6343852013057671
chr15	STRA6	74195301	74195468	0	168	10514	6568	10514	6400	0.0	1.6428125
chr15	STRA6	74195651	74195675	0	25	10514	6568	10514	6543	0.0	1.606908146110347
chr15	STRA6	74183252	74183989	0	738	10514	6568	10514	5830	0.0	1.8034305317324186
chr15	CYP11A1	74339236	74339315	99	80	65780	3410	65681	3330	1.2375	19.724024024024025
chr15	CYP11A1	74347899	74348055	816	157	65780	3410	64964	3253	5.197452229299363	19.970488779588074
chr15	CYP11A1	74350165	74350254	0	90	65780	3410	65780	3320	0.0	19.813253012048193
chr15	SEMA7A	74418267	74418309	0	43	0	3814	0	3771	0.0	0.0
chr15	UBL7	74451435	74451520	0	86	1088	1897	1088	1811	0.0	0.6007730535615682
chr15	UBL7	74459018	74459103	103	86	1088	1897	985	1811	1.197674418604651	0.5438983986747653
chr15	UBL7	74460667	74460778	0	112	1088	1897	1088	1785	0.0	0.6095238095238096
chr15	UBL7	74452295	74452378	0	84	1088	1897	1088	1813	0.0	0.6001103143960287
chr15	EDC3	74655732	74656068	0	337	0	5102	0	4765	0.0	0.0
chr15	EDC3	74671454	74671774	0	321	0	5102	0	4781	0.0	0.0
chr15	EDC3	74676940	74677022	0	83	0	5102	0	5019	0.0	0.0
chr15	EDC3	74687090	74687179	0	90	0	5102	0	5012	0.0	0.0
chr15	EDC3	74674960	74675142	0	183	0	5102	0	4919	0.0	0.0
chr15	EDC3	74692885	74693018	0	134	0	5102	0	4968	0.0	0.0
chr15	EDC3	74679801	74679925	0	125	0	5102	0	4977	0.0	0.0
chr15	CYP1A1	74720966	74721053	0	88	0	3368	0	3280	0.0	0.0
chr15	ULK3	74838265	74838344	0	80	9712	3361	9712	3281	0.0	2.9600731484303564
chr15	ULK3	74842534	74842674	0	141	9712	3361	9712	3220	0.0	3.0161490683229815
chr15	SCAMP2	74854580	74854649	0	70	1224	3262	1224	3192	0.0	0.38345864661654133
chr15	SCAMP2	74853367	74853496	0	130	1224	3262	1224	3132	0.0	0.39080459770114945
chr15	FAM219B	74901168	74901256	204	89	300	3076	96	2987	2.292134831460674	0.03213927017073987
chr15	FAM219B	74904663	74904712	0	50	300	3076	300	3026	0.0	0.0991407799074686
chr15	FAM219B	74906277	74906365	0	89	300	3076	300	2987	0.0	0.1004352192835621
chr15	FAM219B	74904981	74905059	0	79	300	3076	300	2997	0.0	0.1001001001001001
chr15	FAM219B	74906323	74906365	0	43	300	3076	300	3033	0.0	0.09891196834817013
chr15	FAM219B	74904981	74905039	0	59	300	3076	300	3017	0.0	0.09943652635067948
chr15	COX5A	74923647	74923770	6005	124	90024	1332	84019	1208	48.42741935483871	69.5521523178808
chr15	COX5A	74929115	74929232	2147	118	90024	1332	87877	1214	18.194915254237287	72.38632619439868
chr15	COX5A	74926765	74926887	191	123	90024	1332	89833	1209	1.5528455284552845	74.30355665839537
chr15	MAN2C1	75363998	75364188	714	191	8773	7504	8059	7313	3.738219895287958	1.1020101189662246
chr15	MAN2C1	75368072	75368198	1035	127	8773	7504	7738	7377	8.149606299212598	1.0489358817947676
chr15	MAN2C1	75362641	75362748	0	108	8773	7504	8773	7396	0.0	1.1861817198485667
chr15	MAN2C1	75363209	75363290	0	82	8773	7504	8773	7422	0.0	1.1820264079762868
chr15	MAN2C1	75365600	75365698	0	99	8773	7504	8773	7405	0.0	1.1847400405131667
chr15	MAN2C1	75368072	75368159	1035	88	8773	7504	7738	7416	11.761363636363637	1.0434196332254584
chr15	MAN2C1	75365961	75366009	0	49	8773	7504	8773	7455	0.0	1.1767940979208584
chr15	SIN3A	75443592	75443707	0	116	4168	12419	4168	12303	0.0	0.33877915955458016
chr15	SIN3A	75436345	75436443	0	99	4168	12419	4168	12320	0.0	0.3383116883116883
chr15	SIN3A	75446228	75446395	0	168	4168	12419	4168	12251	0.0	0.34021712513264224
chr15	PTPN9	75470679	75470830	0	152	285	8599	285	8447	0.0	0.03373978927429857
chr15	AC105036.3	75597339	75597480	0	142	0	1101	0	959	0.0	0.0
chr15	AC105036.3	75570229	75570346	0	118	0	1101	0	983	0.0	0.0
chr15	SNUPN	75622341	75622490	0	150	204	3528	204	3378	0.0	0.06039076376554174
chr15	SNUPN	75624714	75624935	0	222	204	3528	204	3306	0.0	0.06170598911070781
chr15	SNUPN	75622341	75622408	0	68	204	3528	204	3460	0.0	0.058959537572254334
chr15	NRG4	75971165	75971248	80	84	11295	3050	11215	2966	0.9523809523809523	3.7811867835468647
chr15	NRG4	75969128	75969224	3024	97	11295	3050	8271	2953	31.175257731958762	2.8008804605485946
chr15	NRG4	75959021	75959140	1029	120	11295	3050	10266	2930	8.575	3.503754266211604
chr15	NRG4	76056953	76057019	0	67	11295	3050	11295	2983	0.0	3.786456587328193
chr15	NRG4	76053238	76053369	0	132	11295	3050	11295	2918	0.0	3.8708019191226866
chr15	ETFA	76283756	76283825	0	70	28982	5050	28982	4980	0.0	5.819678714859438
chr15	ETFA	76292618	76292700	0	83	28982	5050	28982	4967	0.0	5.834910408697403
chr15	ETFA	76295590	76295737	0	148	28982	5050	28982	4902	0.0	5.912280701754386
chr15	ETFA	76227712	76227897	1279	186	28982	5050	27703	4864	6.876344086021505	5.695518092105263
chr15	ETFA	76292430	76292513	0	84	28982	5050	28982	4966	0.0	5.836085380587998
chr15	ETFA	76217585	76217677	0	93	28982	5050	28982	4957	0.0	5.8466814605608235
chr15	ETFA	76227712	76227918	1515	207	28982	5050	27467	4843	7.318840579710145	5.6714846169729505
chr15	ETFA	76309931	76310064	0	134	28982	5050	28982	4916	0.0	5.895443449959316
chr15	ETFA	76284364	76284460	0	97	28982	5050	28982	4953	0.0	5.851403189985867
chr15	ETFA	76284804	76284927	0	124	28982	5050	28982	4926	0.0	5.8834754364596025
chr15	SCAPER	76841733	76841931	0	199	1049	11270	1049	11071	0.0	0.0947520549182549
chr15	SCAPER	76862415	76862533	0	119	1049	11270	1049	11151	0.0	0.09407228051295848
chr15	SCAPER	76793232	76793391	0	160	1049	11270	1049	11110	0.0	0.09441944194419442
chr15	SCAPER	76855809	76855876	0	68	1049	11270	1049	11202	0.0	0.09364399214425996
chr15	SCAPER	76567269	76567405	0	137	1049	11270	1049	11133	0.0	0.09422437797538849
chr15	SCAPER	76904613	76904791	0	179	1049	11270	1049	11091	0.0	0.09458119195744297
chr15	SCAPER	76774367	76774409	0	43	1049	11270	1049	11227	0.0	0.09343546806805024
chr15	TSPAN3	77055788	77055863	0	76	4442	6899	4442	6823	0.0	0.6510332698226586
chr15	TSPAN3	77056063	77056255	0	193	4442	6899	4442	6706	0.0	0.6623918878616165
chr15	TSPAN3	77055788	77055829	0	42	4442	6899	4442	6857	0.0	0.6478051626075543
chr15	PEAK1	77252366	77252526	0	161	90693	23394	90693	23233	0.0	3.903628459518788
chr15	PEAK1	77286422	77286504	0	83	90693	23394	90693	23311	0.0	3.890566685255888
chr15	PEAK1	77365162	77365225	0	64	90693	23394	90693	23330	0.0	3.88739819974282
chr15	LINGO1	77677088	77677174	0	87	562	5340	562	5253	0.0	0.10698648391395393
chr15	CIB2	78105738	78105934	0	197	0	2145	0	1948	0.0	0.0
chr15	CIB2	78111164	78111276	0	113	0	2145	0	2032	0.0	0.0
chr15	CIB2	78123704	78123739	0	36	0	2145	0	2109	0.0	0.0
chr15	CIB2	78110655	78110733	0	79	0	2145	0	2066	0.0	0.0
chr15	CIB2	78120567	78120661	0	95	0	2145	0	2050	0.0	0.0
chr15	ACSBG1	78208001	78208102	0	102	1925	8170	1925	8068	0.0	0.23859692612791275
chr15	ACSBG1	78226454	78226605	0	152	1925	8170	1925	8018	0.0	0.24008480917934646
chr15	ACSBG1	78209144	78209249	0	106	1925	8170	1925	8064	0.0	0.2387152777777778
chr15	WDR61	78294945	78294973	754	29	53088	5010	52334	4981	26.0	10.506725557117045
chr15	WDR61	78288842	78288917	4843	76	53088	5010	48245	4934	63.723684210526315	9.778070531009323
chr15	CHRNA3	78593913	78594011	0	99	204	4771	204	4672	0.0	0.04366438356164384
chr15	CHRNB4	78628966	78629945	0	980	0	5003	0	4023	0.0	0.0
chr15	CHRNB4	78634621	78634739	0	119	0	5003	0	4884	0.0	0.0
chr15	CHRNB4	78652577	78652671	0	95	0	5003	0	4908	0.0	0.0
chr15	ADAMTS7	78767378	78767592	143	215	31048	6831	30905	6616	0.6651162790697674	4.671251511487304
chr15	CTSH	78922992	78923118	0	127	51	11133	51	11006	0.0	0.0046338360894057785
chr15	CTSH	78929411	78929493	0	83	51	11133	51	11050	0.0	0.004615384615384616
chr15	CTSH	78931868	78932038	0	171	51	11133	51	10962	0.0	0.004652435686918446
chr15	CTSH	78932371	78932458	0	88	51	11133	51	11045	0.0	0.004617473970122227
chr15	CTSH	78937317	78937423	0	107	51	11133	51	11026	0.0	0.004625430799927444
chr15	CTSH	78926174	78926254	0	81	51	11133	51	11052	0.0	0.004614549402823019
chr15	CTSH	78926781	78926830	0	50	51	11133	51	11083	0.0	0.004601642154651268
chr15	CTSH	78937317	78937496	0	180	51	11133	51	10953	0.0	0.0046562585592988225
chr15	CTSH	78937685	78937792	0	108	51	11133	51	11025	0.0	0.004625850340136055
chr15	CTSH	78926781	78926939	0	159	51	11133	51	10974	0.0	0.004647348277747403
chr15	CTSH	78937685	78937823	0	139	51	11133	51	10994	0.0	0.004638893942150264
chr15	CTSH	78931900	78932038	0	139	51	11133	51	10994	0.0	0.004638893942150264
chr15	CTSH	78926562	78926684	0	123	51	11133	51	11010	0.0	0.004632152588555858
chr15	CTSH	78931868	78932041	0	174	51	11133	51	10959	0.0	0.0046537092800438
chr15	CTSH	78944537	78944631	0	95	51	11133	51	11038	0.0	0.004620402246783837
chr15	CTSH	78937034	78937185	0	152	51	11133	51	10981	0.0	0.004644385757217011
chr15	CTSH	78932275	78932458	0	184	51	11133	51	10949	0.0	0.004657959631016531
chr15	CTSH	78942840	78942930	0	91	51	11133	51	11042	0.0	0.00461872849121536
chr15	CTSH	78926781	78926868	0	88	51	11133	51	11045	0.0	0.004617473970122227
chr15	CTSH	78927367	78927436	0	70	51	11133	51	11063	0.0	0.004609961131700262
chr15	RASGRF1	79012488	79012527	0	40	1021	9181	1021	9141	0.0	0.11169456295810086
chr15	ANKRD34C-AS1	79260704	79260846	0	143	760484	10687	760484	10544	0.0	72.12481031866464
chr15	ANKRD34C-AS1	79213186	79213359	312	174	760484	10687	760172	10513	1.793103448275862	72.30780937886426
chr15	ANKRD34C-AS1	79260228	79260301	0	74	760484	10687	760484	10613	0.0	71.65589371525488
chr15	ANKRD34C-AS1	79260224	79260306	0	83	760484	10687	760484	10604	0.0	71.7167106752169
chr15	ANKRD34C-AS1	79260228	79260306	0	79	760484	10687	760484	10608	0.0	71.68966817496229
chr15	ST20-MTHFS	79907628	79907684	0	57	0	987	0	930	0.0	0.0
chr15	BCL2A1	79967636	79967692	0	57	51	839	51	782	0.0	0.06521739130434782
chr15	AC027808.2	80900829	80900965	0	137	0	749	0	612	0.0	0.0
chr15	MESD	80952936	80953036	0	101	0	4448	0	4347	0.0	0.0
chr15	STARD5	81322898	81322948	0	51	5562	5447	5562	5396	0.0	1.030763528539659
chr15	AC104041.1	81797923	81798044	0	122	1729	7188	1729	7066	0.0	0.24469289555618454
chr15	EFL1	82240417	82240555	0	139	0	4691	0	4552	0.0	0.0
chr15	EFL1	82252690	82252775	0	86	0	4691	0	4605	0.0	0.0
chr15	EFL1	82259087	82259155	0	69	0	4691	0	4622	0.0	0.0
chr15	EFL1	82261985	82262348	0	364	0	4691	0	4327	0.0	0.0
chr15	GOLGA2P10	82477837	82477926	0	90	0	1291	0	1201	0.0	0.0
chr15	GOLGA2P10	82477202	82477298	0	97	0	1291	0	1194	0.0	0.0
chr15	RPS17	82537921	82538042	0	122	0	1750	0	1628	0.0	0.0
chr15	RPS17	82539299	82539375	0	77	0	1750	0	1673	0.0	0.0
chr15	CPEB1	82557759	82557986	21	228	8875	8139	8854	7911	0.09210526315789473	1.1192011123751737
chr15	CPEB1	82583370	82583462	0	93	8875	8139	8875	8046	0.0	1.1030325627641064
chr15	AP3B2	82659844	82659983	0	140	1275758	8150	1275758	8010	0.0	159.27066167290886
chr15	AP3B2	82662693	82662922	0	230	1275758	8150	1275758	7920	0.0	161.08055555555555
chr15	AP3B2	82688735	82688831	80	97	1275758	8150	1275678	8053	0.8247422680412371	158.41028188252824
chr15	AP3B2	82665246	82665303	0	58	1275758	8150	1275758	8092	0.0	157.65669797330696
chr15	AP3B2	82665859	82665984	0	126	1275758	8150	1275758	8024	0.0	158.99277168494515
chr15	AP3B2	82688019	82688096	0	78	1275758	8150	1275758	8072	0.0	158.04732408325074
chr15	AP3B2	82689157	82689232	0	76	1275758	8150	1275758	8074	0.0	158.00817438692098
chr15	AC105339.1	82711186	82711432	2826	247	6022	1228	3196	981	11.441295546558704	3.2579001019367992
chr15	FSD2	82769749	82769884	0	136	30655	6550	30655	6414	0.0	4.779388836919239
chr15	FSD2	82796249	82796366	0	118	30655	6550	30655	6432	0.0	4.76601368159204
chr15	C15ORF40	83008547	83008675	0	129	6073	2219	6073	2090	0.0	2.905741626794258
chr15	BTBD1	83020674	83020762	0	89	761	4076	761	3987	0.0	0.1908703285678455
chr15	BTBD1	83050072	83050178	102	107	761	4076	659	3969	0.9532710280373832	0.16603678508440414
chr15	BTBD1	83028615	83028728	0	114	761	4076	761	3962	0.0	0.19207470974255428
chr15	HDGFL3	83192251	83192308	0	58	788061	16068	788061	16010	0.0	49.223048094940665
chr15	HDGFL3	83189360	83189516	0	157	788061	16068	788061	15911	0.0	49.5293193388222
chr15	GOLGA2P7	84204599	84204691	0	93	0	3261	0	3168	0.0	0.0
chr15	GOLGA2P7	84204176	84204331	0	156	0	3261	0	3105	0.0	0.0
chr15	GOLGA2P7	84205230	84205319	0	90	0	3261	0	3171	0.0	0.0
chr15	UBE2Q2P1	84534179	84534238	0	60	51	2432	51	2372	0.0	0.021500843170320406
chr15	UBE2Q2P1	84539703	84539788	0	86	51	2432	51	2346	0.0	0.021739130434782608
chr15	AC048382.5	84606361	84606463	0	103	0	3673	0	3570	0.0	0.0
chr15	WDR73	84648536	84648625	0	90	0	8315	0	8225	0.0	0.0
chr15	WDR73	84645972	84646085	0	114	0	8315	0	8201	0.0	0.0
chr15	WDR73	84646689	84647023	0	335	0	8315	0	7980	0.0	0.0
chr15	SEC11A	84670724	84670782	0	59	0	4847	0	4788	0.0	0.0
chr15	SEC11A	84687624	84687774	0	151	0	4847	0	4696	0.0	0.0
chr15	SEC11A	84679931	84679969	0	39	0	4847	0	4808	0.0	0.0
chr15	SEC11A	84680712	84680832	0	121	0	4847	0	4726	0.0	0.0
chr15	SEC11A	84714730	84714866	0	137	0	4847	0	4710	0.0	0.0
chr15	SEC11A	84679225	84679287	0	63	0	4847	0	4784	0.0	0.0
chr15	SEC11A	84691969	84692120	0	152	0	4847	0	4695	0.0	0.0
chr15	AC044860.1	85209829	85209918	0	90	117315	2932	117315	2842	0.0	41.279028852920476
chr15	KLHL25	85768016	85769820	0	1805	918	7114	918	5309	0.0	0.17291391975889997
chr15	LINC01584	86088303	86088343	0	41	2296	3080	2296	3039	0.0	0.7555116814741691
chr15	LINC01584	86086249	86086373	0	125	2296	3080	2296	2955	0.0	0.7769881556683587
chr15	LINC01584	86109772	86109919	0	148	2296	3080	2296	2932	0.0	0.7830832196452933
chr15	LINC01584	86111052	86111250	10	199	2296	3080	2286	2881	0.05025125628140704	0.7934744880249913
chr15	LINC01584	86110442	86110539	0	98	2296	3080	2296	2982	0.0	0.7699530516431925
chr15	LINC01584	86109772	86109861	0	90	2296	3080	2296	2990	0.0	0.7678929765886288
chr15	LINC01584	86087898	86087996	0	99	2296	3080	2296	2981	0.0	0.7702113384770212
chr15	LINC01584	86109772	86109874	0	103	2296	3080	2296	2977	0.0	0.7712462210278804
chr15	AGBL1-AS1	86299735	86299881	424	147	7956	2445	7532	2298	2.8843537414965987	3.27763272410792
chr15	AGBL1-AS1	86312131	86312382	85	252	7956	2445	7871	2193	0.3373015873015873	3.5891472868217056
chr15	AC020687.1	87429897	87429992	0	96	0	1553	0	1457	0.0	0.0
chr15	AC020687.1	87487601	87487663	0	63	0	1553	0	1490	0.0	0.0
chr15	AC020687.1	87542920	87542997	0	78	0	1553	0	1475	0.0	0.0
chr15	NTRK3	88126270	88126373	0	104	25192	25769	25192	25665	0.0	0.9815702318332359
chr15	NTRK3	88128710	88128734	0	25	25192	25769	25192	25744	0.0	0.9785581106277191
chr15	NTRK3	87885693	87885735	0	43	25192	25769	25192	25726	0.0	0.9792427893959419
chr15	NTRK3	88135100	88135397	0	298	25192	25769	25192	25471	0.0	0.9890463664559696
chr15	NTRK3	87908488	87908563	741	76	25192	25769	24451	25693	9.75	0.9516599852099794
chr15	NTRK3	87925569	87925664	0	96	25192	25769	25192	25673	0.0	0.9812643633389164
chr15	NTRK3	87981225	87981360	0	136	25192	25769	25192	25633	0.0	0.9827956150275036
chr15	MRPL46	88460152	88460382	0	231	102	1223	102	992	0.0	0.1028225806451613
chr15	MRPL46	88465586	88465773	0	188	102	1223	102	1035	0.0	0.09855072463768116
chr15	DET1	88527598	88527786	0	189	153	4789	153	4600	0.0	0.03326086956521739
chr15	DET1	88536311	88536381	0	71	153	4789	153	4718	0.0	0.03242899533700721
chr15	HAPLN3	88879417	88880610	51	1194	51	3496	0	2302	0.04271356783919598	0.0
chr15	HAPLN3	88892973	88893112	0	140	51	3496	51	3356	0.0	0.015196662693682956
chr15	HAPLN3	88879417	88879452	0	36	51	3496	51	3460	0.0	0.014739884393063583
chr15	MFGE8	88899655	88899811	0	157	152	4651	152	4494	0.0	0.03382287494437027
chr15	MFGE8	88909791	88909923	0	133	152	4651	152	4518	0.0	0.033643204957945996
chr15	MFGE8	88912123	88912176	0	54	152	4651	152	4597	0.0	0.03306504241896889
chr15	POLG	89322741	89322902	0	162	155	6927	155	6765	0.0	0.022912047302291204
chr15	POLG	89323403	89323552	0	150	155	6927	155	6777	0.0	0.02287147705474399
chr15	POLG	89328455	89328535	0	81	155	6927	155	6846	0.0	0.02264095822378031
chr15	POLG	89332217	89332374	0	158	155	6927	155	6769	0.0	0.022898507903678533
chr15	POLG	89323403	89323511	0	109	155	6927	155	6818	0.0	0.02273393957172191
chr15	POLG	89317938	89318037	0	100	155	6927	155	6827	0.0	0.02270396953273766
chr15	POLG	89317938	89317975	0	38	155	6927	155	6889	0.0	0.022499637102627378
chr15	RHCG	89486270	89486529	0	260	51	2548	51	2288	0.0	0.022290209790209792
chr15	LINC00928	89517283	89517437	38	155	38	2562	0	2407	0.24516129032258063	0.0
chr15	LINC00928	89517401	89517437	37	37	38	2562	1	2525	1.0	0.00039603960396039607
chr15	PEX11A	89686430	89686546	0	117	102	1637	102	1520	0.0	0.06710526315789474
chr15	ANPEP	89814113	89814294	246	182	30577	5070	30331	4888	1.3516483516483517	6.205196399345335
chr15	ARPIN-AP3S2	89903776	89903983	0	208	12450	2684	12450	2476	0.0	5.02827140549273
chr15	AP3S2	89877305	89877424	5345	120	30014	3566	24669	3446	44.541666666666664	7.158734764944864
chr15	AP3S2	89878264	89878300	0	37	30014	3566	30014	3529	0.0	8.504958911873052
chr15	IDH2	90084815	90084908	0	94	9	2799	9	2705	0.0	0.0033271719038817007
chr15	CIB1	90231683	90231788	126	106	5403	1480	5277	1374	1.1886792452830188	3.8406113537117905
chr15	HDDC3	90932428	90932806	264	379	13693	2622	13429	2243	0.6965699208443272	5.987070887204637
chr15	PRC1	90969078	90969120	0	43	13227	5528	13227	5485	0.0	2.411485870556062
chr15	PRC1	90970403	90970514	0	112	13227	5528	13227	5416	0.0	2.442208271787297
chr15	PRC1	90981498	90981669	0	172	13227	5528	13227	5356	0.0	2.4695668409260643
chr15	PRC1	90984017	90984140	0	124	13227	5528	13227	5404	0.0	2.4476313841598816
chr15	PRC1	90984692	90984825	4555	134	13227	5528	8672	5394	33.992537313432834	1.6077122728958102
chr15	VPS33B	91016962	91017024	3709	63	25576	3572	21867	3509	58.87301587301587	6.23168994015389
chr15	VPS33B	91017804	91017885	7425	82	25576	3572	18151	3490	90.54878048780488	5.200859598853868
chr15	H2AZ2P1	92724161	92724238	0	78	16371	2874	16371	2796	0.0	5.855150214592275
chr15	RGMA	93051992	93052507	0	516	0	12942	0	12426	0.0	0.0
chr15	RGMA	93066100	93066255	0	156	0	12942	0	12786	0.0	0.0
chr15	RGMA	93065831	93066259	561	429	0	12942	-561	12513	1.3076923076923077	-0.04483337329177655
chr15	LINC01579	93801444	93801627	27	184	179	9355	152	9171	0.14673913043478262	0.016573983207938067
chr15	LINC01579	93900035	93900135	0	101	179	9355	179	9254	0.0	0.019342986816511778
chr15	LINC01579	93897422	93897539	50	118	179	9355	129	9237	0.423728813559322	0.013965573238064306
chr15	AC087633.1	95039431	95039523	0	93	0	1474	0	1381	0.0	0.0
chr15	AC087636.1	95147018	95147238	0	221	0	4475	0	4254	0.0	0.0
chr15	LINC01197	95289421	95289554	0	134	0	13078	0	12944	0.0	0.0
chr15	LINC01197	95212680	95212879	0	200	0	13078	0	12878	0.0	0.0
chr15	LINC01197	95307378	95307576	0	199	0	13078	0	12879	0.0	0.0
chr15	LINC01197	95260470	95260574	0	105	0	13078	0	12973	0.0	0.0
chr15	LINC01197	95257025	95257202	0	178	0	13078	0	12900	0.0	0.0
chr15	LINC01197	95278429	95278513	0	85	0	13078	0	12993	0.0	0.0
chr15	AC027013.1	95491498	95491549	0	52	51	1510	51	1458	0.0	0.03497942386831276
chr15	AC027013.1	95469783	95469878	0	96	51	1510	51	1414	0.0	0.03606789250353607
chr15	AC024337.1	96062683	96062756	0	74	0	1640	0	1566	0.0	0.0
chr15	NR2F2-AS1	96288663	96288755	0	93	0	6853	0	6760	0.0	0.0
chr15	AC087477.5	96402430	96402626	0	197	0	817	0	620	0.0	0.0
chr15	AC020704.1	97311971	97312050	0	80	0	727	0	647	0.0	0.0
chr15	LINC02254	97427650	97427767	0	118	0	5214	0	5096	0.0	0.0
chr15	LINC02254	97427650	97427770	0	121	0	5214	0	5093	0.0	0.0
chr15	LINC02254	97342146	97342322	0	177	0	5214	0	5037	0.0	0.0
chr15	LINC00923	97808991	97809081	20	91	122	13269	102	13178	0.21978021978021978	0.007740173015632114
chr15	LINC00923	97758489	97758661	0	173	122	13269	122	13096	0.0	0.00931582162492364
chr15	LINC01582	98083833	98083900	0	68	0	2922	0	2854	0.0	0.0
chr15	FAM169B	98445994	98446128	0	135	51	4244	51	4109	0.0	0.01241177902165977
chr15	PGPEP1L	99001186	99001279	0	94	0	1634	0	1540	0.0	0.0
chr15	PGPEP1L	98998110	98998163	0	54	0	1634	0	1580	0.0	0.0
chr15	TTC23	99241364	99241559	51	196	1394	5136	1343	4940	0.2602040816326531	0.27186234817813765
chr15	TTC23	99245388	99245510	0	123	1394	5136	1394	5013	0.0	0.27807699980051864
chr15	TTC23	99234987	99235080	0	94	1394	5136	1394	5042	0.0	0.2764775882586275
chr15	TTC23	99249621	99249799	0	179	1394	5136	1394	4957	0.0	0.28121847891870083
chr15	TTC23	99249170	99249799	0	630	1394	5136	1394	4506	0.0	0.3093652907234798
chr15	TTC23	99234987	99235078	0	92	1394	5136	1394	5044	0.0	0.27636796193497226
chr15	LYSMD4	99731172	99731198	0	27	6091	5573	6091	5546	0.0	1.0982690227190768
chr15	LYSMD4	99732928	99733028	0	101	6091	5573	6091	5472	0.0	1.1131213450292399
chr15	LYSMD4	99731357	99731422	0	66	6091	5573	6091	5507	0.0	1.106046849464318
chr15	LYSMD4	99731357	99731407	0	51	6091	5573	6091	5522	0.0	1.1030423759507424
chr15	DNM1P46	99804799	99804929	0	131	320598	3985	320598	3854	0.0	83.18578100674624
chr15	ADAMTS17	100341038	100341409	2379	372	28090	6863	25711	6491	6.395161290322581	3.961022954860576
chr15	ADAMTS17	100063678	100063759	0	82	28090	6863	28090	6781	0.0	4.142456864769208
chr15	CERS3	100528812	100529075	0	264	3380	5147	3380	4883	0.0	0.6921974196190867
chr15	CERS3	100503709	100503848	0	140	3380	5147	3380	5007	0.0	0.6750549231076493
chr15	LINS1	100586223	100586332	0	110	0	7512	0	7402	0.0	0.0
chr15	AC015712.2	100917887	100918213	0	327	0	7703	0	7376	0.0	0.0
chr15	CHSY1	101187992	101188219	85	228	12623	5408	12538	5180	0.37280701754385964	2.4204633204633206
chr15	SNRPA1	101286213	101286293	0	81	0	2337	0	2256	0.0	0.0
chr15	SNRPA1	101287655	101287702	0	48	0	2337	0	2289	0.0	0.0
chr15	SNRPA1	101293292	101293393	0	102	0	2337	0	2235	0.0	0.0
chr15	PCSK6	101313375	101313505	0	131	53100	16686	53100	16555	0.0	3.2074901842343704
chr15	PCSK6	101366195	101366332	0	138	53100	16686	53100	16548	0.0	3.2088469905728787
chr15	PCSK6	101331650	101331689	0	40	53100	16686	53100	16646	0.0	3.189955544875646
chr15	PCSK6	101305105	101305355	0	251	53100	16686	53100	16435	0.0	3.2309096440523275
chr15	PCSK6	101431319	101431463	783	145	53100	16686	52317	16541	5.4	3.1628680249078047
chr15	PCSK6	101364998	101365044	0	47	53100	16686	53100	16639	0.0	3.1912975539395396
chr15	TM2D3	101651695	101651773	0	79	2125	11588	2125	11509	0.0	0.18463810930576072
chr15	TARS3	101657784	101657857	0	74	1814	4478	1814	4404	0.0	0.41189827429609444
chr15	TARS3	101699330	101699435	0	106	1814	4478	1814	4372	0.0	0.4149130832570906
chr15	TARS3	101655866	101656020	0	155	1814	4478	1814	4323	0.0	0.41961600740226696
chr16	SNRNP25	56320	56420	0	101	0	1293	0	1192	0.0	0.0
chr16	MPG	79138	79331	809	194	5145	1503	4336	1309	4.170103092783505	3.312452253628724
chr16	FAM234A	259482	259599	1722	118	74763	5109	73041	4991	14.59322033898305	14.63454217591665
chr16	FAM234A	264015	264171	0	157	74763	5109	74763	4952	0.0	15.09753634894992
chr16	FAM234A	264810	264908	95	99	74763	5109	74668	5010	0.9595959595959596	14.903792415169661
chr16	FAM234A	253832	253929	0	98	74763	5109	74763	5011	0.0	14.91977649171822
chr16	FAM234A	246956	247069	0	114	74763	5109	74763	4995	0.0	14.967567567567567
chr16	FAM234A	248243	248397	457	155	74763	5109	74306	4954	2.9483870967741934	14.999192571659265
chr16	ARHGDIG	281745	281925	3186	181	22875	1855	19689	1674	17.60220994475138	11.761648745519713
chr16	NME4	399378	399480	0	103	60411	3175	60411	3072	0.0	19.6650390625
chr16	NME4	398207	398385	0	179	60411	3175	60411	2996	0.0	20.16388518024032
chr16	NME4	398207	398394	0	188	60411	3175	60411	2987	0.0	20.224640107130902
chr16	DECR2	406684	406777	0	94	153	2636	153	2542	0.0	0.06018882769472856
chr16	NME4	397878	397902	0	25	60411	3175	60411	3150	0.0	19.17809523809524
chr16	DECR2	411360	411578	0	219	153	2636	153	2417	0.0	0.063301613570542
chr16	DECR2	405512	405665	102	154	153	2636	51	2482	0.6623376623376623	0.02054794520547945
chr16	DECR2	407424	407560	0	137	153	2636	153	2499	0.0	0.061224489795918366
chr16	DECR2	406684	406952	0	269	153	2636	153	2367	0.0	0.06463878326996197
chr16	RAB11FIP3	491133	491268	0	136	157678	6050	157678	5914	0.0	26.661819411565777
chr16	CAPN15	536028	536142	51	115	180113	8004	180062	7889	0.4434782608695652	22.82443909240715
chr16	PIGQ	578784	578938	801	155	23122	6456	22321	6301	5.167741935483871	3.542453578797016
chr16	PIGQ	580182	580263	418	82	23122	6456	22704	6374	5.097560975609756	3.5619705051772828
chr16	PIGQ	580857	580972	51	116	23122	6456	23071	6340	0.4396551724137931	3.6389589905362776
chr16	PIGQ	582247	582309	47	63	23122	6456	23075	6393	0.746031746031746	3.6094165493508523
chr16	PIGQ	570647	570760	9554	114	23122	6456	13568	6342	83.80701754385964	2.139388205613371
chr16	PIGQ	574527	574763	0	237	23122	6456	23122	6219	0.0	3.717961086991478
chr16	PIGQ	581198	581341	0	144	23122	6456	23122	6312	0.0	3.6631812420785805
chr16	RAB40C	618199	618260	0	62	98056	3905	98056	3843	0.0	25.515482695810565
chr16	RAB40C	625036	625242	0	207	98056	3905	98056	3698	0.0	26.51595457003786
chr16	RAB40C	596316	596448	5478	133	98056	3905	92578	3772	41.18796992481203	24.543478260869566
chr16	MCRIP2	647416	647544	323	129	24670	2777	24347	2648	2.503875968992248	9.194486404833837
chr16	MCRIP2	646471	646608	622	138	24670	2777	24048	2639	4.507246376811594	9.11254262978401
chr16	WDR90	660057	660161	0	105	78603	10446	78603	10341	0.0	7.601102407890919
chr16	WDR90	662672	662844	1541	173	78603	10446	77062	10273	8.907514450867051	7.501411466952205
chr16	WDR90	666454	666598	0	145	78603	10446	78603	10301	0.0	7.630618386564411
chr16	WDR90	666904	666989	0	86	78603	10446	78603	10360	0.0	7.587162162162162
chr16	WDR90	662678	662844	1509	167	78603	10446	77094	10279	9.035928143712574	7.500145928592276
chr16	RHOT2	668487	668569	57	83	27744	4192	27687	4109	0.6867469879518072	6.73813579946459
chr16	RHOT2	669552	669606	1106	55	27744	4192	26638	4137	20.10909090909091	6.438965433889292
chr16	RHOT2	670674	670773	131	100	27744	4192	27613	4092	1.31	6.748044965786901
chr16	RHOT2	670695	670773	80	79	27744	4192	27664	4113	1.0126582278481013	6.725990761001702
chr16	RHBDL1	676671	676896	2	226	52527	1727	52525	1501	0.008849557522123894	34.99333777481679
chr16	ANTKMT	722083	722134	22248	52	209710	1398	187462	1346	427.84615384615387	139.27340267459138
chr16	HAGHL	727964	728029	62	66	221403	4949	221341	4883	0.9393939393939394	45.328896170387054
chr16	HAGHL	728315	728604	0	290	221403	4949	221403	4659	0.0	47.521571152607855
chr16	CHTF18	791850	791948	0	99	12796	4621	12796	4522	0.0	2.829721362229102
chr16	CHTF18	790006	790081	35	76	12796	4621	12761	4545	0.4605263157894737	2.8077007700770076
chr16	CHTF18	792223	792347	0	125	12796	4621	12796	4496	0.0	2.846085409252669
chr16	LMF1-AS1	933100	933255	592	156	6750	1451	6158	1295	3.7948717948717947	4.755212355212355
chr16	CACNA1H	1212510	1212528	0	19	0	8655	0	8636	0.0	0.0
chr16	UBE2I	1314292	1314376	0	85	51	8510	51	8425	0.0	0.006053412462908012
chr16	UBE2I	1312346	1312603	0	258	51	8510	51	8252	0.0	0.006180319922443044
chr16	UBE2I	1314019	1314096	0	78	51	8510	51	8432	0.0	0.006048387096774193
chr16	UBE2I	1312346	1312667	0	322	51	8510	51	8188	0.0	0.006228627259404006
chr16	UBE2I	1312346	1312558	0	213	51	8510	51	8297	0.0	0.006146800048210196
chr16	UBE2I	1319701	1319862	0	162	51	8510	51	8348	0.0	0.00610924772400575
chr16	BAIAP3	1342526	1342634	0	109	1150	6110	1150	6001	0.0	0.1916347275454091
chr16	BAIAP3	1346846	1346955	0	110	1150	6110	1150	6000	0.0	0.19166666666666668
chr16	BAIAP3	1346933	1346955	0	23	1150	6110	1150	6087	0.0	0.18892722194841466
chr16	GNPTG	1357699	1357832	0	134	139925	2982	139925	2848	0.0	49.1309691011236
chr16	GNPTG	1361742	1361797	66	56	139925	2982	139859	2926	1.1785714285714286	47.798701298701296
chr16	TELO2	1502644	1502761	3402	118	284188	4075	280786	3957	28.83050847457627	70.95931261056356
chr16	CRAMP1	1662760	1662835	0	76	43996	8617	43996	8541	0.0	5.151153260742301
chr16	CRAMP1	1666072	1666177	2038	106	43996	8617	41958	8511	19.22641509433962	4.929855481142051
chr16	CRAMP1	1667334	1667400	523	67	43996	8617	43473	8550	7.8059701492537314	5.084561403508772
chr16	JPT2	1685438	1685587	0	150	37474	3868	37474	3718	0.0	10.079074771382464
chr16	JPT2	1683508	1683592	0	85	37474	3868	37474	3783	0.0	9.905894792492731
chr16	JPT2	1691842	1691985	689	144	37474	3868	36785	3724	4.784722222222222	9.87781954887218
chr16	JPT2	1683508	1683620	0	113	37474	3868	37474	3755	0.0	9.979760319573902
chr16	MAPK8IP3	1758977	1758995	0	19	21080	7888	21080	7869	0.0	2.6788664379209557
chr16	MAPK8IP3	1740694	1740718	0	25	21080	7888	21080	7863	0.0	2.6809105939208955
chr16	NUBP2	1786756	1786955	487	200	9482	3124	8995	2924	2.435	3.076265389876881
chr16	NUBP2	1786737	1786955	612	219	9482	3124	8870	2905	2.7945205479452055	3.053356282271945
chr16	NUBP2	1783876	1784066	0	191	9482	3124	9482	2933	0.0	3.2328673712921923
chr16	NUBP2	1785638	1785902	1468	265	9482	3124	8014	2859	5.539622641509434	2.803077999300455
chr16	FAHD1	1838015	1838134	11691	120	352741	3016	341050	2896	97.425	117.76588397790056
chr16	GFER	1984746	1984943	0	198	2244	2703	2244	2505	0.0	0.895808383233533
chr16	SYNGR3	1990498	1990672	0	175	13754	2313	13754	2138	0.0	6.43311506080449
chr16	TSC2	2048586	2048753	11939	168	127539	14665	115600	14497	71.06547619047619	7.974063599365386
chr16	TSC2	2060952	2061039	0	88	127539	14665	127539	14577	0.0	8.749331138094258
chr16	TSC2	2062971	2063053	31	83	127539	14665	127508	14582	0.37349397590361444	8.744205184474009
chr16	TSC2	2053341	2053452	0	112	127539	14665	127539	14553	0.0	8.763760049474335
chr16	TSC2	2077597	2077726	0	130	127539	14665	127539	14535	0.0	8.774613003095975
chr16	TSC2	2068557	2068776	0	220	127539	14665	127539	14445	0.0	8.829283489096573
chr16	TSC2	2082435	2082504	0	70	127539	14665	127539	14595	0.0	8.738540596094554
chr16	RAB26	2151129	2151315	0	187	88403	2395	88403	2208	0.0	40.03759057971015
chr16	MLST8	2207034	2207110	294	77	79014	3668	78720	3591	3.8181818181818183	21.921470342522973
chr16	MLST8	2208209	2208334	0	126	79014	3668	79014	3542	0.0	22.30773574251835
chr16	MLST8	2206742	2206929	0	188	79014	3668	79014	3480	0.0	22.705172413793104
chr16	MLST8	2207856	2208024	561	169	79014	3668	78453	3499	3.3195266272189348	22.421549014004
chr16	AC009065.4	2271675	2271891	0	217	0	984	0	767	0.0	0.0
chr16	ABCA17P	2375342	2375455	0	114	5104	6345	5104	6231	0.0	0.8191301556732467
chr16	ABCA17P	2412277	2412397	0	121	5104	6345	5104	6224	0.0	0.8200514138817481
chr16	ABCA17P	2424158	2424335	0	178	5104	6345	5104	6167	0.0	0.8276309388681693
chr16	CCNF	2432960	2433067	0	108	353	5549	353	5441	0.0	0.06487777981988604
chr16	TEDC2	2460282	2460381	0	100	714	2854	714	2754	0.0	0.25925925925925924
chr16	TEDC2	2460815	2461224	532	410	714	2854	182	2444	1.2975609756097561	0.07446808510638298
chr16	TBC1D24	2499356	2499420	16387	65	565564	11559	549177	11494	252.1076923076923	47.779450147903255
chr16	TBC1D24	2497709	2497727	718	19	565564	11559	564846	11540	37.78947368421053	48.94679376083189
chr16	AMDHD2	2527560	2527615	160	56	26592	3044	26432	2988	2.857142857142857	8.846050870147256
chr16	AMDHD2	2527772	2527985	2294	214	26592	3044	24298	2830	10.719626168224298	8.585865724381625
chr16	AMDHD2	2520768	2520905	0	138	26592	3044	26592	2906	0.0	9.150722642807983
chr16	AMDHD2	2528649	2528718	0	70	26592	3044	26592	2974	0.0	8.94149293880296
chr16	AMDHD2	2527572	2527615	124	44	26592	3044	26468	3000	2.8181818181818183	8.822666666666667
chr16	PDPK1	2538501	2538771	102	271	69665	8690	69563	8419	0.3763837638376384	8.262620263689275
chr16	PDPK1	2538618	2538771	0	154	69665	8690	69665	8536	0.0	8.161316776007498
chr16	AC141586.1	2610461	2611052	16786	592	23464	2755	6678	2163	28.35472972972973	3.087378640776699
chr16	KCTD5	2697905	2697997	3090	93	33562	3381	30472	3288	33.225806451612904	9.267639902676398
chr16	SRRM2	2756333	2756606	0	274	127808	11355	127808	11081	0.0	11.533977077881058
chr16	SRRM2	2768504	2768599	0	96	127808	11355	127808	11259	0.0	11.351629807265299
chr16	FLYWCH2	2895219	2895320	0	102	0	1343	0	1241	0.0	0.0
chr16	FLYWCH1	2913005	2913250	0	246	22049	6621	22049	6375	0.0	3.458666666666667
chr16	FLYWCH1	2928823	2928917	0	95	22049	6621	22049	6526	0.0	3.3786392889978547
chr16	FLYWCH1	2936331	2936425	0	95	22049	6621	22049	6526	0.0	3.3786392889978547
chr16	FLYWCH1	2934614	2934667	0	54	22049	6621	22049	6567	0.0	3.3575453022689206
chr16	KREMEN2	2967525	2967604	0	80	7525	2270	7525	2190	0.0	3.4360730593607305
chr16	PAQR4	2971273	2971378	988	106	5147	2874	4159	2768	9.320754716981131	1.5025289017341041
chr16	PAQR4	2971156	2971378	1830	223	5147	2874	3317	2651	8.20627802690583	1.2512259524707658
chr16	LINC00514	2989973	2990006	300	34	44829	4466	44529	4432	8.823529411764707	10.047157039711191
chr16	LINC00514	2990454	2990487	109	34	44829	4466	44720	4432	3.2058823529411766	10.090252707581227
chr16	TNFRSF12A	3021188	3021319	17621	132	172802	1406	155181	1274	133.49242424242425	121.8061224489796
chr16	TNFRSF12A	3021214	3021319	13776	106	172802	1406	159026	1300	129.96226415094338	122.3276923076923
chr16	THOC6	3027365	3027500	9206	136	141580	1743	132374	1607	67.69117647058823	82.37336652146857
chr16	IL32	3065783	3065826	0	44	2027	2993	2027	2949	0.0	0.6873516446252967
chr16	IL32	3067553	3067613	0	61	2027	2993	2027	2932	0.0	0.6913369713506139
chr16	IL32	3067983	3068010	0	28	2027	2993	2027	2965	0.0	0.6836424957841484
chr16	IL32	3068179	3068239	288	61	2027	2993	1739	2932	4.721311475409836	0.5931105047748977
chr16	IL32	3065780	3065826	0	47	2027	2993	2027	2946	0.0	0.688051595383571
chr16	IL32	3065641	3065687	0	47	2027	2993	2027	2946	0.0	0.688051595383571
chr16	IL32	3065620	3065687	0	68	2027	2993	2027	2925	0.0	0.692991452991453
chr16	ZNF205	3118904	3119015	77	112	17155	2337	17078	2225	0.6875	7.675505617977528
chr16	ZNF213	3138744	3138818	0	75	994	3717	994	3642	0.0	0.2729269632070291
chr16	ZNF213	3138974	3139098	714	125	994	3717	280	3592	5.712	0.0779510022271715
chr16	CASP16P	3144452	3144647	0	196	0	3549	0	3353	0.0	0.0
chr16	ZNF263	3285058	3285239	39	182	20276	6076	20237	5894	0.21428571428571427	3.4334916864608074
chr16	ZNF263	3285680	3285754	0	75	20276	6076	20276	6001	0.0	3.3787702049658392
chr16	ZNF263	3288453	3288570	0	118	20276	6076	20276	5958	0.0	3.4031554212823094
chr16	ZNF75A	3308312	3308836	1216	525	11669	4348	10453	3823	2.316190476190476	2.7342401255558464
chr16	ZNF75A	3313048	3313175	2193	128	11669	4348	9476	4220	17.1328125	2.2454976303317538
chr16	NAA60	3476221	3476337	0	117	20914	6190	20914	6073	0.0	3.4437674954717603
chr16	NAA60	3447481	3447620	11576	140	20914	6190	9338	6050	82.68571428571428	1.5434710743801654
chr16	NAA60	3479470	3479600	0	131	20914	6190	20914	6059	0.0	3.4517247070473673
chr16	NAA60	3482501	3482598	0	98	20914	6190	20914	6092	0.0	3.433026920551543
chr16	NAA60	3448470	3448540	279	71	20914	6190	20635	6119	3.9295774647887325	3.372283052786403
chr16	NAA60	3456809	3456916	0	108	20914	6190	20914	6082	0.0	3.4386714896415653
chr16	CLUAP1	3508288	3508468	18	181	63266	4556	63248	4375	0.09944751381215469	14.456685714285713
chr16	NAA60	3472158	3472385	434	228	20914	6190	20480	5962	1.9035087719298245	3.4350888963435087
chr16	NAA60	3462597	3462683	0	87	20914	6190	20914	6103	0.0	3.4268392593806323
chr16	CLUAP1	3504719	3504831	0	113	63266	4556	63266	4443	0.0	14.239477830294845
chr16	CLUAP1	3506330	3506415	0	86	63266	4556	63266	4470	0.0	14.153467561521254
chr16	CLUAP1	3526411	3526484	0	74	63266	4556	63266	4482	0.0	14.115573404730032
chr16	CLUAP1	3533098	3533155	508	58	63266	4556	62758	4498	8.758620689655173	13.952423299244108
chr16	DNASE1	3651316	3651921	12126	606	74602	8622	62476	8016	20.00990099009901	7.793912175648702
chr16	DNASE1	3655848	3655966	0	119	74602	8622	74602	8503	0.0	8.773609314359637
chr16	DNASE1	3656998	3657111	0	114	74602	8622	74602	8508	0.0	8.768453220498355
chr16	DNASE1	3655848	3655937	0	90	74602	8622	74602	8532	0.0	8.743788091889357
chr16	DNASE1	3656963	3657111	0	149	74602	8622	74602	8473	0.0	8.80467366930249
chr16	DNAJA3	4434383	4434517	2719	135	28620	5966	25901	5831	20.14074074074074	4.44194820785457
chr16	DNAJA3	4441374	4441575	19	202	28620	5966	28601	5764	0.09405940594059406	4.962005551700209
chr16	DNAJA3	4431598	4431672	647	75	28620	5966	27973	5891	8.626666666666667	4.748429808181973
chr16	DNAJA3	4454810	4454927	0	118	28620	5966	28620	5848	0.0	4.893980848153215
chr16	HMOX2	4483636	4483754	0	119	40405	3349	40405	3230	0.0	12.509287925696594
chr16	HMOX2	4488643	4488742	144	100	40405	3349	40261	3249	1.44	12.391812865497077
chr16	HMOX2	4505483	4505610	29116	128	40405	3349	11289	3221	227.46875	3.504812170133499
chr16	HMOX2	4483636	4483738	0	103	40405	3349	40405	3246	0.0	12.44762784966112
chr16	HMOX2	4502743	4502959	1943	217	40405	3349	38462	3132	8.953917050691244	12.280332056194124
chr16	MGRN1	4677462	4677572	0	111	17052	6231	17052	6120	0.0	2.7862745098039214
chr16	MGRN1	4680031	4680097	0	67	17052	6231	17052	6164	0.0	2.7663854639844256
chr16	MGRN1	4672399	4672516	0	118	17052	6231	17052	6113	0.0	2.7894650744315395
chr16	MGRN1	4686258	4686303	0	46	17052	6231	17052	6185	0.0	2.756992724333064
chr16	UBN1	4868832	4868903	0	72	105816	7647	105816	7575	0.0	13.969108910891089
chr16	UBN1	4871154	4871301	664	148	105816	7647	105152	7499	4.486486486486487	14.022136284837979
chr16	UBN1	4877384	4877474	432	91	105816	7647	105384	7556	4.747252747252747	13.947061937533086
chr16	RBFOX1	7579776	7579920	0	145	306	14371	306	14226	0.0	0.021509911429776464
chr16	RBFOX1	7587246	7587300	0	55	306	14371	306	14316	0.0	0.02137468566638726
chr16	RBFOX1	7595548	7595641	0	94	306	14371	306	14277	0.0	0.0214330741752469
chr16	RBFOX1	7630602	7630683	0	82	306	14371	306	14289	0.0	0.02141507453285744
chr16	RBFOX1	7664928	7664968	0	41	306	14371	306	14330	0.0	0.021353803210048847
chr16	RBFOX1	7693314	7693367	0	54	306	14371	306	14317	0.0	0.021373192707969547
chr16	RBFOX1	7579779	7579920	0	142	306	14371	306	14229	0.0	0.021505376344086023
chr16	RBFOX1	6775732	6776011	0	280	306	14371	306	14091	0.0	0.021715988929103685
chr16	RBFOX1	6876661	6876743	0	83	306	14371	306	14288	0.0	0.021416573348264276
chr16	RBFOX1	7671556	7671599	0	44	306	14371	306	14327	0.0	0.021358274586445174
chr16	METTL22	8623756	8623895	0	140	0	7747	0	7607	0.0	0.0
chr16	METTL22	8635038	8635079	0	42	0	7747	0	7705	0.0	0.0
chr16	METTL22	8623852	8624118	0	267	0	7747	0	7480	0.0	0.0
chr16	METTL22	8641402	8641445	0	44	0	7747	0	7703	0.0	0.0
chr16	ABAT	8722766	8722842	4550	77	64576	9737	60026	9660	59.09090909090909	6.213871635610766
chr16	ABAT	8746000	8746098	0	99	64576	9737	64576	9638	0.0	6.7001452583523555
chr16	ABAT	8738442	8738454	1144	13	64576	9737	63432	9724	88.0	6.523241464417935
chr16	ABAT	8757194	8757310	0	117	64576	9737	64576	9620	0.0	6.712681912681913
chr16	PMM2	8804766	8804843	0	78	36	4133	36	4055	0.0	0.008877928483353885
chr16	PMM2	8811078	8811178	36	101	36	4133	0	4032	0.3564356435643564	0.0
chr16	PMM2	8806315	8806407	0	93	36	4133	36	4040	0.0	0.00891089108910891
chr16	PMM2	8802260	8802389	0	130	36	4133	36	4003	0.0	0.008993255058705971
chr16	LINC02177	9385373	9385465	0	93	0	5834	0	5741	0.0	0.0
chr16	LINC02177	9389665	9389873	0	209	0	5834	0	5625	0.0	0.0
chr16	LINC02177	9402623	9402746	0	124	0	5834	0	5710	0.0	0.0
chr16	AC012178.1	9501491	9501611	0	121	0	4432	0	4311	0.0	0.0
chr16	AC012178.1	9517455	9517524	0	70	0	4432	0	4362	0.0	0.0
chr16	AC012178.1	9501723	9501787	0	65	0	4432	0	4367	0.0	0.0
chr16	ATF7IP2	10419580	10419623	0	44	51	5287	51	5243	0.0	0.009727255388136563
chr16	ATF7IP2	10457371	10457529	0	159	51	5287	51	5128	0.0	0.009945397815912636
chr16	ATF7IP2	10473922	10473989	0	68	51	5287	51	5219	0.0	0.009771986970684038
chr16	ATF7IP2	10414573	10414612	0	40	51	5287	51	5247	0.0	0.009719839908519153
chr16	ATF7IP2	10428867	10429016	0	150	51	5287	51	5137	0.0	0.009927973525403932
chr16	ATF7IP2	10472109	10472183	0	75	51	5287	51	5212	0.0	0.009785111281657714
chr16	NUBP1	10752609	10752678	0	70	0	1968	0	1898	0.0	0.0
chr16	NUBP1	10755720	10755753	0	34	0	1968	0	1934	0.0	0.0
chr16	NUBP1	10761756	10761859	0	104	0	1968	0	1864	0.0	0.0
chr16	NUBP1	10767948	10768032	0	85	0	1968	0	1883	0.0	0.0
chr16	NUBP1	10756689	10756780	0	92	0	1968	0	1876	0.0	0.0
chr16	CIITA	10902037	10902184	0	148	341	11180	341	11032	0.0	0.03091007976794779
chr16	CIITA	10908982	10909187	0	206	341	11180	341	10974	0.0	0.031073446327683617
chr16	CIITA	10901797	10902184	0	388	341	11180	341	10792	0.0	0.03159747961452928
chr16	CLEC16A	10972553	10972559	0	7	13228	11576	13228	11569	0.0	1.1434004667646296
chr16	CLEC16A	11156573	11156682	0	110	13228	11576	13228	11466	0.0	1.1536717251002966
chr16	CLEC16A	11174153	11174277	0	125	13228	11576	13228	11451	0.0	1.155182953453847
chr16	TNFRSF17	11966194	11966341	9663	148	18113	1019	8450	871	65.29054054054055	9.701492537313433
chr16	TNFRSF17	11967019	11967143	971	125	18113	1019	17142	894	7.768	19.174496644295303
chr16	SNX29	12029612	12029734	48	123	9592	11326	9544	11203	0.3902439024390244	0.8519146657145408
chr16	SHISA9	13213252	13213300	0	49	153	10188	153	10139	0.0	0.015090245586349738
chr16	U91319.1	13552392	13552550	0	159	204	3219	204	3060	0.0	0.06666666666666667
chr16	U91319.1	13258332	13258435	0	104	204	3219	204	3115	0.0	0.06548956661316212
chr16	ERCC4	13943973	13944095	0	123	286	8348	286	8225	0.0	0.03477203647416413
chr16	MRTFB	14092720	14092882	0	163	1326	15184	1326	15021	0.0	0.08827641302176953
chr16	MIR193BHG	14325550	14325590	0	41	5151	6057	5151	6016	0.0	0.856216755319149
chr16	MIR193BHG	14323296	14323383	0	88	5151	6057	5151	5969	0.0	0.8629586195342603
chr16	MIR193BHG	14323224	14323383	0	160	5151	6057	5151	5897	0.0	0.8734949974563337
chr16	MIR193BHG	14325554	14325590	0	37	5151	6057	5151	6020	0.0	0.8556478405315615
chr16	MIR193BHG	14322967	14323061	0	95	5151	6057	5151	5962	0.0	0.8639718215363972
chr16	BFAR	14655065	14655210	0	146	51	3298	51	3152	0.0	0.01618020304568528
chr16	BFAR	14648387	14648592	0	206	51	3298	51	3092	0.0	0.016494178525226392
chr16	BFAR	14649803	14649973	0	171	51	3298	51	3127	0.0	0.016309561880396548
chr16	NOMO1	14846576	14846683	190	108	16401	5532	16211	5424	1.7592592592592593	2.988753687315634
chr16	NPIPA1	14925100	14925189	0	90	38158	7367	38158	7277	0.0	5.2436443589391235
chr16	PDXDC1	15001775	15001856	0	82	145079	9435	145079	9353	0.0	15.51149363840479
chr16	PDXDC1	15008778	15008847	768	70	145079	9435	144311	9365	10.971428571428572	15.40961025093433
chr16	PDXDC1	14974886	14974973	0	88	145079	9435	145079	9347	0.0	15.521450732855461
chr16	PDXDC1	15004186	15004333	73	148	145079	9435	145006	9287	0.49324324324324326	15.61386884892861
chr16	PDXDC1	15001775	15001887	0	113	145079	9435	145079	9322	0.0	15.563076593005793
chr16	MPV17L	15400786	15400857	0	72	51	6017	51	5945	0.0	0.008578637510513036
chr16	MPV17L	15399430	15399548	0	119	51	6017	51	5898	0.0	0.008646998982706003
chr16	AC140504.1	15434394	15434759	0	366	0	1057	0	691	0.0	0.0
chr16	BMERB1	15447934	15448032	0	99	0	3385	0	3286	0.0	0.0
chr16	BMERB1	15532986	15533135	0	150	0	3385	0	3235	0.0	0.0
chr16	BMERB1	15583155	15583238	0	84	0	3385	0	3301	0.0	0.0
chr16	NDE1	15649347	15649469	0	123	18222	8104	18222	7981	0.0	2.283172534770079
chr16	NDE1	15687374	15687511	0	138	18222	8104	18222	7966	0.0	2.287471754958574
chr16	NDE1	15694164	15694256	561	93	18222	8104	17661	8011	6.032258064516129	2.204593683684933
chr16	NDE1	15696708	15696860	480	153	18222	8104	17742	7951	3.1372549019607843	2.2314174317695885
chr16	NDE1	15672689	15672771	0	83	18222	8104	18222	8021	0.0	2.271786560279267
chr16	NDE1	15651468	15651584	0	117	18222	8104	18222	7987	0.0	2.281457368223363
chr16	NDE1	15651930	15652050	0	121	18222	8104	18222	7983	0.0	2.2826005261180007
chr16	NDE1	15695907	15695990	946	84	18222	8104	17276	8020	11.261904761904763	2.154114713216958
chr16	NDE1	15699728	15699854	208	127	18222	8104	18014	7977	1.6377952755905512	2.2582424470352263
chr16	ABCC1	16016495	16016621	0	127	38709	8561	38709	8434	0.0	4.589637182831397
chr16	ABCC1	16083365	16083542	10	178	38709	8561	38699	8383	0.056179775280898875	4.616366455922701
chr16	ABCC1	16086823	16086991	0	169	38709	8561	38709	8392	0.0	4.612607244995234
chr16	ABCC1	16098872	16098902	0	31	38709	8561	38709	8530	0.0	4.537983587338804
chr16	ABCC1	16138363	16138558	23894	196	38709	8561	14815	8365	121.90816326530613	1.7710699342498506
chr16	ABCC1	16105399	16105460	0	62	38709	8561	38709	8499	0.0	4.5545358277444405
chr16	NOMO3	16245067	16245174	26	108	19420	10120	19394	10012	0.24074074074074073	1.9370755093887335
chr16	NOMO3	16251962	16252100	0	139	19420	10120	19420	9981	0.0	1.9456968239655346
chr16	NOMO3	16287742	16287862	0	121	19420	10120	19420	9999	0.0	1.9421942194219421
chr16	NOMO3	16293651	16293744	0	94	19420	10120	19420	10026	0.0	1.9369638938759226
chr16	NOMO3	16254943	16255013	0	71	19420	10120	19420	10049	0.0	1.9325306000597073
chr16	NOMO3	16235842	16236020	17701	179	19420	10120	1719	9941	98.88826815642459	0.1729202293531838
chr16	NOMO3	16247394	16247467	360	74	19420	10120	19060	10046	4.864864864864865	1.8972725462870794
chr16	NOMO3	16248107	16248363	0	257	19420	10120	19420	9863	0.0	1.9689749569096624
chr16	NOMO3	16266596	16266655	0	60	19420	10120	19420	10060	0.0	1.9304174950298212
chr16	NOMO3	16293959	16294081	153	123	19420	10120	19267	9997	1.2439024390243902	1.9272781834550365
chr16	AC138969.1	16318513	16318734	0	222	27355	7438	27355	7216	0.0	3.7908813747228383
chr16	AC138969.1	16323751	16323848	0	98	27355	7438	27355	7340	0.0	3.7268392370572205
chr16	AC138969.1	16318550	16318734	0	185	27355	7438	27355	7253	0.0	3.7715428098717774
chr16	AC138969.1	16322527	16322551	0	25	27355	7438	27355	7413	0.0	3.6901389450964523
chr16	AC138969.1	16335860	16335992	0	133	27355	7438	27355	7305	0.0	3.7446954140999313
chr16	AC138969.1	16349228	16349298	0	71	27355	7438	27355	7367	0.0	3.7131803990769647
chr16	NPIPA7	16392592	16392662	80	71	123915	1410	123835	1339	1.1267605633802817	92.48319641523526
chr16	ABCC6P1	18574319	18574435	0	117	38345	3328	38345	3211	0.0	11.941762690750545
chr16	COQ7	19073920	19074035	3174	116	22616	3599	19442	3483	27.362068965517242	5.58196956646569
chr16	COQ7	19073920	19074097	3363	178	22616	3599	19253	3421	18.89325842696629	5.627886582870506
chr16	SYT17	19172759	19172777	0	19	0	4839	0	4820	0.0	0.0
chr16	CLEC19A	19303871	19303975	0	105	0	3419	0	3314	0.0	0.0
chr16	TMC5	19487192	19487326	0	135	214	6198	214	6063	0.0	0.03529605805706746
chr16	TMC5	19490394	19490568	0	175	214	6198	214	6023	0.0	0.035530466544911175
chr16	TMC5	19472087	19472243	0	157	214	6198	214	6041	0.0	0.035424598576394635
chr16	TMC5	19462502	19462565	0	64	214	6198	214	6134	0.0	0.03488751222693186
chr16	TMC5	19474757	19474874	0	118	214	6198	214	6080	0.0	0.03519736842105263
chr16	CCP110	19525718	19525861	0	144	57034	9143	57034	8999	0.0	6.337815312812535
chr16	CCP110	19532415	19532544	0	130	57034	9143	57034	9013	0.0	6.327970708975924
chr16	CCP110	19548514	19548600	2636	87	57034	9143	54398	9056	30.298850574712645	6.00684628975265
chr16	CCP110	19524779	19525019	102	241	57034	9143	56932	8902	0.42323651452282157	6.395416760278589
chr16	VPS35L	19575097	19575122	0	26	44499	9805	44499	9779	0.0	4.550465282748747
chr16	VPS35L	19578303	19578358	14	56	44499	9805	44485	9749	0.25	4.563032105857011
chr16	VPS35L	19591789	19591874	0	86	44499	9805	44499	9719	0.0	4.578557464759749
chr16	VPS35L	19579051	19579128	0	78	44499	9805	44499	9727	0.0	4.574791816592988
chr16	VPS35L	19650381	19650459	0	79	44499	9805	44499	9726	0.0	4.575262183837138
chr16	IQCK	19735352	19735450	0	99	141203	5005	141203	4906	0.0	28.781695882592743
chr16	IQCK	19763847	19764112	0	266	141203	5005	141203	4739	0.0	29.795948512344378
chr16	IQCK	19730429	19730494	150	66	141203	5005	141053	4939	2.272727272727273	28.55902004454343
chr16	IQCK	19736111	19736192	2	82	141203	5005	141201	4923	0.024390243902439025	28.681901279707496
chr16	ACSM5	20423915	20424069	0	155	51	3976	51	3821	0.0	0.013347291285003926
chr16	ACSM5	20427787	20427867	0	81	51	3976	51	3895	0.0	0.013093709884467265
chr16	ACSM2A	20452387	20452466	0	80	0	8018	0	7938	0.0	0.0
chr16	ACSM2A	20460106	20460291	0	186	0	8018	0	7832	0.0	0.0
chr16	ACSM2A	20452380	20452466	0	87	0	8018	0	7931	0.0	0.0
chr16	ACSM2A	20452431	20452466	0	36	0	8018	0	7982	0.0	0.0
chr16	ACSM2A	20452084	20452466	0	383	0	8018	0	7635	0.0	0.0
chr16	ACSM2A	20470815	20470958	0	144	0	8018	0	7874	0.0	0.0
chr16	ACSM2A	20452338	20452466	0	129	0	8018	0	7889	0.0	0.0
chr16	AC141273.1	20585499	20585662	0	164	0	646	0	482	0.0	0.0
chr16	ACSM3	20779796	20779907	0	112	3368	7534	3368	7422	0.0	0.45378604149824847
chr16	REXO5	20806951	20807091	652	141	38705	3857	38053	3716	4.624113475177305	10.240312163616792
chr16	REXO5	20839754	20839859	14633	106	38705	3857	24072	3751	138.04716981132074	6.417488669688083
chr16	REXO5	20843933	20844026	0	94	38705	3857	38705	3763	0.0	10.285676322083445
chr16	REXO5	20824438	20824527	1649	90	38705	3857	37056	3767	18.322222222222223	9.8370055747279
chr16	REXO5	20808787	20808880	553	94	38705	3857	38152	3763	5.882978723404255	10.138719107095403
chr16	LYRM1	20915555	20915714	1623	160	6401	3603	4778	3443	10.14375	1.3877432471681672
chr16	LYRM1	20911182	20911264	326	83	6401	3603	6075	3520	3.927710843373494	1.7258522727272727
chr16	LYRM1	20902485	20902717	0	233	6401	3603	6401	3370	0.0	1.899406528189911
chr16	TMEM159	21166839	21166911	0	73	648	2567	648	2494	0.0	0.2598235765838011
chr16	TMEM159	21178796	21178932	126	137	648	2567	522	2430	0.9197080291970803	0.21481481481481482
chr16	TMEM159	21174009	21174148	420	140	648	2567	228	2427	3.0	0.09394313967861558
chr16	TMEM159	21160977	21161008	0	32	648	2567	648	2535	0.0	0.2556213017751479
chr16	TMEM159	21177136	21177327	0	192	648	2567	648	2375	0.0	0.2728421052631579
chr16	METTL9	21617864	21618074	0	211	7428	3443	7428	3232	0.0	2.2982673267326734
chr16	METTL9	21612644	21612835	102	192	7428	3443	7326	3251	0.53125	2.2534604737004
chr16	OTOA	21705168	21705292	0	125	152	7574	152	7449	0.0	0.020405423546784804
chr16	UQCRC2	21957234	21957318	0	85	343948	4093	343948	4008	0.0	85.81536926147704
chr16	UQCRC2	21959338	21959555	0	218	343948	4093	343948	3875	0.0	88.76077419354839
chr16	UQCRC2	21980546	21980700	0	155	343948	4093	343948	3938	0.0	87.34078212290503
chr16	UQCRC2	21961327	21961465	0	139	343948	4093	343948	3954	0.0	86.98735457764289
chr16	MOSMO	22064337	22064438	0	102	4898	3362	4898	3260	0.0	1.5024539877300613
chr16	VWA3A	22097571	22097695	0	125	4862	5073	4862	4948	0.0	0.9826192400970089
chr16	VWA3A	22103474	22103529	0	56	4862	5073	4862	5017	0.0	0.9691050428542954
chr16	VWA3A	22109481	22109580	0	100	4862	5073	4862	4973	0.0	0.9776794691333199
chr16	VWA3A	22120967	22121103	0	137	4862	5073	4862	4936	0.0	0.9850081037277147
chr16	VWA3A	22123473	22123536	0	64	4862	5073	4862	5009	0.0	0.9706528249151527
chr16	VWA3A	22141202	22141249	0	48	4862	5073	4862	5025	0.0	0.9675621890547264
chr16	VWA3A	22147570	22147642	0	73	4862	5073	4862	5000	0.0	0.9724
chr16	POLR3E	22332059	22332185	4921	127	112165	6743	107244	6616	38.74803149606299	16.209794437726725
chr16	POLR3E	22302930	22303004	0	75	112165	6743	112165	6668	0.0	16.821385722855428
chr16	POLR3E	22332122	22332185	3457	64	112165	6743	108708	6679	54.015625	16.276089234915407
chr16	POLR3E	22298952	22299036	6059	85	112165	6743	106106	6658	71.28235294117647	15.936617602883748
chr16	POLR3E	22305378	22305494	0	117	112165	6743	112165	6626	0.0	16.928010866284335
chr16	SMG1P1	22451619	22451658	28	40	37496	6698	37468	6658	0.7	5.6275157705016525
chr16	SMG1P1	22455449	22455605	0	157	37496	6698	37496	6541	0.0	5.732456810885186
chr16	NPIPB5	22519137	22519269	2078	133	124995	8940	122917	8807	15.62406015037594	13.956738957647326
chr16	NPIPB5	22519328	22519414	1157	87	124995	8940	123838	8853	13.298850574712644	13.988252569750367
chr16	NPIPB5	22519137	22519414	5293	278	124995	8940	119702	8662	19.03956834532374	13.8192103440314
chr16	NPIPB5	22530942	22531044	2042	103	124995	8940	122953	8837	19.825242718446603	13.913432160235374
chr16	SCNN1B	23367855	23367959	0	105	89	3900	89	3795	0.0	0.02345191040843215
chr16	SCNN1B	23371775	23371883	0	109	89	3900	89	3791	0.0	0.023476655236085466
chr16	AC008915.2	23455469	23455530	0	62	651	1010	651	948	0.0	0.6867088607594937
chr16	DCTN5	23658506	23658625	0	120	132011	12112	132011	11992	0.0	11.008255503669112
chr16	DCTN5	23657485	23657586	0	102	132011	12112	132011	12010	0.0	10.991756869275603
chr16	RBBP6	24564796	24564865	6141	70	67345	10087	61204	10017	87.72857142857143	6.110012977937506
chr16	RBBP6	24567791	24567893	1428	103	67345	10087	65917	9984	13.864077669902912	6.602263621794871
chr16	RBBP6	24558420	24558534	0	115	67345	10087	67345	9972	0.0	6.753409546730847
chr16	TNRC6A	24793472	24793649	204	178	51246	12322	51042	12144	1.146067415730337	4.20306324110672
chr16	TNRC6A	24804704	24804851	2911	148	51246	12322	48335	12174	19.66891891891892	3.9703466403811403
chr16	TNRC6A	24778343	24778468	72	126	51246	12322	51174	12196	0.5714285714285714	4.195965890455887
chr16	SLC5A11	24858619	24858778	0	160	7	3411	7	3251	0.0	0.002153183635804368
chr16	SLC5A11	24869900	24870005	0	106	7	3411	7	3305	0.0	0.002118003025718608
chr16	SLC5A11	24875626	24875731	0	106	7	3411	7	3305	0.0	0.002118003025718608
chr16	SLC5A11	24890868	24891074	0	207	7	3411	7	3204	0.0	0.002184769038701623
chr16	LINC02175	25070739	25070815	0	77	13995	5566	13995	5489	0.0	2.5496447440335217
chr16	LCMT1	25125963	25126126	0	164	36229	2603	36229	2439	0.0	14.854038540385403
chr16	LCMT1	25151553	25151615	13092	63	36229	2603	23137	2540	207.8095238095238	9.109055118110236
chr16	LCMT1	25170713	25170805	826	93	36229	2603	35403	2510	8.881720430107526	14.104780876494024
chr16	LCMT1	25174936	25175034	888	99	36229	2603	35341	2504	8.969696969696969	14.113817891373802
chr16	LCMT1	25170713	25170797	794	85	36229	2603	35435	2518	9.341176470588236	14.072676727561557
chr16	AC009158.1	26324036	26324263	0	228	0	2160	0	1932	0.0	0.0
chr16	AC009158.1	26319146	26319355	0	210	0	2160	0	1950	0.0	0.0
chr16	AC009158.1	26324144	26324263	0	120	0	2160	0	2040	0.0	0.0
chr16	AC009158.1	26324008	26324263	0	256	0	2160	0	1904	0.0	0.0
chr16	AC002331.1	26548903	26549038	0	136	102	1862	102	1726	0.0	0.05909617612977984
chr16	KDM8	27220392	27220485	0	94	12300	3982	12300	3888	0.0	3.1635802469135803
chr16	NSMCE1-DT	27288799	27288953	0	155	43013	3274	43013	3119	0.0	13.790638025008015
chr16	IL4R	27334315	27334417	839	103	49172	5144	48333	5041	8.145631067961165	9.58797857567943
chr16	IL4R	27330065	27330198	1257	134	49172	5144	47915	5010	9.380597014925373	9.563872255489022
chr16	IL4R	27341069	27341313	357	245	49172	5144	48815	4899	1.457142857142857	9.964278424168198
chr16	IL4R	27346466	27346618	408	153	49172	5144	48764	4991	2.6666666666666665	9.770386696052896
chr16	IL4R	27318634	27318767	0	134	49172	5144	49172	5010	0.0	9.814770459081837
chr16	IL4R	27360939	27361020	164	82	49172	5144	49008	5062	2.0	9.68154879494271
chr16	IL21R	27403079	27403220	0	142	102	5467	102	5325	0.0	0.01915492957746479
chr16	KATNIP	27618424	27618501	0	78	46339	9815	46339	9737	0.0	4.759063366540002
chr16	KATNIP	27699533	27699599	0	67	46339	9815	46339	9748	0.0	4.7536930652441525
chr16	KATNIP	27740040	27740920	0	881	46339	9815	46339	8934	0.0	5.186814416834564
chr16	KATNIP	27654607	27654736	0	130	46339	9815	46339	9685	0.0	4.7846153846153845
chr16	SGF29	28588609	28588691	766	83	1572	2033	806	1950	9.228915662650602	0.41333333333333333
chr16	NPIPB9	28757997	28758083	0	87	11176	2131	11176	2044	0.0	5.467710371819961
chr16	ATXN2L	28832816	28832887	0	72	107556	6097	107556	6025	0.0	17.85161825726141
chr16	ATXN2L	28836325	28836490	1827	166	107556	6097	105729	5931	11.006024096385541	17.826504805260495
chr16	SH2B1	28861617	28861747	814	131	136072	4469	135258	4338	6.213740458015267	31.179806362378976
chr16	SH2B1	28866011	28867033	5050	1023	136072	4469	131022	3446	4.936461388074291	38.02147417295415
chr16	SH2B1	28873169	28873269	1865	101	136072	4469	134207	4368	18.465346534653467	30.72504578754579
chr16	ATP2A1	28894504	28894607	0	104	53619	4569	53619	4465	0.0	12.008734602463607
chr16	ATP2A1	28903699	28903741	0	43	53619	4569	53619	4526	0.0	11.846884666372073
chr16	ATP2A1	28892314	28892659	0	346	53619	4569	53619	4223	0.0	12.696897939853185
chr16	ATP2A1	28892314	28892431	0	118	53619	4569	53619	4451	0.0	12.046506403055494
chr16	CD19	28937768	28937825	189	58	6480	2694	6291	2636	3.2586206896551726	2.3865705614567525
chr16	SPNS1	28975491	28975557	40297	67	214067	3805	173770	3738	601.4477611940298	46.487426431246654
chr16	SPNS1	28977907	28978044	14845	138	214067	3805	199222	3667	107.57246376811594	54.32833378783747
chr16	SPNS1	28981900	28982056	0	157	214067	3805	214067	3648	0.0	58.68064692982456
chr16	SPNS1	28983785	28983957	95	173	214067	3805	213972	3632	0.5491329479768786	58.91299559471366
chr16	LAT	28989932	28990019	11491	88	268017	4040	256526	3952	130.57954545454547	64.91042510121457
chr16	LAT	28986134	28986216	16482	83	268017	4040	251535	3957	198.57831325301206	63.567096285064444
chr16	RRN3P2	29084442	29084532	0	91	4152	2287	4152	2196	0.0	1.8907103825136613
chr16	RRN3P2	29087333	29087403	25	71	4152	2287	4127	2216	0.352112676056338	1.8623646209386282
chr16	SLX1B	29455543	29455885	26245	343	111055	1631	84810	1288	76.51603498542273	65.84627329192547
chr16	SULT1A4	29462692	29462785	0	94	35727	1840	35727	1746	0.0	20.462199312714777
chr16	QPRT	29694663	29695199	816	537	816	2415	0	1878	1.5195530726256983	0.0
chr16	QPRT	29694663	29694755	84	93	816	2415	732	2322	0.9032258064516129	0.3152454780361757
chr16	KIF22	29792465	29792514	0	50	2606	3665	2606	3615	0.0	0.7208852005532503
chr16	MAZ	29806977	29807828	2244	852	660470	3213	658226	2361	2.6338028169014085	278.79119017365525
chr16	MAZ	29809539	29809764	40656	226	660470	3213	619814	2987	179.89380530973452	207.5038500167392
chr16	MAZ	29808229	29808293	25343	65	660470	3213	635127	3148	389.89230769230767	201.75571791613723
chr16	PRRT2	29812989	29813393	24240	405	265381	2305	241141	1900	59.851851851851855	126.91631578947369
chr16	PRRT2	29813685	29813933	7137	249	265381	2305	258244	2056	28.662650602409638	125.60505836575875
chr16	MVP	29830877	29831073	106244	197	208997	5786	102753	5589	539.3096446700507	18.384863123993558
chr16	MVP	29825941	29826092	20224	152	208997	5786	188773	5634	133.05263157894737	33.506034788782394
chr16	ASPHD1	29906078	29906127	0	50	6603	2178	6603	2128	0.0	3.1029135338345863
chr16	TMEM219	29968024	29968254	0	231	381	2382	381	2151	0.0	0.17712691771269176
chr16	TMEM219	29972041	29972140	0	100	381	2382	381	2282	0.0	0.16695880806310254
chr16	INO80E	30001413	30001530	5442	118	348723	5075	343281	4957	46.11864406779661	69.25176518055275
chr16	INO80E	30001211	30001530	17148	320	348723	5075	331575	4755	53.5875	69.73186119873817
chr16	INO80E	30004567	30004657	22797	91	348723	5075	325926	4984	250.5164835164835	65.39446227929373
chr16	INO80E	30001464	30001530	3997	67	348723	5075	344726	5008	59.656716417910445	68.83506389776358
chr16	AC093512.2	30054783	30054927	0	145	3839	3371	3839	3226	0.0	1.190018598884067
chr16	AC093512.2	30055171	30055327	0	157	3839	3371	3839	3214	0.0	1.1944617299315494
chr16	ALDOA	30069305	30069389	0	85	11236	2724	11236	2639	0.0	4.257673361121637
chr16	AC093512.2	30058940	30059053	0	114	3839	3371	3839	3257	0.0	1.1786920478968377
chr16	ALDOA	30066884	30067038	667	155	11236	2724	10569	2569	4.303225806451613	4.114052160373686
chr16	ALDOA	30065875	30065927	326	53	11236	2724	10910	2671	6.150943396226415	4.084612504679895
chr16	PPP4C	30082745	30082847	385	103	2764571	2653	2764186	2550	3.737864077669903	1083.9945098039216
chr16	PPP4C	30081258	30081310	433055	53	2764571	2653	2331516	2600	8170.8490566037735	896.7369230769231
chr16	PPP4C	30081199	30081310	1308569	112	2764571	2653	1456002	2541	11683.651785714286	573.0035419126328
chr16	PPP4C	30082745	30082963	2194	219	2764571	2653	2762377	2434	10.018264840182649	1134.9124897288414
chr16	CORO1A	30186597	30186720	0	124	0	3668	0	3544	0.0	0.0
chr16	CORO1A	30186815	30186945	0	131	0	3668	0	3537	0.0	0.0
chr16	CORO1A	30188360	30188576	0	217	0	3668	0	3451	0.0	0.0
chr16	CORO1A	30184225	30184343	0	119	0	3668	0	3549	0.0	0.0
chr16	SLX1A-SULT1A3	30194885	30195227	1859	343	40996	4064	39137	3721	5.419825072886297	10.517871539908628
chr16	SULT1A3	30201195	30201293	474	99	40146	2001	39672	1902	4.787878787878788	20.858044164037857
chr16	SLX1A	30196973	30197101	0	129	3573	2134	3573	2005	0.0	1.7820448877805486
chr16	SULT1A3	30202037	30202130	0	94	40146	2001	40146	1907	0.0	21.051914001048768
chr16	ZNF48	30395779	30395873	0	95	7516	3730	7516	3635	0.0	2.06767537826685
chr16	ITGAL	30473964	30474083	9	120	417	9594	408	9474	0.075	0.04306523115896137
chr16	ITGAL	30479330	30479461	0	132	417	9594	417	9462	0.0	0.044071020925808495
chr16	ITGAL	30489253	30489386	0	134	417	9594	417	9460	0.0	0.04408033826638478
chr16	ITGAL	30516972	30517086	0	115	417	9594	417	9479	0.0	0.043991982276611455
chr16	ITGAL	30481438	30481584	0	147	417	9594	417	9447	0.0	0.04414099714194983
chr16	ITGAL	30479090	30479208	0	119	417	9594	417	9475	0.0	0.04401055408970976
chr16	ITGAL	30489253	30492069	306	2817	417	9594	111	6777	0.10862619808306709	0.01637892872952634
chr16	AC002310.2	30581723	30582148	1920	426	17270	2132	15350	1706	4.507042253521127	8.997655334114889
chr16	PRR14	30650992	30651127	0	136	240	3517	240	3381	0.0	0.0709849157054126
chr16	SRCAP	30721188	30721476	56757	289	559304	13678	502547	13389	196.3910034602076	37.53431921726791
chr16	SRCAP	30722562	30722748	44	187	559304	13678	559260	13491	0.23529411764705882	41.454302868579056
chr16	RNF40	30766378	30766558	5990	181	497203	6186	491213	6005	33.0939226519337	81.80066611157369
chr16	RNF40	30766162	30766282	2178	121	497203	6186	495025	6065	18.0	81.6199505358615
chr16	MIR762HG	30888713	30888958	51	246	2198	1675	2147	1429	0.2073170731707317	1.5024492652204338
chr16	MIR762HG	30888770	30888958	51	189	2198	1675	2147	1486	0.2698412698412698	1.4448183041722746
chr16	FBXL19	30927744	30927963	252	220	18501	4683	18249	4463	1.1454545454545455	4.088953618642169
chr16	ORAI3	30949696	30949871	0	176	45185	2322	45185	2146	0.0	21.055452003727865
chr16	HSD3B7	30986839	30987002	0	164	1048	2497	1048	2333	0.0	0.44920702957565367
chr16	BCKDK	31110687	31110761	0	75	13495	3416	13495	3341	0.0	4.039209817419934
chr16	BCKDK	31111299	31111389	0	91	13495	3416	13495	3325	0.0	4.0586466165413535
chr16	KAT8	31117061	31117188	0	128	150266	5737	150266	5609	0.0	26.79015867356035
chr16	FUS	31186801	31186836	0	36	219322	5439	219322	5403	0.0	40.59263372200629
chr16	ITGAM	31277966	31278109	0	144	295	5718	295	5574	0.0	0.052924291352709006
chr16	ITGAX	31372377	31372509	0	133	842	6954	842	6821	0.0	0.12344231051165518
chr16	ITGAX	31373248	31373390	0	143	842	6954	842	6811	0.0	0.12362355013948026
chr16	TGFB1I1	31473681	31473734	1620	54	67573	4233	65953	4179	30.0	15.782005264417325
chr16	TGFB1I1	31473834	31473977	4768	144	67573	4233	62805	4089	33.111111111111114	15.359501100513572
chr16	TGFB1I1	31474151	31474239	1291	89	67573	4233	66282	4144	14.50561797752809	15.99469111969112
chr16	TGFB1I1	31473440	31473556	2751	117	67573	4233	64822	4116	23.512820512820515	15.748785228377065
chr16	CLUHP3	31701662	31701858	0	197	1918	5837	1918	5640	0.0	0.3400709219858156
chr16	CLUHP3	31702534	31702681	49	148	1918	5837	1869	5689	0.3310810810810811	0.32852873967305324
chr16	ZNF720	31753765	31753900	0	136	7023	6006	7023	5870	0.0	1.1964224872231686
chr16	ZNF720	31733510	31733627	123	118	7023	6006	6900	5888	1.0423728813559323	1.171875
chr16	ZNF720	31759356	31759466	0	111	7023	6006	7023	5895	0.0	1.1913486005089058
chr16	ZNF267	31890206	31890250	0	45	2958	3669	2958	3624	0.0	0.8162251655629139
chr16	ZNF267	31875202	31875302	0	101	2958	3669	2958	3568	0.0	0.8290358744394619
chr16	ZNF267	31875151	31875302	0	152	2958	3669	2958	3517	0.0	0.8410577196474268
chr16	TP53TG3D	32254393	32254683	0	291	0	2115	0	1824	0.0	0.0
chr16	HERC2P5	32747016	32747338	0	323	683	6105	683	5782	0.0	0.11812521618817018
chr16	HERC2P5	32769686	32769879	173	194	683	6105	510	5911	0.8917525773195877	0.08627981728979868
chr16	HERC2P5	32765437	32765545	0	109	683	6105	683	5996	0.0	0.11390927284856571
chr16	TP53TG3B	33361940	33362229	0	290	0	1937	0	1647	0.0	0.0
chr16	ORC6	46695561	46695674	16671	114	472081	3973	455410	3859	146.23684210526315	118.01243845555844
chr16	ITFG1-AS1	47153631	47153796	100	166	127	633	27	467	0.6024096385542169	0.057815845824411134
chr16	PHKB	47463898	47463993	0	96	15265	10959	15265	10863	0.0	1.4052287581699345
chr16	PHKB	47463881	47463993	15	113	15265	10959	15250	10846	0.13274336283185842	1.4060483127420247
chr16	PHKB	47462340	47462452	0	113	15265	10959	15265	10846	0.0	1.4074313110824268
chr16	PHKB	47562397	47562495	0	99	15265	10959	15265	10860	0.0	1.4056169429097607
chr16	LONP2	48256609	48256741	0	133	1326	6169	1326	6036	0.0	0.21968190854870775
chr16	LONP2	48262777	48262872	0	96	1326	6169	1326	6073	0.0	0.2183434875679236
chr16	LONP2	48336392	48336498	0	107	1326	6169	1326	6062	0.0	0.2187396898713296
chr16	AC007614.1	49285482	49285623	0	142	102	24089	102	23947	0.0	0.004259406188666639
chr16	AC007614.1	49285520	49285623	0	104	102	24089	102	23985	0.0	0.0042526579111944966
chr16	AC007614.1	49287719	49287989	0	271	102	24089	102	23818	0.0	0.004282475438743807
chr16	AC007614.1	49287829	49287989	0	161	102	24089	102	23928	0.0	0.004262788365095286
chr16	AC007614.1	49343346	49343497	0	152	102	24089	102	23937	0.0	0.004261185612232109
chr16	AC007614.1	49342087	49342208	0	122	102	24089	102	23967	0.0	0.0042558517962198025
chr16	AC007614.1	49336660	49336877	0	218	102	24089	102	23871	0.0	0.004272967198692974
chr16	AC007614.1	49285482	49285520	0	39	102	24089	102	24050	0.0	0.004241164241164241
chr16	AC007614.1	49290728	49291066	0	339	102	24089	102	23750	0.0	0.0042947368421052635
chr16	AC007614.1	49344186	49344349	0	164	102	24089	102	23925	0.0	0.004263322884012539
chr16	AC007614.1	49289537	49289655	0	119	102	24089	102	23970	0.0	0.00425531914893617
chr16	AC007614.1	49287901	49287989	0	89	102	24089	102	24000	0.0	0.00425
chr16	CNEP1R1	50025650	50025701	0	52	0	4101	0	4049	0.0	0.0
chr16	CNEP1R1	50029724	50029798	0	75	0	4101	0	4026	0.0	0.0
chr16	HEATR3	50066366	50066539	736	174	59404	5056	58668	4882	4.2298850574712645	12.017206063088897
chr16	ADCY7	50289220	50289313	0	94	686	8372	686	8278	0.0	0.08287025851654989
chr16	NOD2	50707854	50707960	0	107	0	6889	0	6782	0.0	0.0
chr16	NOD2	50715608	50715755	0	148	0	6889	0	6741	0.0	0.0
chr16	NOD2	50716890	50716974	0	85	0	6889	0	6804	0.0	0.0
chr16	NOD2	50696339	50696480	0	142	0	6889	0	6747	0.0	0.0
chr16	NOD2	50719924	50720008	0	85	0	6889	0	6804	0.0	0.0
chr16	CYLD	50744729	50744866	0	138	38471	10005	38471	9867	0.0	3.8989561163474207
chr16	CYLD	50775165	50775174	0	10	38471	10005	38471	9995	0.0	3.849024512256128
chr16	CYLD	50742761	50742822	0	62	38471	10005	38471	9943	0.0	3.86915417881927
chr16	CYLD	50742761	50742841	0	81	38471	10005	38471	9924	0.0	3.8765618702136235
chr16	LINC02128	50843529	50843646	0	118	0	5070	0	4952	0.0	0.0
chr16	LINC02128	50881906	50882192	0	287	0	5070	0	4783	0.0	0.0
chr16	LINC02127	51024807	51025059	0	253	0	1918	0	1665	0.0	0.0
chr16	LINC02127	51026790	51026827	0	38	0	1918	0	1880	0.0	0.0
chr16	LINC02127	51024807	51025013	0	207	0	1918	0	1711	0.0	0.0
chr16	LINC02180	52092262	52092338	0	77	0	2068	0	1991	0.0	0.0
chr16	LINC02180	52094958	52095073	0	116	0	2068	0	1952	0.0	0.0
chr16	LINC02180	52092262	52092336	0	75	0	2068	0	1993	0.0	0.0
chr16	LINC02180	52092526	52092649	0	124	0	2068	0	1944	0.0	0.0
chr16	LINC02180	52092262	52092342	0	81	0	2068	0	1987	0.0	0.0
chr16	LINC02180	52093047	52093308	0	262	0	2068	0	1806	0.0	0.0
chr16	LINC02180	52093101	52093308	0	208	0	2068	0	1860	0.0	0.0
chr16	AC007333.1	52243403	52243506	0	104	0	2171	0	2067	0.0	0.0
chr16	AC007333.1	52238341	52238565	0	225	0	2171	0	1946	0.0	0.0
chr16	CASC22	52273064	52273219	0	156	0	2437	0	2281	0.0	0.0
chr16	CASC22	52272618	52272649	0	32	0	2437	0	2405	0.0	0.0
chr16	CASC22	52272618	52273219	0	602	0	2437	0	1835	0.0	0.0
chr16	CASC22	52273111	52273219	0	109	0	2437	0	2328	0.0	0.0
chr16	CASC22	52273701	52274217	0	517	0	2437	0	1920	0.0	0.0
chr16	CASC22	52275468	52275526	0	59	0	2437	0	2378	0.0	0.0
chr16	AC026462.3	52608835	52608914	0	80	0	3107	0	3027	0.0	0.0
chr16	CHD9	53303719	53304625	0	907	4499	15474	4499	14567	0.0	0.30884876776275144
chr16	CHD9	53319812	53319951	0	140	4499	15474	4499	15334	0.0	0.2934002869440459
chr16	CHD9	53321162	53321217	0	56	4499	15474	4499	15418	0.0	0.2918017901154495
chr16	FTO	53825863	53826491	66	629	1089	14928	1023	14299	0.10492845786963434	0.07154346457794251
chr16	FTO	54149686	54149762	93	77	1089	14928	996	14851	1.2077922077922079	0.0670661908289004
chr16	FTO	54061661	54061720	0	60	1089	14928	1089	14868	0.0	0.07324455205811138
chr16	FTO	53984937	53984954	0	18	1089	14928	1089	14910	0.0	0.07303822937625755
chr16	IRX5	54932053	54932209	0	157	0	2148	0	1991	0.0	0.0
chr16	MMP2	55489650	55489824	0	175	0	4725	0	4550	0.0	0.0
chr16	SLC6A2	55691917	55692052	0	136	0	5213	0	5077	0.0	0.0
chr16	SLC6A2	55700138	55700306	0	169	0	5213	0	5044	0.0	0.0
chr16	SLC6A2	55701862	55701934	0	73	0	5213	0	5140	0.0	0.0
chr16	CES1P1	55764696	55764904	0	209	0	3209	0	3000	0.0	0.0
chr16	GNAO1	56328630	56328791	0	162	360	13840	360	13678	0.0	0.026319637373885072
chr16	GNAO1	56334728	56334857	0	130	360	13840	360	13710	0.0	0.0262582056892779
chr16	GNAO1	56351383	56351537	0	155	360	13840	360	13685	0.0	0.026306174643770552
chr16	GNAO1	56354865	56355081	0	217	360	13840	360	13623	0.0	0.026425897379431844
chr16	GNAO1	56255520	56255591	0	72	360	13840	360	13768	0.0	0.026147588611272515
chr16	GNAO1	56235012	56235384	0	373	360	13840	360	13467	0.0	0.026732011583871687
chr16	GNAO1	56355255	56355328	0	74	360	13840	360	13766	0.0	0.02615138747639111
chr16	GNAO1	56354865	56354987	0	123	360	13840	360	13717	0.0	0.026244805715535467
chr16	OGFOD1	56462533	56462634	0	102	50204	5793	50204	5691	0.0	8.821648216482165
chr16	OGFOD1	56467164	56467293	1353	130	50204	5793	48851	5663	10.407692307692308	8.626346459473778
chr16	MT3	56589525	56589621	0	97	0	1018	0	921	0.0	0.0
chr16	MT1E	56626465	56626531	0	67	0	1054	0	987	0.0	0.0
chr16	NUP93	56741779	56741817	0	39	120263	11123	120263	11084	0.0	10.850144352219415
chr16	NUP93	56748233	56748426	0	194	120263	11123	120263	10929	0.0	11.004025985909049
chr16	NUP93	56805503	56805632	0	130	120263	11123	120263	10993	0.0	10.939961793868825
chr16	NUP93	56841704	56841833	0	130	120263	11123	120263	10993	0.0	10.939961793868825
chr16	NUP93	56842577	56842695	0	119	120263	11123	120263	11004	0.0	10.929025808796801
chr16	HERPUD1	56935400	56935475	0	76	153	4885	153	4809	0.0	0.031815346225826574
chr16	HERPUD1	56939236	56939359	0	124	153	4885	153	4761	0.0	0.03213610586011342
chr16	HERPUD1	56935403	56935475	0	73	153	4885	153	4812	0.0	0.031795511221945134
chr16	HERPUD1	56939894	56940245	0	352	153	4885	153	4533	0.0	0.033752481800132364
chr16	CETP	56973330	56973510	102	181	202951	3408	202849	3227	0.56353591160221	62.85993182522467
chr16	NLRC5	57034511	57034946	0	436	21072	12006	21072	11570	0.0	1.8212618841832324
chr16	NLRC5	57041981	57042065	0	85	21072	12006	21072	11921	0.0	1.7676369432094623
chr16	NLRC5	57046551	57046641	0	91	21072	12006	21072	11915	0.0	1.7685270667226185
chr16	NLRC5	57055432	57055519	0	88	21072	12006	21072	11918	0.0	1.7680818929350561
chr16	NLRC5	57058064	57058148	0	85	21072	12006	21072	11921	0.0	1.7676369432094623
chr16	NLRC5	57055435	57055519	0	85	21072	12006	21072	11921	0.0	1.7676369432094623
chr16	NLRC5	57062158	57062173	0	16	21072	12006	21072	11990	0.0	1.757464553794829
chr16	NLRC5	57058971	57059061	0	91	21072	12006	21072	11915	0.0	1.7685270667226185
chr16	NLRC5	57075940	57076056	246	117	21072	12006	20826	11889	2.1025641025641026	1.7517032551097653
chr16	CPNE2	57137148	57137282	1048	135	4495	4393	3447	4258	7.762962962962963	0.8095349929544388
chr16	CPNE2	57093949	57094091	0	143	4495	4393	4495	4250	0.0	1.0576470588235294
chr16	CPNE2	57125276	57125363	0	88	4495	4393	4495	4305	0.0	1.0441347270615564
chr16	CPNE2	57134774	57134826	0	53	4495	4393	4495	4340	0.0	1.0357142857142858
chr16	RSPRY1	57216106	57216173	5366	68	155387	5008	150021	4940	78.91176470588235	30.368623481781377
chr16	RSPRY1	57207592	57207685	13391	94	155387	5008	141996	4914	142.45744680851064	28.896214896214897
chr16	CX3CL1	57379615	57379754	0	140	0	5963	0	5823	0.0	0.0
chr16	CX3CL1	57379633	57379754	0	122	0	5963	0	5841	0.0	0.0
chr16	COQ9	57458245	57458350	0	106	357	3924	357	3818	0.0	0.09350445259298062
chr16	COQ9	57456930	57457015	0	86	357	3924	357	3838	0.0	0.09301719645648776
chr16	COQ9	57456503	57456646	0	144	357	3924	357	3780	0.0	0.09444444444444444
chr16	COQ9	57456503	57456626	0	124	357	3924	357	3800	0.0	0.09394736842105263
chr16	POLR2C	57463655	57464055	0	401	77339	3195	77339	2794	0.0	27.68038654259127
chr16	ADGRG5	57570417	57570535	1722	119	17484	5643	15762	5524	14.470588235294118	2.8533671252715425
chr16	ADGRG1	57641586	57641708	0	123	1225	7445	1225	7322	0.0	0.16730401529636713
chr16	ADGRG1	57641590	57641708	0	119	1225	7445	1225	7326	0.0	0.16721266721266723
chr16	ADGRG1	57621690	57621845	0	156	1225	7445	1225	7289	0.0	0.16806146247770612
chr16	ADGRG1	57628659	57628802	0	144	1225	7445	1225	7301	0.0	0.16778523489932887
chr16	ADGRG1	57628636	57628802	0	167	1225	7445	1225	7278	0.0	0.16831547128331958
chr16	ADGRG1	57647966	57648000	0	35	1225	7445	1225	7410	0.0	0.16531713900134953
chr16	ADGRG1	57647915	57648000	0	86	1225	7445	1225	7359	0.0	0.1664628346242696
chr16	ADGRG3	57674588	57674649	0	62	14007	3253	14007	3191	0.0	4.389533061736133
chr16	ADGRG3	57676199	57676338	0	140	14007	3253	14007	3113	0.0	4.499518149694828
chr16	ADGRG3	57683931	57684212	5761	282	14007	3253	8246	2971	20.429078014184398	2.7754964658364187
chr16	DRC7	57696402	57696594	0	193	28143	4027	28143	3834	0.0	7.34037558685446
chr16	DRC7	57698849	57699024	14023	176	28143	4027	14120	3851	79.67613636363636	3.6665801090625814
chr16	DRC7	57701935	57702130	0	196	28143	4027	28143	3831	0.0	7.346123727486296
chr16	DRC7	57726831	57726942	0	112	28143	4027	28143	3915	0.0	7.188505747126436
chr16	DRC7	57696463	57696594	0	132	28143	4027	28143	3895	0.0	7.225417201540436
chr16	DRC7	57698849	57699033	14023	185	28143	4027	14120	3842	75.8	3.6751691827173345
chr16	KATNB1	57750826	57750927	0	102	0	3360	0	3258	0.0	0.0
chr16	TEPP	57977814	57978039	51	226	51	1756	0	1530	0.22566371681415928	0.0
chr16	USB1	58009928	58010112	0	185	240	4598	240	4413	0.0	0.054384772263766146
chr16	USB1	58014272	58014326	0	55	240	4598	240	4543	0.0	0.05282852740479859
chr16	USB1	58014272	58014294	0	23	240	4598	240	4575	0.0	0.05245901639344262
chr16	AC009107.2	58157066	58157188	0	123	80351	4798	80351	4675	0.0	17.187379679144385
chr16	AC009107.2	58138416	58138509	0	94	80351	4798	80351	4704	0.0	17.08142006802721
chr16	CCDC113	58253997	58254159	0	163	51	5938	51	5775	0.0	0.008831168831168832
chr16	CCDC113	58252726	58252853	0	128	51	5938	51	5810	0.0	0.008777969018932874
chr16	GINS3	58329862	58329949	0	88	102	3687	102	3599	0.0	0.028341205890525144
chr16	GINS3	58395101	58395218	0	118	102	3687	102	3569	0.0	0.02857943401513029
chr16	GINS3	58403097	58403331	0	235	102	3687	102	3452	0.0	0.02954808806488992
chr16	LINC02137	58433809	58433948	300	140	5274	1782	4974	1642	2.142857142857143	3.0292326431181484
chr16	NDRG4	58494963	58495008	0	46	2739	7151	2739	7105	0.0	0.38550316678395496
chr16	NDRG4	58509153	58509189	0	37	2739	7151	2739	7114	0.0	0.3850154624683722
chr16	NDRG4	58509300	58509352	0	53	2739	7151	2739	7098	0.0	0.38588334742180896
chr16	NDRG4	58500987	58501077	0	91	2739	7151	2739	7060	0.0	0.3879603399433428
chr16	NDRG4	58487755	58487850	0	96	2739	7151	2739	7055	0.0	0.38823529411764707
chr16	NDRG4	58475611	58475657	0	47	2739	7151	2739	7104	0.0	0.38555743243243246
chr16	NDRG4	58510644	58510683	0	40	2739	7151	2739	7111	0.0	0.38517789340458447
chr16	NDRG4	58464821	58465071	0	251	2739	7151	2739	6900	0.0	0.39695652173913043
chr16	NDRG4	58501972	58502147	0	176	2739	7151	2739	6975	0.0	0.39268817204301076
chr16	NDRG4	58501947	58502147	0	201	2739	7151	2739	6950	0.0	0.39410071942446046
chr16	NDRG4	58501944	58502147	0	204	2739	7151	2739	6947	0.0	0.39427090830574346
chr16	SETD6	58515952	58516097	1224	146	6423	7506	5199	7360	8.383561643835616	0.7063858695652174
chr16	AC009081.2	60360479	60360705	0	227	0	2517	0	2290	0.0	0.0
chr16	AC009081.2	60440562	60440617	0	56	0	2517	0	2461	0.0	0.0
chr16	AC009081.2	60496020	60496156	0	137	0	2517	0	2380	0.0	0.0
chr16	LINC02165	63731409	63731489	0	81	43	3243	43	3162	0.0	0.01359898798228969
chr16	CDH5	66368642	66368752	0	111	23	6002	23	5891	0.0	0.003904260736717026
chr16	BEAN1	66437594	66437701	0	108	0	6888	0	6780	0.0	0.0
chr16	BEAN1	66482881	66482915	0	35	0	6888	0	6853	0.0	0.0
chr16	CKLF	66558189	66558348	0	160	1116	1167	1116	1007	0.0	1.1082423038728897
chr16	CKLF	66563121	66563217	0	97	1116	1167	1116	1070	0.0	1.0429906542056075
chr16	CMTM1	66571136	66571270	102	135	2311	1471	2209	1336	0.7555555555555555	1.653443113772455
chr16	CMTM1	66577103	66577202	341	100	2311	1471	1970	1371	3.41	1.436907366885485
chr16	CMTM1	66569935	66570094	255	160	2311	1471	2056	1311	1.59375	1.5682684973302823
chr16	CMTM1	66571150	66571270	102	121	2311	1471	2209	1350	0.8429752066115702	1.6362962962962964
chr16	CMTM1	66574939	66575137	1386	199	2311	1471	925	1272	6.964824120603015	0.7272012578616353
chr16	CMTM1	66577128	66577202	341	75	2311	1471	1970	1396	4.546666666666667	1.4111747851002865
chr16	CMTM2	66580025	66580184	2652	160	6440	1143	3788	983	16.575	3.8535096642929805
chr16	CMTM3	66609434	66609530	0	97	9920	2917	9920	2820	0.0	3.517730496453901
chr16	CMTM3	66604730	66604952	493	223	9920	2917	9427	2694	2.210762331838565	3.4992576095025982
chr16	CA7	66850540	66850659	20695	120	25930	1835	5235	1715	172.45833333333334	3.052478134110787
chr16	PDP2	66883014	66883102	0	89	2307	5160	2307	5071	0.0	0.45493985407217513
chr16	CES3	66963065	66963084	0	20	357296	4941	357296	4921	0.0	72.60638081690713
chr16	CES4A	67004792	67004873	112	82	7043	4201	6931	4119	1.3658536585365855	1.6826899732944889
chr16	CES4A	67006390	67006519	0	130	7043	4201	7043	4071	0.0	1.7300417587816261
chr16	CES4A	67006744	67006817	0	74	7043	4201	7043	4127	0.0	1.7065665132057184
chr16	CES4A	66996059	66996179	1071	121	7043	4201	5972	4080	8.851239669421487	1.4637254901960783
chr16	CBFB	67036638	67036755	0	118	107975	4534	107975	4416	0.0	24.450860507246375
chr16	CBFB	67093413	67093629	0	217	107975	4534	107975	4317	0.0	25.011582117211027
chr16	C16ORF70	67125958	67126042	510	85	465126	5214	464616	5129	6.0	90.58607915773055
chr16	FBXL8	67163511	67163852	0	342	2906	2967	2906	2625	0.0	1.107047619047619
chr16	FBXL8	67162847	67163852	0	1006	2906	2967	2906	1961	0.0	1.4818969913309537
chr16	AC074143.1	67164440	67164934	0	495	620	1427	620	932	0.0	0.6652360515021459
chr16	HSF4	67165521	67165630	518	110	20186	2898	19668	2788	4.709090909090909	7.054519368723099
chr16	HSF4	67167302	67167402	392	101	20186	2898	19794	2797	3.881188118811881	7.076868072935288
chr16	HSF4	67167474	67167599	100	126	20186	2898	20086	2772	0.7936507936507936	7.246031746031746
chr16	HSF4	67167823	67167947	101	125	20186	2898	20085	2773	0.808	7.243058059862964
chr16	HSF4	67169278	67169348	49	71	20186	2898	20137	2827	0.6901408450704225	7.123098691192077
chr16	HSF4	67167719	67167947	150	229	20186	2898	20036	2669	0.6550218340611353	7.50693143499438
chr16	HSF4	67167460	67167599	170	140	20186	2898	20016	2758	1.2142857142857142	7.257432922407542
chr16	NOL3	67174161	67174464	8525	304	55556	2844	47031	2540	28.042763157894736	18.516141732283465
chr16	NOL3	67174161	67174340	1911	180	55556	2844	53645	2664	10.616666666666667	20.13701201201201
chr16	NOL3	67174161	67174454	8008	294	55556	2844	47548	2550	27.238095238095237	18.64627450980392
chr16	E2F4	67193421	67193515	1397	95	193676	3376	192279	3281	14.705263157894738	58.603779335568426
chr16	ELMO3	67199950	67200001	1726	52	251427	2551	249701	2499	33.19230769230769	99.9203681472589
chr16	ELMO3	67200191	67200361	40884	171	251427	2551	210543	2380	239.08771929824562	88.46344537815126
chr16	SLC9A5	67257530	67257601	18	72	140596	5438	140578	5366	0.25	26.197912784196795
chr16	SLC9A5	67252541	67252844	0	304	140596	5438	140596	5134	0.0	27.385274639657187
chr16	SLC9A5	67255020	67255184	1071	165	140596	5438	139525	5273	6.490909090909091	26.460269296415703
chr16	PLEKHG4	67288488	67288604	126	117	24073	5721	23947	5604	1.0769230769230769	4.273197715917202
chr16	PLEKHG4	67288475	67288604	140	130	24073	5721	23933	5591	1.0769230769230769	4.280629583258809
chr16	LRRC36	67341956	67342084	0	129	2071	4036	2071	3907	0.0	0.5300742257486563
chr16	LRRC36	67365303	67365355	0	53	2071	4036	2071	3983	0.0	0.5199598292744163
chr16	LRRC36	67376726	67376872	0	147	2071	4036	2071	3889	0.0	0.5325276420673695
chr16	LRRC36	67341982	67342084	0	103	2071	4036	2071	3933	0.0	0.5265700483091788
chr16	LRRC36	67336640	67336730	0	91	2071	4036	2071	3945	0.0	0.5249683143219265
chr16	LRRC36	67375257	67375412	0	156	2071	4036	2071	3880	0.0	0.5337628865979381
chr16	LRRC36	67362183	67362305	0	123	2071	4036	2071	3913	0.0	0.5292614362381804
chr16	LRRC36	67367016	67367457	51	442	2071	4036	2020	3594	0.11538461538461539	0.562047857540345
chr16	LRRC36	67375246	67375412	0	167	2071	4036	2071	3869	0.0	0.5352804342207289
chr16	RIPOR1	67538671	67538824	10493	154	24075	6172	13582	6018	68.13636363636364	2.2568959787304754
chr16	RIPOR1	67538659	67538824	10493	166	24075	6172	13582	6006	63.21084337349398	2.2614052614052613
chr16	RIPOR1	67544955	67545117	0	163	24075	6172	24075	6009	0.0	4.006490264603095
chr16	RIPOR1	67529636	67529859	500	224	24075	6172	23575	5948	2.232142857142857	3.9635171486213854
chr16	CTCF	67572482	67572599	639	118	27075	9887	26436	9769	5.415254237288136	2.706111167980346
chr16	CTCF	67571147	67571264	1063	118	27075	9887	26012	9769	9.008474576271187	2.6627085679189273
chr16	CTCF	67635514	67635632	656	119	27075	9887	26419	9768	5.512605042016807	2.7046478296478296
chr16	CARMIL2	67645539	67645631	0	93	89236	5782	89236	5689	0.0	15.685709263490947
chr16	CARMIL2	67656800	67656881	0	82	89236	5782	89236	5700	0.0	15.655438596491228
chr16	CARMIL2	67656833	67656881	0	49	89236	5782	89236	5733	0.0	15.565323565323565
chr16	C16ORF86	67667295	67667525	255	231	1247	1441	992	1210	1.103896103896104	0.8198347107438017
chr16	C16ORF86	67667226	67667525	310	300	1247	1441	937	1141	1.0333333333333334	0.8212094653812445
chr16	TSNAXIP1	67821098	67821225	0	128	933	3696	933	3568	0.0	0.2614910313901345
chr16	TSNAXIP1	67824582	67824779	0	198	933	3696	933	3498	0.0	0.2667238421955403
chr16	TSNAXIP1	67820838	67820951	0	114	933	3696	933	3582	0.0	0.26046901172529313
chr16	TSNAXIP1	67823625	67823719	0	95	933	3696	933	3601	0.0	0.2590946959178006
chr16	NUTF2	67847277	67847456	0	180	35667	2866	35667	2686	0.0	13.27885331347729
chr16	DUS2	68025414	68025494	0	81	19133	4104	19133	4023	0.0	4.7559035545612725
chr16	DUS2	68049504	68049550	0	47	19133	4104	19133	4057	0.0	4.716046339659847
chr16	DUS2	68025380	68025494	0	115	19133	4104	19133	3989	0.0	4.796440210579092
chr16	DUS2	68023847	68024004	0	158	19133	4104	19133	3946	0.0	4.848707551951343
chr16	DUS2	68026959	68027082	0	124	19133	4104	19133	3980	0.0	4.807286432160804
chr16	NFATC3	68166842	68167015	0	174	31727	8798	31727	8624	0.0	3.6789192949907235
chr16	NFATC3	68214328	68214432	561	105	31727	8798	31166	8693	5.3428571428571425	3.5851834809616934
chr16	NFATC3	68121986	68123121	0	1136	31727	8798	31727	7662	0.0	4.14082484990864
chr16	NFATC3	68126447	68126610	0	164	31727	8798	31727	8634	0.0	3.6746583275422746
chr16	NFATC3	68221195	68221284	0	90	31727	8798	31727	8708	0.0	3.6434313275149286
chr16	PLA2G15	68249289	68249446	949	158	117020	3863	116071	3705	6.006329113924051	31.328205128205127
chr16	PLA2G15	68248568	68248692	408	125	117020	3863	116612	3738	3.264	31.196361690743714
chr16	PLA2G15	68253421	68253517	764	97	117020	3863	116256	3766	7.876288659793815	30.869888475836433
chr16	PLA2G15	68255281	68255380	161	100	117020	3863	116859	3763	1.61	31.054743555673664
chr16	SLC7A6	68287745	68287871	692	127	60047	6338	59355	6211	5.448818897637795	9.55643213653196
chr16	SLC7A6	68291208	68291332	0	125	60047	6338	60047	6213	0.0	9.664735232576856
chr16	SLC7A6	68273817	68273904	0	88	60047	6338	60047	6250	0.0	9.60752
chr16	SLC7A6	68287322	68287435	451	114	60047	6338	59596	6224	3.956140350877193	9.575192802056556
chr16	SLC7A6	68290395	68290540	0	146	60047	6338	60047	6192	0.0	9.69751291989664
chr16	SLC7A6	68273821	68273904	0	84	60047	6338	60047	6254	0.0	9.601375119923249
chr16	PRMT7	68315896	68316074	4064	179	108658	8534	104594	8355	22.70391061452514	12.518731298623578
chr16	PRMT7	68321425	68321462	1018	38	108658	8534	107640	8496	26.789473684210527	12.669491525423728
chr16	PRMT7	68324682	68324832	3547	151	108658	8534	105111	8383	23.490066225165563	12.53859000357867
chr16	PRMT7	68329065	68329174	96	110	108658	8534	108562	8424	0.8727272727272727	12.887226970560304
chr16	PRMT7	68312041	68312176	0	136	108658	8534	108658	8398	0.0	12.938556799237913
chr16	PRMT7	68356140	68356215	1737	76	108658	8534	106921	8458	22.855263157894736	12.641404587372902
chr16	ZFP90	68539757	68539825	0	69	2754	5921	2754	5852	0.0	0.47060833902939164
chr16	CDH3	68645635	68645750	0	116	17114	5982	17114	5866	0.0	2.917490623934538
chr16	CDH3	68676384	68676470	0	87	17114	5982	17114	5895	0.0	2.9031382527565732
chr16	CDH3	68678761	68678906	4579	146	17114	5982	12535	5836	31.363013698630137	2.1478752570253596
chr16	CDH1	68808692	68808848	0	157	102	5466	102	5309	0.0	0.019212657750988887
chr16	CDH1	68810196	68810341	0	146	102	5466	102	5320	0.0	0.019172932330827067
chr16	CDH1	68813312	68813495	0	184	102	5466	102	5282	0.0	0.019310867095797046
chr16	CDH1	68819279	68819425	51	147	102	5466	51	5319	0.3469387755102041	0.009588268471517203
chr16	CDH1	68813499	68813562	0	64	102	5466	102	5402	0.0	0.01888189559422436
chr16	CDH1	68813312	68813562	0	251	102	5466	102	5215	0.0	0.01955896452540748
chr16	UTP4	69133511	69133618	0	108	660098	3922	660098	3814	0.0	173.0723649711589
chr16	UTP4	69133457	69133618	26	162	660098	3922	660072	3760	0.16049382716049382	175.55106382978724
chr16	SNTB2	69260049	69260260	54	212	21439	9427	21385	9215	0.25471698113207547	2.3206728160607706
chr16	SNTB2	69235747	69235833	0	87	21439	9427	21439	9340	0.0	2.2953961456102783
chr16	SNTB2	69260049	69260127	54	79	21439	9427	21385	9348	0.6835443037974683	2.2876551133932392
chr16	SNTB2	69260170	69260260	0	91	21439	9427	21439	9336	0.0	2.296379605826907
chr16	NIP7	69341179	69341320	25676	142	308526	3074	282850	2932	180.81690140845072	96.4699863574352
chr16	NFAT5	69568494	69568548	51	55	13607	11906	13556	11851	0.9272727272727272	1.1438697156358113
chr16	NFAT5	69646516	69646578	0	63	13607	11906	13607	11843	0.0	1.1489487460947394
chr16	NFAT5	69659726	69659899	0	174	13607	11906	13607	11732	0.0	1.15981929764746
chr16	NFAT5	69644796	69644856	0	61	13607	11906	13607	11845	0.0	1.1487547488391727
chr16	WWP2	69783031	69783152	12501	122	69558	8808	57057	8686	102.4672131147541	6.5688464195256735
chr16	WWP2	69827893	69828019	0	127	69558	8808	69558	8681	0.0	8.012671351226818
chr16	CLEC18A	69954333	69954573	0	241	17085	5340	17085	5099	0.0	3.3506569915669737
chr16	CLEC18A	69962739	69962766	0	28	17085	5340	17085	5312	0.0	3.2163027108433737
chr16	PDPR	70114820	70114930	0	111	80158	9700	80158	9589	0.0	8.359370111586193
chr16	PDPR	70131301	70131419	42	119	80158	9700	80116	9581	0.35294117647058826	8.361966391817138
chr16	PDPR	70153390	70153573	24070	184	80158	9700	56088	9516	130.81521739130434	5.894073139974779
chr16	PDPR	70120460	70120719	0	260	80158	9700	80158	9440	0.0	8.491313559322034
chr16	PDPR	70114869	70114930	0	62	80158	9700	80158	9638	0.0	8.316870720066404
chr16	PDPR	70147540	70147673	1836	134	80158	9700	78322	9566	13.701492537313433	8.187539201338073
chr16	CLEC18C	70177240	70177480	18219	241	68521	4195	50302	3954	75.59751037344398	12.721800708143652
chr16	CLEC18C	70185647	70185674	0	28	68521	4195	68521	4167	0.0	16.443724502039835
chr16	DDX19B	70317495	70317588	192	94	205610	4471	205418	4377	2.0425531914893615	46.93123143705734
chr16	DDX19B	70312608	70312657	0	50	205610	4471	205610	4421	0.0	46.507577471160374
chr16	DDX19B	70315968	70316104	0	137	205610	4471	205610	4334	0.0	47.44116289801569
chr16	DDX19B	70314901	70314955	0	55	205610	4471	205610	4416	0.0	46.560235507246375
chr16	DDX19A	70361417	70361510	0	94	20147	5294	20147	5200	0.0	3.874423076923077
chr16	DDX19A	70350556	70350605	0	50	20147	5294	20147	5244	0.0	3.8419145690312737
chr16	DDX19A	70356111	70356247	102	137	20147	5294	20045	5157	0.7445255474452555	3.886949777002133
chr16	DDX19A	70361417	70361636	1786	220	20147	5294	18361	5074	8.118181818181819	3.6186440677966103
chr16	DDX19A	70360776	70360894	0	119	20147	5294	20147	5175	0.0	3.8931400966183576
chr16	DDX19A	70347874	70347990	51	117	20147	5294	20096	5177	0.4358974358974359	3.8817848174618503
chr16	DDX19A	70356128	70356247	102	120	20147	5294	20045	5174	0.85	3.8741785852338615
chr16	DDX19A	70364542	70364645	102	104	20147	5294	20045	5190	0.9807692307692307	3.8622350674373798
chr16	FCSK	70462172	70462292	166	121	6369	7256	6203	7135	1.371900826446281	0.8693763139453399
chr16	FCSK	70465125	70465176	301	52	6369	7256	6068	7204	5.788461538461538	0.8423098278734037
chr16	FCSK	70457912	70457975	0	64	6369	7256	6369	7192	0.0	0.8855672969966629
chr16	FCSK	70469151	70469323	459	173	6369	7256	5910	7083	2.653179190751445	0.8343922066920796
chr16	FCSK	70465029	70465176	403	148	6369	7256	5966	7108	2.722972972972973	0.8393359594822735
chr16	FCSK	70476186	70476334	51	149	6369	7256	6318	7107	0.3422818791946309	0.8889826931194597
chr16	SF3B3	70524863	70525017	0	155	153036	8298	153036	8143	0.0	18.793565025174995
chr16	SF3B3	70526586	70526726	51	141	153036	8298	152985	8157	0.3617021276595745	18.755057006252297
chr16	SF3B3	70550649	70550678	0	30	153036	8298	153036	8268	0.0	18.50943396226415
chr16	IL34	70654537	70654671	0	135	56	2241	56	2106	0.0	0.026590693257359924
chr16	CALB2	71374744	71374834	0	91	0	1478	0	1387	0.0	0.0
chr16	CALB2	71385576	71385648	0	73	0	1478	0	1405	0.0	0.0
chr16	IST1	71923287	71923380	0	94	94002	7331	94002	7237	0.0	12.989083874533646
chr16	IST1	71903589	71903676	94	88	94002	7331	93908	7243	1.0681818181818181	12.965345851166644
chr16	IST1	71920738	71920822	0	85	94002	7331	94002	7246	0.0	12.972950593430859
chr16	IST1	71903164	71903258	0	95	94002	7331	94002	7236	0.0	12.990878938640133
chr16	IST1	71924090	71924281	600	192	94002	7331	93402	7139	3.125	13.083345006303404
chr16	DHODH	72013583	72013770	0	188	51	5708	51	5520	0.0	0.00923913043478261
chr16	DHODH	72015683	72015858	25	176	51	5708	26	5532	0.14204545454545456	0.004699927693420101
chr16	HP	72058564	72058672	2454	109	136252	3591	133798	3482	22.513761467889907	38.42561746122918
chr16	HPR	72064756	72064994	0	239	4527	1930	4527	1691	0.0	2.6771141336487285
chr16	DHX38	72094396	72094454	0	59	2709	6143	2709	6084	0.0	0.4452662721893491
chr16	AC004943.2	72713946	72713989	0	44	72749	7033	72749	6989	0.0	10.409071397911003
chr16	AC004943.2	72713332	72713416	0	85	72749	7033	72749	6948	0.0	10.470495106505469
chr16	AC004943.2	72781727	72781819	767	93	72749	7033	71982	6940	8.24731182795699	10.372046109510087
chr16	AC004943.2	72747120	72747182	0	63	72749	7033	72749	6970	0.0	10.437446197991392
chr16	LINC01568	73400138	73400269	0	132	0	6893	0	6761	0.0	0.0
chr16	LINC01568	73420092	73420230	0	139	0	6893	0	6754	0.0	0.0
chr16	LINC01568	73420098	73420230	0	133	0	6893	0	6760	0.0	0.0
chr16	LINC01568	73408186	73408393	0	208	0	6893	0	6685	0.0	0.0
chr16	LINC01568	73404397	73404533	0	137	0	6893	0	6756	0.0	0.0
chr16	LINC01568	73411516	73411562	0	47	0	6893	0	6846	0.0	0.0
chr16	LINC01568	73409680	73409942	0	263	0	6893	0	6630	0.0	0.0
chr16	PSMD7	74299575	74299745	0	171	204	2552	204	2381	0.0	0.08567828643427132
chr16	ZNRF1	75106481	75106571	0	91	6321	6955	6321	6864	0.0	0.9208916083916084
chr16	ZNRF1	75095597	75095750	0	154	6321	6955	6321	6801	0.0	0.929422143802382
chr16	ZFP1	75152908	75152966	0	59	2291	3766	2291	3707	0.0	0.6180199622336121
chr16	ZFP1	75166769	75166896	0	128	2291	3766	2291	3638	0.0	0.6297416162726773
chr16	ZFP1	75166769	75166913	0	145	2291	3766	2291	3621	0.0	0.6326981496824082
chr16	GABARAPL2	75568036	75568209	0	174	10839	1344	10839	1170	0.0	9.264102564102565
chr16	CNTNAP4	76449714	76449858	0	145	51	6913	51	6768	0.0	0.007535460992907801
chr16	MON1B	77193450	77193777	0	328	0	6532	0	6204	0.0	0.0
chr16	MON1B	77193436	77193777	0	342	0	6532	0	6190	0.0	0.0
chr16	MON1B	77191475	77191633	0	159	0	6532	0	6373	0.0	0.0
chr16	AC025284.1	77435857	77435920	0	64	0	3386	0	3322	0.0	0.0
chr16	NUDT7	77735393	77735507	0	115	0	1645	0	1530	0.0	0.0
chr16	NUDT7	77736649	77736743	0	95	0	1645	0	1550	0.0	0.0
chr16	NUDT7	77735827	77735986	0	160	0	1645	0	1485	0.0	0.0
chr16	NUDT7	77725430	77725584	0	155	0	1645	0	1490	0.0	0.0
chr16	WWOX	78114975	78115154	0	180	204	4894	204	4714	0.0	0.04327535002121341
chr16	WWOX	78108422	78108487	0	66	204	4894	204	4828	0.0	0.04225352112676056
chr16	WWOX	78164182	78164289	0	108	204	4894	204	4786	0.0	0.04262432093606352
chr16	WWOX	78756939	78757015	0	77	204	4894	204	4817	0.0	0.042350010379904504
chr16	LINC01229	79726356	79726676	0	321	0	9960	0	9639	0.0	0.0
chr16	LINC01229	79796752	79796798	0	47	0	9960	0	9913	0.0	0.0
chr16	LINC01229	79714814	79714887	0	74	0	9960	0	9886	0.0	0.0
chr16	LINC01229	79723528	79723716	0	189	0	9960	0	9771	0.0	0.0
chr16	LINC01229	79687509	79687635	0	127	0	9960	0	9833	0.0	0.0
chr16	LINC01229	79795102	79795297	0	196	0	9960	0	9764	0.0	0.0
chr16	LINC01229	79728888	79728936	0	49	0	9960	0	9911	0.0	0.0
chr16	LINC01229	79747017	79747235	0	219	0	9960	0	9741	0.0	0.0
chr16	LINC01229	79801172	79801326	0	155	0	9960	0	9805	0.0	0.0
chr16	DYNLRB2	80549483	80549651	0	169	0	1486	0	1317	0.0	0.0
chr16	DYNLRB2	80547757	80547847	0	91	0	1486	0	1395	0.0	0.0
chr16	DYNLRB2	80548942	80549651	0	710	0	1486	0	776	0.0	0.0
chr16	CENPN	81017325	81017385	0	61	7664	3581	7664	3520	0.0	2.1772727272727272
chr16	CENPN	81022596	81022698	757	103	7664	3581	6907	3478	7.349514563106796	1.9859114433582519
chr16	CENPN	81017757	81017834	480	78	7664	3581	7184	3503	6.153846153846154	2.0508135883528404
chr16	ATMIN	81042280	81042480	1040	201	100847	6264	99807	6063	5.174129353233831	16.461652647204353
chr16	BCO1	81259675	81259805	0	131	51	2700	51	2569	0.0	0.01985208252238225
chr16	GAN	81354404	81354755	0	352	15736	15711	15736	15359	0.0	1.0245458688716713
chr16	GAN	81351582	81351697	0	116	15736	15711	15736	15595	0.0	1.0090413594100673
chr16	AC099524.1	81740263	81740379	0	117	15701	1867	15701	1750	0.0	8.972
chr16	PLCG2	81858262	81858356	0	95	28252	13417	28252	13322	0.0	2.1207025972076265
chr16	PLCG2	81893708	81893794	0	87	28252	13417	28252	13330	0.0	2.119429857464366
chr16	PLCG2	81900611	81900780	0	170	28252	13417	28252	13247	0.0	2.1327092926700386
chr16	HSD17B2	82068169	82068382	0	214	0	2501	0	2287	0.0	0.0
chr16	CDH13	82639359	82639465	0	107	51	11050	51	10943	0.0	0.004660513570318926
chr16	CDH13	83032009	83032218	0	210	51	11050	51	10840	0.0	0.004704797047970479
chr16	CDH13	83125384	83125501	0	118	51	11050	51	10932	0.0	0.004665203073545554
chr16	CDH13	82705061	82705274	0	214	51	11050	51	10836	0.0	0.004706533776301218
chr16	CDH13	82719361	82719475	0	115	51	11050	51	10935	0.0	0.004663923182441701
chr16	CDH13	83023012	83023094	0	83	51	11050	51	10967	0.0	0.004650314580103948
chr16	MLYCD	83949036	83949107	4751	72	19605	16265	14854	16193	65.98611111111111	0.9173099487432841
chr16	MLYCD	83948210	83948332	120	123	19605	16265	19485	16142	0.975609756097561	1.2070994920084253
chr16	OSGIN1	83953261	83953370	293	110	55184	5572	54891	5462	2.6636363636363636	10.049615525448553
chr16	NECAB2	83980838	83980864	0	27	1485	2534	1485	2507	0.0	0.5923414439569207
chr16	NECAB2	83997215	83997269	0	55	1485	2534	1485	2479	0.0	0.5990318676885841
chr16	NECAB2	84000723	84000801	0	79	1485	2534	1485	2455	0.0	0.604887983706721
chr16	DNAAF1	84159148	84159211	255	64	9728	3756	9473	3692	3.984375	2.5658179848320692
chr16	DNAAF1	84177513	84177606	0	94	9728	3756	9728	3662	0.0	2.6564718732932824
chr16	ADAD2	84194005	84194221	0	217	629	3985	629	3768	0.0	0.166932059447983
chr16	ADAD2	84194932	84194980	0	49	629	3985	629	3936	0.0	0.1598069105691057
chr16	ADAD2	84195814	84196044	0	231	629	3985	629	3754	0.0	0.1675546084176878
chr16	ATP2C2	84410703	84410765	0	63	0	6756	0	6693	0.0	0.0
chr16	ATP2C2	84459505	84459592	0	88	0	6756	0	6668	0.0	0.0
chr16	ATP2C2	84459269	84459386	0	118	0	6756	0	6638	0.0	0.0
chr16	ATP2C2	84410679	84410765	0	87	0	6756	0	6669	0.0	0.0
chr16	USP10	84733052	84733105	0	54	87707	4768	87707	4714	0.0	18.605642766228257
chr16	USP10	84740308	84740369	0	62	87707	4768	87707	4706	0.0	18.637271568210796
chr16	USP10	84704739	84704860	0	122	87707	4768	87707	4646	0.0	18.877959535083942
chr16	USP10	84772540	84772685	102	146	87707	4768	87605	4622	0.6986301369863014	18.953916053656425
chr16	USP10	84775159	84775225	0	67	87707	4768	87707	4701	0.0	18.657094235269092
chr16	USP10	84744632	84745673	2145	1042	87707	4768	85562	3726	2.058541266794626	22.963499731615673
chr16	USP10	84732467	84732589	3	123	87707	4768	87704	4645	0.024390243902439025	18.881377825618944
chr16	CRISPLD2	84836176	84836435	612	260	38344	7982	37732	7722	2.353846153846154	4.886298886298886
chr16	KIAA0513	85082563	85082593	0	31	1102	8851	1102	8820	0.0	0.12494331065759637
chr16	KIAA0513	85081314	85081392	0	79	1102	8851	1102	8772	0.0	0.12562699498404012
chr16	GSE1	85665014	85665128	0	115	5183	12710	5183	12595	0.0	0.41151250496228664
chr16	GSE1	85633913	85634132	0	220	5183	12710	5183	12490	0.0	0.41497197758206567
chr16	GSE1	85672181	85672309	204	129	5183	12710	4979	12581	1.5813953488372092	0.3957555043319291
chr16	COX4I1	85801204	85801278	150	75	2158	1997	2008	1922	2.0	1.04474505723205
chr16	COX4I1	85804539	85804661	0	123	2158	1997	2158	1874	0.0	1.1515474919957311
chr16	COX4I1	85801183	85801278	153	96	2158	1997	2005	1901	1.59375	1.0547080483955813
chr16	IRF8	85900927	85901246	0	320	0	4561	0	4241	0.0	0.0
chr16	LINC02188	86736507	86736764	0	258	0	5791	0	5533	0.0	0.0
chr16	LINC02188	86727867	86727967	0	101	0	5791	0	5690	0.0	0.0
chr16	MAP1LC3B	87399597	87399686	243	90	26273	5043	26030	4953	2.7	5.255400767211791
chr16	AC092720.3	87495518	87495713	0	196	969	2669	969	2473	0.0	0.3918317832591994
chr16	BANP	87975047	87975185	0	139	26021	7681	26021	7542	0.0	3.4501458499071864
chr16	BANP	88004294	88004411	0	118	26021	7681	26021	7563	0.0	3.4405659129974877
chr16	BANP	88065266	88065332	0	67	26021	7681	26021	7614	0.0	3.4175203572366692
chr16	BANP	87978439	87978692	0	254	26021	7681	26021	7427	0.0	3.5035680624747543
chr16	BANP	87952180	87952273	0	94	26021	7681	26021	7587	0.0	3.4296823513905363
chr16	BANP	88003481	88003563	0	83	26021	7681	26021	7598	0.0	3.4247170307975785
chr16	ZFPM1	88489030	88489153	0	124	0	5882	0	5758	0.0	0.0
chr16	ZC3H18	88587541	88587613	21	73	15546	7150	15525	7077	0.2876712328767123	2.1937261551504874
chr16	SNAI3-AS1	88671565	88671693	204	129	36456	5297	36252	5168	1.5813953488372092	7.014705882352941
chr16	CTU2	88715047	88715106	1572	60	496285	3247	494713	3187	26.2	155.2284279887041
chr16	CTU2	88709937	88710016	33216	80	496285	3247	463069	3167	415.2	146.21692453425956
chr16	TRAPPC2L	88859344	88859443	364	100	8812	3018	8448	2918	3.64	2.8951336531871146
chr16	TRAPPC2L	88859344	88859750	999	407	8812	3018	7813	2611	2.4545454545454546	2.9923400995787053
chr16	TRAPPC2L	88859572	88859750	478	179	8812	3018	8334	2839	2.670391061452514	2.935540683339204
chr16	ACSF3	89098590	89098763	0	174	330	8565	330	8391	0.0	0.03932785126921702
chr16	ACSF3	89114338	89114487	0	150	330	8565	330	8415	0.0	0.0392156862745098
chr16	ACSF3	89100661	89101347	0	687	330	8565	330	7878	0.0	0.041888804265041886
chr16	ACSF3	89095194	89095303	0	110	330	8565	330	8455	0.0	0.03903015966883501
chr16	ZNF778	89222091	89222183	0	93	12148	11351	12148	11258	0.0	1.0790548942973885
chr16	ZNF778	89223156	89223283	0	128	12148	11351	12148	11223	0.0	1.08242003029493
chr16	ZNF778	89224718	89224802	0	85	12148	11351	12148	11266	0.0	1.078288656133499
chr16	AC137932.2	89323765	89323920	84	156	4171	1364	4087	1208	0.5384615384615384	3.3832781456953644
chr16	SPG7	89529476	89529579	0	104	40502	18796	40502	18692	0.0	2.1668093301947358
chr16	SPG7	89531903	89532066	811	164	40502	18796	39691	18632	4.945121951219512	2.130259768140833
chr16	SPG7	89544647	89544772	153	126	40502	18796	40349	18670	1.2142857142857142	2.1611676486341724
chr16	SPG7	89548002	89548113	1801	112	40502	18796	38701	18684	16.080357142857142	2.0713444658531364
chr16	SPG7	89510489	89510592	0	104	40502	18796	40502	18692	0.0	2.1668093301947358
chr16	SPG7	89546657	89546760	0	104	40502	18796	40502	18692	0.0	2.1668093301947358
chr16	SPG7	89524005	89524247	1005	243	40502	18796	39497	18553	4.135802469135802	2.128874036543955
chr16	SPG7	89531924	89532066	627	143	40502	18796	39875	18653	4.384615384615385	2.137725834986329
chr16	SPG7	89526757	89527023	0	267	40502	18796	40502	18529	0.0	2.185870797128825
chr16	SPG7	89545871	89546030	0	160	40502	18796	40502	18636	0.0	2.1733204550332688
chr16	SPG7	89526328	89526468	0	141	40502	18796	40502	18655	0.0	2.1711069418386493
chr16	SPG7	89529134	89529524	60	391	40502	18796	40442	18405	0.1534526854219949	2.1973376799782667
chr16	SPG7	89528631	89529524	510	894	40502	18796	39992	17902	0.5704697986577181	2.2339403418612447
chr16	SPG7	89540943	89541384	612	442	40502	18796	39890	18354	1.3846153846153846	2.1733682031164867
chr16	SPG7	89545871	89546181	0	311	40502	18796	40502	18485	0.0	2.191073843657019
chr16	SPG7	89555877	89556085	0	209	40502	18796	40502	18587	0.0	2.179049873567547
chr16	SPG7	89536764	89536948	0	185	40502	18796	40502	18611	0.0	2.176239858148407
chr16	SPG7	89545871	89545979	0	109	40502	18796	40502	18687	0.0	2.1673890940225826
chr16	SPG7	89546131	89546181	0	51	40502	18796	40502	18745	0.0	2.160682848759669
chr16	SPG7	89528631	89529579	510	949	40502	18796	39992	17847	0.5374077976817703	2.2408247884798564
chr16	SPG7	89519977	89520255	1428	279	40502	18796	39074	18517	5.118279569892473	2.1101690338607764
chr16	SPG7	89540943	89542279	612	1337	40502	18796	39890	17459	0.45774121166791326	2.2847814880577353
chr16	SPG7	89540943	89541346	612	404	40502	18796	39890	18392	1.5148514851485149	2.1688777729447586
chr16	SPG7	89548979	89549336	361	358	40502	18796	40141	18438	1.0083798882681565	2.17707994359475
chr16	SPG7	89545871	89545995	0	125	40502	18796	40502	18671	0.0	2.169246424937068
chr16	SPG7	89546131	89546187	0	57	40502	18796	40502	18739	0.0	2.1613746731415766
chr16	SPG7	89549499	89549713	1479	215	40502	18796	39023	18581	6.879069767441861	2.1001560734083204
chr16	SPG7	89555920	89556085	0	166	40502	18796	40502	18630	0.0	2.174020397208803
chr16	SPG7	89548426	89549713	3417	1288	40502	18796	37085	17508	2.652950310559006	2.1181745487777017
chr16	SPG7	89549080	89549336	100	257	40502	18796	40402	18539	0.38910505836575876	2.1792976967473976
chr16	SPG7	89555958	89556085	0	128	40502	18796	40502	18668	0.0	2.1695950289265054
chr16	RPL13	89560939	89561063	250	125	25337	3088	25087	2963	2.0	8.46675666554168
chr16	RPL13	89560953	89561063	240	111	25337	3088	25097	2977	2.1621621621621623	8.430298958683238
chr16	CPNE7	89591126	89591260	1269	135	173165	3078	171896	2943	9.4	58.40842677539925
chr16	CPNE7	89578856	89578996	0	141	173165	3078	173165	2937	0.0	58.959822948587
chr16	CPNE7	89583443	89583528	2163	86	173165	3078	171002	2992	25.151162790697676	57.15307486631016
chr16	CPNE7	89587555	89587582	2846	28	173165	3078	170319	3050	101.64285714285714	55.842295081967215
chr16	CPNE7	89595830	89595924	22000	95	173165	3078	151165	2983	231.57894736842104	50.675494468655714
chr16	DPEP1	89630304	89630514	44211	211	57616	2727	13405	2516	209.53080568720378	5.327901430842608
chr16	CDK10	89694664	89694788	32	125	134	5398	102	5273	0.256	0.01934382704342879
chr16	CDK10	89687588	89687815	0	228	134	5398	134	5170	0.0	0.025918762088974853
chr16	CDK10	89689251	89689324	0	74	134	5398	134	5324	0.0	0.025169045830202855
chr16	CDK10	89687448	89687548	0	101	134	5398	134	5297	0.0	0.02529733811591467
chr16	CDK10	89694568	89694788	32	221	134	5398	102	5177	0.14479638009049775	0.019702530423024917
chr16	SPIRE2	89868188	89868216	18	29	226741	7580	226723	7551	0.6206896551724138	30.025559528539265
chr16	SPIRE2	89836214	89836433	95351	220	226741	7580	131390	7360	433.4136363636364	17.851902173913043
chr16	SPIRE2	89869566	89869682	6627	117	226741	7580	220114	7463	56.64102564102564	29.494037250435483
chr16	TCF25	89887651	89887717	0	67	66725	6664	66725	6597	0.0	10.114445960284979
chr16	TCF25	89893727	89893858	0	132	66725	6664	66725	6532	0.0	10.215094917330067
chr16	TCF25	89907242	89907322	51	81	66725	6664	66674	6583	0.6296296296296297	10.128209023241682
chr16	TCF25	89908965	89909083	1788	119	66725	6664	64937	6545	15.025210084033613	9.921619556913674
chr16	TCF25	89887651	89887681	0	31	66725	6664	66725	6633	0.0	10.059550731192521
chr16	TCF25	89878460	89878627	204	168	66725	6664	66521	6496	1.2142857142857142	10.24030172413793
chr16	TUBB3	89931800	89931939	2688	140	70244	4255	67556	4115	19.2	16.417010935601457
chr16	TUBB3	89934329	89934575	7537	247	70244	4255	62707	4008	30.51417004048583	15.645459081836327
chr16	TUBB3	89933138	89933367	918	230	70244	4255	69326	4025	3.991304347826087	17.223850931677017
chr16	TUBB3	89933114	89933367	918	254	70244	4255	69326	4001	3.6141732283464565	17.327168207948013
chr16	DEF8	89954242	89954376	351	135	170457	5553	170106	5418	2.6	31.396456256921372
chr16	DEF8	89950066	89950306	1627	241	170457	5553	168830	5312	6.75103734439834	31.782756024096386
chr16	DEF8	89949419	89949513	93	95	170457	5553	170364	5458	0.9789473684210527	31.213631366801025
chr16	DEF8	89954288	89954376	223	89	170457	5553	170234	5464	2.50561797752809	31.155563689604683
chr16	DEF8	89949416	89949513	93	98	170457	5553	170364	5455	0.9489795918367347	31.230797433547206
chr16	DEF8	89949564	89949638	487	75	170457	5553	169970	5478	6.493333333333333	31.027747353048557
chr16	DEF8	89949416	89949638	1428	223	170457	5553	169029	5330	6.403587443946188	31.712757973733584
chr16	DEF8	89950066	89950328	1727	263	170457	5553	168730	5290	6.566539923954372	31.89603024574669
chr16	DEF8	89952557	89952682	51	126	170457	5553	170406	5427	0.40476190476190477	31.39966832504146
chr16	DEF8	89952561	89952682	51	122	170457	5553	170406	5431	0.4180327868852459	31.376542073283005
chr16	AFG3L1P	89977638	89977802	14551	165	5067709	8480	5053158	8315	88.18787878787879	607.7159350571256
chr16	AFG3L1P	89977677	89977802	12291	126	5067709	8480	5055418	8354	97.54761904761905	605.1493895140053
chr16	AFG3L1P	89978809	89978878	3102	70	5067709	8480	5064607	8410	44.31428571428572	602.212485136742
chr16	AFG3L1P	89977604	89977802	16442	199	5067709	8480	5051267	8281	82.62311557788945	609.9827315541602
chr16	AFG3L1P	89988851	89988951	168	101	5067709	8480	5067541	8379	1.6633663366336633	604.7906671440506
chr16	AFG3L1P	89991228	89991383	357	156	5067709	8480	5067352	8324	2.2884615384615383	608.7640557424315
chr16	GAS8	90035632	90035687	108	56	317344	5447	317236	5391	1.9285714285714286	58.84548321276201
chr16	GAS8	90031175	90031189	13	15	317344	5447	317331	5432	0.8666666666666667	58.41881443298969
chr16	GAS8	90027635	90027722	103	88	317344	5447	317241	5359	1.1704545454545454	59.197798096659824
chr16	FAM157C	90111375	90111485	1791	111	41790	7152	39999	7041	16.135135135135137	5.680869194716659
chr16	FAM157C	90111371	90111485	1795	115	41790	7152	39995	7037	15.608695652173912	5.683529913315334
chr16	LINC02193	90194120	90194225	28	106	10573	4443	10545	4337	0.2641509433962264	2.4314041964491584
chr16	LINC02193	90222243	90222292	280	50	10573	4443	10293	4393	5.6	2.3430457546096064
chr16	LINC02193	90222243	90222296	296	54	10573	4443	10277	4389	5.481481481481482	2.341535657325131
chr16	RHBDF1	64332	64437	2975	106	9939	4192	6964	4086	28.066037735849058	1.7043563387175722
chr16	NPRL3	110524	110606	12424	83	41948	5493	29524	5410	149.6867469879518	5.457301293900185
chr16	NPRL3	117300	117375	2444	76	41948	5493	39504	5417	32.1578947368421	7.292597378622854
chr16	NPRL3	119125	119255	560	131	41948	5493	41388	5362	4.2748091603053435	7.71876165609847
chr16	NPRL3	130521	130591	187	71	41948	5493	41761	5422	2.6338028169014085	7.702139431943932
chr16	NPRL3	138149	138334	0	186	41948	5493	41948	5307	0.0	7.9042773695119655
chr16	NPRL3	123506	123545	0	40	41948	5493	41948	5453	0.0	7.692646249770768
chr16	NPRL3	124936	125073	357	138	41948	5493	41591	5355	2.5869565217391304	7.766760037348273
chr16	LUC7L	199061	199238	0	178	5313	6101	5313	5923	0.0	0.8970116495019416
chr16	LUC7L	228332	228402	472	71	5313	6101	4841	6030	6.647887323943662	0.8028192371475954
chr16	LUC7L	208600	208664	0	65	5313	6101	5313	6036	0.0	0.8802186878727635
chr16	RGS11	272862	272931	0	70	35923	4272	35923	4202	0.0	8.549024274155164
chr16	RGS11	274975	275082	475	108	35923	4272	35448	4164	4.398148148148148	8.512968299711815
chr16	AXIN1	291189	291297	16	109	107217	3776	107201	3667	0.14678899082568808	29.233978729206434
chr16	AXIN1	346147	347106	16948	960	107217	3776	90269	2816	17.654166666666665	32.05575284090909
chr16	PGAP6	372610	372727	572	118	4627	4443	4055	4325	4.8474576271186445	0.9375722543352601
chr16	PGAP6	377670	377848	0	179	4627	4443	4627	4264	0.0	1.0851313320825515
chr16	METTL26	634888	634956	174	69	590	1123	416	1054	2.5217391304347827	0.3946869070208729
chr16	METTL26	635280	635340	0	61	590	1123	590	1062	0.0	0.5555555555555556
chr16	METTL26	635611	635774	245	164	590	1123	345	959	1.4939024390243902	0.3597497393117831
chr16	METTL26	634888	635063	204	176	590	1123	386	947	1.1590909090909092	0.40760295670538543
chr16	METTL26	635517	635774	386	258	590	1123	204	865	1.496124031007752	0.23583815028901733
chr16	JMJD8	682952	683087	102	136	13361	2400	13259	2264	0.75	5.856448763250883
chr16	JMJD8	684065	684155	0	91	13361	2400	13361	2309	0.0	5.78648765699437
chr16	JMJD8	682957	683087	102	131	13361	2400	13259	2269	0.7786259541984732	5.843543411194359
chr16	WDR24	687826	688048	0	223	189966	3327	189966	3104	0.0	61.20038659793814
chr16	CCDC78	725412	725580	561	169	225654	2919	225093	2750	3.3195266272189348	81.852
chr16	CCDC78	725445	725580	561	136	225654	2919	225093	2783	4.125	80.88142292490119
chr16	CIAO3	736265	736398	278	134	557062	6627	556784	6493	2.074626865671642	85.75142461111967
chr16	CIAO3	740021	740103	1034	83	557062	6627	556028	6544	12.457831325301205	84.96760391198045
chr16	CIAO3	737497	737695	15128	199	557062	6627	541934	6428	76.02010050251256	84.30833851897947
chr16	RPUSD1	787076	787179	102	104	23123	2764	23021	2660	0.9807692307692307	8.65451127819549
chr16	RPUSD1	787555	787744	1232	190	23123	2764	21891	2574	6.484210526315789	8.504662004662004
chr16	RPUSD1	787067	787179	102	113	23123	2764	23021	2651	0.9026548672566371	8.683892870614862
chr16	RPUSD1	787555	787645	643	91	23123	2764	22480	2673	7.065934065934066	8.410026187803966
chr16	LMF1	931641	931793	367	153	6057	8238	5690	8085	2.3986928104575163	0.7037724180581324
chr16	LMF1	855106	856055	0	950	6057	8238	6057	7288	0.0	0.8310922063666301
chr16	LMF1	933990	934145	15	156	6057	8238	6042	8082	0.09615384615384616	0.7475872308834447
chr16	CEROX1	976326	976400	0	75	102	2975	102	2900	0.0	0.03517241379310345
chr16	CEROX1	979600	979758	0	159	102	2975	102	2816	0.0	0.03622159090909091
chr16	CEROX1	979600	979763	0	164	102	2975	102	2811	0.0	0.03628601921024546
chr16	TSR3	1349888	1349952	0	65	0	1216	0	1151	0.0	0.0
chr16	UNKL	1371518	1371611	108	94	242038	4550	241930	4456	1.148936170212766	54.29308797127469
chr16	CCDC154	1435968	1436086	1893	119	16226	2440	14333	2321	15.907563025210084	6.1753554502369665
chr16	CLCN7	1465266	1465338	0	73	11970	7637	11970	7564	0.0	1.5824960338445266
chr16	HAGH	1819114	1819223	594	110	352969	5851	352375	5741	5.4	61.378679672530915
chr16	HAGH	1826506	1826602	1792	97	352969	5851	351177	5754	18.47422680412371	61.0318039624609
chr16	MEIOB	1837783	1837870	6110	88	43412	2319	37302	2231	69.43181818181819	16.71985656656208
chr16	MEIOB	1865777	1865835	753	59	43412	2319	42659	2260	12.76271186440678	18.87566371681416
chr16	MEIOB	1868106	1868184	0	79	43412	2319	43412	2240	0.0	19.380357142857143
chr16	LINC00254	1879660	1879709	506	50	152542	717	152036	667	10.12	227.9400299850075
chr16	MSRB1	1940777	1940892	0	116	0	2025	0	1909	0.0	0.0
chr16	MSRB1	1941028	1941167	0	140	0	2025	0	1885	0.0	0.0
chr16	RPS2	1962496	1962656	0	161	102	1934	102	1773	0.0	0.05752961082910321
chr16	RPS2	1962735	1962909	0	175	102	1934	102	1759	0.0	0.057987492893689596
chr16	RPS2	1963148	1963256	0	109	102	1934	102	1825	0.0	0.05589041095890411
chr16	RPS2	1964275	1964365	0	91	102	1934	102	1843	0.0	0.05534454693434617
chr16	RPS2	1964448	1964628	0	181	102	1934	102	1753	0.0	0.05818596691386195
chr16	RPS2	1963652	1963839	0	188	102	1934	102	1746	0.0	0.058419243986254296
chr16	AC005606.2	1988957	1989112	20707	156	24226	2294	3519	2138	132.73717948717947	1.645930776426567
chr16	ZNF598	1998964	1999121	0	158	214860	4333	214860	4175	0.0	51.463473053892216
chr16	NTHL1	2044629	2044800	0	172	95899	1666	95899	1494	0.0	64.18942436412316
chr16	NTHL1	2042001	2042146	3375	146	95899	1666	92524	1520	23.116438356164384	60.87105263157895
chr16	PKD1	2091422	2091597	480	176	277560	16200	277080	16024	2.727272727272727	17.291562656015977
chr16	PKD1	2092953	2093093	406	141	277560	16200	277154	16059	2.879432624113475	17.25848433899994
chr16	PKD1	2099643	2099770	0	128	277560	16200	277560	16072	0.0	17.269785963165756
chr16	PKD1	2116832	2117053	1173	222	277560	16200	276387	15978	5.283783783783784	17.297972211791212
chr16	PKD1	2116832	2117016	1035	185	277560	16200	276525	16015	5.594594594594595	17.266625039025914
chr16	PKD1	2111815	2111871	745	57	277560	16200	276815	16143	13.070175438596491	17.147680109025583
chr16	RNPS1	2255584	2255726	0	143	446461	7319	446461	7176	0.0	62.21585841694537
chr16	RNPS1	2264572	2264760	5016	189	446461	7319	441445	7130	26.53968253968254	61.91374474053296
chr16	RNPS1	2267174	2267237	90	64	446461	7319	446371	7255	1.40625	61.52598208132323
chr16	RNPS1	2266109	2266216	0	108	446461	7319	446461	7211	0.0	61.91388156982388
chr16	RNPS1	2267174	2267218	90	45	446461	7319	446371	7274	2.0	61.365273577124
chr16	RNPS1	2267188	2267237	6	50	446461	7319	446455	7269	0.12	61.419039757875915
chr16	ABCA3	2308449	2308623	4519	175	312404	7825	307885	7650	25.822857142857142	40.24640522875817
chr16	ERVK13-1	2671344	2672570	3711	1227	51005	6668	47294	5441	3.024449877750611	8.692152177908472
chr16	ERVK13-1	2663083	2663407	255	325	51005	6668	50750	6343	0.7846153846153846	8.000945924641337
chr16	ERVK13-1	2670863	2670974	408	112	51005	6668	50597	6556	3.642857142857143	7.7176632092739474
chr16	ERVK13-1	2669410	2669561	51	152	51005	6668	50954	6516	0.3355263157894737	7.819828115408226
chr16	ERVK13-1	2672706	2672859	4439	154	51005	6668	46566	6514	28.824675324675326	7.148603008903899
chr16	ERVK13-1	2669410	2672570	8352	3161	51005	6668	42653	3507	2.6422018348623855	12.162246934702024
chr16	ERVK13-1	2671023	2671231	1377	209	51005	6668	49628	6459	6.588516746411483	7.683542344016102
chr16	ERVK13-1	2672706	2672976	4593	271	51005	6668	46412	6397	16.948339483394832	7.2552759105830855
chr16	ERVK13-1	2671344	2671735	2141	392	51005	6668	48864	6276	5.461734693877551	7.78585086042065
chr16	ERVK13-1	2667962	2668040	0	79	51005	6668	51005	6589	0.0	7.740931856123843
chr16	ERVK13-1	2663083	2663430	255	348	51005	6668	50750	6320	0.7327586206896551	8.030063291139241
chr16	ERVK13-1	2671594	2672570	2875	977	51005	6668	48130	5691	2.9426816786079835	8.457213143560008
chr16	ERVK13-1	2670809	2670974	408	166	51005	6668	50597	6502	2.4578313253012047	7.781759458628114
chr16	ERVK13-1	2671103	2671231	551	129	51005	6668	50454	6539	4.271317829457364	7.715858693989906
chr16	PRSS27	2715717	2715880	2777	164	79886	5155	77109	4991	16.932926829268293	15.44960929673412
chr16	SRRM2-AS1	2740957	2741341	1221	385	51997	5093	50776	4708	3.1714285714285713	10.785046728971963
chr16	SRRM2-AS1	2738441	2738500	0	60	51997	5093	51997	5033	0.0	10.331213987681304
chr16	ELOB	2775450	2775556	0	107	33	1115	33	1008	0.0	0.03273809523809524
chr16	ELOB	2775450	2775625	0	176	33	1115	33	939	0.0	0.03514376996805112
chr16	PRSS33	2785374	2785646	0	273	314	2118	314	1845	0.0	0.17018970189701896
chr16	PRSS33	2786088	2786121	13	34	314	2118	301	2084	0.38235294117647056	0.1444337811900192
chr16	PRSS30P	2841572	2841599	0	28	0	1785	0	1757	0.0	0.0
chr16	PKMYT1	2975981	2976089	98	109	45511	4989	45413	4880	0.8990825688073395	9.30594262295082
chr16	HCFC1R1	3023473	3023530	2395	58	245437	1068	243042	1010	41.293103448275865	240.63564356435643
chr16	HCFC1R1	3023846	3023968	134	123	245437	1068	245303	945	1.089430894308943	259.57989417989415
chr16	BICDL2	3031409	3031508	74	100	140900	4458	140826	4358	0.74	32.31436438733364
chr16	MMP25-AS1	3058539	3058702	1190	164	22989	4858	21799	4694	7.2560975609756095	4.644013634426928
chr16	ZSCAN10	3092048	3092316	0	269	2606	3080	2606	2811	0.0	0.9270722162931341
chr16	ZSCAN10	3092541	3093004	197	464	2606	3080	2409	2616	0.4245689655172414	0.9208715596330275
chr16	ZSCAN10	3092676	3093004	179	329	2606	3080	2427	2751	0.5440729483282675	0.8822246455834242
chr16	ZSCAN10	3093267	3093358	75	92	2606	3080	2531	2988	0.8152173913043478	0.8470548862115127
chr16	ZNF213-AS1	3124486	3124898	0	413	11489	9872	11489	9459	0.0	1.2146104239348767
chr16	ZNF213-AS1	3129247	3129310	0	64	11489	9872	11489	9808	0.0	1.1713907014681892
chr16	ZNF213-AS1	3132849	3133194	0	346	11489	9872	11489	9526	0.0	1.2060676044509764
chr16	ZNF213-AS1	3132849	3132945	0	97	11489	9872	11489	9775	0.0	1.1753452685421995
chr16	MEFV	3244472	3244588	969	117	14956	4838	13987	4721	8.282051282051283	2.9627197627621267
chr16	MEFV	3254157	3254790	3234	634	14956	4838	11722	4204	5.100946372239748	2.7882968601332063
chr16	MEFV	3251956	3252049	0	94	14956	4838	14956	4744	0.0	3.1526138279932545
chr16	MEFV	3248464	3248562	0	99	14956	4838	14956	4739	0.0	3.155940071745094
chr16	MEFV	3247015	3247246	0	232	14956	4838	14956	4606	0.0	3.2470690403821103
chr16	MEFV	3244253	3244286	17	34	14956	4838	14939	4804	0.5	3.1097002497918402
chr16	ZSCAN32	3397191	3397744	930	554	1904	3334	974	2780	1.6787003610108304	0.35035971223021584
chr16	ZSCAN32	3393648	3393814	0	167	1904	3334	1904	3167	0.0	0.6011998736975055
chr16	ZSCAN32	3390009	3390183	0	175	1904	3334	1904	3159	0.0	0.6027223805001583
chr16	ZSCAN32	3390422	3390517	0	96	1904	3334	1904	3238	0.0	0.5880172946263126
chr16	NLRC3	3548669	3548753	0	85	4149	6710	4149	6625	0.0	0.6262641509433963
chr16	NLRC3	3555780	3555916	0	137	4149	6710	4149	6573	0.0	0.6312186216339571
chr16	TRAP1	3672699	3672820	0	122	29965	5144	29965	5022	0.0	5.966746316208682
chr16	TRAP1	3690826	3690985	3670	160	29965	5144	26295	4984	22.9375	5.275882825040129
chr16	TRAP1	3710384	3710453	1609	70	29965	5144	28356	5074	22.985714285714284	5.588490342924715
chr16	TRAP1	3689714	3689811	0	98	29965	5144	29965	5046	0.0	5.938367023384859
chr16	TRAP1	3704219	3704334	775	116	29965	5144	29190	5028	6.681034482758621	5.805489260143198
chr16	CREBBP	3738558	3738672	0	115	1069011	15252	1069011	15137	0.0	70.62238224218801
chr16	CREBBP	3777612	3777657	1722	46	1069011	15252	1067289	15206	37.43478260869565	70.18867552281993
chr16	CREBBP	3791980	3792094	198	115	1069011	15252	1068813	15137	1.7217391304347827	70.60930171103918
chr16	CREBBP	3739577	3739724	0	148	1069011	15252	1069011	15104	0.0	70.77668167372882
chr16	ADCY9	3992145	3992363	51	219	6388	9168	6337	8949	0.2328767123287671	0.7081238127165046
chr16	ADCY9	4007367	4007558	0	192	6388	9168	6388	8976	0.0	0.7116755793226381
chr16	ADCY9	3992145	3992270	51	126	6388	9168	6337	9042	0.40476190476190477	0.7008405220084052
chr16	SRL	4206726	4208104	51	1379	1479	5710	1428	4331	0.03698332124728064	0.3297160009235742
chr16	LINC01569	4251321	4252034	0	714	102	2431	102	1717	0.0	0.0594059405940594
chr16	TFAP4	4268047	4268081	0	35	153	6909	153	6874	0.0	0.022257782950247308
chr16	PAM16	4343206	4343291	0	86	267	2128	267	2042	0.0	0.1307541625857003
chr16	CORO7	4357967	4358103	0	137	26665	7153	26665	7016	0.0	3.800598631698974
chr16	CORO7	4413307	4413404	71	98	26665	7153	26594	7055	0.7244897959183674	3.769525159461375
chr16	CORO7	4361748	4361803	0	56	26665	7153	26665	7097	0.0	3.7572213611385092
chr16	CORO7	4415714	4415852	0	139	26665	7153	26665	7014	0.0	3.801682349586541
chr16	CORO7	4416458	4416600	0	143	26665	7153	26665	7010	0.0	3.8038516405135523
chr16	CORO7	4397317	4397450	1055	134	26665	7153	25610	7019	7.873134328358209	3.6486679014104575
chr16	CORO7	4412355	4412430	0	76	26665	7153	26665	7077	0.0	3.767839480005652
chr16	NMRAL1	4463419	4463512	330	94	9242	3199	8912	3105	3.5106382978723403	2.870209339774557
chr16	NMRAL1	4471313	4471449	75	137	9242	3199	9167	3062	0.5474452554744526	2.9937949052906596
chr16	NMRAL1	4471356	4471449	75	94	9242	3199	9167	3105	0.7978723404255319	2.9523349436392916
chr16	CDIP1	4512790	4513064	355	275	225635	2499	225280	2224	1.290909090909091	101.29496402877697
chr16	CDIP1	4514045	4514144	2781	100	225635	2499	222854	2399	27.81	92.89453939141309
chr16	CDIP1	4512790	4512947	355	158	225635	2499	225280	2341	2.2468354430379747	96.23237932507476
chr16	CDIP1	4512790	4512998	355	209	225635	2499	225280	2290	1.6985645933014355	98.37554585152839
chr16	CDIP1	4536439	4536768	0	330	225635	2499	225635	2169	0.0	104.02720147533425
chr16	UBALD1	4610492	4610656	0	165	306	2587	306	2422	0.0	0.1263418662262593
chr16	UBALD1	4610492	4610555	0	64	306	2587	306	2523	0.0	0.12128418549346016
chr16	ANKS3	4726658	4726780	283	123	66065	6948	65782	6825	2.3008130081300813	9.638388278388279
chr16	ANKS3	4726978	4727177	1463	200	66065	6948	64602	6748	7.315	9.573503260225252
chr16	ANKS3	4724749	4724831	35	83	66065	6948	66030	6865	0.42168674698795183	9.618353969410052
chr16	ANKS3	4729979	4730151	11623	173	66065	6948	54442	6775	67.18497109826589	8.035719557195572
chr16	ANKS3	4731511	4731579	4258	69	66065	6948	61807	6879	61.710144927536234	8.984881523477249
chr16	ANKS3	4726658	4726854	720	197	66065	6948	65345	6751	3.6548223350253806	9.679306769367502
chr16	ANKS3	4717442	4717547	1530	106	66065	6948	64535	6842	14.433962264150944	9.432183572054955
chr16	ANKS3	4726658	4726776	267	119	66065	6948	65798	6829	2.2436974789915967	9.63508566407966
chr16	SEPTIN12	4783930	4784068	40	139	9199	1954	9159	1815	0.28776978417266186	5.046280991735538
chr16	ROGDI	4797937	4797987	1160	51	55188	2850	54028	2799	22.745098039215687	19.302608074312253
chr16	ROGDI	4798568	4798667	0	100	55188	2850	55188	2750	0.0	20.068363636363635
chr16	ROGDI	4801266	4801321	1124	56	55188	2850	54064	2794	20.071428571428573	19.350035790980673
chr16	ROGDI	4802381	4802453	2864	73	55188	2850	52324	2777	39.23287671232877	18.841915736406193
chr16	ROGDI	4798568	4798801	15	234	55188	2850	55173	2616	0.0641025641025641	21.09059633027523
chr16	ROGDI	4801049	4801321	19445	273	55188	2850	35743	2577	71.22710622710623	13.87000388048118
chr16	GLYR1	4831978	4832221	0	244	23237	5290	23237	5046	0.0	4.605033690051526
chr16	GLYR1	4821546	4821597	0	52	23237	5290	23237	5238	0.0	4.436235204276441
chr16	GLYR1	4843403	4843602	0	200	23237	5290	23237	5090	0.0	4.565225933202358
chr16	NAGPA	5031744	5031884	0	141	153	4883	153	4742	0.0	0.0322648671446647
chr16	NAGPA	5027277	5027379	53	103	153	4883	100	4780	0.5145631067961165	0.02092050209205021
chr16	NAGPA	5028296	5028398	0	103	153	4883	153	4780	0.0	0.03200836820083682
chr16	NAGPA	5028296	5028365	0	70	153	4883	153	4813	0.0	0.031788905048826095
chr16	NAGPA	5032990	5033155	0	166	153	4883	153	4717	0.0	0.03243587025651897
chr16	C16ORF89	5055686	5055782	0	97	0	2076	0	1979	0.0	0.0
chr16	EEF2KMT	5090083	5090349	0	267	1169	2853	1169	2586	0.0	0.4520494972931168
chr16	EEF2KMT	5091793	5091895	0	103	1169	2853	1169	2750	0.0	0.4250909090909091
chr16	EEF2KMT	5093483	5093564	0	82	1169	2853	1169	2771	0.0	0.4218693612414291
chr16	EEF2KMT	5090431	5090565	0	135	1169	2853	1169	2718	0.0	0.4300956585724798
chr16	EEF2KMT	5097279	5097353	98	75	1169	2853	1071	2778	1.3066666666666666	0.3855291576673866
chr16	LINC01570	5613399	5613506	0	108	0	3791	0	3683	0.0	0.0
chr16	AC093515.1	7977828	7977898	0	71	0	2683	0	2612	0.0	0.0
chr16	TMEM114	8572086	8572224	0	139	216	1425	216	1286	0.0	0.16796267496111975
chr16	CARHSP1	8860104	8860218	0	115	51	4936	51	4821	0.0	0.010578718108276292
chr16	USP7	8900989	8901057	297	69	65147	8661	64850	8592	4.304347826086956	7.547718808193668
chr16	USP7	8929368	8929543	938	176	65147	8661	64209	8485	5.329545454545454	7.567354154390101
chr16	USP7	8900529	8900630	1851	102	65147	8661	63296	8559	18.147058823529413	7.395256455193364
chr16	GRIN2A	9768850	9769089	0	240	1382	11177	1382	10937	0.0	0.12636006217427082
chr16	TVP23A	10771669	10771798	0	130	0	5785	0	5655	0.0	0.0
chr16	TVP23A	10774951	10775547	0	597	0	5785	0	5188	0.0	0.0
chr16	TVP23A	10808536	10808606	0	71	0	5785	0	5714	0.0	0.0
chr16	TVP23A	10766037	10766153	0	117	0	5785	0	5668	0.0	0.0
chr16	TVP23A	10774951	10775096	0	146	0	5785	0	5639	0.0	0.0
chr16	TVP23A	10770271	10770331	0	61	0	5785	0	5724	0.0	0.0
chr16	DEXI	10933843	10934004	0	162	0	1682	0	1520	0.0	0.0
chr16	AC099489.1	11487261	11487386	0	126	26221	12096	26221	11970	0.0	2.1905597326649957
chr16	AC099489.1	11467151	11467258	0	108	26221	12096	26221	11988	0.0	2.1872706039372707
chr16	LITAF	11553532	11553689	0	158	1173	4952	1173	4794	0.0	0.24468085106382978
chr16	LITAF	11551706	11551804	0	99	1173	4952	1173	4853	0.0	0.24170616113744076
chr16	LITAF	11553532	11553748	0	217	1173	4952	1173	4735	0.0	0.24772967265047519
chr16	LITAF	11556510	11556735	0	226	1173	4952	1173	4726	0.0	0.24820143884892087
chr16	LITAF	11575405	11575586	0	182	1173	4952	1173	4770	0.0	0.2459119496855346
chr16	LITAF	11584189	11584332	0	144	1173	4952	1173	4808	0.0	0.24396838602329451
chr16	LITAF	11561145	11561574	0	430	1173	4952	1173	4522	0.0	0.2593984962406015
chr16	TXNDC11	11703669	11703750	0	82	510	3727	510	3645	0.0	0.13991769547325103
chr16	TXNDC11	11730644	11730774	0	131	510	3727	510	3596	0.0	0.1418242491657397
chr16	TXNDC11	11700451	11700564	0	114	510	3727	510	3613	0.0	0.14115693329642956
chr16	TXNDC11	11733981	11734079	0	99	510	3727	510	3628	0.0	0.14057331863285558
chr16	TXNDC11	11721313	11721435	0	123	510	3727	510	3604	0.0	0.14150943396226415
chr16	ZC3H7A	11769030	11769095	0	66	29501	7094	29501	7028	0.0	4.197638019351166
chr16	ZC3H7A	11776319	11776358	0	40	29501	7094	29501	7054	0.0	4.182166146867026
chr16	ZC3H7A	11770782	11770987	16072	206	29501	7094	13429	6888	78.01941747572816	1.9496225319396052
chr16	ZC3H7A	11796218	11796415	0	198	29501	7094	29501	6896	0.0	4.277987238979119
chr16	BCAR4	11828321	11828391	0	71	29758	1241	29758	1170	0.0	25.434188034188033
chr16	BCAR4	11828321	11828606	0	286	29758	1241	29758	955	0.0	31.16020942408377
chr16	BCAR4	11821637	11821755	0	119	29758	1241	29758	1122	0.0	26.5222816399287
chr16	BCAR4	11824526	11824739	29758	214	29758	1241	0	1027	139.05607476635515	0.0
chr16	RSL1D1	11846500	11846602	12241	103	24530	5881	12289	5778	118.84466019417475	2.1268605053651783
chr16	RSL1D1	11850278	11850418	1047	141	24530	5881	23483	5740	7.425531914893617	4.0911149825783975
chr16	RSL1D1	11849257	11849385	0	129	24530	5881	24530	5752	0.0	4.264603616133519
chr16	GSPT1	11876085	11876175	1172	91	55167	8072	53995	7981	12.87912087912088	6.7654429269515095
chr16	NPIPB2	11930449	11930551	3069	103	184139	2700	181070	2597	29.796116504854368	69.72275702733924
chr16	CPPED1	12704623	12705049	0	427	32238	2670	32238	2243	0.0	14.372715113687025
chr16	U95743.1	13767036	13767366	0	331	0	2505	0	2174	0.0	0.0
chr16	LINC02185	14009967	14010145	0	179	7033	5100	7033	4921	0.0	1.4291810607600082
chr16	PARN	14554064	14554151	0	88	49697	8816	49697	8728	0.0	5.69397341888176
chr16	PARN	14588097	14588172	0	76	49697	8816	49697	8740	0.0	5.686155606407323
chr16	PARN	14604145	14604226	0	82	49697	8816	49697	8734	0.0	5.690061827341425
chr16	PARN	14606483	14606526	0	44	49697	8816	49697	8772	0.0	5.665412676698587
chr16	PARN	14617589	14617650	0	62	49697	8816	49697	8754	0.0	5.677061914553347
chr16	PARN	14627268	14627336	0	69	49697	8816	49697	8747	0.0	5.68160512175603
chr16	PARN	14591912	14592033	46	122	49697	8816	49651	8694	0.3770491803278688	5.710950080515298
chr16	PARN	14578530	14578628	0	99	49697	8816	49697	8717	0.0	5.701158655500746
chr16	PARN	14627105	14627187	9	83	49697	8816	49688	8733	0.10843373493975904	5.689682812321081
chr16	PARN	14531053	14531174	0	122	49697	8816	49697	8694	0.0	5.7162410858063035
chr16	PARN	14627727	14627819	0	93	49697	8816	49697	8723	0.0	5.697237189040468
chr16	PARN	14558372	14558489	0	118	49697	8816	49697	8698	0.0	5.713612324672338
chr16	PARN	14482269	14482388	0	120	49697	8816	49697	8696	0.0	5.714926402943882
chr16	PARN	14604145	14604223	0	79	49697	8816	49697	8737	0.0	5.688108046240128
chr16	PARN	14623923	14623953	0	31	49697	8816	49697	8785	0.0	5.657029026750142
chr16	PLA2G10	14678644	14678760	2044	117	2044	757	0	640	17.47008547008547	0.0
chr16	NTAN1	15044333	15044407	3752	75	179043	3324	175291	3249	50.026666666666664	53.95229301323484
chr16	NTAN1	15047854	15047920	0	67	179043	3324	179043	3257	0.0	54.97175314706785
chr16	NTAN1	15047996	15048099	3	104	179043	3324	179040	3220	0.028846153846153848	55.60248447204969
chr16	NTAN1	15048077	15048099	0	23	179043	3324	179043	3301	0.0	54.23901847924871
chr16	RRN3	15086364	15086454	1632	91	10530	4156	8898	4065	17.934065934065934	2.188929889298893
chr16	NPIPP1	15105548	15105818	22	271	12250	1447	12228	1176	0.08118081180811808	10.39795918367347
chr16	MARF1	15615829	15616005	1020	177	3477	10846	2457	10669	5.762711864406779	0.23029337332458524
chr16	MARF1	15625371	15625800	306	430	3477	10846	3171	10416	0.7116279069767442	0.30443548387096775
chr16	MARF1	15625371	15625797	306	427	3477	10846	3171	10419	0.7166276346604216	0.30434782608695654
chr16	MYH11	15708802	15708841	0	40	87400	16806	87400	16766	0.0	5.2129309316473815
chr16	MYH11	15784697	15784718	0	22	87400	16806	87400	16784	0.0	5.207340324118208
chr16	MYH11	15750418	15750509	0	92	87400	16806	87400	16714	0.0	5.2291492162259186
chr16	CEP20	15873490	15873627	0	138	8	2398	8	2260	0.0	0.0035398230088495575
chr16	CEP20	15879803	15879888	0	86	8	2398	8	2312	0.0	0.0034602076124567475
chr16	CEP20	15884007	15884205	8	199	8	2398	0	2199	0.04020100502512563	0.0
chr16	CEP20	15882948	15883020	0	73	8	2398	8	2325	0.0	0.0034408602150537634
chr16	CEP20	15882948	15883048	0	101	8	2398	8	2297	0.0	0.0034828036569438396
chr16	CEP20	15884007	15884124	8	118	8	2398	0	2280	0.06779661016949153	0.0
chr16	ABCC6	16162992	16163192	0	201	72339	6965	72339	6764	0.0	10.694707273802484
chr16	ABCC6	16177451	16177626	0	176	72339	6965	72339	6789	0.0	10.655324790101634
chr16	ABCC6	16220272	16220388	0	117	72339	6965	72339	6848	0.0	10.563522196261681
chr16	PKD1P4	18344820	18344915	0	96	400	6833	400	6737	0.0	0.059373608431052396
chr16	NPIPA9	18359381	18359451	0	71	0	2981	0	2910	0.0	0.0
chr16	NPIPA9	18372722	18372854	0	133	0	2981	0	2848	0.0	0.0
chr16	NOMO2	18549520	18549627	0	108	284362	6838	284362	6730	0.0	42.25289747399703
chr16	NOMO2	18528012	18528071	448	60	284362	6838	283914	6778	7.466666666666667	41.88757745647683
chr16	NOMO2	18558676	18558854	102	179	284362	6838	284260	6659	0.5698324022346368	42.68809130500075
chr16	RPS15A	18788062	18788142	765	81	2653	4037	1888	3956	9.444444444444445	0.47724974721941354
chr16	RPS15A	18786239	18786336	103	98	2653	4037	2550	3939	1.0510204081632653	0.6473724295506473
chr16	RPS15A	18788062	18788105	390	44	2653	4037	2263	3993	8.863636363636363	0.5667417981467568
chr16	RPS15A	18788062	18788159	765	98	2653	4037	1888	3939	7.8061224489795915	0.4793094694084793
chr16	RPS15A	18783640	18783714	0	75	2653	4037	2653	3962	0.0	0.6696113074204947
chr16	ARL6IP1	18795463	18795581	1342	119	59476	3352	58134	3233	11.277310924369749	17.981441385709868
chr16	SMG1	18896051	18896207	0	157	548337	22455	548337	22298	0.0	24.591308637545968
chr16	SMG1	18899986	18900044	0	59	548337	22455	548337	22396	0.0	24.48370244686551
chr16	KNOP1	19711371	19711440	0	70	220690	7765	220690	7695	0.0	28.67966211825861
chr16	GPRC5B	19880969	19880993	0	25	498	5349	498	5324	0.0	0.09353869271224644
chr16	GPRC5B	19874731	19874798	0	68	498	5349	498	5281	0.0	0.0943003219087294
chr16	GPRC5B	19882131	19882301	0	171	498	5349	498	5178	0.0	0.09617612977983778
chr16	GPR139	20070923	20071022	0	100	306	4934	306	4834	0.0	0.063301613570542
chr16	GP2	20323815	20324256	0	442	0	4061	0	3619	0.0	0.0
chr16	GP2	20323380	20323389	0	10	0	4061	0	4051	0.0	0.0
chr16	GP2	20323815	20324061	0	247	0	4061	0	3814	0.0	0.0
chr16	UMOD	20349770	20349869	0	100	0	3277	0	3177	0.0	0.0
chr16	UMOD	20349800	20349869	0	70	0	3277	0	3207	0.0	0.0
chr16	UMOD	20349707	20349869	0	163	0	3277	0	3114	0.0	0.0
chr16	UMOD	20351019	20351171	0	153	0	3277	0	3124	0.0	0.0
chr16	PDILT	20388786	20388909	0	124	0	2284	0	2160	0.0	0.0
chr16	ACSM2B	20564668	20564853	0	186	51	7431	51	7245	0.0	0.007039337474120083
chr16	ACSM2B	20575421	20575803	0	383	51	7431	51	7048	0.0	0.007236095346197503
chr16	ACSM2B	20575421	20575456	0	36	51	7431	51	7395	0.0	0.006896551724137931
chr16	ACSM2B	20554034	20554177	0	144	51	7431	51	7287	0.0	0.00699876492383697
chr16	ACSM2B	20575421	20575500	0	80	51	7431	51	7351	0.0	0.0069378315875391105
chr16	ACSM2B	20575421	20575549	0	129	51	7431	51	7302	0.0	0.006984387838948234
chr16	ACSM2B	20575421	20575507	0	87	51	7431	51	7344	0.0	0.006944444444444444
chr16	ACSM1	20640460	20640584	0	125	51	2887	51	2762	0.0	0.018464880521361332
chr16	ACSM1	20636738	20636840	51	103	51	2887	0	2784	0.49514563106796117	0.0
chr16	ACSM1	20674043	20674100	0	58	51	2887	51	2829	0.0	0.018027571580063628
chr16	THUMPD1	20738087	20738269	72	183	294	6379	222	6196	0.39344262295081966	0.035829567462879276
chr16	ERI2	20800301	20800402	51	102	3329	5706	3278	5604	0.5	0.5849393290506781
chr16	ERI2	20805714	20805945	0	232	3329	5706	3329	5474	0.0	0.6081476068688345
chr16	DNAH3	21021970	21022100	0	131	37544	14456	37544	14325	0.0	2.62087260034904
chr16	CRYM	21268546	21268684	0	139	6189	3607	6189	3468	0.0	1.7846020761245676
chr16	CRYM	21258788	21258845	0	58	6189	3607	6189	3549	0.0	1.7438715131022824
chr16	NPIPB3	21419489	21419575	530	87	55825	4575	55295	4488	6.091954022988506	12.320632798573975
chr16	NPIPB3	21419634	21419766	1787	133	55825	4575	54038	4442	13.436090225563909	12.165240882485367
chr16	SMG1P3	21483631	21483787	0	157	106538	7138	106538	6981	0.0	15.261137372869216
chr16	SMG1P3	21487577	21487616	8	40	106538	7138	106530	7098	0.2	15.008453085376162
chr16	RRN3P1	21819301	21819481	0	181	1589	5269	1589	5088	0.0	0.31230345911949686
chr16	NPIPB4	21851769	21851855	236	87	65942	7314	65706	7227	2.7126436781609193	9.091739310917394
chr16	NPIPB4	21851914	21852046	891	133	65942	7314	65051	7181	6.6992481203007515	9.058766188553125
chr16	NPIPB4	21851769	21852046	3320	278	65942	7314	62622	7036	11.942446043165468	8.900227401932916
chr16	SMG1P4	21915120	21915276	0	157	83841	5968	83841	5811	0.0	14.427981414558596
chr16	PDZD9	21995237	21995308	0	72	7716	1342	7716	1270	0.0	6.075590551181103
chr16	PDZD9	21996321	21996501	0	181	7716	1342	7716	1161	0.0	6.645994832041343
chr16	CDR2	22364901	22365014	51	114	24831	3964	24780	3850	0.4473684210526316	6.4363636363636365
chr16	CDR2	22422160	22422214	131	55	24831	3964	24700	3909	2.381818181818182	6.3187515988743925
chr16	COG7	23391961	23392234	0	274	39250	4252	39250	3978	0.0	9.866767219708397
chr16	EARS2	23553043	23553123	0	81	96082	4213	96082	4132	0.0	23.253146176185865
chr16	EARS2	23556889	23556927	0	39	96082	4213	96082	4174	0.0	23.019166267369428
chr16	EARS2	23553006	23553123	0	118	96082	4213	96082	4095	0.0	23.46324786324786
chr16	NDUFAB1	23587196	23587319	357	124	148722	1555	148365	1431	2.879032258064516	103.67924528301887
chr16	NDUFAB1	23595428	23595638	357	211	148722	1555	148365	1344	1.6919431279620853	110.390625
chr16	PALB2	23607863	23608012	0	150	44669	4745	44669	4595	0.0	9.721218715995647
chr16	ERN2	23692183	23692331	172676	149	1122167	4763	949491	4614	1158.8993288590605	205.78478543563068
chr16	ERN2	23695018	23695118	2052	101	1122167	4763	1120115	4662	20.316831683168317	240.26490776490778
chr16	ERN2	23700958	23701114	20379	157	1122167	4763	1101788	4606	129.80254777070064	239.20712114633088
chr16	ERN2	23709170	23709270	0	101	1122167	4763	1122167	4662	0.0	240.7050622050622
chr16	ERN2	23711995	23712078	0	84	1122167	4763	1122167	4679	0.0	239.8305193417397
chr16	ARHGAP17	24939363	24939597	65	235	318989	9674	318924	9439	0.2765957446808511	33.78790126072677
chr16	ARHGAP17	24959670	24959752	469	83	318989	9674	318520	9591	5.650602409638554	33.21030132415807
chr16	ARHGAP17	24927683	24927732	0	50	318989	9674	318989	9624	0.0	33.14515793848712
chr16	ARHGAP17	24929612	24929660	16	49	318989	9674	318973	9625	0.32653061224489793	33.14005194805195
chr16	ARHGAP17	25013862	25013956	0	95	318989	9674	318989	9579	0.0	33.30086647875561
chr16	ARHGAP17	24972595	24972633	0	39	318989	9674	318989	9635	0.0	33.107317073170734
chr16	NSMCE1	27225725	27225846	683	122	13465	2869	12782	2747	5.598360655737705	4.653076082999636
chr16	NSMCE1	27241352	27241889	735	538	13465	2869	12730	2331	1.3661710037174721	5.461175461175461
chr16	NSMCE1	27268162	27268374	0	213	13465	2869	13465	2656	0.0	5.069653614457831
chr16	NSMCE1	27241352	27241484	123	133	13465	2869	13342	2736	0.924812030075188	4.876461988304094
chr16	NSMCE1	27241798	27241889	0	92	13465	2869	13465	2777	0.0	4.8487576521426
chr16	GTF3C1	27482510	27482585	306	76	181040	10137	180734	10061	4.026315789473684	17.963820693768014
chr16	GSG1L	27884485	27884638	0	154	207290	5435	207290	5281	0.0	39.25203559931831
chr16	GSG1L	27823861	27823915	0	55	207290	5435	207290	5380	0.0	38.52973977695167
chr16	GSG1L	27850478	27850623	0	146	207290	5435	207290	5289	0.0	39.192664019663454
chr16	XPO6	28117317	28117462	145162	146	272922	7020	127760	6874	994.2602739726027	18.58597614198429
chr16	XPO6	28166507	28166585	5425	79	272922	7020	267497	6941	68.67088607594937	38.53868318686068
chr16	XPO6	28180940	28181031	1892	92	272922	7020	271030	6928	20.565217391304348	39.1209584295612
chr16	XPO6	28208986	28209122	0	137	272922	7020	272922	6883	0.0	39.65160540462008
chr16	XPO6	28152929	28152964	0	36	272922	7020	272922	6984	0.0	39.078178694158076
chr16	XPO6	28208986	28209055	0	70	272922	7020	272922	6950	0.0	39.26935251798561
chr16	AC138894.1	28476250	28476375	0	126	54916	4138	54916	4012	0.0	13.687936191425722
chr16	CLN3	28486346	28486490	0	145	270893	5985	270893	5840	0.0	46.385787671232876
chr16	CLN3	28486577	28486650	0	74	270893	5985	270893	5911	0.0	45.82862459820673
chr16	CLN3	28487661	28487741	0	81	270893	5985	270893	5904	0.0	45.882960704607044
chr16	CLN3	28488590	28488662	45723	73	270893	5985	225170	5912	626.3424657534247	38.08694181326116
chr16	CLN3	28491481	28491560	84	80	270893	5985	270809	5905	1.05	45.86096528365792
chr16	AC138894.1	28466719	28466902	0	184	54916	4138	54916	3954	0.0	13.888720283257461
chr16	CLN3	28479643	28479765	454	123	270893	5985	270439	5862	3.6910569105691056	46.13425452064142
chr16	AC138894.1	28470372	28470460	746	89	54916	4138	54170	4049	8.382022471910112	13.378612002963695
chr16	AC138894.1	28469687	28469817	133	131	54916	4138	54783	4007	1.015267175572519	13.671824307461941
chr16	AC138894.1	28477011	28477128	354	118	54916	4138	54562	4020	3.0	13.572636815920397
chr16	CLN3	28491481	28491513	66	33	270893	5985	270827	5952	2.0	45.50184811827957
chr16	CLN3	28479643	28479741	344	99	270893	5985	270549	5886	3.474747474747475	45.964831804281346
chr16	CLN3	28489289	28489386	706	98	270893	5985	270187	5887	7.204081632653061	45.89553252930185
chr16	CLN3	28484005	28484118	0	114	270893	5985	270893	5871	0.0	46.14086186339635
chr16	CLN3	28479461	28479586	52	126	270893	5985	270841	5859	0.4126984126984127	46.226489161973035
chr16	CLN3	28487455	28487541	38	87	270893	5985	270855	5898	0.4367816091954023	45.923194303153615
chr16	CLN3	28490318	28490416	0	99	270893	5985	270893	5886	0.0	46.02327556914713
chr16	CLN3	28493785	28493809	4167	25	270893	5985	266726	5960	166.68	44.752684563758386
chr16	NUPR1	28538525	28538654	0	130	255	5512	255	5382	0.0	0.04738015607580825
chr16	SULT1A1	28608477	28608603	0	127	8726	7829	8726	7702	0.0	1.132952479875357
chr16	SULT1A1	28609362	28609435	0	74	8726	7829	8726	7755	0.0	1.1252095422308188
chr16	SULT1A1	28609930	28610191	0	262	8726	7829	8726	7567	0.0	1.153165058807982
chr16	TUFM	28845313	28845480	132692	168	608932	2220	476240	2052	789.8333333333334	232.08576998050683
chr16	RABEP2	28924402	28924615	1451	214	25349	4517	23898	4303	6.780373831775701	5.553799674645596
chr16	RABEP2	28905866	28905878	13	13	25349	4517	25336	4504	1.0	5.625222024866785
chr16	RABEP2	28911083	28911179	1204	97	25349	4517	24145	4420	12.412371134020619	5.462669683257919
chr16	RABEP2	28921062	28921213	0	152	25349	4517	25349	4365	0.0	5.807331042382589
chr16	AC009093.1	29218427	29218514	0	88	0	4775	0	4687	0.0	0.0
chr16	NPIPB12	29488408	29488510	176	103	57489	4334	57313	4231	1.7087378640776698	13.545970219806192
chr16	NPIPB12	29499997	29500083	690	87	57489	4334	56799	4247	7.931034482758621	13.373910995997175
chr16	NPIPB12	29488022	29488091	48	70	57489	4334	57441	4264	0.6857142857142857	13.471153846153847
chr16	NPIPB12	29499997	29500274	4032	278	57489	4334	53457	4056	14.503597122302159	13.179733727810651
chr16	NPIPB12	29500142	29500274	2599	133	57489	4334	54890	4201	19.541353383458645	13.065936681742443
chr16	CDIPT	29859441	29859523	0	83	212603	2826	212603	2743	0.0	77.50747356908494
chr16	CDIPT	29862585	29862720	0	136	212603	2826	212603	2690	0.0	79.03457249070632
chr16	CDIPT	29862585	29862635	0	51	212603	2826	212603	2775	0.0	76.61369369369369
chr16	SEZ6L2	29872704	29872743	234	40	218911	4128	218677	4088	5.85	53.49241682974559
chr16	SEZ6L2	29879863	29880064	0	202	218911	4128	218911	3926	0.0	55.75929699439633
chr16	SEZ6L2	29897852	29897984	0	133	218911	4128	218911	3995	0.0	54.79624530663329
chr16	SEZ6L2	29895720	29895860	0	141	218911	4128	218911	3987	0.0	54.906195134186106
chr16	SEZ6L2	29895258	29895460	0	203	218911	4128	218911	3925	0.0	55.77350318471338
chr16	KCTD13	29925538	29925581	806	44	115746	5191	114940	5147	18.318181818181817	22.331455216631046
chr16	HIRIP3	29993905	29994843	78326	939	187277	3487	108951	2548	83.41427050053248	42.759419152276294
chr16	HIRIP3	29994647	29994843	2383	197	187277	3487	184894	3290	12.096446700507615	56.198784194528876
chr16	DOC2A	30006412	30006509	21110	98	453809	6385	432699	6287	215.40816326530611	68.82439955463656
chr16	DOC2A	30010902	30010989	3505	88	453809	6385	450304	6297	39.82954545454545	71.51087819596633
chr16	DOC2A	30010272	30010340	29	69	453809	6385	453780	6316	0.42028985507246375	71.846105129829
chr16	TLCD3B	30036154	30036214	563	61	5609	4932	5046	4871	9.229508196721312	1.0359269143912955
chr16	TLCD3B	30046565	30046631	0	67	5609	4932	5609	4865	0.0	1.152929085303186
chr16	YPEL3	30094384	30094475	4226	92	490128	2150	485902	2058	45.93478260869565	236.10398445092324
chr16	YPEL3	30094788	30094897	100162	110	490128	2150	389966	2040	910.5636363636364	191.15980392156862
chr16	GDPD3	30108212	30108264	164	53	6994	1473	6830	1420	3.0943396226415096	4.809859154929577
chr16	GDPD3	30108120	30108264	426	145	6994	1473	6568	1328	2.9379310344827587	4.945783132530121
chr16	MAPK3	30117153	30117285	0	133	25236	3678	25236	3545	0.0	7.118758815232722
chr16	MAPK3	30118046	30118163	0	118	25236	3678	25236	3560	0.0	7.0887640449438205
chr16	MAPK3	30117136	30117285	0	150	25236	3678	25236	3528	0.0	7.153061224489796
chr16	MAPK3	30115594	30115645	0	52	25236	3678	25236	3626	0.0	6.959735245449531
chr16	MAPK3	30118098	30118163	0	66	25236	3678	25236	3612	0.0	6.98671096345515
chr16	AC012645.3	30184148	30184331	0	184	0	728	0	544	0.0	0.0
chr16	NPIPB13	30228378	30228480	0	103	35505	5013	35505	4910	0.0	7.231160896130346
chr16	NPIPB13	30239965	30240051	788	87	35505	5013	34717	4926	9.057471264367816	7.047706049533089
chr16	NPIPB13	30239965	30240242	4707	278	35505	5013	30798	4735	16.931654676258994	6.504329461457234
chr16	TBC1D10B	30359171	30359361	0	191	573744	6408	573744	6217	0.0	92.28631172591282
chr16	TBC1D10B	30364899	30365006	50208	108	573744	6408	523536	6300	464.8888888888889	83.10095238095238
chr16	SEPTIN1	30381759	30381883	335	125	49587	3136	49252	3011	2.68	16.357356360013284
chr16	SEPTIN1	30382524	30382598	0	75	49587	3136	49587	3061	0.0	16.199607971251226
chr16	ZNF688	30571009	30571123	357	115	2625	2926	2268	2811	3.1043478260869564	0.8068303094983992
chr16	ZNF689	30610587	30610782	51	196	5406	3804	5355	3608	0.2602040816326531	1.4842017738359201
chr16	CCDC189	30759011	30759101	0	91	5237	2142	5237	2051	0.0	2.5533885909312533
chr16	CCDC189	30759653	30759724	63	72	5237	2142	5174	2070	0.875	2.4995169082125606
chr16	ZNF668	31064571	31064685	0	115	28458	3757	28458	3642	0.0	7.813838550247117
chr16	VKORC1	31091091	31091342	14874	252	143913	2196	129039	1944	59.023809523809526	66.37808641975309
chr16	VKORC1	31093311	31093421	1417	111	143913	2196	142496	2085	12.765765765765765	68.34340527577938
chr16	VKORC1	31093311	31093482	3968	172	143913	2196	139945	2024	23.069767441860463	69.14278656126483
chr16	VKORC1	31092782	31092864	13613	83	143913	2196	130300	2113	164.0120481927711	61.665877898722194
chr16	PRSS8	31135153	31135171	2520	19	343061	2981	340541	2962	132.6315789473684	114.96995273463875
chr16	PRSS36	31140293	31140415	522	123	102847	3373	102325	3250	4.2439024390243905	31.484615384615385
chr16	PYCARD	31202146	31202203	857	58	1106318	1662	1105461	1604	14.775862068965518	689.1901496259352
chr16	RUSF1	31507763	31507878	0	116	44651	3175	44651	3059	0.0	14.59660019614253
chr16	HERC2P4	32152448	32152645	0	198	446	5885	446	5687	0.0	0.07842447687708809
chr16	TP53TG3	32675463	32675630	0	168	0	3008	0	2840	0.0	0.0
chr16	TP53TG3	32674776	32675065	0	290	0	3008	0	2718	0.0	0.0
chr16	SLC6A10P	32883066	32883157	0	92	3443	4120	3443	4028	0.0	0.8547666335650447
chr16	HERC2P8	33123069	33123391	153	323	462	5145	309	4822	0.47368421052631576	0.0640812940688511
chr16	BMS1P8	33697736	33697795	0	60	102	2182	102	2122	0.0	0.04806786050895382
chr16	FRG2DP	35478921	35478991	0	71	0	1277	0	1206	0.0	0.0
chr16	AC018558.1	35505627	35505918	0	292	0	1199	0	907	0.0	0.0
chr16	AC018558.1	35505761	35505918	0	158	0	1199	0	1041	0.0	0.0
chr16	AC018558.1	35505761	35505890	0	130	0	1199	0	1069	0.0	0.0
chr16	ANKRD26P1	46475765	46475994	0	230	47	6109	47	5879	0.0	0.007994556897431535
chr16	ANKRD26P1	46487997	46488123	0	127	47	6109	47	5982	0.0	0.007856904045469742
chr16	ANKRD26P1	46514841	46514880	0	40	47	6109	47	6069	0.0	0.007744274180260339
chr16	SHCBP1	46604227	46604461	0	235	10753	6187	10753	5952	0.0	1.806619623655914
chr16	VPS35	46674313	46674462	0	150	112919	9751	112919	9601	0.0	11.761170711384231
chr16	VPS35	46682477	46682684	0	208	112919	9751	112919	9543	0.0	11.832652205805303
chr16	VPS35	46682477	46682666	0	190	112919	9751	112919	9561	0.0	11.810375483736012
chr16	MYLK3	46737710	46738143	0	434	357098	10660	357098	10226	0.0	34.92059456287894
chr16	C16ORF87	46809602	46809785	0	184	1777	7223	1777	7039	0.0	0.25245063219207275
chr16	C16ORF87	46807968	46808134	0	167	1777	7223	1777	7056	0.0	0.25184240362811794
chr16	NETO2	47086225	47086339	0	115	16732	7390	16732	7275	0.0	2.2999312714776634
chr16	ABCC12	48086740	48086819	0	80	50	8731	50	8651	0.0	0.005779678649867067
chr16	ABCC12	48104141	48104368	0	228	50	8731	50	8503	0.0	0.005880277549100318
chr16	ABCC12	48111435	48111507	0	73	50	8731	50	8658	0.0	0.005775005775005775
chr16	ABCC12	48117260	48117333	0	74	50	8731	50	8657	0.0	0.005775672865888876
chr16	ABCC12	48139162	48139336	0	175	50	8731	50	8556	0.0	0.00584385226741468
chr16	ABCC12	48153615	48153884	0	270	50	8731	50	8461	0.0	0.005909466966079659
chr16	ABCC12	48139187	48139336	0	150	50	8731	50	8581	0.0	0.00582682671017364
chr16	ABCC11	48170104	48170218	0	115	306	8503	306	8388	0.0	0.03648068669527897
chr16	SIAH1	48392756	48392892	0	137	13170	5767	13170	5630	0.0	2.339253996447602
chr16	N4BP1	48546146	48546254	0	109	153	7819	153	7710	0.0	0.019844357976653695
chr16	N4BP1	48551385	48551482	0	98	153	7819	153	7721	0.0	0.0198160859992229
chr16	SALL1	51138687	51142145	35	3459	86	5665	51	2206	0.01011853136744724	0.023118766999093383
chr16	LINC00919	52084712	52084824	0	113	0	1662	0	1549	0.0	0.0
chr16	TOX3	52475530	52475640	0	111	0	6765	0	6654	0.0	0.0
chr16	CASC16	52562813	52562862	0	50	0	1651	0	1601	0.0	0.0
chr16	CASC16	52573180	52573344	0	165	0	1651	0	1486	0.0	0.0
chr16	AKTIP	53501520	53501570	0	51	58155	4978	58155	4927	0.0	11.803328597523848
chr16	AKTIP	53494838	53494955	0	118	58155	4978	58155	4860	0.0	11.966049382716049
chr16	AKTIP	53502699	53503044	204	346	58155	4978	57951	4632	0.5895953757225434	12.5110103626943
chr16	RPGRIP1L	53622218	53622356	0	139	12548	12304	12548	12165	0.0	1.0314837648993014
chr16	RPGRIP1L	53638309	53638411	0	103	12548	12304	12548	12201	0.0	1.0284402917793622
chr16	RPGRIP1L	53703227	53703261	300	35	12548	12304	12248	12269	8.571428571428571	0.9982883690602331
chr16	LINC02169	54258349	54258440	0	92	0	858	0	766	0.0	0.0
chr16	IRX3	54284496	54285613	0	1118	0	1990	0	872	0.0	0.0
chr16	CRNDE	54924600	54924687	0	88	128	12295	128	12207	0.0	0.01048578684361432
chr16	CES1	55806332	55806464	0	133	70	2953	70	2820	0.0	0.024822695035460994
chr16	CES1	55828766	55828974	0	209	70	2953	70	2744	0.0	0.025510204081632654
chr16	CES1	55828766	55828971	0	206	70	2953	70	2747	0.0	0.025482344375682562
chr16	CES1	55812335	55812430	0	96	70	2953	70	2857	0.0	0.024501225061253063
chr16	CES1	55826150	55826295	70	146	70	2953	0	2807	0.4794520547945205	0.0
chr16	CES5A	55849623	55849773	0	151	102	3225	102	3074	0.0	0.03318152244632401
chr16	CES5A	55856376	55856445	0	70	102	3225	102	3155	0.0	0.03232963549920761
chr16	CES5A	55861411	55861516	0	106	102	3225	102	3119	0.0	0.03270278935556268
chr16	CES5A	55865962	55866116	0	155	102	3225	102	3070	0.0	0.03322475570032573
chr16	CES5A	55856376	55856442	0	67	102	3225	102	3158	0.0	0.03229892336922103
chr16	AC040168.1	56187602	56187700	0	99	306	8683	306	8584	0.0	0.03564771668219944
chr16	AC040168.1	56161887	56162106	0	220	306	8683	306	8463	0.0	0.03615739099610067
chr16	AMFR	56389184	56389375	10	192	8773	5506	8763	5314	0.052083333333333336	1.6490402709823109
chr16	AMFR	56388757	56388853	0	97	8773	5506	8773	5409	0.0	1.6219264189314107
chr16	BBS2	56497742	56497880	2374	139	279645	5825	277271	5686	17.07913669064748	48.76380583890257
chr16	MT1G	56667311	56667380	6777	70	53313	753	46536	683	96.81428571428572	68.13469985358712
chr16	MT1G	56667311	56667377	6750	67	53313	753	46563	686	100.74626865671642	67.87609329446065
chr16	PSME3IP1	57175538	57175590	3351	53	111294	3087	107943	3034	63.22641509433962	35.57778510217535
chr16	PSME3IP1	57174168	57174286	0	119	111294	3087	111294	2968	0.0	37.49797843665768
chr16	PSME3IP1	57178501	57178852	306	352	111294	3087	110988	2735	0.8693181818181818	40.58062157221207
chr16	PSME3IP1	57174619	57174688	926	70	111294	3087	110368	3017	13.228571428571428	36.58203513423931
chr16	PSME3IP1	57178805	57178852	61	48	111294	3087	111233	3039	1.2708333333333333	36.60184271141823
chr16	PLLP	57261896	57262070	0	175	69649	5318	69649	5143	0.0	13.54248493097414
chr16	CIAPIN1	57431150	57431266	0	117	0	3392	0	3275	0.0	0.0
chr16	CIAPIN1	57432486	57432560	0	75	0	3392	0	3317	0.0	0.0
chr16	CIAPIN1	57436655	57436732	0	78	0	3392	0	3314	0.0	0.0
chr16	CIAPIN1	57440771	57440983	0	213	0	3392	0	3179	0.0	0.0
chr16	CIAPIN1	57430257	57430339	0	83	0	3392	0	3309	0.0	0.0
chr16	DOK4	57475505	57475620	236	116	114931	4617	114695	4501	2.0344827586206895	25.48211508553655
chr16	KIFC3	57759124	57759153	0	30	137741	7697	137741	7667	0.0	17.965436285378896
chr16	KIFC3	57788574	57788713	300	140	137741	7697	137441	7557	2.142857142857143	18.187243615191214
chr16	KIFC3	57794998	57795141	46014	144	137741	7697	91727	7553	319.5416666666667	12.144445915530254
chr16	KIFC3	57776485	57776690	0	206	137741	7697	137741	7491	0.0	18.38753170471232
chr16	KIFC3	57779876	57779951	1409	76	137741	7697	136332	7621	18.539473684210527	17.88899094607007
chr16	KIFC3	57785463	57785666	13973	204	137741	7697	123768	7493	68.49509803921569	16.5178166288536
chr16	KIFC3	57779360	57779450	0	91	137741	7697	137741	7606	0.0	18.10951880094662
chr16	CNGB1	57887854	57888074	0	221	162	7346	162	7125	0.0	0.02273684210526316
chr16	CNGB1	57931715	57931878	0	164	162	7346	162	7182	0.0	0.022556390977443608
chr16	CNGB1	57937091	57937359	0	269	162	7346	162	7077	0.0	0.022891055532005086
chr16	PRSS54	58290958	58291136	51	179	1167	2120	1116	1941	0.2849162011173184	0.5749613601236476
chr16	CNOT1	58547565	58547682	135	118	86360	10398	86225	10280	1.1440677966101696	8.387645914396888
chr16	CNOT1	58553781	58553860	7922	80	86360	10398	78438	10318	99.025	7.602054661756155
chr16	CNOT1	58527922	58528105	0	184	86360	10398	86360	10214	0.0	8.455061680046994
chr16	CNOT1	58543168	58543292	1733	125	86360	10398	84627	10273	13.864	8.237807845809403
chr16	CNOT1	58624672	58624794	0	123	86360	10398	86360	10275	0.0	8.404866180048662
chr16	CNOT1	58623281	58623409	0	129	86360	10398	86360	10269	0.0	8.409776998734054
chr16	CNOT1	58624652	58624794	0	143	86360	10398	86360	10255	0.0	8.421257922964408
chr16	SLC38A7	58671044	58671244	0	201	1681	6005	1681	5804	0.0	0.2896278428669883
chr16	SLC38A7	58683954	58684178	0	225	1681	6005	1681	5780	0.0	0.29083044982698963
chr16	SLC38A7	58675212	58675342	0	131	1681	6005	1681	5874	0.0	0.2861763704460334
chr16	SLC38A7	58683954	58684083	0	130	1681	6005	1681	5875	0.0	0.28612765957446806
chr16	GOT2	58716662	58716813	0	152	4568	3760	4568	3608	0.0	1.2660753880266076
chr16	GOT2	58722149	58722278	0	130	4568	3760	4568	3630	0.0	1.2584022038567493
chr16	GOT2	58723745	58723902	0	158	4568	3760	4568	3602	0.0	1.2681843420322043
chr16	CDH8	61727093	61727215	0	123	408	13549	408	13426	0.0	0.030388797854908386
chr16	AC138305.1	63532816	63532931	0	116	0	2383	0	2267	0.0	0.0
chr16	CDH11	64948608	64948787	0	180	25712	13237	25712	13057	0.0	1.969211916979398
chr16	CDH11	65004641	65005041	0	401	25712	13237	25712	12836	0.0	2.0031162355874104
chr16	CDH11	65053803	65053928	0	126	25712	13237	25712	13111	0.0	1.9611013652658074
chr16	CDH11	65123673	65123820	0	148	25712	13237	25712	13089	0.0	1.9643975857590343
chr16	LINC00922	65311413	65311695	153	283	153	2337	0	2054	0.5406360424028268	0.0
chr16	LINC00922	65356430	65356489	0	60	153	2337	153	2277	0.0	0.06719367588932806
chr16	LINC00922	65311413	65311547	0	135	153	2337	153	2202	0.0	0.06948228882833787
chr16	LINC00922	65363380	65363503	0	124	153	2337	153	2213	0.0	0.06913691821057388
chr16	LINC00922	65356394	65356489	0	96	153	2337	153	2241	0.0	0.06827309236947791
chr16	AC010542.3	66477943	66478117	0	175	546	1350	546	1175	0.0	0.4646808510638298
chr16	BEAN1-AS1	66471376	66471564	33	189	33	1739	0	1550	0.1746031746031746	0.0
chr16	BEAN1-AS1	66473989	66474173	0	185	33	1739	33	1554	0.0	0.021235521235521235
chr16	BEAN1-AS1	66471514	66471564	33	51	33	1739	0	1688	0.6470588235294118	0.0
chr16	BEAN1-AS1	66479007	66479131	0	125	33	1739	33	1614	0.0	0.020446096654275093
chr16	BEAN1-AS1	66479652	66479755	0	104	33	1739	33	1635	0.0	0.02018348623853211
chr16	BEAN1-AS1	66480248	66480419	0	172	33	1739	33	1567	0.0	0.021059349074664963
chr16	TK2	66513730	66513811	0	82	58762	8924	58762	8842	0.0	6.6457814973987785
chr16	TK2	66517135	66517215	0	81	58762	8924	58762	8843	0.0	6.6450299672057
chr16	TK2	66528993	66529067	0	75	58762	8924	58762	8849	0.0	6.640524353034241
chr16	TK2	66531379	66531469	0	91	58762	8924	58762	8833	0.0	6.652552926525529
chr16	TK2	66536963	66537017	569	55	58762	8924	58193	8869	10.345454545454546	6.561393618220769
chr16	TK2	66541878	66541953	196	76	58762	8924	58566	8848	2.5789473684210527	6.619122965641953
chr16	TK2	66547970	66548065	0	96	58762	8924	58762	8828	0.0	6.656320797462619
chr16	TK2	66513730	66513862	0	133	58762	8924	58762	8791	0.0	6.684336252986008
chr16	TK2	66513285	66513351	0	67	58762	8924	58762	8857	0.0	6.63452636332844
chr16	TK2	66550252	66550327	84	76	58762	8924	58678	8848	1.105263157894737	6.631781193490054
chr16	TK2	66536078	66536199	0	122	58762	8924	58762	8802	0.0	6.675982731197455
chr16	TK2	66546146	66546226	22	81	58762	8924	58740	8843	0.2716049382716049	6.642542123713672
chr16	TK2	66546104	66546221	55	118	58762	8924	58707	8806	0.4661016949152542	6.666704519645696
chr16	TK2	66546146	66546221	17	76	58762	8924	58745	8848	0.2236842105263158	6.6393535262206145
chr16	TK2	66548742	66548784	136	43	58762	8924	58626	8881	3.1627906976744184	6.601283639229816
chr16	DYNC1LI2	66728200	66728242	4	43	3179	6030	3175	5987	0.09302325581395349	0.5303156839819609
chr16	DYNC1LI2	66742437	66742668	0	232	3179	6030	3179	5798	0.0	0.5482925146602277
chr16	DYNC1LI2	66749196	66749313	0	118	3179	6030	3179	5912	0.0	0.5377198917456022
chr16	DYNC1LI2	66724661	66724748	0	88	3179	6030	3179	5942	0.0	0.5350050488051161
chr16	DYNC1LI2	66742437	66742554	0	118	3179	6030	3179	5912	0.0	0.5377198917456022
chr16	TERB1	66768103	66768168	19988	66	262942	3451	242954	3385	302.8484848484849	71.77370753323486
chr16	TERB1	66775117	66775243	189	127	262942	3451	262753	3324	1.4881889763779528	79.04723225030084
chr16	TERB1	66800976	66801053	0	78	262942	3451	262942	3373	0.0	77.95493625852357
chr16	TERB1	66796767	66796830	0	64	262942	3451	262942	3387	0.0	77.63271331561855
chr16	TERB1	66800047	66800196	0	150	262942	3451	262942	3301	0.0	79.65525598303545
chr16	NAE1	66805776	66805862	0	87	102	4416	102	4329	0.0	0.02356202356202356
chr16	NAE1	66805776	66805826	0	51	102	4416	102	4365	0.0	0.02336769759450172
chr16	NAE1	66824854	66824885	0	32	102	4416	102	4384	0.0	0.023266423357664233
chr16	NAE1	66826667	66826780	0	114	102	4416	102	4302	0.0	0.023709902370990237
chr16	NAE1	66826676	66826780	0	105	102	4416	102	4311	0.0	0.023660403618649965
chr16	NAE1	66827979	66828077	0	99	102	4416	102	4317	0.0	0.0236275191104934
chr16	NAE1	66823226	66823306	51	81	102	4416	51	4335	0.6296296296296297	0.011764705882352941
chr16	NAE1	66827979	66828142	0	164	102	4416	102	4252	0.0	0.02398871119473189
chr16	NAE1	66827459	66827564	0	106	102	4416	102	4310	0.0	0.023665893271461718
chr16	NAE1	66827934	66828077	0	144	102	4416	102	4272	0.0	0.023876404494382022
chr16	CDH16	66913490	66913613	0	124	12644	3606	12644	3482	0.0	3.631246410109133
chr16	CDH16	66918020	66918078	0	59	12644	3606	12644	3547	0.0	3.564702565548351
chr16	CIAO2B	66932480	66932550	0	71	0	1010	0	939	0.0	0.0
chr16	KIAA0895L	67178009	67178107	3239	99	192351	3439	189112	3340	32.717171717171716	56.620359281437125
chr16	KIAA0895L	67178009	67178097	2980	89	192351	3439	189371	3350	33.48314606741573	56.52865671641791
chr16	KIAA0895L	67181557	67181697	13417	141	192351	3439	178934	3298	95.15602836879432	54.25530624620983
chr16	KIAA0895L	67181605	67181697	7489	93	192351	3439	184862	3346	80.52688172043011	55.2486551105798
chr16	EXOC3L1	67184685	67184810	120	126	59390	3057	59270	2931	0.9523809523809523	20.221767314909588
chr16	EXOC3L1	67186758	67186884	210	127	59390	3057	59180	2930	1.6535433070866141	20.197952218430036
chr16	LRRC29	67208311	67208455	6054	145	215984	2814	209930	2669	41.751724137931035	78.65492693892844
chr16	FHOD1	67231187	67231349	459	163	195821	5039	195362	4876	2.815950920245399	40.06603773584906
chr16	FHOD1	67236410	67236434	636	25	195821	5039	195185	5014	25.44	38.92800159553251
chr16	KCTD19	67304420	67304571	990	152	196761	7397	195771	7245	6.5131578947368425	27.02153209109731
chr16	TPPP3	67392946	67393037	0	92	408	2263	408	2171	0.0	0.1879318286503915
chr16	ZDHHC1	67398572	67398731	0	160	1751	3245	1751	3085	0.0	0.5675850891410049
chr16	ATP6V0D1	67444527	67444706	0	180	27750	6487	27750	6307	0.0	4.399873156809893
chr16	ATP6V0D1	67453543	67453715	0	173	27750	6487	27750	6314	0.0	4.394995248653785
chr16	ATP6V0D1	67457563	67457651	0	89	27750	6487	27750	6398	0.0	4.33729290403251
chr16	ATP6V0D1	67452237	67452360	0	124	27750	6487	27750	6363	0.0	4.3611504007543616
chr16	ATP6V0D1	67445811	67445965	0	155	27750	6487	27750	6332	0.0	4.3825015792798485
chr16	ACD	67659902	67660045	1173	144	23941	2398	22768	2254	8.145833333333334	10.101153504880212
chr16	ACD	67659902	67660036	1173	135	23941	2398	22768	2263	8.688888888888888	10.060980998674326
chr16	ENKD1	67663656	67663820	38	165	14359	2573	14321	2408	0.23030303030303031	5.947259136212624
chr16	ENKD1	67663936	67664062	0	127	14359	2573	14359	2446	0.0	5.870400654129191
chr16	ENKD1	67664995	67665168	33	174	14359	2573	14326	2399	0.1896551724137931	5.971654856190079
chr16	GFOD2	67677765	67677857	0	93	15713	4622	15713	4529	0.0	3.4694192978582468
chr16	RANBP10	67744287	67744455	0	169	52129	6474	52129	6305	0.0	8.267882632831087
chr16	RANBP10	67772033	67772086	585	54	52129	6474	51544	6420	10.833333333333334	8.028660436137072
chr16	RANBP10	67805427	67805539	51	113	52129	6474	52078	6361	0.45132743362831856	8.18707750353718
chr16	CENPT	67832227	67832315	0	89	204	5102	204	5013	0.0	0.040694195092758824
chr16	CENPT	67831840	67831890	0	51	204	5102	204	5051	0.0	0.04038804197188676
chr16	CENPT	67832227	67832350	0	124	204	5102	204	4978	0.0	0.04098031337886701
chr16	CENPT	67832227	67832354	0	128	204	5102	204	4974	0.0	0.04101326899879373
chr16	CENPT	67835537	67835586	0	50	204	5102	204	5052	0.0	0.040380047505938245
chr16	CENPT	67835537	67835658	0	122	204	5102	204	4980	0.0	0.04096385542168675
chr16	CTRL	67931097	67931201	0	105	1978	2174	1978	2069	0.0	0.9560173997100049
chr16	LCAT	67940736	67940831	0	96	117963	2295	117963	2199	0.0	53.643929058663026
chr16	SLC12A4	67946437	67946633	7	197	177457	8217	177450	8020	0.03553299492385787	22.125935162094763
chr16	SLC12A4	67963464	67963559	847	96	177457	8217	176610	8121	8.822916666666666	21.747321758404137
chr16	DPEP3	67979638	67979765	29785	128	142289	1748	112504	1620	232.6953125	69.44691358024691
chr16	DPEP2	67992509	67992636	388	128	34468	3207	34080	3079	3.03125	11.068528743098408
chr16	DPEP2	67999266	67999748	1323	483	34468	3207	33145	2724	2.739130434782609	12.167767988252569
chr16	ESRP2	68232370	68232503	868	134	10313	5121	9445	4987	6.477611940298507	1.8939242029276118
chr16	ESRP2	68235847	68235879	0	33	10313	5121	10313	5088	0.0	2.026926100628931
chr16	SMPD3	68386597	68386659	94	63	135031	6995	134937	6932	1.492063492063492	19.465810732833237
chr16	CHTF8	69121052	69121170	816	119	15850	1694	15034	1575	6.857142857142857	9.545396825396825
chr16	CHTF8	69121435	69121493	245	59	15850	1694	15605	1635	4.1525423728813555	9.54434250764526
chr16	CHTF8	69120106	69120208	485	103	15850	1694	15365	1591	4.70873786407767	9.657448145820238
chr16	AC026464.1	69347787	69347936	222	150	18573	752	18351	602	1.48	30.483388704318937
chr16	TERF2	69357517	69357561	3960	45	493993	3724	490033	3679	88.0	133.19733623267192
chr16	TERF2	69368586	69368595	2904	10	493993	3724	491089	3714	290.4	132.22644049542274
chr16	NQO1	69713027	69713129	0	103	19775	2978	19775	2875	0.0	6.878260869565217
chr16	NQO1	69714963	69715077	102	115	19775	2978	19673	2863	0.8869565217391304	6.871463499825358
chr16	NOB1	69752240	69752371	616209	132	2096813	2054	1480604	1922	4668.25	770.3454734651405
chr16	NOB1	69749558	69749630	91	73	2096813	2054	2096722	1981	1.2465753424657535	1058.4159515396263
chr16	PDXDC2P-NPIPB14P	69976810	69978003	255	1194	31213	6094	30958	4900	0.2135678391959799	6.317959183673469
chr16	PDXDC2P-NPIPB14P	69989955	69990208	0	254	31213	6094	31213	5840	0.0	5.344691780821917
chr16	NPIPB14P	69978221	69978282	1530	62	1530	1595	0	1533	24.677419354838708	0.0
chr16	PDXDC2P-NPIPB14P	69990596	69990683	0	88	31213	6094	31213	6006	0.0	5.196969696969697
chr16	PDXDC2P-NPIPB14P	69992910	69993248	133	339	31213	6094	31080	5755	0.39233038348082594	5.400521285838401
chr16	PDXDC2P	70064670	70064776	102	107	27857	2726	27755	2619	0.9532710280373832	10.597556319205804
chr16	AC009060.1	70161443	70161893	0	451	5385	3435	5385	2984	0.0	1.8046246648793565
chr16	AARS1	70258032	70258217	419	186	132468	9918	132049	9732	2.252688172043011	13.568536785861077
chr16	AARS1	70262345	70262524	265	180	132468	9918	132203	9738	1.4722222222222223	13.575990963236805
chr16	AARS1	70270195	70270340	279	146	132468	9918	132189	9772	1.9109589041095891	13.527322963569382
chr16	AARS1	70278899	70279045	0	147	132468	9918	132468	9771	0.0	13.557261283389622
chr16	AARS1	70262345	70262484	150	140	132468	9918	132318	9778	1.0714285714285714	13.532215176927798
chr16	AARS1	70262366	70262524	265	159	132468	9918	132203	9759	1.6666666666666667	13.546777333743211
chr16	AARS1	70262372	70262524	265	153	132468	9918	132203	9765	1.7320261437908497	13.538453661034307
chr16	AARS1	70258052	70258217	419	166	132468	9918	132049	9752	2.5240963855421685	13.540709598031173
chr16	AARS1	70258032	70258244	521	213	132468	9918	131947	9705	2.4460093896713615	13.595775373518805
chr16	AARS1	70254390	70254483	0	94	132468	9918	132468	9824	0.0	13.484120521172638
chr16	AARS1	70264957	70265102	1398	146	132468	9918	131070	9772	9.575342465753424	13.412812116250512
chr16	AC012184.3	70317255	70317373	154	119	10005	1770	9851	1651	1.2941176470588236	5.966686856450636
chr16	COG4	70482091	70482175	168	85	66177	4424	66009	4339	1.9764705882352942	15.212952293155105
chr16	COG4	70490329	70490392	0	64	66177	4424	66177	4360	0.0	15.178211009174312
chr16	COG4	70515867	70516040	33986	174	66177	4424	32191	4250	195.32183908045977	7.57435294117647
chr16	COG4	70519648	70519731	102	84	66177	4424	66075	4340	1.2142857142857142	15.224654377880185
chr16	COG4	70517625	70517740	1071	116	66177	4424	65106	4308	9.232758620689655	15.112813370473537
chr16	COG4	70508665	70508824	3437	160	66177	4424	62740	4264	21.48125	14.71388367729831
chr16	COG4	70519676	70519731	88	56	66177	4424	66089	4368	1.5714285714285714	15.130265567765568
chr16	MTSS2	70679314	70679323	0	10	329	4987	329	4977	0.0	0.06610407876230662
chr16	VAC14	70692820	70692971	0	152	78277	7702	78277	7550	0.0	10.367814569536424
chr16	VAC14	70786214	70786365	0	152	78277	7702	78277	7550	0.0	10.367814569536424
chr16	HYDIN	70862047	70862255	0	209	44005	28693	44005	28484	0.0	1.5449024013481252
chr16	HYDIN	70918210	70918429	0	220	44005	28693	44005	28473	0.0	1.545499244898676
chr16	HYDIN	70991317	70991396	0	80	44005	28693	44005	28613	0.0	1.5379373012267152
chr16	HYDIN	71025382	71025526	0	145	44005	28693	44005	28548	0.0	1.5414389799635702
chr16	HYDIN	71162530	71162730	0	201	44005	28693	44005	28492	0.0	1.5444686227713043
chr16	HYDIN	70811311	70811435	0	125	44005	28693	44005	28568	0.0	1.5403598431811818
chr16	HYDIN	70865117	70865363	0	247	44005	28693	44005	28446	0.0	1.546966181536947
chr16	HYDIN	71027601	71027875	0	275	44005	28693	44005	28418	0.0	1.5484903934126257
chr16	HYDIN	71066782	71066933	0	152	44005	28693	44005	28541	0.0	1.5418170351424267
chr16	HYDIN	71075943	71075988	0	46	44005	28693	44005	28647	0.0	1.5361119838028414
chr16	HYDIN	71203724	71204057	0	334	44005	28693	44005	28359	0.0	1.551711978560598
chr16	CMTR2	71288877	71288937	0	61	0	5440	0	5379	0.0	0.0
chr16	ZNF23	71456071	71456121	0	51	153	6589	153	6538	0.0	0.023401651881309268
chr16	ZNF23	71450589	71450715	0	127	153	6589	153	6462	0.0	0.023676880222841225
chr16	ZNF19	71478878	71479005	0	128	10992	8775	10992	8647	0.0	1.2711923210361975
chr16	ZNF19	71482081	71482143	2276	63	10992	8775	8716	8712	36.12698412698413	1.000459136822773
chr16	ZNF23	71461658	71462004	0	347	153	6589	153	6242	0.0	0.02451137455943608
chr16	ZNF19	71478878	71479100	0	223	10992	8775	10992	8552	0.0	1.285313376987839
chr16	ZNF19	71478434	71478507	0	74	10992	8775	10992	8701	0.0	1.263303068612803
chr16	ZNF19	71487079	71487410	5294	332	10992	8775	5698	8443	15.94578313253012	0.674878597654862
chr16	PHLPP2	71663898	71664099	0	202	33600	12515	33600	12313	0.0	2.7288231949971573
chr16	PHLPP2	71644750	71644855	0	106	33600	12515	33600	12409	0.0	2.7077121444113144
chr16	AP1G1	71761511	71761567	0	57	59370	10941	59370	10884	0.0	5.4547960308710035
chr16	AP1G1	71806685	71806728	0	44	59370	10941	59370	10897	0.0	5.448288519776085
chr16	AP1G1	71808504	71808677	0	174	59370	10941	59370	10767	0.0	5.51407077180273
chr16	AP1G1	71767876	71767885	0	10	59370	10941	59370	10931	0.0	5.431342054706797
chr16	AP1G1	71772959	71773053	4538	95	59370	10941	54832	10846	47.76842105263158	5.0555043333948
chr16	AP1G1	71808014	71808150	0	137	59370	10941	59370	10804	0.0	5.495186967789707
chr16	AP1G1	71807800	71807838	0	39	59370	10941	59370	10902	0.0	5.445789763346175
chr16	ZNF821	71861775	71861942	2244	168	54736	3268	52492	3100	13.357142857142858	16.932903225806452
chr16	ZNF821	71881316	71881434	24	119	54736	3268	54712	3149	0.20168067226890757	17.37440457288028
chr16	ZNF821	71864902	71865048	0	147	54736	3268	54736	3121	0.0	17.537968599807755
chr16	ZNF821	71867911	71868037	0	127	54736	3268	54736	3141	0.0	17.42629735752945
chr16	ZNF821	71867892	71868037	0	146	54736	3268	54736	3122	0.0	17.532351057014733
chr16	TXNL4B	72090088	72090177	0	90	29	3150	29	3060	0.0	0.009477124183006535
chr16	PMFBP1	72164370	72164486	399	117	193099	5619	192700	5502	3.41025641025641	35.023627771719376
chr16	PMFBP1	72128376	72128569	0	194	193099	5619	193099	5425	0.0	35.59428571428571
chr16	LINC01572	72522552	72522623	0	72	7305	12582	7305	12510	0.0	0.5839328537170264
chr16	LINC01572	72540577	72540611	0	35	7305	12582	7305	12547	0.0	0.582210887064637
chr16	LINC01572	72561972	72562086	0	115	7305	12582	7305	12467	0.0	0.585946899815513
chr16	ZFHX3	72957426	72960194	0	2769	36905	22271	36905	19502	0.0	1.8923700133319659
chr16	AC009053.1	74349741	74349859	2985	119	101391	3342	98406	3223	25.084033613445378	30.532423208191126
chr16	CLEC18B	74418058	74418298	51	241	6100	2892	6049	2651	0.21161825726141079	2.281780460203697
chr16	CLEC18B	74409851	74409878	171	28	6100	2892	5929	2864	6.107142857142857	2.07018156424581
chr16	GLG1	74532120	74532153	0	34	68458	12730	68458	12696	0.0	5.392091997479521
chr16	GLG1	74472525	74472634	132	110	68458	12730	68326	12620	1.2	5.414104595879556
chr16	RFWD3	74660931	74661451	2030	521	83855	6472	81825	5951	3.896353166986564	13.749789951268694
chr16	RFWD3	74664623	74664745	21993	123	83855	6472	61862	6349	178.8048780487805	9.743581666404157
chr16	RFWD3	74664689	74664745	15978	57	83855	6472	67877	6415	280.3157894736842	10.580982073265783
chr16	RFWD3	74665232	74665280	0	49	83855	6472	83855	6423	0.0	13.055425813482795
chr16	MLKL	74675612	74675764	0	153	90965	4745	90965	4592	0.0	19.809451219512194
chr16	MLKL	74676300	74676425	0	126	90965	4745	90965	4619	0.0	19.69365663563542
chr16	WDR59	74908907	74908977	624	71	47937	9092	47313	9021	8.788732394366198	5.244762221483206
chr16	WDR59	74942737	74942826	3410	90	47937	9092	44527	9002	37.888888888888886	4.946345256609642
chr16	WDR59	74899697	74899754	0	58	47937	9092	47937	9034	0.0	5.306287358866505
chr16	WDR59	74959349	74959592	0	244	47937	9092	47937	8848	0.0	5.417834538878843
chr16	CTRB2	75204796	75204906	1956	111	40363	2319	38407	2208	17.62162162162162	17.39447463768116
chr16	CTRB2	75204772	75204906	2508	135	40363	2319	37855	2184	18.57777777777778	17.332875457875456
chr16	CTRB2	75204741	75204906	4281	166	40363	2319	36082	2153	25.789156626506024	16.758941012540642
chr16	BCAR1	75236881	75236998	0	118	17179	8469	17179	8351	0.0	2.05711890791522
chr16	BCAR1	75252234	75252398	34	165	17179	8469	17145	8304	0.20606060606060606	2.0646676300578033
chr16	BCAR1	75264350	75264601	1224	252	17179	8469	15955	8217	4.857142857142857	1.9417062188146526
chr16	BCAR1	75236827	75236998	0	172	17179	8469	17179	8297	0.0	2.0705074123177054
chr16	CFDP1	75414577	75414695	0	119	2951	2941	2951	2822	0.0	1.0457122608079377
chr16	CFDP1	75391379	75391508	0	130	2951	2941	2951	2811	0.0	1.0498043400924937
chr16	TMEM170A	75451737	75451839	0	103	138956	5151	138956	5048	0.0	27.526941362916006
chr16	CFDP1	75419017	75419193	0	177	2951	2941	2951	2764	0.0	1.067655571635311
chr16	CHST6	75490613	75490769	2209	157	273458	7315	271249	7158	14.070063694267516	37.894523609946916
chr16	TMEM231	75545351	75545495	0	145	30501	5614	30501	5469	0.0	5.57707076247943
chr16	TMEM231	75545825	75545954	102	130	30501	5614	30399	5484	0.7846153846153846	5.543216630196937
chr16	ADAT1	75618585	75618698	0	114	174036	4501	174036	4387	0.0	39.67084568041942
chr16	ADAT1	75618585	75618640	0	56	174036	4501	174036	4445	0.0	39.15320584926884
chr16	ADAT1	75622402	75622464	30	63	174036	4501	174006	4438	0.47619047619047616	39.208201892744476
chr16	KARS1	75640183	75640349	0	167	162742	3670	162742	3503	0.0	46.45789323437054
chr16	KARS1	75644282	75644462	0	181	162742	3670	162742	3489	0.0	46.64431069074233
chr16	KARS1	75636453	75636547	3913	95	162742	3670	158829	3575	41.189473684210526	44.42769230769231
chr16	KARS1	75642752	75642835	7196	84	162742	3670	155546	3586	85.66666666666667	43.37590630228667
chr16	AC105430.1	75839897	75839995	0	99	0	737	0	638	0.0	0.0
chr16	ADAMTS18	77362104	77362264	714	161	9429	6624	8715	6463	4.434782608695652	1.3484449945845582
chr16	MAFTRR	79721474	79721621	0	148	0	3915	0	3767	0.0	0.0
chr16	MAFTRR	79751213	79751276	0	64	0	3915	0	3851	0.0	0.0
chr16	MAFTRR	79757650	79757715	0	66	0	3915	0	3849	0.0	0.0
chr16	MAFTRR	79740146	79740237	0	92	0	3915	0	3823	0.0	0.0
chr16	AC105411.1	80157613	80157682	0	70	0	7114	0	7044	0.0	0.0
chr16	CDYL2	80662744	80662747	0	4	102	8838	102	8834	0.0	0.011546298392574145
chr16	CDYL2	80679733	80679736	0	4	102	8838	102	8834	0.0	0.011546298392574145
chr16	CDYL2	80670943	80670946	0	4	102	8838	102	8834	0.0	0.011546298392574145
chr16	ARLNC1	80841061	80841152	0	92	0	5783	0	5691	0.0	0.0
chr16	ARLNC1	80837931	80838045	0	115	0	5783	0	5668	0.0	0.0
chr16	ARLNC1	80840899	80840964	0	66	0	5783	0	5717	0.0	0.0
chr16	ARLNC1	80840118	80840222	0	105	0	5783	0	5678	0.0	0.0
chr16	CMC2	81001247	81001334	0	88	1479	11900	1479	11812	0.0	0.12521164917033525
chr16	ARLNC1	80841061	80841129	0	69	0	5783	0	5714	0.0	0.0
chr16	ARLNC1	80841894	80842042	0	149	0	5783	0	5634	0.0	0.0
chr16	ARLNC1	80841297	80841320	0	24	0	5783	0	5759	0.0	0.0
chr16	CMC2	80997313	80997429	51	117	1479	11900	1428	11783	0.4358974358974359	0.12119154714419078
chr16	ARLNC1	80841979	80842042	0	64	0	5783	0	5719	0.0	0.0
chr16	ARLNC1	80837910	80838045	0	136	0	5783	0	5647	0.0	0.0
chr16	ARLNC1	80830740	80830757	0	18	0	5783	0	5765	0.0	0.0
chr16	ARLNC1	80837931	80837987	0	57	0	5783	0	5726	0.0	0.0
chr16	ARLNC1	80831692	80831876	0	185	0	5783	0	5598	0.0	0.0
chr16	ARLNC1	80837910	80837987	0	78	0	5783	0	5705	0.0	0.0
chr16	CMC2	80981805	80981877	0	73	1479	11900	1479	11827	0.0	0.12505284518474677
chr16	CMC2	80978241	80978415	0	175	1479	11900	1479	11725	0.0	0.1261407249466951
chr16	CMC2	80980769	80980879	0	111	1479	11900	1479	11789	0.0	0.125455933497328
chr16	CMC2	80988539	80988596	0	58	1479	11900	1479	11842	0.0	0.1248944435061645
chr16	CMC2	80996922	80997020	0	99	1479	11900	1479	11801	0.0	0.12532836200322006
chr16	CMC2	80998284	80998354	0	71	1479	11900	1479	11829	0.0	0.1250317017499366
chr16	CMC2	80991753	80991957	0	205	1479	11900	1479	11695	0.0	0.1264643009833262
chr16	CMC2	80998284	80998351	0	68	1479	11900	1479	11832	0.0	0.125
chr16	CMC2	80998284	80998473	0	190	1479	11900	1479	11710	0.0	0.12630230572160547
chr16	GCSH	81087600	81087664	1397	65	2811	2011	1414	1946	21.49230769230769	0.7266187050359713
chr16	GCSH	81090600	81090680	121	81	2811	2011	2690	1930	1.4938271604938271	1.3937823834196892
chr16	C16ORF46	81063745	81063993	21509	249	214877	2382	193368	2133	86.38152610441767	90.65541490857946
chr16	C16ORF46	81066192	81066281	0	90	214877	2382	214877	2292	0.0	93.75087260034904
chr16	GCSH	81084462	81084594	0	133	2811	2011	2811	1878	0.0	1.4968051118210863
chr16	GCSH	81090996	81091107	0	112	2811	2011	2811	1899	0.0	1.4802527646129542
chr16	PKD1L2	81139507	81139712	96	206	15645	15813	15549	15607	0.46601941747572817	0.9962837188441084
chr16	PKD1L2	81156858	81157089	0	232	15645	15813	15645	15581	0.0	1.004107566908414
chr16	PKD1L2	81177806	81177983	0	178	15645	15813	15645	15635	0.0	1.0006395906619763
chr16	PKD1L2	81179644	81179786	0	143	15645	15813	15645	15670	0.0	0.9984045947670709
chr16	SDR42E1	82000300	82000417	0	118	1225	11909	1225	11791	0.0	0.10389279959290984
chr16	MPHOSPH6	82164651	82164741	0	91	0	2011	0	1920	0.0	0.0
chr16	MPHOSPH6	82151237	82151352	0	116	0	2011	0	1895	0.0	0.0
chr16	AC009119.1	83803668	83803715	0	48	0	5039	0	4991	0.0	0.0
chr16	MBTPS1	84074596	84074741	0	146	159310	9094	159310	8948	0.0	17.803978542691105
chr16	MBTPS1	84084982	84085134	0	153	159310	9094	159310	8941	0.0	17.817917458897217
chr16	MBTPS1	84110712	84110825	0	114	159310	9094	159310	8980	0.0	17.74053452115813
chr16	HSDL1	84139222	84139306	0	85	117538	3850	117538	3765	0.0	31.21859229747676
chr16	TAF1C	84179945	84180083	0	139	1786	4997	1786	4858	0.0	0.3676410045286126
chr16	TAF1C	84179945	84180080	0	136	1786	4997	1786	4861	0.0	0.3674141123225674
chr16	TAF1C	84183075	84183149	0	75	1786	4997	1786	4922	0.0	0.36286062576188544
chr16	TAF1C	84183696	84183778	0	83	1786	4997	1786	4914	0.0	0.3634513634513635
chr16	TAF1C	84184850	84184899	0	50	1786	4997	1786	4947	0.0	0.36102688498079644
chr16	TAF1C	84184850	84185060	0	211	1786	4997	1786	4786	0.0	0.37317175094024235
chr16	TAF1C	84183071	84183149	0	79	1786	4997	1786	4918	0.0	0.36315575437169584
chr16	TAF1C	84184850	84184989	0	140	1786	4997	1786	4857	0.0	0.3677166975499279
chr16	AC009123.1	84195260	84195441	0	182	0	1255	0	1073	0.0	0.0
chr16	MEAK7	84503957	84504147	3619	191	67216	7544	63597	7353	18.94764397905759	8.649122807017545
chr16	MEAK7	84497418	84497647	5916	230	67216	7544	61300	7314	25.721739130434784	8.381186765108012
chr16	MEAK7	84502720	84502862	7982	143	67216	7544	59234	7401	55.81818181818182	8.003513038778543
chr16	MEAK7	84499915	84500035	1197	121	67216	7544	66019	7423	9.892561983471074	8.893843459517715
chr16	COTL1	84617500	84617583	365	84	8533	6513	8168	6429	4.345238095238095	1.2704930782392285
chr16	ZDHHC7	84981869	84981994	0	126	6124	3678	6124	3552	0.0	1.7240990990990992
chr16	ZDHHC7	84988762	84988873	0	112	6124	3678	6124	3566	0.0	1.7173303421200223
chr16	C16ORF74	85710163	85710285	492	123	65805	2085	65313	1962	4.0	33.288990825688074
chr16	C16ORF74	85710163	85710307	1114	145	65805	2085	64691	1940	7.682758620689655	33.345876288659795
chr16	C16ORF74	85710409	85710473	72	65	65805	2085	65733	2020	1.1076923076923078	32.54108910891089
chr16	EMC8	85780378	85780473	0	96	8309	3516	8309	3420	0.0	2.42953216374269
chr16	LINC00917	86332958	86333044	0	87	83	5647	83	5560	0.0	0.014928057553956835
chr16	LINC00917	86335677	86335872	0	196	83	5647	83	5451	0.0	0.015226563933223261
chr16	LINC00917	86349017	86349148	0	132	83	5647	83	5515	0.0	0.015049864007252946
chr16	LINC00917	86334903	86334994	0	92	83	5647	83	5555	0.0	0.014941494149414942
chr16	LINC00917	86335677	86335853	0	177	83	5647	83	5470	0.0	0.015173674588665448
chr16	LINC00917	86337681	86338661	0	981	83	5647	83	4666	0.0	0.01778825546506644
chr16	LINC00917	86349017	86349155	0	139	83	5647	83	5508	0.0	0.015068990559186637
chr16	FENDRR	86478700	86478756	0	57	0	6492	0	6435	0.0	0.0
chr16	FENDRR	86490852	86491004	0	153	0	6492	0	6339	0.0	0.0
chr16	FENDRR	86477885	86478132	0	248	0	6492	0	6244	0.0	0.0
chr16	MTHFSD	86552032	86552146	0	115	4806	6866	4806	6751	0.0	0.7118945341430899
chr16	MTHFSD	86554644	86554751	0	108	4806	6866	4806	6758	0.0	0.7111571470849364
chr16	MTHFSD	86548034	86548111	0	78	4806	6866	4806	6788	0.0	0.7080141426045964
chr16	MTHFSD	86552178	86552292	0	115	4806	6866	4806	6751	0.0	0.7118945341430899
chr16	MTHFSD	86551972	86552146	0	175	4806	6866	4806	6691	0.0	0.7182782842624421
chr16	MTHFSD	86554644	86554748	0	105	4806	6866	4806	6761	0.0	0.7108415914805503
chr16	AC010531.4	87290718	87290797	588	80	920	2102	332	2022	7.35	0.1641938674579624
chr16	FBXO31	87358410	87358497	467	88	46083	6926	45616	6838	5.306818181818182	6.67095642000585
chr16	KLHDC4	87709264	87709667	0	404	45453	8827	45453	8423	0.0	5.396295856583166
chr16	KLHDC4	87730551	87730644	70	94	45453	8827	45383	8733	0.7446808510638298	5.196725065842208
chr16	KLHDC4	87748672	87748809	38	138	45453	8827	45415	8689	0.2753623188405797	5.226723443434227
chr16	KLHDC4	87756398	87756477	92	80	45453	8827	45361	8747	1.15	5.1858923059334625
chr16	KLHDC4	87755193	87755292	58	100	45453	8827	45395	8727	0.58	5.201672968946946
chr16	KLHDC4	87761948	87762040	7605	93	45453	8827	37848	8734	81.7741935483871	4.333409663384474
chr16	KLHDC4	87756421	87756477	92	57	45453	8827	45361	8770	1.6140350877192982	5.172291904218929
chr16	KLHDC4	87765065	87765206	6044	142	45453	8827	39409	8685	42.563380281690144	4.537593552101324
chr16	KLHDC4	87757342	87757463	0	122	45453	8827	45453	8705	0.0	5.221481906950029
chr16	KLHDC4	87765065	87765340	13835	276	45453	8827	31618	8551	50.1268115942029	3.6975792304993567
chr16	CA5A	87901911	87901974	51	64	36858	2077	36807	2013	0.796875	18.284649776453055
chr16	CA5A	87904785	87904904	0	120	36858	2077	36858	1957	0.0	18.833929483903933
chr16	CA5A	87893618	87893726	0	109	36858	2077	36858	1968	0.0	18.728658536585368
chr16	AC134312.5	88178783	88178952	0	170	0	2379	0	2209	0.0	0.0
chr16	CYBA	88646519	88646603	875	85	20603	2788	19728	2703	10.294117647058824	7.2985571587125415
chr16	MVD	88657145	88657247	150	103	10811	4212	10661	4109	1.4563106796116505	2.594548551959114
chr16	MVD	88662711	88662781	690	71	10811	4212	10121	4141	9.71830985915493	2.4440956290751026
chr16	MVD	88660747	88660841	1653	95	10811	4212	9158	4117	17.4	2.22443526839932
chr16	PIEZO1	88725008	88725080	2000	73	248096	10919	246096	10846	27.397260273972602	22.690023971971232
chr16	PIEZO1	88717536	88717615	0	80	248096	10919	248096	10839	0.0	22.889196420333977
chr16	APRT	88810422	88810556	0	135	1885	1728	1885	1593	0.0	1.1833019460138103
chr16	GALNS	88837621	88837765	0	145	14266	7488	14266	7343	0.0	1.9428026692087703
chr16	GALNS	88842705	88842829	0	125	14266	7488	14266	7363	0.0	1.9375254651636562
chr16	GALNS	88843029	88843199	255	171	14266	7488	14011	7317	1.4912280701754386	1.914855815224819
chr16	PABPN1L	88864852	88864940	0	89	90	1321	90	1232	0.0	0.07305194805194805
chr16	PABPN1L	88865021	88865128	0	108	90	1321	90	1213	0.0	0.0741962077493817
chr16	CBFA2T3	88898077	88898152	42	76	571069	5793	571027	5717	0.5526315789473685	99.88228091656462
chr16	CBFA2T3	88880987	88881148	4092	162	571069	5793	566977	5631	25.25925925925926	100.68851003374179
chr16	ANKRD11	89316932	89317078	4456	147	37481	12643	33025	12496	30.312925170068027	2.642845710627401
chr16	ANKRD11	89431255	89431326	0	72	37481	12643	37481	12571	0.0	2.981544825391775
chr16	ANKRD11	89291680	89291777	0	98	37481	12643	37481	12545	0.0	2.98772419290554
chr16	ANKRD11	89316932	89317075	4420	144	37481	12643	33061	12499	30.694444444444443	2.6450916073285864
chr16	ANKRD11	89288527	89288670	2096	144	37481	12643	35385	12499	14.555555555555555	2.8310264821185696
chr16	ANKRD11	89313316	89313589	39	274	37481	12643	37442	12369	0.14233576642335766	3.02708383862883
chr16	ANKRD11	89291680	89291799	0	120	37481	12643	37481	12523	0.0	2.992972929809151
chr16	ANKRD11	89305205	89305344	375	140	37481	12643	37106	12503	2.6785714285714284	2.9677677357434216
chr16	CHMP1A	89649350	89649497	2257	148	452900	5318	450643	5170	15.25	87.16499032882011
chr16	CHMP1A	89649350	89649520	2528	171	452900	5318	450372	5147	14.783625730994151	87.50184573537983
chr16	CHMP1A	89653903	89653923	1482	21	452900	5318	451418	5297	70.57142857142857	85.22144610156693
chr16	CHMP1A	89647034	89647121	13729	88	452900	5318	439171	5230	156.01136363636363	83.9715105162524
chr16	CHMP1A	89656632	89656734	0	103	452900	5318	452900	5215	0.0	86.84563758389261
chr16	CHMP1A	89653903	89654020	9348	118	452900	5318	443552	5200	79.22033898305085	85.29846153846154
chr16	CHMP1A	89649350	89649552	3390	203	452900	5318	449510	5115	16.699507389162562	87.88074291300097
chr16	CHMP1A	89651261	89651343	6165	83	452900	5318	446735	5235	74.27710843373494	85.33619866284623
chr16	CHMP1A	89649377	89649497	2219	121	452900	5318	450681	5197	18.33884297520661	86.7194535308832
chr16	FANCA	89740803	89740866	0	64	201571	7815	201571	7751	0.0	26.00580570249
chr16	FANCA	89742799	89742938	465	140	201571	7815	201106	7675	3.3214285714285716	26.20273615635179
chr16	FANCA	89749729	89749902	226	174	201571	7815	201345	7641	1.2988505747126438	26.350608559089125
chr16	FANCA	89752137	89752222	51	86	201571	7815	201520	7729	0.5930232558139535	26.073230689610558
chr16	FANCA	89758576	89758705	325	130	201571	7815	201246	7685	2.5	26.186857514638906
chr16	FANCA	89795905	89796018	2346	114	201571	7815	199225	7701	20.57894736842105	25.870016880924556
chr16	FANCA	89803258	89803341	2544	84	201571	7815	199027	7731	30.285714285714285	25.74401759151468
chr16	FANCA	89810706	89810802	204	97	201571	7815	201367	7718	2.1030927835051547	26.090567504534853
chr16	FANCA	89762637	89762793	3857	157	201571	7815	197714	7658	24.56687898089172	25.81796813789501
chr16	FANCA	89778340	89778462	3762	123	201571	7815	197809	7692	30.585365853658537	25.71619864794592
chr16	DBNDD1	90011583	90011696	0	114	20651	3943	20651	3829	0.0	5.393314181248368
chr16	URAHP	90044113	90044233	18844	121	145341	2347	126497	2226	155.73553719008265	56.827044025157235
chr16	PRDM7	90060340	90060623	1152	284	168771	4282	167619	3998	4.056338028169014	41.92571285642821
chr16	PRDM7	90075350	90075474	0	125	168771	4282	168771	4157	0.0	40.59923021409671
chr17	RPH3AL	281767	281854	0	88	1161	6091	1161	6003	0.0	0.1934032983508246
chr17	RPH3AL	333758	333934	0	177	1161	6091	1161	5914	0.0	0.19631383158606697
chr17	VPS53	628087	628231	0	145	173157	10943	173157	10798	0.0	16.036025189849973
chr17	VPS53	661808	661895	867	88	173157	10943	172290	10855	9.852272727272727	15.871948410870566
chr17	VPS53	632743	632841	40	99	173157	10943	173117	10844	0.40404040404040403	15.964312061969753
chr17	GEMIN4	749813	749909	78	97	1782	3543	1704	3446	0.8041237113402062	0.4944863609982589
chr17	GLOD4	770420	770507	105	88	704	3270	599	3182	1.1931818181818181	0.18824638592080453
chr17	GLOD4	780683	780738	0	56	704	3270	704	3214	0.0	0.21904169259489734
chr17	GLOD4	781862	782043	0	182	704	3270	704	3088	0.0	0.22797927461139897
chr17	NXN	805067	805247	0	181	74266	5509	74266	5328	0.0	13.938813813813814
chr17	ABR	1056034	1056109	794	76	29893	9793	29099	9717	10.447368421052632	2.9946485540804777
chr17	ABR	1100636	1100735	0	100	29893	9793	29893	9693	0.0	3.0839781285463737
chr17	ABR	1012473	1012557	0	85	29893	9793	29893	9708	0.0	3.0792130201895342
chr17	ABR	1177916	1178059	0	144	29893	9793	29893	9649	0.0	3.098041247797699
chr17	YWHAE	1361929	1362008	204	80	107963	2966	107759	2886	2.55	37.338530838530836
chr17	YWHAE	1369708	1369741	52	34	107963	2966	107911	2932	1.5294117647058822	36.80457025920873
chr17	YWHAE	1347961	1348008	0	48	107963	2966	107963	2918	0.0	36.99897189856066
chr17	YWHAE	1354210	1354347	127	138	107963	2966	107836	2828	0.9202898550724637	38.13154172560113
chr17	YWHAE	1364858	1365058	93	201	107963	2966	107870	2765	0.4626865671641791	39.0126582278481
chr17	MYO1C	1486951	1487098	307	148	30953	7816	30646	7668	2.074324324324324	3.99660928534168
chr17	INPP5K	1513452	1513561	0	110	34689	5034	34689	4924	0.0	7.044882209585703
chr17	INPP5K	1515426	1515585	51	160	34689	5034	34638	4874	0.31875	7.106688551497743
chr17	INPP5K	1515887	1516118	0	232	34689	5034	34689	4802	0.0	7.223865056226572
chr17	INPP5K	1513871	1513979	0	109	34689	5034	34689	4925	0.0	7.043451776649746
chr17	INPP5K	1513452	1513554	0	103	34689	5034	34689	4931	0.0	7.034881362806733
chr17	INPP5K	1515568	1515585	0	18	34689	5034	34689	5016	0.0	6.91566985645933
chr17	PITPNA	1543019	1543027	0	9	349330	4776	349330	4767	0.0	73.28088944829032
chr17	PITPNA	1558528	1558559	0	32	349330	4776	349330	4744	0.0	73.63617200674537
chr17	PITPNA	1541641	1541649	0	9	349330	4776	349330	4767	0.0	73.28088944829032
chr17	PITPNA	1535784	1535841	0	58	349330	4776	349330	4718	0.0	74.04196693514201
chr17	PITPNA	1541565	1541640	0	76	349330	4776	349330	4700	0.0	74.32553191489362
chr17	PITPNA	1561198	1561281	0	84	349330	4776	349330	4692	0.0	74.45225916453538
chr17	SLC43A2	1616561	1616769	7565	209	707300	10395	699735	10186	36.196172248803826	68.69575888474377
chr17	SLC43A2	1586948	1586960	9088	13	707300	10395	698212	10382	699.0769230769231	67.25216721248314
chr17	SLC43A2	1603104	1603207	51	104	707300	10395	707249	10291	0.49038461538461536	68.72500242930717
chr17	RILP	1646905	1646989	51	85	1694	1899	1643	1814	0.6	0.9057331863285557
chr17	PRPF8	1661610	1661790	0	181	284662	11016	284662	10835	0.0	26.272450392247347
chr17	PRPF8	1682128	1682293	1649	166	284662	11016	283013	10850	9.933734939759036	26.084147465437788
chr17	MIR22HG	1714370	1714453	0	84	3825	2975	3825	2891	0.0	1.3230716015219648
chr17	SMYD4	1814565	1814795	0	231	1229665	6812	1229665	6581	0.0	186.85078255584258
chr17	TSR1	2329342	2329475	319	134	227626	4816	227307	4682	2.3805970149253732	48.5491243058522
chr17	TSR1	2336036	2336140	0	105	227626	4816	227626	4711	0.0	48.317979197622584
chr17	METTL16	2467760	2467876	51	117	8249	5522	8198	5405	0.4358974358974359	1.5167437557816836
chr17	METTL16	2473523	2473664	0	142	8249	5522	8249	5380	0.0	1.533271375464684
chr17	METTL16	2502203	2502331	157	129	8249	5522	8092	5393	1.2170542635658914	1.5004635638791026
chr17	METTL16	2436673	2436840	0	168	8249	5522	8249	5354	0.0	1.5407172207695181
chr17	METTL16	2475240	2475299	0	60	8249	5522	8249	5462	0.0	1.5102526547052362
chr17	CLUH	2695373	2695526	19	154	530	6845	511	6691	0.12337662337662338	0.07637124495591092
chr17	OR3A2	3383803	3383899	0	97	0	2424	0	2327	0.0	0.0
chr17	SPATA22	3443173	3443271	0	99	114135	2625	114135	2526	0.0	45.18408551068884
chr17	SPATA22	3467425	3467554	153	130	114135	2625	113982	2495	1.176923076923077	45.684168336673345
chr17	SPATA22	3469282	3469398	19547	117	114135	2625	94588	2508	167.06837606837607	37.71451355661882
chr17	SPATA22	3467473	3467554	121	82	114135	2625	114014	2543	1.475609756097561	44.834447502949274
chr17	SPATA22	3467473	3467525	96	53	114135	2625	114039	2572	1.8113207547169812	44.338646967340594
chr17	SPATA22	3468834	3468897	10252	64	114135	2625	103883	2561	160.1875	40.56345177664975
chr17	TRPV3	3546644	3546804	0	161	469023	9617	469023	9456	0.0	49.60057106598985
chr17	TRPV3	3539568	3539645	18	78	469023	9617	469005	9539	0.23076923076923078	49.167103469965404
chr17	TRPV1	3588187	3588367	0	181	1027481	5538	1027481	5357	0.0	191.80156804181445
chr17	TRPV1	3608426	3608565	51	140	1027481	5538	1027430	5398	0.36428571428571427	190.33530937384216
chr17	TRPV1	3588931	3588964	0	34	1027481	5538	1027481	5504	0.0	186.67896075581396
chr17	TRPV1	3588217	3588367	0	151	1027481	5538	1027481	5387	0.0	190.73343233710784
chr17	TAX1BP3	3664194	3664272	0	79	51	1385	51	1306	0.0	0.03905053598774885
chr17	P2RX5	3681895	3681978	0	84	374	4040	374	3956	0.0	0.09453993933265925
chr17	P2RX5	3690955	3691027	0	73	374	4040	374	3967	0.0	0.09427779178220318
chr17	ITGAE	3723287	3723383	37	97	149683	6636	149646	6539	0.38144329896907214	22.885150634653616
chr17	ITGAE	3729477	3729555	5066	79	149683	6636	144617	6557	64.12658227848101	22.055360683239286
chr17	ITGAE	3732367	3732466	0	100	149683	6636	149683	6536	0.0	22.901315789473685
chr17	NCBP3	3824059	3824092	50	34	494	3296	444	3262	1.4705882352941178	0.13611281422440222
chr17	CAMKK1	3882256	3882370	0	115	1900	6843	1900	6728	0.0	0.28240190249702735
chr17	P2RX1	3915345	3915978	332	634	919	3958	587	3324	0.5236593059936908	0.17659446450060168
chr17	ATP2A3	3928226	3928327	6378	102	78618	6298	72240	6196	62.529411764705884	11.659134925758554
chr17	ATP2A3	3927980	3928038	0	59	78618	6298	78618	6239	0.0	12.601057861836832
chr17	ATP2A3	3928239	3928327	5088	89	78618	6298	73530	6209	57.168539325842694	11.842486712836205
chr17	ZZEF1	4056215	4056345	0	131	252132	14559	252132	14428	0.0	17.4751871361242
chr17	ZZEF1	4016632	4016774	0	143	252132	14559	252132	14416	0.0	17.489733629300776
chr17	ZZEF1	4071338	4071446	512	109	252132	14559	251620	14450	4.697247706422019	17.413148788927337
chr17	ANKFY1	4235771	4235890	816	120	139767	12045	138951	11925	6.8	11.652075471698113
chr17	UBE2G1	4296716	4296814	0	99	85593	4548	85593	4449	0.0	19.238705327039785
chr17	UBE2G1	4331773	4331888	0	116	85593	4548	85593	4432	0.0	19.3125
chr17	UBE2G1	4289229	4289408	0	180	85593	4548	85593	4368	0.0	19.595467032967033
chr17	MYBBP1A	4540347	4540484	0	138	51	5295	51	5157	0.0	0.009889470622454915
chr17	GGT6	4559342	4559456	0	115	153	1724	153	1609	0.0	0.09509011808576756
chr17	GGT6	4559342	4559438	0	97	153	1724	153	1627	0.0	0.0940381069452981
chr17	ALOX15	4638580	4638684	4590	105	22519	3401	17929	3296	43.714285714285715	5.439623786407767
chr17	PELP1	4683029	4683111	0	83	11311	6512	11311	6429	0.0	1.759371597449059
chr17	VMO1	4785936	4786052	586	117	2342	806	1756	689	5.0085470085470085	2.548621190130624
chr17	VMO1	4785900	4786052	867	153	2342	806	1475	653	5.666666666666667	2.258805513016845
chr17	VMO1	4785956	4786052	266	97	2342	806	2076	709	2.7422680412371134	2.928067700987306
chr17	SLC25A11	4939059	4939212	0	154	2078	1758	2078	1604	0.0	1.2955112219451372
chr17	CAMTA2	4973584	4973769	0	186	8848	5975	8848	5789	0.0	1.528415961305925
chr17	CAMTA2	4982088	4982227	0	140	8848	5975	8848	5835	0.0	1.5163667523564697
chr17	CAMTA2	4969499	4969520	0	22	8848	5975	8848	5953	0.0	1.4863094238199228
chr17	CAMTA2	4982088	4982160	0	73	8848	5975	8848	5902	0.0	1.4991528295493053
chr17	CAMTA2	4982088	4982175	0	88	8848	5975	8848	5887	0.0	1.502972651605232
chr17	CAMTA2	4986191	4986286	0	96	8848	5975	8848	5879	0.0	1.5050178601803028
chr17	INCA1	4995805	4995930	5128	126	25589	1562	20461	1436	40.698412698412696	14.248607242339833
chr17	SLC52A1	5033260	5033384	0	125	174	3938	174	3813	0.0	0.045633359559402044
chr17	ZNF232	5111075	5111219	26	145	3255	2800	3229	2655	0.1793103448275862	1.216195856873823
chr17	NUP88	5418014	5418116	1266	103	64318	4290	63052	4187	12.29126213592233	15.058992118461905
chr17	NUP88	5418014	5418141	1428	128	64318	4290	62890	4162	11.15625	15.110523786641037
chr17	DHX33	5455159	5455271	0	113	2217	5801	2217	5688	0.0	0.38976793248945146
chr17	DHX33	5463528	5463689	0	162	2217	5801	2217	5639	0.0	0.39315481468345453
chr17	DERL2	5481295	5481389	0	95	453	5129	453	5034	0.0	0.0899880810488677
chr17	DERL2	5480386	5480459	0	74	453	5129	453	5055	0.0	0.08961424332344213
chr17	DERL2	5480386	5480543	0	158	453	5129	453	4971	0.0	0.09112854556427279
chr17	NLRP1	5520880	5521012	0	133	153	11515	153	11382	0.0	0.013442277279915656
chr17	NLRP1	5536850	5536940	0	91	153	11515	153	11424	0.0	0.013392857142857142
chr17	AIPL1	6428317	6428506	472	190	1802	3150	1330	2960	2.4842105263157896	0.44932432432432434
chr17	AIPL1	6433918	6434098	0	181	1802	3150	1802	2969	0.0	0.6069383630852139
chr17	AIPL1	6433918	6434062	0	145	1802	3150	1802	3005	0.0	0.5996672212978369
chr17	AIPL1	6433918	6434032	0	115	1802	3150	1802	3035	0.0	0.5937397034596376
chr17	PITPNM3	6525355	6525463	0	109	27218	10693	27218	10584	0.0	2.57161753590325
chr17	KIAA0753	6611918	6612148	0	231	503	5573	503	5342	0.0	0.09415949082740546
chr17	KIAA0753	6624754	6624861	0	108	503	5573	503	5465	0.0	0.09204025617566332
chr17	KIAA0753	6635010	6635171	0	162	503	5573	503	5411	0.0	0.0929587876547773
chr17	KIAA0753	6635400	6635634	0	235	503	5573	503	5338	0.0	0.09423004870738104
chr17	MED31	6649981	6650078	0	98	0	2018	0	1920	0.0	0.0
chr17	SLC13A5	6687528	6687666	0	139	153	5209	153	5070	0.0	0.03017751479289941
chr17	SLC13A5	6707027	6707156	0	130	153	5209	153	5079	0.0	0.030124040165386886
chr17	SLC13A5	6707031	6707156	0	126	153	5209	153	5083	0.0	0.030100334448160536
chr17	SLC13A5	6707027	6707045	0	19	153	5209	153	5190	0.0	0.029479768786127167
chr17	SLC13A5	6707027	6707148	0	122	153	5209	153	5087	0.0	0.03007666601140161
chr17	TEKT1	6800746	6800943	0	198	714	3628	714	3430	0.0	0.20816326530612245
chr17	TEKT1	6819192	6819358	102	167	714	3628	612	3461	0.6107784431137725	0.17682750650101126
chr17	ALOX12-AS1	7009795	7009889	0	95	204	5591	204	5496	0.0	0.03711790393013101
chr17	ALOX12-AS1	7010058	7010137	0	80	204	5591	204	5511	0.0	0.037016875340228635
chr17	SLC16A11	7041995	7042763	0	769	132	1985	132	1216	0.0	0.10855263157894737
chr17	CLEC10A	7075359	7075466	0	108	5591	2340	5591	2232	0.0	2.504928315412186
chr17	ASGR1	7176829	7176901	0	73	255	2880	255	2807	0.0	0.09084431777698611
chr17	ASGR1	7177209	7177326	21	118	255	2880	234	2762	0.17796610169491525	0.08472121650977553
chr17	DLG4	7191892	7192002	3540	111	353209	9775	349669	9664	31.89189189189189	36.18263658940398
chr17	DLG4	7208173	7208239	0	67	353209	9775	353209	9708	0.0	36.383292130201895
chr17	DLG4	7208074	7208239	0	166	353209	9775	353209	9609	0.0	36.7581434072224
chr17	PHF23	7237628	7237660	0	33	357	2660	357	2627	0.0	0.1358964598401218
chr17	GABARAP	7241600	7241679	0	80	0	1609	0	1529	0.0	0.0
chr17	CTDNEP1	7246790	7246862	0	73	7204	2647	7204	2574	0.0	2.798756798756799
chr17	CTDNEP1	7251194	7251601	4694	408	7204	2647	2510	2239	11.504901960784315	1.1210361768646717
chr17	CLDN7	7260641	7260726	0	86	0	2285	0	2199	0.0	0.0
chr17	GPS2	7313905	7313988	1748	84	60351	2507	58603	2423	20.80952380952381	24.186132893107718
chr17	NEURL4	7327164	7327230	34	67	827625	6057	827591	5990	0.5074626865671642	138.16210350584308
chr17	PLSCR3	7393143	7393364	86	222	1073	2551	987	2329	0.38738738738738737	0.42378703306139975
chr17	PLSCR3	7393600	7393836	0	237	1073	2551	1073	2314	0.0	0.4636992221261884
chr17	TMEM256-PLSCR3	7403309	7403390	15	82	45855	2568	45840	2486	0.18292682926829268	18.439259855189057
chr17	SAT2	7626942	7627044	0	103	50	1405	50	1302	0.0	0.03840245775729647
chr17	SAT2	7627142	7627226	0	85	50	1405	50	1320	0.0	0.03787878787878788
chr17	TP53	7674858	7674971	0	114	0	5536	0	5422	0.0	0.0
chr17	TP53	7675993	7676272	0	280	0	5536	0	5256	0.0	0.0
chr17	TP53	7673206	7673266	0	61	0	5536	0	5475	0.0	0.0
chr17	TP53	7670608	7670715	0	108	0	5536	0	5428	0.0	0.0
chr17	TP53	7673206	7673339	0	134	0	5536	0	5402	0.0	0.0
chr17	TP53	7677324	7677427	0	104	0	5536	0	5432	0.0	0.0
chr17	KCNAB3	7925096	7925183	0	88	17927	4331	17927	4243	0.0	4.225076596747584
chr17	KCNAB3	7925309	7925501	0	193	17927	4331	17927	4138	0.0	4.332286128564524
chr17	TRAPPC1	7931505	7931576	0	72	0	1175	0	1103	0.0	0.0
chr17	ALOX12B	8079395	8079539	15196	145	104748	2762	89552	2617	104.8	34.219335116545665
chr17	HES7	8123319	8123505	561	187	1871	906	1310	719	3.0	1.8219749652294854
chr17	PER1	8143265	8143876	612	612	54371	6344	53759	5732	1.0	9.378750872295882
chr17	PER1	8145957	8146137	311	181	54371	6344	54060	6163	1.718232044198895	8.77170209313646
chr17	PER1	8146896	8147002	0	107	54371	6344	54371	6237	0.0	8.717492384159051
chr17	PER1	8150218	8150317	102	100	54371	6344	54269	6244	1.02	8.691383728379243
chr17	PER1	8153929	8153980	239	52	54371	6344	54132	6292	4.596153846153846	8.603305785123966
chr17	TMEM107	8175958	8176026	0	69	630460	3772	630460	3703	0.0	170.2565487442614
chr17	AURKB	8210176	8210249	0	74	1158	2119	1158	2045	0.0	0.5662591687041565
chr17	AURKB	8206749	8206934	0	186	1158	2119	1158	1933	0.0	0.5990688049663735
chr17	AURKB	8210176	8210225	0	50	1158	2119	1158	2069	0.0	0.5596906718221363
chr17	AURKB	8209953	8210055	0	103	1158	2119	1158	2016	0.0	0.5744047619047619
chr17	CTC1	8229141	8229206	0	66	768	8044	768	7978	0.0	0.09626472800200551
chr17	CTC1	8231275	8231469	0	195	768	8044	768	7849	0.0	0.09784685947254428
chr17	CTC1	8242984	8243148	0	165	768	8044	768	7879	0.0	0.0974742987688793
chr17	CTC1	8228726	8228892	0	167	768	8044	768	7877	0.0	0.09749904786086074
chr17	CTC1	8233362	8233456	0	95	768	8044	768	7949	0.0	0.0966159265316392
chr17	SLC25A35	8290602	8290678	0	77	4291	3447	4291	3370	0.0	1.273293768545994
chr17	SLC25A35	8290614	8290678	0	65	4291	3447	4291	3382	0.0	1.268775872264932
chr17	KRBA2	8371308	8372081	71636	774	427112	13409	355476	12635	92.55297157622739	28.134230312623664
chr17	RPL26	8380586	8380703	1175	118	52968	2188	51793	2070	9.957627118644067	25.020772946859903
chr17	MYH10	8576642	8576669	0	28	4033	9053	4033	9025	0.0	0.4468698060941828
chr17	MYH10	8530622	8530685	510	64	4033	9053	3523	8989	7.96875	0.39192346200912226
chr17	MYH10	8576642	8576672	0	31	4033	9053	4033	9022	0.0	0.4470183994679672
chr17	MYH10	8623423	8623497	0	75	4033	9053	4033	8978	0.0	0.4492091779906438
chr17	CCDC42	8735389	8735611	0	223	25	1716	25	1493	0.0	0.016744809109176157
chr17	PIK3R6	8832888	8833045	0	158	207	3586	207	3428	0.0	0.06038506417736289
chr17	PIK3R6	8803661	8803802	0	142	207	3586	207	3444	0.0	0.06010452961672474
chr17	PIK3R5	8911391	8911507	0	117	113	7453	113	7336	0.0	0.015403489640130861
chr17	PIK3R5	8889972	8890126	0	155	113	7453	113	7298	0.0	0.015483694162784325
chr17	PIK3R5	8890737	8890912	0	176	113	7453	113	7277	0.0	0.015528377078466401
chr17	STX8	9568370	9568470	0	101	1059	2932	1059	2831	0.0	0.3740727658071353
chr17	STX8	9505037	9505162	0	126	1059	2932	1059	2806	0.0	0.3774055595153243
chr17	DHRS7C	9772766	9772922	0	157	0	1307	0	1150	0.0	0.0
chr17	GAS7	9969676	9969762	0	87	55	3981	55	3894	0.0	0.014124293785310734
chr17	GAS7	10027019	10027099	0	81	55	3981	55	3900	0.0	0.014102564102564103
chr17	MYH13	10371208	10371259	0	52	0	6161	0	6109	0.0	0.0
chr17	SCO1	10691589	10691649	0	61	62	10307	62	10246	0.0	0.006051141909037674
chr17	TMEM220	10723269	10723329	0	61	612	3223	612	3162	0.0	0.1935483870967742
chr17	TMEM220	10729030	10729060	0	31	612	3223	612	3192	0.0	0.19172932330827067
chr17	TMEM220	10724454	10724502	0	49	612	3223	612	3174	0.0	0.19281663516068054
chr17	ZNF18	11983296	11983407	0	112	127	2988	127	2876	0.0	0.04415855354659249
chr17	ZNF18	11983296	11983404	0	109	127	2988	127	2879	0.0	0.04411253907606808
chr17	ZNF18	11993501	11993654	0	154	127	2988	127	2834	0.0	0.04481298517995766
chr17	ELAC2	13011662	13011782	0	121	0	6704	0	6583	0.0	0.0
chr17	ELAC2	13014438	13014496	0	59	0	6704	0	6645	0.0	0.0
chr17	LINC02093	13303151	13303270	0	120	0	621	0	501	0.0	0.0
chr17	COX10-AS1	14033551	14033661	0	111	0	11234	0	11123	0.0	0.0
chr17	AC005863.1	14776732	14776885	0	154	0	3446	0	3292	0.0	0.0
chr17	PMP22	15239470	15239611	0	142	582	6135	582	5993	0.0	0.09711329884865677
chr17	PMP22	15260649	15260761	0	113	582	6135	582	6022	0.0	0.0966456326801727
chr17	PMP22	15233188	15233355	0	168	582	6135	582	5967	0.0	0.09753645047762695
chr17	PMP22	15253452	15253554	0	103	582	6135	582	6032	0.0	0.09648541114058355
chr17	PMP22	15232368	15232613	0	246	582	6135	582	5889	0.0	0.09882832399388691
chr17	PMP22	15259093	15259193	0	101	582	6135	582	6034	0.0	0.09645343056015909
chr17	PMP22	15239470	15239600	0	131	582	6135	582	6004	0.0	0.09693537641572285
chr17	PMP22	15260649	15260757	0	109	582	6135	582	6026	0.0	0.0965814802522403
chr17	PMP22	15260649	15260983	0	335	582	6135	582	5800	0.0	0.1003448275862069
chr17	PMP22	15235218	15235284	0	67	582	6135	582	6068	0.0	0.09591298615688859
chr17	TEKT3	15340027	15340061	5372	35	9750	2613	4378	2578	153.4857142857143	1.6982156710628393
chr17	TEKT3	15310872	15311012	0	141	9750	2613	9750	2472	0.0	3.9441747572815533
chr17	TEKT3	15340421	15340519	2048	99	9750	2613	7702	2514	20.68686868686869	3.0636435958631663
chr17	TVP23C	15553684	15553829	102	146	40755	5447	40653	5301	0.6986301369863014	7.66893039049236
chr17	TVP23C	15540432	15540561	0	130	40755	5447	40755	5317	0.0	7.665036674816626
chr17	TVP23C	15553764	15553829	102	66	40755	5447	40653	5381	1.5454545454545454	7.554915443226166
chr17	CDRT4	15440207	15440285	918	79	30239	3262	29321	3183	11.620253164556962	9.211749921457745
chr17	TRIM16	15632508	15632674	0	167	2054	4831	2054	4664	0.0	0.4403945111492281
chr17	TRIM16	15651090	15651946	0	857	2054	4831	2054	3974	0.0	0.5168595873175642
chr17	TRIM16	15682853	15682951	0	99	2054	4831	2054	4732	0.0	0.4340659340659341
chr17	TRIM16	15677574	15677721	0	148	2054	4831	2054	4683	0.0	0.4386077300875507
chr17	TRIM16	15631618	15631714	0	97	2054	4831	2054	4734	0.0	0.43388255175327417
chr17	TRIM16	15658801	15658876	0	76	2054	4831	2054	4755	0.0	0.4319663512092534
chr17	TRIM16	15682860	15682951	0	92	2054	4831	2054	4739	0.0	0.43342477315889427
chr17	ZSWIM7	15993756	15993778	391	23	6749	2082	6358	2059	17.0	3.087906750849927
chr17	ZSWIM7	15977578	15977913	0	336	6749	2082	6749	1746	0.0	3.8654066437571593
chr17	ZSWIM7	15981039	15981144	102	106	6749	2082	6647	1976	0.9622641509433962	3.3638663967611335
chr17	ZSWIM7	15986799	15986886	0	88	6749	2082	6749	1994	0.0	3.384653961885657
chr17	ZSWIM7	15990864	15991104	0	241	6749	2082	6749	1841	0.0	3.665942422596415
chr17	ZSWIM7	15986799	15986892	0	94	6749	2082	6749	1988	0.0	3.3948692152917506
chr17	NCOR1	16087171	16087345	0	175	56884	14501	56884	14326	0.0	3.9706826748569037
chr17	NCOR1	16151589	16151616	84	28	56884	14501	56800	14473	3.0	3.9245491605057694
chr17	NCOR1	16198600	16198719	0	120	56884	14501	56884	14381	0.0	3.9554968361031917
chr17	CENPV	16349139	16349333	1683	195	1947190	1849	1945507	1654	8.63076923076923	1176.2436517533254
chr17	LRRC75A	16447844	16447960	0	117	5320	3740	5320	3623	0.0	1.4683963566105438
chr17	ZNF287	16568042	16568117	0	76	7854	7922	7854	7846	0.0	1.0010196278358399
chr17	KRT17P4	16848999	16849077	0	79	0	2302	0	2223	0.0	0.0
chr17	TBC1D27P	16928791	16928876	0	86	0	4955	0	4869	0.0	0.0
chr17	TNFRSF13B	16952445	16952583	0	139	1977	3037	1977	2898	0.0	0.6821946169772257
chr17	COPS3	17247479	17247560	714	82	2413	2898	1699	2816	8.707317073170731	0.6033380681818182
chr17	COPS3	17260300	17260474	0	175	2413	2898	2413	2723	0.0	0.8861549761292692
chr17	COPS3	17264801	17264981	0	181	2413	2898	2413	2717	0.0	0.8881118881118881
chr17	COPS3	17270757	17270807	0	51	2413	2898	2413	2847	0.0	0.8475588338602037
chr17	COPS3	17276034	17276164	0	131	2413	2898	2413	2767	0.0	0.8720636067943621
chr17	COPS3	17276034	17276183	0	150	2413	2898	2413	2748	0.0	0.8780931586608443
chr17	COPS3	17261599	17261692	0	94	2413	2898	2413	2804	0.0	0.8605563480741797
chr17	PEMT	17522279	17522395	0	117	279	1735	279	1618	0.0	0.17243510506798518
chr17	PEMT	17507168	17507202	35	35	279	1735	244	1700	1.0	0.14352941176470588
chr17	PEMT	17507168	17507199	32	32	279	1735	247	1703	1.0	0.1450381679389313
chr17	PEMT	17512508	17512654	0	147	279	1735	279	1588	0.0	0.1756926952141058
chr17	PEMT	17565250	17565306	0	57	279	1735	279	1678	0.0	0.16626936829559
chr17	SREBF1	17813367	17813479	628	113	9822	6629	9194	6516	5.557522123893805	1.410988336402701
chr17	SREBF1	17814614	17814747	105	134	9822	6629	9717	6495	0.7835820895522388	1.4960739030023096
chr17	SREBF1	17817547	17817591	34	45	9822	6629	9788	6584	0.7555555555555555	1.4866342648845687
chr17	SREBF1	17823517	17823607	412	91	9822	6629	9410	6538	4.527472527472527	1.4392780666870602
chr17	TOM1L2	17850892	17850952	0	61	16666	7882	16666	7821	0.0	2.1309295486510678
chr17	TOM1L2	17882704	17882863	0	160	16666	7882	16666	7722	0.0	2.1582491582491583
chr17	TOM1L2	17884633	17884768	16	136	16666	7882	16650	7746	0.11764705882352941	2.149496514329977
chr17	TOM1L2	17893660	17893810	0	151	16666	7882	16666	7731	0.0	2.1557366446772734
chr17	TOM1L2	17857768	17857855	0	88	16666	7882	16666	7794	0.0	2.138311521683346
chr17	ATPAF2	18021122	18021238	0	117	57	5022	57	4905	0.0	0.011620795107033639
chr17	ATPAF2	18021744	18021857	0	114	57	5022	57	4908	0.0	0.011613691931540342
chr17	ATPAF2	18028231	18028377	0	147	57	5022	57	4875	0.0	0.011692307692307693
chr17	FLII	18245743	18245850	46	108	158013	5686	157967	5578	0.42592592592592593	28.31964861957691
chr17	FLII	18253543	18253719	561	177	158013	5686	157452	5509	3.169491525423729	28.58086767108368
chr17	FLII	18254520	18254682	0	163	158013	5686	158013	5523	0.0	28.609994568169473
chr17	FLII	18254520	18254619	0	100	158013	5686	158013	5586	0.0	28.28732545649839
chr17	FLII	18253598	18253719	330	122	158013	5686	157683	5564	2.7049180327868854	28.339863407620417
chr17	TOP3A	18292644	18292852	0	209	3960	5240	3960	5031	0.0	0.7871198568872988
chr17	TOP3A	18305111	18305220	0	110	3960	5240	3960	5130	0.0	0.7719298245614035
chr17	TOP3A	18308350	18308424	4	75	3960	5240	3956	5165	0.05333333333333334	0.7659244917715392
chr17	TOP3A	18308881	18308941	0	61	3960	5240	3960	5179	0.0	0.7646263757482139
chr17	TOP3A	18308312	18308424	80	113	3960	5240	3880	5127	0.7079646017699115	0.7567778427930564
chr17	SHMT1	18335558	18335675	0	118	561	4817	561	4699	0.0	0.11938710363907214
chr17	SHMT1	18348324	18348440	0	117	561	4817	561	4700	0.0	0.11936170212765958
chr17	SHMT1	18360413	18360552	0	140	561	4817	561	4677	0.0	0.11994868505452214
chr17	NOS2P2	18499195	18499388	0	194	192	1981	192	1787	0.0	0.10744264129826525
chr17	NOS2P2	18500914	18501036	0	123	192	1981	192	1858	0.0	0.10333692142088267
chr17	FAM106A	18532711	18532902	0	192	5982	8673	5982	8481	0.0	0.7053413512557482
chr17	FAM106A	18521078	18521145	142	68	5982	8673	5840	8605	2.088235294117647	0.6786751888436955
chr17	FAM106A	18523776	18523877	0	102	5982	8673	5982	8571	0.0	0.6979348967448372
chr17	USP32P2	18516524	18516617	280	94	5184	5285	4904	5191	2.978723404255319	0.9447120015411289
chr17	FAM106A	18527569	18527760	0	192	5982	8673	5982	8481	0.0	0.7053413512557482
chr17	FAM106A	18528572	18528747	448	176	5982	8673	5534	8497	2.5454545454545454	0.6512886901259268
chr17	FAM106A	18542868	18542987	0	120	5982	8673	5982	8553	0.0	0.6994037179936864
chr17	FAM106A	18532505	18532597	0	93	5982	8673	5982	8580	0.0	0.6972027972027972
chr17	FAM106A	18523650	18523877	0	228	5982	8673	5982	8445	0.0	0.708348134991119
chr17	FAM106A	18524142	18524400	0	259	5982	8673	5982	8414	0.0	0.7109579272640837
chr17	FAM106A	18542987	18543094	0	108	5982	8673	5982	8565	0.0	0.6984238178633976
chr17	CCDC144B	18577939	18578077	110	139	148823	9924	148713	9785	0.7913669064748201	15.198058252427185
chr17	TBC1D28	18642585	18642632	0	48	130498	4165	130498	4117	0.0	31.697352441097888
chr17	GRAP	19024214	19024383	102	170	612	2505	510	2335	0.6	0.21841541755888652
chr17	GRAP	19030375	19030443	0	69	612	2505	612	2436	0.0	0.2512315270935961
chr17	B9D1	19343789	19343857	0	69	116	6772	116	6703	0.0	0.017305684022079666
chr17	B9D1	19357571	19357634	0	64	116	6772	116	6708	0.0	0.0172927847346452
chr17	B9D1	19340104	19340109	0	6	116	6772	116	6766	0.0	0.017144546260715342
chr17	AC004448.2	19453584	19453660	0	77	3140	4848	3140	4771	0.0	0.6581429469712848
chr17	AC004448.2	19455867	19456005	0	139	3140	4848	3140	4709	0.0	0.6668082395413039
chr17	SLC47A2	19703091	19703167	0	77	131138	5723	131138	5646	0.0	23.226709174636913
chr17	SLC47A2	19704652	19704694	342	43	131138	5723	130796	5680	7.953488372093023	23.027464788732395
chr17	ALDH3A1	19738995	19739095	0	101	2101	3484	2101	3383	0.0	0.621046408513154
chr17	ALDH3A1	19744967	19745134	1479	168	2101	3484	622	3316	8.803571428571429	0.1875753920386007
chr17	ULK2	19785936	19786086	51	151	30015	9898	29964	9747	0.33774834437086093	3.0741766697445367
chr17	ULK2	19816748	19816920	0	173	30015	9898	30015	9725	0.0	3.086375321336761
chr17	ULK2	19826138	19826186	0	49	30015	9898	30015	9849	0.0	3.047517514468474
chr17	ULK2	19785936	19786005	0	70	30015	9898	30015	9828	0.0	3.054029304029304
chr17	ULK2	19848254	19848344	0	91	30015	9898	30015	9807	0.0	3.060568981339859
chr17	ULK2	19860940	19861055	0	116	30015	9898	30015	9782	0.0	3.0683909221018197
chr17	AKAP10	19924407	19924517	0	111	8140	4590	8140	4479	0.0	1.817369948649252
chr17	AKAP10	19931804	19931978	0	175	8140	4590	8140	4415	0.0	1.8437146092865233
chr17	AKAP10	19940886	19941010	51	125	8140	4590	8089	4465	0.408	1.8116461366181411
chr17	AKAP10	19924407	19924512	0	106	8140	4590	8140	4484	0.0	1.815343443354148
chr17	AKAP10	19967918	19968034	0	117	8140	4590	8140	4473	0.0	1.819807735300693
chr17	LGALS9B	20460351	20460443	0	93	0	2682	0	2589	0.0	0.0
chr17	LGALS9B	20457377	20457563	0	187	0	2682	0	2495	0.0	0.0
chr17	LINC02693	21573225	21573735	0	511	1309	11034	1309	10523	0.0	0.12439418416801293
chr17	LINC02693	21533391	21533510	0	120	1309	11034	1309	10914	0.0	0.11993769470404984
chr17	LINC02693	21550995	21551116	0	122	1309	11034	1309	10912	0.0	0.11995967741935484
chr17	LINC02693	21546705	21546799	0	95	1309	11034	1309	10939	0.0	0.11966358899350946
chr17	LINC02002	22241265	22241508	381	244	432	1721	51	1477	1.5614754098360655	0.034529451591062965
chr17	LINC02002	22245825	22245930	0	106	432	1721	432	1615	0.0	0.2674922600619195
chr17	LINC02002	22241265	22241505	381	241	432	1721	51	1480	1.5809128630705394	0.03445945945945946
chr17	LINC02002	22254345	22254489	0	145	432	1721	432	1576	0.0	0.27411167512690354
chr17	LINC02002	22240991	22241162	51	172	432	1721	381	1549	0.29651162790697677	0.2459651387992253
chr17	LYRM9	27880120	27880183	0	64	77701	3560	77701	3496	0.0	22.225686498855836
chr17	LINC01992	27988764	27988870	0	107	36680	3413	36680	3306	0.0	11.094978826376286
chr17	IFT20	28332145	28332181	0	37	0	2307	0	2270	0.0	0.0
chr17	IFT20	28329172	28329276	0	105	0	2307	0	2202	0.0	0.0
chr17	IFT20	28330110	28330228	0	119	0	2307	0	2188	0.0	0.0
chr17	IFT20	28332145	28332382	0	238	0	2307	0	2069	0.0	0.0
chr17	IFT20	28332689	28332723	0	35	0	2307	0	2272	0.0	0.0
chr17	SLC46A1	28402237	28402321	0	85	65996	7870	65996	7785	0.0	8.47732819524727
chr17	SLC46A1	28400609	28400766	0	158	65996	7870	65996	7712	0.0	8.557572614107883
chr17	SLC46A1	28405886	28405997	0	112	65996	7870	65996	7758	0.0	8.506831657643723
chr17	PIGS	28561421	28561629	0	209	0	4809	0	4600	0.0	0.0
chr17	PIGS	28570851	28570963	0	113	0	4809	0	4696	0.0	0.0
chr17	PIGS	28571048	28571188	0	141	0	4809	0	4668	0.0	0.0
chr17	ALDOC	28574493	28574577	0	85	128048	2363	128048	2278	0.0	56.210711150131694
chr17	ALDOC	28575964	28576020	10687	57	128048	2363	117361	2306	187.49122807017545	50.8937554206418
chr17	ALDOC	28575964	28576017	10003	54	128048	2363	118045	2309	185.24074074074073	51.12386314421828
chr17	SPAG5	28584651	28584745	0	95	2822	4721	2822	4626	0.0	0.6100302637267618
chr17	SPAG5	28585533	28585653	0	121	2822	4721	2822	4600	0.0	0.6134782608695653
chr17	SPAG5	28582726	28582819	0	94	2822	4721	2822	4627	0.0	0.6098984223038686
chr17	KIAA0100	28616888	28616999	0	112	113382	9105	113382	8993	0.0	12.607806071388858
chr17	KIAA0100	28643609	28643659	0	51	113382	9105	113382	9054	0.0	12.52286282306163
chr17	SDF2	28655286	28655483	0	198	153	2825	153	2627	0.0	0.05824133993148078
chr17	SDF2	28651485	28651542	0	58	153	2825	153	2767	0.0	0.05529454282616552
chr17	SDF2	28651485	28651577	0	93	153	2825	153	2732	0.0	0.05600292825768668
chr17	PROCA1	28706679	28706763	6196	85	7202	3553	1006	3468	72.89411764705882	0.290080738177624
chr17	RAB34	28715992	28716061	0	70	1224	3005	1224	2935	0.0	0.4170357751277683
chr17	RAB34	28715992	28716058	0	67	1224	3005	1224	2938	0.0	0.41660993873383256
chr17	RAB34	28716902	28716994	0	93	1224	3005	1224	2912	0.0	0.42032967032967034
chr17	FAM222B	28790377	28790425	0	49	12387	5523	12387	5474	0.0	2.262879064669346
chr17	FAM222B	28834292	28834326	238	35	12387	5523	12149	5488	6.8	2.2137390670553936
chr17	FAM222B	28777047	28777149	0	103	12387	5523	12387	5420	0.0	2.2854243542435424
chr17	FAM222B	28761985	28762156	0	172	12387	5523	12387	5351	0.0	2.314894412259391
chr17	FLOT2	28885611	28885685	0	75	0	3397	0	3322	0.0	0.0
chr17	FLOT2	28888944	28889026	0	83	0	3397	0	3314	0.0	0.0
chr17	FLOT2	28884224	28884315	0	92	0	3397	0	3305	0.0	0.0
chr17	FLOT2	28885856	28885947	0	92	0	3397	0	3305	0.0	0.0
chr17	PHF12	28919142	28919275	0	134	9036	6230	9036	6096	0.0	1.4822834645669292
chr17	PHF12	28923908	28924302	714	395	9036	6230	8322	5835	1.8075949367088608	1.4262210796915167
chr17	PHF12	28911329	28911384	0	56	9036	6230	9036	6174	0.0	1.4635568513119535
chr17	SEZ6	28956718	28956757	399	40	89425	4750	89026	4710	9.975	18.90148619957537
chr17	MYO18A	29085603	29085648	203	46	160023	15087	159820	15041	4.413043478260869	10.625623296323383
chr17	MYO18A	29093979	29094090	357	112	160023	15087	159666	14975	3.1875	10.662170283806343
chr17	MYO18A	29086437	29086577	12941	141	160023	15087	147082	14946	91.78014184397163	9.840893884651411
chr17	MYO18A	29137015	29137084	16	70	160023	15087	160007	15017	0.22857142857142856	10.655057601385097
chr17	MYO18A	29079726	29081000	1416	1275	160023	15087	158607	13812	1.1105882352941177	11.483275412684621
chr17	MYO18A	29124652	29124688	62	37	160023	15087	159961	15050	1.6756756756756757	10.628637873754153
chr17	NUFIP2	29285991	29287716	1173	1726	3876	10881	2703	9155	0.6796060254924682	0.29524849808847625
chr17	GIT1	29578961	29578988	0	28	6619	5400	6619	5372	0.0	1.2321295606850335
chr17	CORO6	29617499	29617619	0	121	1112	4103	1112	3982	0.0	0.2792566549472627
chr17	CORO6	29621223	29621423	0	201	1112	4103	1112	3902	0.0	0.2849820604818042
chr17	CORO6	29617241	29617340	0	100	1112	4103	1112	4003	0.0	0.27779165625780666
chr17	CORO6	29618047	29618167	0	121	1112	4103	1112	3982	0.0	0.2792566549472627
chr17	CORO6	29621223	29621484	0	262	1112	4103	1112	3841	0.0	0.2895079406404582
chr17	SSH2	29848848	29848929	0	82	22548	7664	22548	7582	0.0	2.9738855183328936
chr17	SLC6A4	30209142	30209242	0	101	96163	6998	96163	6897	0.0	13.94272872263303
chr17	SLC6A4	30222818	30222915	81	98	96163	6998	96082	6900	0.826530612244898	13.924927536231884
chr17	BLMH	30289372	30289482	8	111	3570	5133	3562	5022	0.07207207207207207	0.7092791716447631
chr17	TMIGD1	30318809	30318913	0	105	3118	1235	3118	1130	0.0	2.75929203539823
chr17	CRLF3	30803900	30804108	2506	209	48117	2781	45611	2572	11.990430622009569	17.73367029548989
chr17	AC134669.1	31307886	31307959	0	74	0	1247	0	1173	0.0	0.0
chr17	AC134669.1	31313978	31314044	0	67	0	1247	0	1180	0.0	0.0
chr17	EVI2A	31320372	31320513	0	142	102	3090	102	2948	0.0	0.03459972862957938
chr17	COPRS	31856798	31856865	0	68	0	1318	0	1250	0.0	0.0
chr17	COPRS	31856564	31856711	0	148	0	1318	0	1170	0.0	0.0
chr17	UTP6	31865365	31865438	0	74	0	6216	0	6142	0.0	0.0
chr17	UTP6	31866654	31866715	0	62	0	6216	0	6154	0.0	0.0
chr17	C17ORF75	32333416	32333520	0	105	0	5756	0	5651	0.0	0.0
chr17	MYO1D	32745521	32745689	0	169	0	8223	0	8054	0.0	0.0
chr17	CCT6B	34958559	34958694	10998	136	112535	4148	101537	4012	80.86764705882354	25.308325024925225
chr17	CCT6B	34942795	34942906	4136	112	112535	4148	108399	4036	36.92857142857143	26.85802775024777
chr17	RFFL	35014739	35014763	0	25	0	6708	0	6683	0.0	0.0
chr17	RFFL	35017522	35017606	0	85	0	6708	0	6623	0.0	0.0
chr17	RFFL	35021370	35021781	0	412	0	6708	0	6296	0.0	0.0
chr17	RFFL	35069293	35069658	0	366	0	6708	0	6342	0.0	0.0
chr17	RFFL	35036337	35036518	0	182	0	6708	0	6526	0.0	0.0
chr17	RAD51D	35107365	35107447	0	83	0	11317	0	11234	0.0	0.0
chr17	RFFL	35025182	35025340	0	159	0	6708	0	6549	0.0	0.0
chr17	RAD51D	35106987	35107122	0	136	0	11317	0	11181	0.0	0.0
chr17	RAD51D	35118500	35118619	0	120	0	11317	0	11197	0.0	0.0
chr17	RAD51D	35106127	35106249	0	123	0	11317	0	11194	0.0	0.0
chr17	RAD51D	35116858	35117037	0	180	0	11317	0	11137	0.0	0.0
chr17	RAD51D	35106987	35107061	0	75	0	11317	0	11242	0.0	0.0
chr17	NLE1	35137542	35137640	0	99	0	5488	0	5389	0.0	0.0
chr17	NLE1	35139848	35140066	0	219	0	5488	0	5269	0.0	0.0
chr17	NLE1	35134942	35135059	0	118	0	5488	0	5370	0.0	0.0
chr17	NLE1	35139819	35140066	0	248	0	5488	0	5240	0.0	0.0
chr17	SLFN11	35366946	35367043	77	98	587	4258	510	4160	0.7857142857142857	0.12259615384615384
chr17	SLFN11	35367602	35367700	0	99	587	4258	587	4159	0.0	0.1411396970425583
chr17	SLFN11	35366946	35367063	77	118	587	4258	510	4140	0.652542372881356	0.12318840579710146
chr17	SLFN11	35367649	35367700	0	52	587	4258	587	4206	0.0	0.1395625297194484
chr17	SLFN11	35367540	35367700	0	161	587	4258	587	4097	0.0	0.14327556748840614
chr17	SLFN12	35430470	35430592	0	123	3162	3433	3162	3310	0.0	0.9552870090634441
chr17	SLFN12	35432187	35432257	51	71	3162	3433	3111	3362	0.7183098591549296	0.9253420582986318
chr17	SLFN12	35430470	35430613	0	144	3162	3433	3162	3289	0.0	0.9613864396473092
chr17	SLFN13	35446716	35446753	306	38	39566	9056	39260	9018	8.052631578947368	4.353515191838545
chr17	SLFN13	35445372	35445693	0	322	39566	9056	39566	8734	0.0	4.530112205175177
chr17	SLFN13	35445655	35445693	0	39	39566	9056	39566	9017	0.0	4.387933902628369
chr17	SLFN13	35446839	35446932	0	94	39566	9056	39566	8962	0.0	4.4148627538495875
chr17	MMP28	35766196	35766894	25017	699	30804	3200	5787	2501	35.78969957081545	2.3138744502199122
chr17	MMP28	35773179	35773404	0	226	30804	3200	30804	2974	0.0	10.357767316745125
chr17	MMP28	35766972	35767035	1289	64	30804	3200	29515	3136	20.140625	9.411670918367347
chr17	CCL5	35875560	35875642	294	83	43515	1504	43221	1421	3.5421686746987953	30.415904292751584
chr17	RDM1	35924603	35924772	0	170	2676	1650	2676	1480	0.0	1.808108108108108
chr17	RDM1	35930075	35930255	0	181	2676	1650	2676	1469	0.0	1.8216473791695031
chr17	RDM1	35922576	35922675	0	100	2676	1650	2676	1550	0.0	1.726451612903226
chr17	RDM1	35920186	35920272	0	87	2676	1650	2676	1563	0.0	1.7120921305182342
chr17	CCL14	35985747	35985795	0	49	5370	1206	5370	1157	0.0	4.641313742437338
chr17	TBC1D3B	36174406	36174629	0	224	102	2860	102	2636	0.0	0.038694992412746584
chr17	MYO19	36515112	36515182	153	71	13363	11489	13210	11418	2.1549295774647885	1.1569451742862147
chr17	MYO19	36501851	36501961	0	111	13363	11489	13363	11378	0.0	1.1744594832132185
chr17	MYO19	36501851	36501901	0	51	13363	11489	13363	11438	0.0	1.1682986536107711
chr17	MYO19	36512657	36512779	165	123	13363	11489	13198	11366	1.3414634146341464	1.1611824740453986
chr17	MYO19	36533159	36533423	2376	265	13363	11489	10987	11224	8.966037735849056	0.9788845331432644
chr17	ACACA	37151300	37151421	0	122	513100	11022	513100	10900	0.0	47.07339449541284
chr17	ACACA	37179259	37179406	0	148	513100	11022	513100	10874	0.0	47.18594813316167
chr17	ACACA	37210466	37210490	0	25	513100	11022	513100	10997	0.0	46.65817950350095
chr17	ACACA	37289417	37289528	0	112	513100	11022	513100	10910	0.0	47.03024747937672
chr17	ACACA	37345252	37345382	0	131	513100	11022	513100	10891	0.0	47.11229455513727
chr17	SYNRG	37520178	37520214	0	37	17679	8725	17679	8688	0.0	2.034875690607735
chr17	SYNRG	37570636	37570885	0	250	17679	8725	17679	8475	0.0	2.086017699115044
chr17	SYNRG	37577379	37577613	0	235	17679	8725	17679	8490	0.0	2.0823321554770318
chr17	SYNRG	37529782	37529851	0	70	17679	8725	17679	8655	0.0	2.04263431542461
chr17	SYNRG	37577446	37577613	0	168	17679	8725	17679	8557	0.0	2.066027813486035
chr17	DDX52	37633287	37633418	43	132	3308	8334	3265	8202	0.32575757575757575	0.3980736405754694
chr17	DDX52	37639453	37639568	2	116	3308	8334	3306	8218	0.017241379310344827	0.40228766123144316
chr17	DDX52	37635550	37635604	0	55	3308	8334	3308	8279	0.0	0.3995651648749849
chr17	HNF1B	37699075	37699194	0	120	15474	2777	15474	2657	0.0	5.823861497929996
chr17	HNF1B	37700982	37701177	0	196	15474	2777	15474	2581	0.0	5.995350639287098
chr17	AC244153.1	38451305	38451393	0	89	25668	1252	25668	1163	0.0	22.070507308684437
chr17	SRCIN1	38568210	38568234	0	25	207298	11692	207298	11667	0.0	17.767892345932975
chr17	SRCIN1	38547758	38547881	33971	124	207298	11692	173327	11568	273.9596774193548	14.983316044260027
chr17	CWC25	38815624	38815741	0	118	1389	3726	1389	3608	0.0	0.38497782705099776
chr17	CWC25	38810275	38810400	0	126	1389	3726	1389	3600	0.0	0.3858333333333333
chr17	PLXDC1	39072449	39072485	0	37	0	9280	0	9243	0.0	0.0
chr17	PLXDC1	39083458	39083540	0	83	0	9280	0	9197	0.0	0.0
chr17	PLXDC1	39081249	39081449	0	201	0	9280	0	9079	0.0	0.0
chr17	PLXDC1	39079501	39079528	0	28	0	9280	0	9252	0.0	0.0
chr17	PLXDC1	39126904	39127004	0	101	0	9280	0	9179	0.0	0.0
chr17	PLXDC1	39139653	39139832	0	180	0	9280	0	9100	0.0	0.0
chr17	CACNB1	39185130	39185150	0	21	0	5588	0	5567	0.0	0.0
chr17	CACNB1	39185949	39186104	0	156	0	5588	0	5432	0.0	0.0
chr17	FBXL20	39285477	39285573	0	97	102	4602	102	4505	0.0	0.022641509433962263
chr17	MED1	39440385	39440518	0	134	0	8626	0	8492	0.0	0.0
chr17	MED1	39445410	39445569	0	160	0	8626	0	8466	0.0	0.0
chr17	PGAP3	39673513	39673650	0	138	663	3628	663	3490	0.0	0.18997134670487106
chr17	PGAP3	39674616	39674679	0	64	663	3628	663	3564	0.0	0.18602693602693604
chr17	PGAP3	39684596	39684749	0	154	663	3628	663	3474	0.0	0.19084628670120898
chr17	PGAP3	39685921	39686019	0	99	663	3628	663	3529	0.0	0.1878719183904789
chr17	PGAP3	39676613	39676755	0	143	663	3628	663	3485	0.0	0.1902439024390244
chr17	IKZF3	39777650	39777767	0	118	51	10138	51	10020	0.0	0.005089820359281437
chr17	IKZF3	39788257	39788374	0	118	51	10138	51	10020	0.0	0.005089820359281437
chr17	IKZF3	39791415	39791583	0	169	51	10138	51	9969	0.0	0.00511585916340656
chr17	IKZF3	39792672	39792933	0	262	51	10138	51	9876	0.0	0.005164034021871203
chr17	IKZF3	39829386	39829488	0	103	51	10138	51	10035	0.0	0.005082212257100149
chr17	IKZF3	39777884	39778010	0	127	51	10138	51	10011	0.0	0.005094396164219359
chr17	GSDMB	39906960	39906987	0	28	48594	4922	48594	4894	0.0	9.929301185124642
chr17	GSDMB	39908175	39908214	0	40	48594	4922	48594	4882	0.0	9.953707496927489
chr17	GSDMB	39908957	39909042	0	86	48594	4922	48594	4836	0.0	10.048387096774194
chr17	GSDMB	39909755	39909924	0	170	48594	4922	48594	4752	0.0	10.2260101010101
chr17	MED24	40027382	40027465	344	84	492955	6850	492611	6766	4.095238095238095	72.80682825894176
chr17	MED24	40035721	40035795	0	75	492955	6850	492955	6775	0.0	72.76088560885609
chr17	MED24	40036115	40036154	0	40	492955	6850	492955	6810	0.0	72.38693098384728
chr17	MED24	40053468	40053635	364	168	492955	6850	492591	6682	2.1666666666666665	73.71909607901826
chr17	MED24	40053468	40053657	540	190	492955	6850	492415	6660	2.8421052631578947	73.93618618618619
chr17	MED24	40034915	40034972	30	58	492955	6850	492925	6792	0.5172413793103449	72.57435217903416
chr17	MED24	40053297	40053380	162	84	492955	6850	492793	6766	1.9285714285714286	72.83372746083359
chr17	MED24	40053468	40053679	612	212	492955	6850	492343	6638	2.8867924528301887	74.17038264537511
chr17	MED24	40053468	40053768	708	301	492955	6850	492247	6549	2.352159468438538	75.16368911284165
chr17	TNS4	40479673	40479842	2009	170	208200	4886	206191	4716	11.81764705882353	43.7215860899067
chr17	CCR7	40558892	40558942	75	51	1914212	2512	1914137	2461	1.4705882352941178	777.788297440065
chr17	SMARCE1	40632194	40632367	1850	174	94542	10517	92692	10343	10.632183908045977	8.96180991975249
chr17	SMARCE1	40642454	40642559	15608	106	94542	10517	78934	10411	147.24528301886792	7.581788492940159
chr17	SMARCE1	40645575	40645619	0	45	94542	10517	94542	10472	0.0	9.02807486631016
chr17	SMARCE1	40645795	40645847	0	53	94542	10517	94542	10464	0.0	9.034977064220184
chr17	SMARCE1	40630207	40630286	0	80	94542	10517	94542	10437	0.0	9.058350100603622
chr17	SMARCE1	40639980	40640078	0	99	94542	10517	94542	10418	0.0	9.074870416586677
chr17	SMARCE1	40644384	40644459	0	76	94542	10517	94542	10441	0.0	9.054879800785365
chr17	SMARCE1	40642117	40642559	15608	443	94542	10517	78934	10074	35.23250564334086	7.835417907484614
chr17	KRT23	40929939	40930096	2525	158	87941	2919	85416	2761	15.981012658227849	30.936617167692866
chr17	KRT23	40937127	40937259	483	133	87941	2919	87458	2786	3.6315789473684212	31.391959798994975
chr17	KRT39	40964128	40964172	232	45	143134	2000	142902	1955	5.155555555555556	73.09565217391304
chr17	KRT13	41501718	41501744	0	27	0	2923	0	2896	0.0	0.0
chr17	KRT15	41517082	41517165	0	84	51	5117	51	5033	0.0	0.01013312139876813
chr17	KRT15	41519664	41519872	0	209	51	5117	51	4908	0.0	0.01039119804400978
chr17	KRT15	41517336	41517609	0	274	51	5117	51	4843	0.0	0.010530662812306421
chr17	HAP1	41727761	41727836	0	76	1245	2283	1245	2207	0.0	0.5641141821477118
chr17	HAP1	41727297	41727453	51	157	1245	2283	1194	2126	0.3248407643312102	0.561618062088429
chr17	JUP	41772817	41772926	0	110	0	4876	0	4766	0.0	0.0
chr17	P3H4	41809705	41809834	0	130	0	3317	0	3187	0.0	0.0
chr17	NT5C3B	41827425	41827626	0	202	0	2859	0	2657	0.0	0.0
chr17	NT5C3B	41828789	41828952	0	164	0	2859	0	2695	0.0	0.0
chr17	NT5C3B	41830800	41830890	0	91	0	2859	0	2768	0.0	0.0
chr17	NT5C3B	41835858	41835957	0	100	0	2859	0	2759	0.0	0.0
chr17	NT5C3B	41835587	41835682	0	96	0	2859	0	2763	0.0	0.0
chr17	NT5C3B	41835587	41835642	0	56	0	2859	0	2803	0.0	0.0
chr17	ACLY	41896619	41896649	0	31	11170	5239	11170	5208	0.0	2.1447772657450077
chr17	DNAJC7	41981854	41982007	0	154	743	9268	743	9114	0.0	0.0815229317533465
chr17	DNAJC7	41996310	41996424	0	115	743	9268	743	9153	0.0	0.08117557085108708
chr17	DNAJC7	42000481	42000570	0	90	743	9268	743	9178	0.0	0.08095445630856396
chr17	DNAJC7	41987594	41987694	0	101	743	9268	743	9167	0.0	0.08105159812370459
chr17	DNAJC7	42003358	42003557	0	200	743	9268	743	9068	0.0	0.08193647992942214
chr17	DNAJC7	41992798	41992867	0	70	743	9268	743	9198	0.0	0.08077843009349858
chr17	DNAJC7	42000955	42001066	0	112	743	9268	743	9156	0.0	0.08114897335080822
chr17	DHX58	42103607	42103798	0	192	73350	3749	73350	3557	0.0	20.62131009277481
chr17	DHX58	42105735	42105989	707	255	73350	3749	72643	3494	2.772549019607843	20.790784201488265
chr17	DHX58	42111724	42111893	915	170	73350	3749	72435	3579	5.382352941176471	20.23889354568315
chr17	DHX58	42111745	42111893	754	149	73350	3749	72596	3600	5.060402684563758	20.165555555555557
chr17	AC099811.2	42120029	42120119	0	91	648	1208	648	1117	0.0	0.5801253357206804
chr17	AC099811.2	42120705	42120829	0	125	648	1208	648	1083	0.0	0.5983379501385041
chr17	RAB5C	42131606	42131822	0	217	2550	2590	2550	2373	0.0	1.0745891276864727
chr17	RAB5C	42137761	42137878	168	118	2550	2590	2382	2472	1.423728813559322	0.9635922330097088
chr17	GHDC	42193766	42193850	0	85	3478	3702	3478	3617	0.0	0.961570362178601
chr17	STAT3	42326115	42326199	0	85	1726	9674	1726	9589	0.0	0.17999791427677547
chr17	STAT3	42339313	42339409	0	97	1726	9674	1726	9577	0.0	0.1802234520204657
chr17	STAT3	42348388	42348539	0	152	1726	9674	1726	9522	0.0	0.1812644402436463
chr17	STAT3	42374058	42374206	0	149	1726	9674	1726	9525	0.0	0.18120734908136482
chr17	STAT3	42348388	42348520	0	133	1726	9674	1726	9541	0.0	0.18090346923802536
chr17	STAT3	42348388	42348517	0	130	1726	9674	1726	9544	0.0	0.1808466051969824
chr17	STAT3	42317181	42317224	0	44	1726	9674	1726	9630	0.0	0.17923156801661475
chr17	PSMC3IP	42574315	42574334	0	20	2913	2585	2913	2565	0.0	1.135672514619883
chr17	RETREG3	42586764	42586891	425	128	2848	4732	2423	4604	3.3203125	0.5262814943527367
chr17	RETREG3	42587833	42587864	0	32	2848	4732	2848	4700	0.0	0.6059574468085106
chr17	RETREG3	42596532	42596627	0	96	2848	4732	2848	4636	0.0	0.6143226919758412
chr17	RETREG3	42609497	42609727	14	231	2848	4732	2834	4501	0.06060606060606061	0.6296378582537214
chr17	PLEKHH3	42674740	42674875	0	136	51	3655	51	3519	0.0	0.014492753623188406
chr17	EZH1	42718453	42718617	0	165	153	6587	153	6422	0.0	0.023824353783867953
chr17	EZH1	42719104	42719207	0	104	153	6587	153	6483	0.0	0.023600185099490977
chr17	EZH1	42722794	42722915	0	122	153	6587	153	6465	0.0	0.023665893271461718
chr17	EZH1	42724304	42724424	0	121	153	6587	153	6466	0.0	0.02366223321991958
chr17	EZH1	42728824	42728952	0	129	153	6587	153	6458	0.0	0.023691545370083618
chr17	EZH1	42730827	42730918	0	92	153	6587	153	6495	0.0	0.023556581986143188
chr17	EZH1	42727634	42727763	0	130	153	6587	153	6457	0.0	0.023695214495895928
chr17	EZH1	42727661	42727763	0	103	153	6587	153	6484	0.0	0.023596545342381245
chr17	EZH1	42731774	42731893	0	120	153	6587	153	6467	0.0	0.0236585743002938
chr17	EZH1	42729146	42729239	0	94	153	6587	153	6493	0.0	0.02356383797936239
chr17	BECN1	42811654	42811797	459	144	55969	5109	55510	4965	3.1875	11.180261832829808
chr17	BECN1	42813947	42814008	32	62	55969	5109	55937	5047	0.5161290322580645	11.083217753120666
chr17	BECN1	42815907	42816054	0	148	55969	5109	55969	4961	0.0	11.281798024591817
chr17	BECN1	42812230	42812356	0	127	55969	5109	55969	4982	0.0	11.234243275792855
chr17	BECN1	42827250	42827341	5605	92	55969	5109	50364	5017	60.92391304347826	10.038668527008172
chr17	BECN1	42824154	42824379	51	226	55969	5109	55918	4883	0.22566371681415928	11.451566659840262
chr17	LINC00671	42897686	42897918	51	233	115372	2175	115321	1942	0.21888412017167383	59.38259526261586
chr17	LINC00671	42884594	42884686	637	93	115372	2175	114735	2082	6.849462365591398	55.10806916426513
chr17	LINC00671	42895376	42895493	0	118	115372	2175	115372	2057	0.0	56.08750607681089
chr17	AARSD1	42951799	42951894	746	96	79835	2950	79089	2854	7.770833333333333	27.711632796075683
chr17	AARSD1	42953723	42953778	1315	56	79835	2950	78520	2894	23.482142857142858	27.131997235659988
chr17	PTGES3L-AARSD1	42971606	42971696	156	91	37974	2312	37818	2221	1.7142857142857142	17.027465105808194
chr17	PTGES3L-AARSD1	42979169	42979268	0	100	37974	2312	37974	2212	0.0	17.16726943942134
chr17	PTGES3L-AARSD1	42979549	42979663	0	115	37974	2312	37974	2197	0.0	17.284478834774692
chr17	AARSD1	42962174	42962272	784	99	79835	2950	79051	2851	7.91919191919192	27.72746404770256
chr17	AARSD1	42962174	42962295	816	122	79835	2950	79019	2828	6.688524590163935	27.94165487977369
chr17	PTGES3L-AARSD1	42979549	42979773	1298	225	37974	2312	36676	2087	5.768888888888889	17.573550551030188
chr17	VAT1	43021935	43022350	11228	416	75593	3313	64365	2897	26.990384615384617	22.217811529168106
chr17	BRCA1	43049120	43049194	0	75	41484	8555	41484	8480	0.0	4.891981132075472
chr17	BRCA1	43091434	43094860	0	3427	41484	8555	41484	5128	0.0	8.089703588143525
chr17	BRCA1	43106455	43106533	153	79	41484	8555	41331	8476	1.9367088607594938	4.8762387918829635
chr17	BRCA1	43115725	43115779	627	55	41484	8555	40857	8500	11.4	4.806705882352941
chr17	BRCA1	43079333	43079399	0	67	41484	8555	41484	8488	0.0	4.887370405278039
chr17	BRCA1	43094743	43094860	0	118	41484	8555	41484	8437	0.0	4.916913594879697
chr17	BRCA1	43106477	43106533	123	57	41484	8555	41361	8498	2.1578947368421053	4.867145210637797
chr17	BRCA1	43121557	43121676	0	120	41484	8555	41484	8435	0.0	4.918079430942502
chr17	BRCA1	43110464	43110580	445	117	41484	8555	41039	8438	3.8034188034188032	4.863593268547049
chr17	BRCA1	43112486	43112606	735	121	41484	8555	40749	8434	6.074380165289257	4.8315152952335785
chr17	BRCA1	43119120	43119265	159	146	41484	8555	41325	8409	1.0890410958904109	4.9143774527292186
chr17	AC060780.1	43167733	43167849	368	117	57171	6052	56803	5935	3.1452991452991452	9.570850884582983
chr17	CCDC200	43223740	43223835	0	96	104112	3210	104112	3114	0.0	33.433526011560694
chr17	CCDC200	43223900	43224026	0	127	104112	3210	104112	3083	0.0	33.769704832954915
chr17	LINC00910	43356391	43356530	1663	140	291389	8593	289726	8453	11.878571428571428	34.274931976812965
chr17	LINC00910	43379122	43379262	495	141	291389	8593	290894	8452	3.5106382978723403	34.41717936583057
chr17	LINC00910	43381272	43381660	80	389	291389	8593	291309	8204	0.20565552699228792	35.50816674792784
chr17	LINC00910	43387935	43388057	0	123	291389	8593	291389	8470	0.0	34.40247933884297
chr17	ETV4	43533186	43533348	101	163	37238	3530	37137	3367	0.6196319018404908	11.02970002970003
chr17	ETV4	43545557	43545668	3253	112	37238	3530	33985	3418	29.044642857142858	9.942949093036864
chr17	MEOX1	43643487	43643660	0	174	3759	2677	3759	2503	0.0	1.5017978425888934
chr17	DUSP3	43774034	43774109	0	76	0	4997	0	4921	0.0	0.0
chr17	DUSP3	43773973	43774109	0	137	0	4997	0	4860	0.0	0.0
chr17	DUSP3	43777528	43777813	0	286	0	4997	0	4711	0.0	0.0
chr17	MPP3	43816676	43816697	0	22	0	4513	0	4491	0.0	0.0
chr17	MPP3	43818999	43819081	0	83	0	4513	0	4430	0.0	0.0
chr17	MPP2	43898261	43898380	0	120	39	6133	39	6013	0.0	0.006485947114585066
chr17	MPP2	43904429	43904493	0	65	39	6133	39	6068	0.0	0.006427158866183257
chr17	MPP2	43906079	43906151	0	73	39	6133	39	6060	0.0	0.006435643564356435
chr17	MPP2	43884083	43884155	0	73	39	6133	39	6060	0.0	0.006435643564356435
chr17	MPP2	43898243	43898380	0	138	39	6133	39	5995	0.0	0.0065054211843202665
chr17	TMEM101	44021321	44021435	0	115	153	3037	153	2922	0.0	0.052361396303901436
chr17	LSM12	44036861	44037102	0	242	765	3123	765	2881	0.0	0.26553280111072547
chr17	HDAC5	44092171	44092284	0	114	9538	7417	9538	7303	0.0	1.306038614268109
chr17	HDAC5	44092380	44092527	0	148	9538	7417	9538	7269	0.0	1.3121474755812355
chr17	HDAC5	44117493	44117704	936	212	9538	7417	8602	7205	4.415094339622642	1.1938931297709923
chr17	ASB16-AS1	44182929	44183093	0	165	1429	2476	1429	2311	0.0	0.6183470359151882
chr17	ASB16-AS1	44178183	44178363	1323	181	1429	2476	106	2295	7.30939226519337	0.04618736383442266
chr17	UBTF	44215905	44215989	0	85	7509	6885	7509	6800	0.0	1.104264705882353
chr17	UBTF	44212343	44212454	624	112	7509	6885	6885	6773	5.571428571428571	1.0165362468625425
chr17	UBTF	44208618	44209001	51	384	7509	6885	7458	6501	0.1328125	1.1472081218274113
chr17	RUNDC3A-AS1	44304980	44305043	0	64	6026	5515	6026	5451	0.0	1.1054852320675106
chr17	SLC25A39	44322807	44322852	0	46	13907	3162	13907	3116	0.0	4.463093709884467
chr17	FAM171A2	44359061	44359143	0	83	102	3579	102	3496	0.0	0.02917620137299771
chr17	FAM171A2	44358944	44359143	0	200	102	3579	102	3379	0.0	0.030186445693992304
chr17	ITGA2B	44384947	44385076	204	130	5338	4794	5134	4664	1.5692307692307692	1.1007718696397941
chr17	ITGA2B	44374353	44374470	451	118	5338	4794	4887	4676	3.8220338983050848	1.0451240376390076
chr17	GPATCH8	44474828	44474903	0	76	17144	9750	17144	9674	0.0	1.7721728344014884
chr17	GPATCH8	44438670	44438715	0	46	17144	9750	17144	9704	0.0	1.7666941467436108
chr17	GPATCH8	44467096	44467114	0	19	17144	9750	17144	9731	0.0	1.7617922104614119
chr17	GPATCH8	44467096	44467202	102	107	17144	9750	17042	9643	0.9532710280373832	1.767292336409831
chr17	GPATCH8	44473724	44473759	0	36	17144	9750	17144	9714	0.0	1.7648754375128681
chr17	CCDC43	44680584	44680643	0	60	510	2861	510	2801	0.0	0.18207782934666192
chr17	CCDC43	44680584	44680652	0	69	510	2861	510	2792	0.0	0.1826647564469914
chr17	GJC1	44807393	44807469	0	77	855628	5154	855628	5077	0.0	168.53023439038802
chr17	EFTUD2	44853295	44853390	0	96	0	9782	0	9686	0.0	0.0
chr17	EFTUD2	44886584	44886750	0	167	0	9782	0	9615	0.0	0.0
chr17	EFTUD2	44894416	44894525	0	110	0	9782	0	9672	0.0	0.0
chr17	EFTUD2	44852408	44852562	0	155	0	9782	0	9627	0.0	0.0
chr17	EFTUD2	44898974	44899041	0	68	0	9782	0	9714	0.0	0.0
chr17	EFTUD2	44895825	44895989	0	165	0	9782	0	9617	0.0	0.0
chr17	GFAP	44913727	44913823	0	97	51	7492	51	7395	0.0	0.006896551724137931
chr17	GFAP	44914027	44914088	0	62	51	7492	51	7430	0.0	0.006864064602960969
chr17	GFAP	44904765	44905149	0	385	51	7492	51	7107	0.0	0.007176023638666104
chr17	GFAP	44903958	44904233	0	276	51	7492	51	7216	0.0	0.007067627494456763
chr17	GFAP	44910225	44910260	0	36	51	7492	51	7456	0.0	0.006840128755364807
chr17	GFAP	44910140	44910260	0	121	51	7492	51	7371	0.0	0.006919006919006919
chr17	GFAP	44910091	44910260	0	170	51	7492	51	7322	0.0	0.006965310024583447
chr17	GFAP	44914027	44914109	0	83	51	7492	51	7409	0.0	0.006883520043190714
chr17	PLCD3	45112862	45113012	153	151	27290	6647	27137	6496	1.0132450331125828	4.177493842364532
chr17	AC008105.3	45220867	45220914	0	48	36644	3429	36644	3381	0.0	10.838213546288081
chr17	MAP3K14	45312284	45312437	0	154	8098	5684	8098	5530	0.0	1.464376130198915
chr17	ARHGAP27	45404600	45404681	0	82	42814	10105	42814	10023	0.0	4.271575376633742
chr17	ARHGAP27	45404268	45404334	0	67	42814	10105	42814	10038	0.0	4.26519226937637
chr17	PLEKHM1	45468208	45468593	0	386	36397	9251	36397	8865	0.0	4.1056965595036665
chr17	PLEKHM1	45477899	45478147	0	249	36397	9251	36397	9002	0.0	4.043212619417907
chr17	PLEKHM1	45475099	45475726	550	628	36397	9251	35847	8623	0.8757961783439491	4.157137887046272
chr17	PLEKHM1	45482436	45482525	0	90	36397	9251	36397	9161	0.0	3.9730378779609214
chr17	PLEKHM1	45478100	45478147	0	48	36397	9251	36397	9203	0.0	3.954906008910138
chr17	PLEKHM1	45477804	45478147	0	344	36397	9251	36397	8907	0.0	4.086336589199506
chr17	MAPT-AS1	45847510	45847698	0	189	6574	7365	6574	7176	0.0	0.9161092530657748
chr17	KANSL1	46039026	46039215	0	190	48377	16946	48377	16756	0.0	2.887144903318214
chr17	KANSL1	46082440	46082542	0	103	48377	16946	48377	16843	0.0	2.872231787686279
chr17	KANSL1	46170854	46172232	2701	1379	48377	16946	45676	15567	1.958665699782451	2.9341555855335004
chr17	ARL17B	46339508	46339774	0	267	51	7947	51	7680	0.0	0.006640625
chr17	ARL17A	46538350	46538426	0	77	664	6519	664	6442	0.0	0.10307357963365414
chr17	AC005670.3	46998699	46998817	670	119	510390	10495	509720	10376	5.630252100840337	49.12490362374711
chr17	AC005670.3	47033319	47033381	0	63	510390	10495	510390	10432	0.0	48.925421779141104
chr17	AC005670.3	47007839	47007884	8630	46	510390	10495	501760	10449	187.6086956521739	48.019906211120684
chr17	AC005670.3	47033277	47033381	0	105	510390	10495	510390	10390	0.0	49.12319538017324
chr17	AC005670.3	47035043	47035126	0	84	510390	10495	510390	10411	0.0	49.024109115358755
chr17	AC005670.3	47054117	47054213	0	97	510390	10495	510390	10398	0.0	49.08540103866128
chr17	CDC27	47142228	47142436	0	209	98	6557	98	6348	0.0	0.01543793320730939
chr17	CDC27	47158205	47158303	0	99	98	6557	98	6458	0.0	0.015174976772994736
chr17	CDC27	47171916	47172064	0	149	98	6557	98	6408	0.0	0.01529338327091136
chr17	CDC27	47169916	47170042	0	127	98	6557	98	6430	0.0	0.015241057542768274
chr17	CDC27	47139770	47139973	0	204	98	6557	98	6353	0.0	0.015425783094600977
chr17	MRPL45P2	47486762	47486884	116536	123	116947	1844	411	1721	947.4471544715448	0.23881464264962232
chr17	AC025682.1	47626546	47626627	0	82	0	1247	0	1165	0.0	0.0
chr17	MRPL10	47829138	47829236	0	99	306	2777	306	2678	0.0	0.11426437640029873
chr17	SCRN2	47840190	47840372	0	183	2692	3004	2692	2821	0.0	0.9542715349166963
chr17	AC018521.5	47893899	47893958	12	60	12	525	0	465	0.2	0.0
chr17	COPZ2	48027675	48027789	0	115	49	1877	49	1762	0.0	0.027809307604994324
chr17	COPZ2	48028471	48028510	0	40	49	1877	49	1837	0.0	0.026673924877517692
chr17	COPZ2	48033210	48033302	49	93	49	1877	0	1784	0.5268817204301075	0.0
chr17	COPZ2	48032155	48032233	0	79	49	1877	49	1798	0.0	0.027252502780867632
chr17	COPZ2	48032685	48032741	0	57	49	1877	49	1820	0.0	0.026923076923076925
chr17	CBX1	48088165	48088307	0	143	0	3053	0	2910	0.0	0.0
chr17	SKAP1	48184722	48184847	0	126	23269	2371	23269	2245	0.0	10.364810690423162
chr17	SKAP1	48231826	48231902	0	77	23269	2371	23269	2294	0.0	10.143417611159547
chr17	SKAP1	48136474	48136560	0	87	23269	2371	23269	2284	0.0	10.187828371278458
chr17	SKAP1	48248886	48249029	0	144	23269	2371	23269	2227	0.0	10.448585541086663
chr17	HOXB3	48573836	48574014	0	179	21434	6082	21434	5903	0.0	3.631035066915128
chr17	HOXB3	48575042	48575208	0	167	21434	6082	21434	5915	0.0	3.6236686390532546
chr17	AC103702.2	48636867	48636993	0	127	0	1600	0	1473	0.0	0.0
chr17	TTLL6	48791377	48791603	0	227	50599	5118	50599	4891	0.0	10.345328153751788
chr17	TTLL6	48815333	48815398	996	66	50599	5118	49603	5052	15.090909090909092	9.81848772763262
chr17	SNF8	48940923	48941062	34174	140	34216	4805	42	4665	244.1	0.0090032154340836
chr17	SNF8	48934478	48934576	42	99	34216	4805	34174	4706	0.42424242424242425	7.2617934551636205
chr17	SNF8	48936854	48936933	0	80	34216	4805	34216	4725	0.0	7.241481481481482
chr17	SNF8	48937280	48937291	0	12	34216	4805	34216	4793	0.0	7.1387440016691
chr17	PHOSPHO1	49225655	49225777	0	123	102	2397	102	2274	0.0	0.044854881266490766
chr17	ZNF652	49322384	49322508	0	125	26565	11753	26565	11628	0.0	2.2845717234262124
chr17	PHB	49411677	49411839	0	163	459	5014	459	4851	0.0	0.09461966604823747
chr17	PHB	49413176	49413291	0	116	459	5014	459	4898	0.0	0.09371171906900776
chr17	PHB	49414241	49414333	0	93	459	5014	459	4921	0.0	0.09327372485267223
chr17	SPOP	49675894	49676016	0	123	8	6342	8	6219	0.0	0.0012863804470172053
chr17	SPOP	49636758	49636809	0	52	8	6342	8	6290	0.0	0.0012718600953895071
chr17	SPOP	49646925	49647122	0	198	8	6342	8	6144	0.0	0.0013020833333333333
chr17	SPOP	49668026	49668078	0	53	8	6342	8	6289	0.0	0.0012720623310542216
chr17	SPOP	49618503	49618563	0	61	8	6342	8	6281	0.0	0.001273682534628244
chr17	SPOP	49620620	49620670	8	51	8	6342	0	6291	0.1568627450980392	0.0
chr17	SPOP	49612778	49612941	0	164	8	6342	8	6178	0.0	0.0012949174490126255
chr17	SPOP	49622205	49622283	0	79	8	6342	8	6263	0.0	0.0012773431262973016
chr17	SPOP	49636196	49636313	0	118	8	6342	8	6224	0.0	0.0012853470437017994
chr17	SLC35B1	49706203	49706334	0	132	284	5087	284	4955	0.0	0.057315842583249246
chr17	SLC35B1	49707342	49707444	0	103	284	5087	284	4984	0.0	0.05698234349919743
chr17	SLC35B1	49706203	49706309	0	107	284	5087	284	4980	0.0	0.0570281124497992
chr17	SLC35B1	49706964	49707068	0	105	284	5087	284	4982	0.0	0.05700521878763549
chr17	FAM117A	49722498	49722594	0	97	0	3816	0	3719	0.0	0.0
chr17	FAM117A	49732550	49732720	0	171	0	3816	0	3645	0.0	0.0
chr17	FAM117A	49717967	49718044	0	78	0	3816	0	3738	0.0	0.0
chr17	TAC4	49841551	49841584	0	34	0	1002	0	968	0.0	0.0
chr17	TAC4	49839849	49839909	0	61	0	1002	0	941	0.0	0.0
chr17	SAMD14	50114356	50114440	0	85	0	6250	0	6165	0.0	0.0
chr17	SAMD14	50125090	50125360	0	271	0	6250	0	5979	0.0	0.0
chr17	MRPL27	50368837	50368867	0	31	0	2282	0	2251	0.0	0.0
chr17	ANKRD40CL	50764164	50764248	0	85	148	2403	148	2318	0.0	0.0638481449525453
chr17	SPAG9	51031680	51031722	0	43	196	9106	196	9063	0.0	0.021626393026591636
chr17	SPAG9	50975862	50975901	0	40	196	9106	196	9066	0.0	0.021619236708581513
chr17	SPAG9	50999475	50999487	0	13	196	9106	196	9093	0.0	0.02155504234026174
chr17	MBTD1	51195213	51195361	0	149	0	6681	0	6532	0.0	0.0
chr17	MBTD1	51209313	51209430	0	118	0	6681	0	6563	0.0	0.0
chr17	CA10	52157725	52158369	0	645	0	4452	0	3807	0.0	0.0
chr17	CA10	52134878	52135049	0	172	0	4452	0	4280	0.0	0.0
chr17	CA10	52157725	52158372	0	648	0	4452	0	3804	0.0	0.0
chr17	MMD	55407745	55407820	0	76	51	3202	51	3126	0.0	0.016314779270633396
chr17	MMD	55404454	55404547	0	94	51	3202	51	3108	0.0	0.016409266409266408
chr17	SMIM36	55479459	55479580	0	122	1433	3515	1433	3393	0.0	0.42234011199528443
chr17	TRIM25	56912104	56912165	0	62	6680	6852	6680	6790	0.0	0.9837997054491899
chr17	AC015845.2	57832641	57832748	0	108	33974	615	33974	507	0.0	67.00986193293886
chr17	CUEDC1	57885228	57885879	0	652	1069	5297	1069	4645	0.0	0.23013993541442412
chr17	VEZF1	57985984	57986144	86	161	5849	4921	5763	4760	0.5341614906832298	1.2107142857142856
chr17	SRSF1	58003650	58004001	9351	352	9193	2405	-158	2053	26.56534090909091	-0.07696054554310765
chr17	MKS1	58206464	58207218	612	755	93257	8985	92645	8230	0.8105960264900662	11.256986634264885
chr17	MKS1	58207084	58207218	0	135	93257	8985	93257	8850	0.0	10.537514124293786
chr17	MKS1	58210979	58211022	551	44	93257	8985	92706	8941	12.522727272727273	10.368638854714238
chr17	MKS1	58214258	58214387	0	130	93257	8985	93257	8855	0.0	10.531564088085828
chr17	MKS1	58214740	58214838	0	99	93257	8985	93257	8886	0.0	10.494823317578213
chr17	MKS1	58218619	58218729	0	111	93257	8985	93257	8874	0.0	10.509015100292991
chr17	MKS1	58206464	58206547	444	84	93257	8985	92813	8901	5.285714285714286	10.427255364565779
chr17	MKS1	58214740	58214898	0	159	93257	8985	93257	8826	0.0	10.566168139587582
chr17	MKS1	58216087	58216243	0	157	93257	8985	93257	8828	0.0	10.56377435432714
chr17	MKS1	58215300	58215444	0	145	93257	8985	93257	8840	0.0	10.549434389140272
chr17	TSPOAP1	58304337	58304399	0	63	2823	8979	2823	8916	0.0	0.31662180349932706
chr17	TSPOAP1	58308540	58309380	204	841	2823	8979	2619	8138	0.24256837098692033	0.3218235438682723
chr17	TSPOAP1	58325533	58325713	0	181	2823	8979	2823	8798	0.0	0.3208683791770857
chr17	SUPT4H1	58347528	58347584	0	57	0	2085	0	2028	0.0	0.0
chr17	RNF43	58370910	58371033	0	124	1581	5286	1581	5162	0.0	0.3062766369624177
chr17	RNF43	58415325	58415962	0	638	1581	5286	1581	4648	0.0	0.3401462994836489
chr17	RNF43	58415325	58415759	0	435	1581	5286	1581	4851	0.0	0.3259121830550402
chr17	MTMR4	58508680	58508841	0	162	215006	7498	215006	7336	0.0	29.30834242093784
chr17	MTMR4	58504049	58504220	0	172	215006	7498	215006	7326	0.0	29.34834834834835
chr17	MTMR4	58514991	58515083	6	93	215006	7498	215000	7405	0.06451612903225806	29.03443619176232
chr17	SEPTIN4	58526681	58526978	0	298	78318	6797	78318	6499	0.0	12.050777042621942
chr17	SEPTIN4	58526766	58526978	0	213	78318	6797	78318	6584	0.0	11.89520048602673
chr17	SEPTIN4	58539111	58539208	6502	98	78318	6797	71816	6699	66.34693877551021	10.720406030750858
chr17	SEPTIN4	58531479	58531551	0	73	78318	6797	78318	6724	0.0	11.647531231409875
chr17	SEPTIN4	58526931	58526978	0	48	78318	6797	78318	6749	0.0	11.60438583493851
chr17	TEX14	58557798	58557850	0	53	7882	5361	7882	5308	0.0	1.4849284099472495
chr17	TEX14	58617537	58617619	0	83	7882	5361	7882	5278	0.0	1.493368700265252
chr17	TEX14	58581610	58581730	9	121	7882	5361	7873	5240	0.0743801652892562	1.5024809160305344
chr17	TEX14	58647991	58648112	30	122	7882	5361	7852	5239	0.2459016393442623	1.498759305210918
chr17	TEX14	58567754	58567911	0	158	7882	5361	7882	5203	0.0	1.5148952527388044
chr17	TRIM37	59001597	59001741	0	145	254	5509	254	5364	0.0	0.04735272184936615
chr17	TRIM37	59001597	59001714	0	118	254	5509	254	5391	0.0	0.047115562975329255
chr17	TRIM37	59084001	59084089	0	89	254	5509	254	5420	0.0	0.046863468634686344
chr17	TRIM37	59104292	59104394	0	103	254	5509	254	5406	0.0	0.04698483166851646
chr17	TRIM37	59090016	59090092	0	77	254	5509	254	5432	0.0	0.046759941089838
chr17	TRIM37	59073093	59073141	0	49	254	5509	254	5460	0.0	0.04652014652014652
chr17	SKA2	59119318	59119495	0	178	8084	3064	8084	2886	0.0	2.8011088011088012
chr17	SKA2	59131280	59131367	0	88	8084	3064	8084	2976	0.0	2.7163978494623655
chr17	SKA2	59124306	59124428	0	123	8084	3064	8084	2941	0.0	2.7487249234954096
chr17	SKA2	59119298	59119495	0	198	8084	3064	8084	2866	0.0	2.820655966503838
chr17	LINC01476	59433653	59433765	0	113	1140	6515	1140	6402	0.0	0.1780693533270853
chr17	LINC01476	59502978	59503094	0	117	1140	6515	1140	6398	0.0	0.17818068146295718
chr17	LINC01476	59434416	59434521	0	106	1140	6515	1140	6409	0.0	0.17787486347324075
chr17	LINC01476	59449741	59449776	0	36	1140	6515	1140	6479	0.0	0.17595307917888564
chr17	PTRH2	59698870	59700189	0	1320	153	3306	153	1986	0.0	0.0770392749244713
chr17	TUBD1	59874538	59874703	0	166	9504	3345	9504	3179	0.0	2.98961937716263
chr17	TUBD1	59880893	59881110	0	218	9504	3345	9504	3127	0.0	3.0393348257115447
chr17	TUBD1	59890830	59891041	0	212	9504	3345	9504	3133	0.0	3.033514203638685
chr17	TUBD1	59866608	59866749	98	142	9504	3345	9406	3203	0.6901408450704225	2.936621916952857
chr17	TUBD1	59884660	59884756	60	97	9504	3345	9444	3248	0.6185567010309279	2.9076354679802954
chr17	TUBD1	59891813	59891960	0	148	9504	3345	9504	3197	0.0	2.9727869878010633
chr17	RNFT1	59960067	59960168	0	102	4779	3189	4779	3087	0.0	1.5481049562682216
chr17	RNFT1	59962539	59962616	0	78	4779	3189	4779	3111	0.0	1.5361620057859209
chr17	RNFT1	59958623	59958701	44	79	4779	3189	4735	3110	0.5569620253164557	1.522508038585209
chr17	TBC1D3P1-DHX40P1	59995631	59995814	0	184	4647	1855	4647	1671	0.0	2.7809694793536806
chr17	TBC1D3P1-DHX40P1	60000030	60000162	0	133	4647	1855	4647	1722	0.0	2.6986062717770034
chr17	HEATR6	60073745	60073886	0	142	17484	7067	17484	6925	0.0	2.524765342960289
chr17	HEATR6	60073745	60074159	0	415	17484	7067	17484	6652	0.0	2.6283824413710164
chr17	HEATR6	60075704	60075833	1479	130	17484	7067	16005	6937	11.376923076923077	2.3071933112296383
chr17	HEATR6	60073961	60074159	0	199	17484	7067	17484	6868	0.0	2.545719277810134
chr17	WFDC21P	60085931	60086126	720	196	5161	1104	4441	908	3.673469387755102	4.890969162995595
chr17	WFDC21P	60085931	60086079	720	149	5161	1104	4441	955	4.832214765100671	4.650261780104712
chr17	WFDC21P	60085931	60085985	720	55	5161	1104	4441	1049	13.090909090909092	4.2335557673975215
chr17	AC025048.2	60132435	60132512	0	78	561	3106	561	3028	0.0	0.18527080581241745
chr17	AC025048.2	60128540	60128659	0	120	561	3106	561	2986	0.0	0.18787675820495647
chr17	AC025048.2	60128955	60129090	51	136	561	3106	510	2970	0.375	0.1717171717171717
chr17	AC025048.2	60128535	60128659	0	125	561	3106	561	2981	0.0	0.1881918819188192
chr17	USP32	60180544	60180637	0	94	21272	9563	21272	9469	0.0	2.2464885415566584
chr17	USP32	60223410	60223586	0	177	21272	9563	21272	9386	0.0	2.2663541444704878
chr17	APPBP2	60500398	60500487	96	90	87966	7651	87870	7561	1.0666666666666667	11.621478640391482
chr17	APPBP2	60496412	60496441	0	30	87966	7651	87966	7621	0.0	11.542579713948301
chr17	TBX2-AS1	61394621	61394738	0	118	0	1010	0	892	0.0	0.0
chr17	BRIP1	61783818	61783907	70	90	267276	10149	267206	10059	0.7777777777777778	26.563873148424296
chr17	BRIP1	61861909	61862075	0	167	267276	10149	267276	9982	0.0	26.775796433580446
chr17	INTS2	61921221	61921342	0	122	592728	8387	592728	8265	0.0	71.71542649727768
chr17	MARCHF10	62705538	62705581	0	44	79511	4528	79511	4484	0.0	17.732158786797502
chr17	MARCHF10	62746864	62746978	32744	115	79511	4528	46767	4413	284.7304347826087	10.59755268524813
chr17	MARCHF10	62804899	62805047	0	149	79511	4528	79511	4379	0.0	18.157341858871888
chr17	AC005972.3	62920405	62920608	0	204	15175	3000	15175	2796	0.0	5.427396280400572
chr17	CYB561	63435085	63435243	0	159	0	4066	0	3907	0.0	0.0
chr17	CYB561	63437345	63437560	0	216	0	4066	0	3850	0.0	0.0
chr17	CYB561	63437345	63437484	0	140	0	4066	0	3926	0.0	0.0
chr17	CYB561	63439111	63439290	0	180	0	4066	0	3886	0.0	0.0
chr17	STRADA	63717074	63717154	0	81	51	9568	51	9487	0.0	0.005375777379572046
chr17	STRADA	63704004	63704047	0	44	51	9568	51	9524	0.0	0.0053548929021419575
chr17	STRADA	63707246	63707418	0	173	51	9568	51	9395	0.0	0.005428419372006386
chr17	STRADA	63710490	63710614	0	125	51	9568	51	9443	0.0	0.0054008260086836814
chr17	STRADA	63714005	63714108	0	104	51	9568	51	9464	0.0	0.005388841927303466
chr17	STRADA	63723297	63723326	0	30	51	9568	51	9538	0.0	0.0053470329209477875
chr17	STRADA	63726637	63726695	0	59	51	9568	51	9509	0.0	0.005363339993690188
chr17	STRADA	63704340	63704582	0	243	51	9568	51	9325	0.0	0.00546916890080429
chr17	STRADA	63741167	63741253	0	87	51	9568	51	9481	0.0	0.005379179411454488
chr17	STRADA	63737395	63737436	0	42	51	9568	51	9526	0.0	0.00535376863321436
chr17	STRADA	63741453	63741663	0	211	51	9568	51	9357	0.0	0.0054504648925937805
chr17	CCDC47	63772776	63772863	0	88	1613	4370	1613	4282	0.0	0.37669313404950955
chr17	FTSJ3	63821983	63822168	0	186	306	4818	306	4632	0.0	0.06606217616580311
chr17	SMARCD2	63833297	63833420	7	124	257	3571	250	3447	0.056451612903225805	0.0725268349289237
chr17	SMARCD2	63837440	63837625	0	186	257	3571	257	3385	0.0	0.07592319054652881
chr17	CSH2	63873178	63873339	0	162	0	1177	0	1015	0.0	0.0
chr17	GH2	63881028	63881148	29	121	92	1160	63	1039	0.2396694214876033	0.06063522617901829
chr17	GH2	63881028	63881103	29	76	92	1160	63	1084	0.3815789473684211	0.058118081180811805
chr17	CSH1	63896074	63896235	0	162	0	1397	0	1235	0.0	0.0
chr17	CSHL1	63910861	63910924	0	64	0	1724	0	1660	0.0	0.0
chr17	GH1	63917759	63917924	0	166	0	993	0	827	0.0	0.0
chr17	GH1	63918016	63918091	0	76	0	993	0	917	0.0	0.0
chr17	GH1	63918345	63918506	0	162	0	993	0	831	0.0	0.0
chr17	GH1	63918016	63918136	0	121	0	993	0	872	0.0	0.0
chr17	CD79B	63930073	63930385	0	313	969	1764	969	1451	0.0	0.667815299793246
chr17	ICAM2	64007740	64007822	0	83	0	1706	0	1623	0.0	0.0
chr17	TEX2	64160800	64160933	408	134	5619	8923	5211	8789	3.044776119402985	0.5929002161793151
chr17	POLG2	64480288	64480389	0	102	452	4433	452	4331	0.0	0.1043638882475179
chr17	POLG2	64483389	64483506	0	118	452	4433	452	4315	0.0	0.10475086906141368
chr17	POLG2	64488842	64488937	0	96	452	4433	452	4337	0.0	0.1042195065713627
chr17	DDX5	64504221	64504318	42	98	5205	7977	5163	7879	0.42857142857142855	0.6552862038329738
chr17	DDX5	64504676	64504842	0	167	5205	7977	5205	7810	0.0	0.6664532650448144
chr17	DDX5	64500986	64501143	64	158	5205	7977	5141	7819	0.4050632911392405	0.657500959201944
chr17	DDX5	64506075	64506262	170	188	5205	7977	5035	7789	0.9042553191489362	0.646424444729747
chr17	DDX5	64506075	64506259	140	185	5205	7977	5065	7792	0.7567567567567568	0.6500256673511293
chr17	DDX5	64501056	64501143	39	88	5205	7977	5166	7889	0.4431818181818182	0.6548358473824313
chr17	DDX5	64504676	64504880	0	205	5205	7977	5205	7772	0.0	0.6697117858980958
chr17	SMURF2	64586085	64586170	0	86	3999	7235	3999	7149	0.0	0.5593789341166596
chr17	SMURF2	64606601	64606640	0	40	3999	7235	3999	7195	0.0	0.5558026407227241
chr17	SMURF2	64593990	64594104	0	115	3999	7235	3999	7120	0.0	0.5616573033707866
chr17	ARHGAP27P1-BPTFP1-KPNA2P3	64750593	64750723	0	131	2724	3051	2724	2920	0.0	0.9328767123287671
chr17	ARHGAP27P1-BPTFP1-KPNA2P3	64779980	64780205	255	226	2724	3051	2469	2825	1.1283185840707965	0.8739823008849558
chr17	PLEKHM1P1	64824624	64824872	0	249	248895	8489	248895	8240	0.0	30.205703883495147
chr17	PLEKHM1P1	64814862	64815245	306	384	248895	8489	248589	8105	0.796875	30.671067242442938
chr17	LRRC37A3	64858778	64858883	0	106	55	7658	55	7552	0.0	0.007282838983050847
chr17	LRRC37A3	64889680	64889752	0	73	55	7658	55	7585	0.0	0.007251153592617007
chr17	LRRC37A3	64918749	64918870	0	122	55	7658	55	7536	0.0	0.0072983014861995755
chr17	LRRC37A3	64894648	64897654	0	3007	55	7658	55	4651	0.0	0.011825413889486132
chr17	AMZ2P1	64969314	64969425	817	112	1129	3863	312	3751	7.294642857142857	0.08317781924820047
chr17	AXIN2	65536868	65537063	0	196	4557	5238	4557	5042	0.0	0.9038080126933756
chr17	CEP112	65661735	65661814	0	80	5108	7937	5108	7857	0.0	0.6501209112892962
chr17	APOH	66214452	66214650	306	199	3442	1342	3136	1143	1.5376884422110553	2.7436570428696414
chr17	HELZ	67179595	67179736	0	142	1939	15615	1939	15473	0.0	0.1253150649518516
chr17	PSMD12	67357518	67357578	0	61	340	5355	340	5294	0.0	0.06422364941443143
chr17	PSMD12	67362775	67362892	0	118	340	5355	340	5237	0.0	0.06492266564827191
chr17	PSMD12	67361094	67361261	0	168	340	5355	340	5187	0.0	0.06554848660111819
chr17	AC145343.1	68100551	68100708	0	158	0	675	0	517	0.0	0.0
chr17	LRRC37A16P	68134098	68134149	0	52	102	3794	102	3742	0.0	0.027258150721539285
chr17	SLC16A6	68273926	68274070	0	145	51	4068	51	3923	0.0	0.01300025490695896
chr17	SLC16A6	68282996	68283123	0	128	51	4068	51	3940	0.0	0.012944162436548223
chr17	SLC16A6	68285544	68285642	0	99	51	4068	51	3969	0.0	0.012849584278155708
chr17	WIPI1	68434555	68434626	0	72	46	3414	46	3342	0.0	0.01376421304608019
chr17	WIPI1	68452909	68452992	0	84	46	3414	46	3330	0.0	0.013813813813813814
chr17	FAM20A	68590123	68590349	0	227	153	6194	153	5967	0.0	0.02564102564102564
chr17	ABCA8	68918426	68918546	0	121	34	10965	34	10844	0.0	0.003135374400590188
chr17	ABCA8	68949311	68949472	0	162	34	10965	34	10803	0.0	0.003147273905396649
chr17	ABCA8	68941938	68942039	0	102	34	10965	34	10863	0.0	0.003129890453834116
chr17	ABCA9	69007758	69007872	0	115	51	9065	51	8950	0.0	0.005698324022346369
chr17	ABCA9	69051539	69051755	0	217	51	9065	51	8848	0.0	0.005764014466546112
chr17	ABCA10	69153470	69153546	0	77	226	8379	226	8302	0.0	0.027222356058781018
chr17	ABCA10	69174606	69174777	0	172	226	8379	226	8207	0.0	0.027537468015109052
chr17	ABCA10	69201499	69201668	0	170	226	8379	226	8209	0.0	0.027530758923133145
chr17	ABCA10	69221791	69221895	0	105	226	8379	226	8274	0.0	0.027314479091128836
chr17	ABCA10	69178919	69179008	0	90	226	8379	226	8289	0.0	0.027265050066353
chr17	ABCA10	69196285	69196483	0	199	226	8379	226	8180	0.0	0.02762836185819071
chr17	ABCA10	69196245	69196483	0	239	226	8379	226	8140	0.0	0.027764127764127764
chr17	ABCA5	69251746	69251866	0	121	0	13202	0	13081	0.0	0.0
chr17	ABCA5	69285387	69285420	0	34	0	13202	0	13168	0.0	0.0
chr17	ABCA5	69325698	69325817	0	120	0	13202	0	13082	0.0	0.0
chr17	ABCA5	69317704	69317823	0	120	0	13202	0	13082	0.0	0.0
chr17	CASC17	71132361	71132470	0	110	11917	2897	11917	2787	0.0	4.275923932543954
chr17	CASC17	71132389	71132470	0	82	11917	2897	11917	2815	0.0	4.233392539964476
chr17	CASC17	71131135	71131322	0	188	11917	2897	11917	2709	0.0	4.399040236249538
chr17	CASC17	71180109	71180212	0	104	11917	2897	11917	2793	0.0	4.266738274257071
chr17	CASC17	71168613	71168687	0	75	11917	2897	11917	2822	0.0	4.22289156626506
chr17	CASC17	71185595	71185655	220	61	11917	2897	11697	2836	3.6065573770491803	4.124471086036672
chr17	CASC17	71134616	71134814	0	199	11917	2897	11917	2698	0.0	4.416975537435137
chr17	CASC17	71200593	71200658	4243	66	11917	2897	7674	2831	64.28787878787878	2.71070293182621
chr17	CASC17	71136876	71137010	0	135	11917	2897	11917	2762	0.0	4.3146270818247645
chr17	CASC17	71168603	71168687	0	85	11917	2897	11917	2812	0.0	4.237908961593172
chr17	ROCR	72024152	72024304	0	153	14	3480	14	3327	0.0	0.004207995190862639
chr17	ROCR	72040515	72040582	14	68	14	3480	0	3412	0.20588235294117646	0.0
chr17	ROCR	72025897	72025977	0	81	14	3480	14	3399	0.0	0.004118858487790526
chr17	ROCR	72040689	72040849	0	161	14	3480	14	3319	0.0	0.004218137993371497
chr17	SOX9-AS1	72082121	72082415	0	295	0	11672	0	11377	0.0	0.0
chr17	SOX9-AS1	72071062	72071231	0	170	0	11672	0	11502	0.0	0.0
chr17	SOX9-AS1	72084989	72085045	0	57	0	11672	0	11615	0.0	0.0
chr17	SOX9-AS1	72074548	72076733	0	2186	0	11672	0	9486	0.0	0.0
chr17	SOX9-AS1	72081359	72081401	0	43	0	11672	0	11629	0.0	0.0
chr17	SOX9-AS1	72114205	72114400	0	196	0	11672	0	11476	0.0	0.0
chr17	SOX9-AS1	72081372	72081401	0	30	0	11672	0	11642	0.0	0.0
chr17	SOX9-AS1	72090726	72091104	0	379	0	11672	0	11293	0.0	0.0
chr17	SOX9-AS1	72086492	72086545	0	54	0	11672	0	11618	0.0	0.0
chr17	LINC00511	72431127	72431224	0	98	504	21819	504	21721	0.0	0.02320335159523042
chr17	LINC00511	72324431	72324651	0	221	504	21819	504	21598	0.0	0.02333549402722474
chr17	LINC00511	72326307	72326430	0	124	504	21819	504	21695	0.0	0.023231159253284166
chr17	LINC00511	72325388	72325517	0	130	504	21819	504	21689	0.0	0.02323758587302319
chr17	LINC00511	72428235	72428298	29	64	504	21819	475	21755	0.453125	0.021834061135371178
chr17	LINC00511	72324021	72324150	0	130	504	21819	504	21689	0.0	0.02323758587302319
chr17	LINC00511	72325388	72325562	0	175	504	21819	504	21644	0.0	0.02328589909443726
chr17	LINC00511	72327995	72328096	16	102	504	21819	488	21717	0.1568627450980392	0.022470875351107426
chr17	LINC00511	72326307	72326377	0	71	504	21819	504	21748	0.0	0.023174544785727422
chr17	LINC00511	72323742	72324150	0	409	504	21819	504	21410	0.0	0.023540401681457265
chr17	LINC00511	72325792	72325946	0	155	504	21819	504	21664	0.0	0.02326440177252585
chr17	LINC00511	72324539	72324651	0	113	504	21819	504	21706	0.0	0.02321938634478946
chr17	LINC00511	72339501	72339569	0	69	504	21819	504	21750	0.0	0.023172413793103447
chr17	LINC00511	72420699	72420964	0	266	504	21819	504	21553	0.0	0.023384215654433257
chr17	LINC00511	72420699	72421066	0	368	504	21819	504	21451	0.0	0.023495408139480676
chr17	LINC00511	72469574	72469656	0	83	504	21819	504	21736	0.0	0.02318733897681266
chr17	LINC00511	72533309	72533371	0	63	504	21819	504	21756	0.0	0.023166023166023165
chr17	LINC00511	72586653	72586825	0	173	504	21819	504	21646	0.0	0.023283747574609628
chr17	LINC00511	72507173	72507278	0	106	504	21819	504	21713	0.0	0.023211900704646987
chr17	LINC00511	72583043	72583138	0	96	504	21819	504	21723	0.0	0.0232012153017539
chr17	LINC00511	72599088	72599144	0	57	504	21819	504	21762	0.0	0.02315963606286187
chr17	LINC00511	72533974	72534077	0	104	504	21819	504	21715	0.0	0.02320976283674879
chr17	SLC39A11	73084807	73084846	314	40	3765	5564	3451	5524	7.85	0.6247284576393918
chr17	SLC39A11	72817869	72817935	0	67	3765	5564	3765	5497	0.0	0.6849190467527743
chr17	SLC39A11	73091823	73092116	51	294	3765	5564	3714	5270	0.17346938775510204	0.7047438330170778
chr17	FAM104A	73227164	73227264	1035	101	79673	3169	78638	3068	10.247524752475247	25.63168187744459
chr17	FAM104A	73212677	73212740	593	64	79673	3169	79080	3105	9.265625	25.468599033816425
chr17	FAM104A	73227164	73227182	321	19	79673	3169	79352	3150	16.894736842105264	25.191111111111113
chr17	CDC42EP4	73286713	73286853	0	141	3766	3030	3766	2889	0.0	1.303565247490481
chr17	SDK2	73380893	73380950	0	58	25521	12010	25521	11952	0.0	2.1352911646586343
chr17	LINC02074	74106879	74106981	0	103	609	2190	609	2087	0.0	0.29180642069956875
chr17	LINC02074	74096632	74096728	0	97	609	2190	609	2093	0.0	0.2909698996655518
chr17	CD300H	74562833	74562897	0	65	114977	610	114977	545	0.0	210.96697247706422
chr17	AC064805.2	74676277	74676468	83520	192	157190	3376	73670	3184	435.0	23.137562814070353
chr17	AC064805.2	74676277	74676465	83034	189	157190	3376	74156	3187	439.3333333333333	23.268277376843425
chr17	CD300LF	74696194	74696217	0	24	6164	2170	6164	2146	0.0	2.8723205964585277
chr17	CD300LF	74698368	74698481	1792	114	6164	2170	4372	2056	15.719298245614034	2.1264591439688716
chr17	CD300LF	74705203	74705377	5	175	6164	2170	6159	1995	0.02857142857142857	3.087218045112782
chr17	CD300LF	74698575	74698621	35	47	6164	2170	6129	2123	0.7446808510638298	2.8869524258125296
chr17	NAT9	74775621	74775707	0	87	21099	2692	21099	2605	0.0	8.099424184261036
chr17	NAT9	74775621	74775852	0	232	21099	2692	21099	2460	0.0	8.576829268292682
chr17	NAT9	74772482	74772576	8784	95	21099	2692	12315	2597	92.46315789473684	4.74201001155179
chr17	NAT9	74773865	74774055	2818	191	21099	2692	18281	2501	14.75392670157068	7.309476209516194
chr17	NAT9	74773865	74773939	795	75	21099	2692	20304	2617	10.6	7.758502101643103
chr17	NAT9	74773992	74774055	1213	64	21099	2692	19886	2628	18.953125	7.566971080669711
chr17	FDXR	74863895	74864067	0	173	102	3392	102	3219	0.0	0.03168685927306617
chr17	FDXR	74864479	74864564	0	86	102	3392	102	3306	0.0	0.030852994555353903
chr17	FDXR	74866445	74866568	0	124	102	3392	102	3268	0.0	0.031211750305997554
chr17	FDXR	74866445	74866544	0	100	102	3392	102	3292	0.0	0.030984204131227218
chr17	FDXR	74869949	74870102	0	154	102	3392	102	3238	0.0	0.03150092649783817
chr17	FDXR	74872197	74872316	0	120	102	3392	102	3272	0.0	0.03117359413202934
chr17	FADS6	74881067	74881255	1305	189	3284	2811	1979	2622	6.904761904761905	0.7547673531655225
chr17	FADS6	74892522	74892689	0	168	3284	2811	3284	2643	0.0	1.2425274309496783
chr17	HID1	74964482	74964632	153	151	255	5791	102	5640	1.0132450331125828	0.018085106382978722
chr17	HID1	74963739	74963910	0	172	255	5791	255	5619	0.0	0.04538174052322477
chr17	ATP5PD	75040091	75040163	0	73	51	2588	51	2515	0.0	0.020278330019880716
chr17	ATP5PD	75039871	75040041	0	171	51	2588	51	2417	0.0	0.021100537856847332
chr17	NT5C	75130752	75130867	0	116	0	1396	0	1280	0.0	0.0
chr17	JPT1	75146665	75146684	450	20	2233	2939	1783	2919	22.5	0.6108256252141144
chr17	JPT1	75149090	75149185	0	96	2233	2939	2233	2843	0.0	0.7854379176925783
chr17	SUMO2	75174751	75174823	0	73	408	3353	408	3280	0.0	0.12439024390243902
chr17	GGA3	75238913	75239083	522	171	1734	4272	1212	4101	3.0526315789473686	0.2955376737381127
chr17	GGA3	75243062	75243166	0	105	1734	4272	1734	4167	0.0	0.41612670986321093
chr17	GGA3	75244618	75244717	0	100	1734	4272	1734	4172	0.0	0.4156279961649089
chr17	GGA3	75248839	75249008	0	170	1734	4272	1734	4102	0.0	0.4227206240858118
chr17	GGA3	75237981	75238090	0	110	1734	4272	1734	4162	0.0	0.4166266218164344
chr17	GGA3	75238913	75239018	334	106	1734	4272	1400	4166	3.150943396226415	0.3360537686029765
chr17	GGA3	75243062	75243258	0	197	1734	4272	1734	4075	0.0	0.42552147239263804
chr17	GGA3	75244401	75244490	0	90	1734	4272	1734	4182	0.0	0.4146341463414634
chr17	MIF4GD	75267745	75267901	0	157	153	3393	153	3236	0.0	0.047280593325092705
chr17	MIF4GD	75269346	75269448	45	103	153	3393	108	3290	0.4368932038834951	0.03282674772036474
chr17	MIF4GD	75269346	75269469	51	124	153	3393	102	3269	0.4112903225806452	0.03120220250841236
chr17	MIF4GD	75268082	75268192	15	111	153	3393	138	3282	0.13513513513513514	0.04204753199268738
chr17	SLC25A19	75288501	75288591	357	91	816	2966	459	2875	3.923076923076923	0.15965217391304348
chr17	SLC25A19	75283422	75283593	0	172	816	2966	816	2794	0.0	0.29205440229062274
chr17	SLC25A19	75286632	75286802	39	171	816	2966	777	2795	0.22807017543859648	0.27799642218246867
chr17	SLC25A19	75288553	75288591	105	39	816	2966	711	2927	2.6923076923076925	0.2429108302015716
chr17	SLC25A19	75288387	75288461	0	75	816	2966	816	2891	0.0	0.2822552749913525
chr17	SLC25A19	75288387	75288591	357	205	816	2966	459	2761	1.7414634146341463	0.16624411445128576
chr17	GRB2	75321658	75321827	0	170	1327	3442	1327	3272	0.0	0.40556234718826406
chr17	GRB2	75325897	75326020	408	124	1327	3442	919	3318	3.2903225806451615	0.2769740807715491
chr17	RECQL5	75650516	75650718	0	203	0	7229	0	7026	0.0	0.0
chr17	GALK1	75763580	75763667	0	88	0	1926	0	1838	0.0	0.0
chr17	UNC13D	75830027	75830151	0	125	0	6820	0	6695	0.0	0.0
chr17	WBP2	75846907	75846984	0	78	0	4661	0	4583	0.0	0.0
chr17	WBP2	75847795	75847930	0	136	0	4661	0	4525	0.0	0.0
chr17	WBP2	75848569	75848662	0	94	0	4661	0	4567	0.0	0.0
chr17	WBP2	75851567	75851676	0	110	0	4661	0	4551	0.0	0.0
chr17	WBP2	75852655	75852820	0	166	0	4661	0	4495	0.0	0.0
chr17	TRIM65	75891812	75891878	0	67	102	3908	102	3841	0.0	0.0265555844832075
chr17	TRIM65	75892010	75892185	0	176	102	3908	102	3732	0.0	0.027331189710610933
chr17	MRPL38	75904539	75904719	0	181	0	3049	0	2868	0.0	0.0
chr17	MRPL38	75904539	75904673	0	135	0	3049	0	2914	0.0	0.0
chr17	FBF1	75910692	75910806	0	115	114	6205	114	6090	0.0	0.0187192118226601
chr17	FBF1	75935631	75935673	0	43	114	6205	114	6162	0.0	0.018500486854917234
chr17	ACOX1	75960214	75960375	0	162	112	6842	112	6680	0.0	0.016766467065868262
chr17	ACOX1	75973624	75973785	0	162	112	6842	112	6680	0.0	0.016766467065868262
chr17	ACOX1	75957458	75957566	0	109	112	6842	112	6733	0.0	0.01663448685578494
chr17	SRP68	76067216	76067330	182	115	8441	7056	8259	6941	1.5826086956521739	1.1898861835470393
chr17	EXOC7	76084247	76084289	0	43	23202	5674	23202	5631	0.0	4.120404901438466
chr17	EXOC7	76086079	76086145	102	67	23202	5674	23100	5607	1.5223880597014925	4.119850187265918
chr17	EXOC7	76091142	76091235	0	94	23202	5674	23202	5580	0.0	4.158064516129032
chr17	EXOC7	76089174	76089320	1227	147	23202	5674	21975	5527	8.346938775510203	3.9759363126470055
chr17	EXOC7	76090328	76090481	0	154	23202	5674	23202	5520	0.0	4.203260869565217
chr17	EXOC7	76086853	76086892	0	40	23202	5674	23202	5634	0.0	4.118210862619808
chr17	EXOC7	76090328	76090397	0	70	23202	5674	23202	5604	0.0	4.140256959314775
chr17	EXOC7	76101678	76101863	4812	186	23202	5674	18390	5488	25.870967741935484	3.3509475218658893
chr17	RNF157	76155251	76155317	0	67	137861	5950	137861	5883	0.0	23.433792282848888
chr17	RNF157	76147268	76147309	0	42	137861	5950	137861	5908	0.0	23.334631008801626
chr17	QRICH2	76277162	76277310	0	149	115	5795	115	5646	0.0	0.02036840240878498
chr17	RHBDF2	76479732	76479941	0	210	2682	6598	2682	6388	0.0	0.4198497182216656
chr17	RHBDF2	76479732	76479854	0	123	2682	6598	2682	6475	0.0	0.4142084942084942
chr17	RHBDF2	76487973	76488132	0	160	2682	6598	2682	6438	0.0	0.41658900279589933
chr17	RHBDF2	76488014	76488132	0	119	2682	6598	2682	6479	0.0	0.41395277048927304
chr17	CYGB	76530978	76531142	0	165	0	2760	0	2595	0.0	0.0
chr17	AC015802.4	76557171	76557297	0	127	0	1500	0	1373	0.0	0.0
chr17	ST6GALNAC2	76568712	76568796	0	85	0	2785	0	2700	0.0	0.0
chr17	ST6GALNAC2	76578755	76578816	0	62	0	2785	0	2723	0.0	0.0
chr17	ST6GALNAC2	76568712	76568913	0	202	0	2785	0	2583	0.0	0.0
chr17	ST6GALNAC2	76580970	76581052	0	83	0	2785	0	2702	0.0	0.0
chr17	ST6GALNAC1	76626288	76626392	0	105	59	3207	59	3102	0.0	0.019019987105093488
chr17	ST6GALNAC1	76626650	76626789	0	140	59	3207	59	3067	0.0	0.019237039452233453
chr17	ST6GALNAC1	76637599	76637736	0	138	59	3207	59	3069	0.0	0.019224503095470837
chr17	ST6GALNAC1	76641807	76641904	0	98	59	3207	59	3109	0.0	0.018977163074943713
chr17	MXRA7	76683846	76683927	0	82	205361	8772	205361	8690	0.0	23.63187571921749
chr17	JMJD6	76720359	76720498	0	140	2029	5977	2029	5837	0.0	0.34761007366798014
chr17	JMJD6	76721262	76721356	0	95	2029	5977	2029	5882	0.0	0.3449506970418225
chr17	JMJD6	76721262	76721351	0	90	2029	5977	2029	5887	0.0	0.3446577204008833
chr17	SRSF2	76735771	76735875	0	105	0	2637	0	2532	0.0	0.0
chr17	TMC6	78120652	78120832	73456	181	808848	11377	735392	11196	405.83425414364643	65.68345837799214
chr17	TMC6	78124888	78124985	0	98	808848	11377	808848	11279	0.0	71.7127404911783
chr17	TMC6	78126776	78126906	0	131	808848	11377	808848	11246	0.0	71.92317268362085
chr17	TMC6	78120408	78120555	0	148	808848	11377	808848	11229	0.0	72.03205984504409
chr17	TMC6	78126776	78126974	0	199	808848	11377	808848	11178	0.0	72.36070853462158
chr17	TK1	78182588	78182682	112	95	33389	1240	33277	1145	1.1789473684210525	29.06288209606987
chr17	TK1	78183753	78183777	3952	25	33389	1240	29437	1215	158.08	24.22798353909465
chr17	DNAH17	78428524	78428707	0	184	411093	16192	411093	16008	0.0	25.680472263868065
chr17	DNAH17	78441050	78441199	198050	150	411093	16192	213043	16042	1320.3333333333333	13.28032664256327
chr17	SCAT1	78627917	78628035	55	119	10626	4114	10571	3995	0.46218487394957986	2.646057571964956
chr17	SCAT1	78628317	78628438	561	122	10626	4114	10065	3992	4.598360655737705	2.5212925851703405
chr17	SCAT1	78621666	78621733	0	68	10626	4114	10626	4046	0.0	2.6262975778546713
chr17	SCAT1	78630031	78630141	0	111	10626	4114	10626	4003	0.0	2.654509118161379
chr17	SCAT1	78618029	78618208	51	180	10626	4114	10575	3934	0.2833333333333333	2.688103711235384
chr17	SCAT1	78629620	78629822	0	203	10626	4114	10626	3911	0.0	2.716952186141652
chr17	SCAT1	78623553	78623750	0	198	10626	4114	10626	3916	0.0	2.7134831460674156
chr17	CYTH1	78696006	78696009	0	4	8396	6766	8396	6762	0.0	1.2416444838805087
chr17	CYTH1	78702537	78702604	0	68	8396	6766	8396	6698	0.0	1.253508510002986
chr17	CYTH1	78709649	78709732	0	84	8396	6766	8396	6682	0.0	1.2565100269380425
chr17	USP36	78797785	78797879	0	95	29811	7560	29811	7465	0.0	3.993436034829203
chr17	USP36	78796316	78796494	0	179	29811	7560	29811	7381	0.0	4.038883620105676
chr17	USP36	78797785	78797902	0	118	29811	7560	29811	7442	0.0	4.0057780166621875
chr17	USP36	78823112	78823183	0	72	29811	7560	29811	7488	0.0	3.981169871794872
chr17	LGALS3BP	78975964	78976156	1940	193	42414	2991	40474	2798	10.05181347150259	14.465332380271622
chr17	LGALS3BP	78972969	78973222	20734	254	42414	2991	21680	2737	81.62992125984252	7.9210814760686885
chr17	LGALS3BP	78972969	78973343	32966	375	42414	2991	9448	2616	87.90933333333334	3.611620795107034
chr17	LGALS3BP	78979445	78979586	51	142	42414	2991	42363	2849	0.3591549295774648	14.86942786942787
chr17	LGALS3BP	78976942	78977000	0	59	42414	2991	42414	2932	0.0	14.465893587994543
chr17	LGALS3BP	78977403	78977473	0	71	42414	2991	42414	2920	0.0	14.525342465753425
chr17	CANT1	78997839	78997963	0	125	6401	4029	6401	3904	0.0	1.6396004098360655
chr17	CANT1	78998147	78998286	0	140	6401	4029	6401	3889	0.0	1.6459244021599382
chr17	CANT1	79000099	79000270	0	172	6401	4029	6401	3857	0.0	1.6595799844438683
chr17	CANT1	79005371	79005481	2023	111	6401	4029	4378	3918	18.225225225225227	1.1174068402246045
chr17	RBFOX3	79103161	79103254	0	94	86575	9894	86575	9800	0.0	8.834183673469388
chr17	CBX8	79796496	79796540	0	45	1317881	4132	1317881	4087	0.0	322.4568142892097
chr17	TBC1D16	79951985	79952195	0	211	71705	11595	71705	11384	0.0	6.298752635277583
chr17	EIF4A3	80141318	80141381	6	64	43004	4553	42998	4489	0.09375	9.578525284027624
chr17	AC087741.1	80204498	80204596	1654	99	261377	2062	259723	1963	16.707070707070706	132.30922058074376
chr17	SGSH	80214614	80214765	3139	152	319886	3964	316747	3812	20.651315789473685	83.09207764952781
chr17	SGSH	80215032	80215138	1215	107	319886	3964	318671	3857	11.355140186915888	82.62146746175785
chr17	SGSH	80211868	80211923	942	56	319886	3964	318944	3908	16.821428571428573	81.61310133060388
chr17	SGSH	80214614	80214679	1630	66	319886	3964	318256	3898	24.696969696969695	81.64597229348384
chr17	SGSH	80214614	80214783	3411	170	319886	3964	316475	3794	20.064705882352943	83.41460200316288
chr17	AATK	81126657	81126817	0	161	48	5255	48	5094	0.0	0.009422850412249705
chr17	CEP131	81192735	81192843	494	109	1932	3992	1438	3883	4.532110091743119	0.3703322173577131
chr17	TEPSIN	81232314	81232518	0	205	0	4141	0	3936	0.0	0.0
chr17	TEPSIN	81237550	81237660	0	111	0	4141	0	4030	0.0	0.0
chr17	SLC38A10	81272515	81272627	0	113	0	6833	0	6720	0.0	0.0
chr17	SLC38A10	81250069	81250093	0	25	0	6833	0	6808	0.0	0.0
chr17	AC110285.1	81381876	81381940	0	65	0	2396	0	2331	0.0	0.0
chr17	AC110285.1	81384945	81385032	0	88	0	2396	0	2308	0.0	0.0
chr17	ACTG1	81511762	81511803	0	42	0	2143	0	2101	0.0	0.0
chr17	FAAP100	81546400	81546540	0	141	0	5365	0	5224	0.0	0.0
chr17	FAAP100	81551927	81552052	0	126	0	5365	0	5239	0.0	0.0
chr17	NPLOC4	81608727	81608822	0	96	0	7339	0	7243	0.0	0.0
chr17	NPLOC4	81610209	81610258	0	50	0	7339	0	7289	0.0	0.0
chr17	NPLOC4	81563920	81563979	0	60	0	7339	0	7279	0.0	0.0
chr17	NPLOC4	81560561	81560629	0	69	0	7339	0	7270	0.0	0.0
chr17	NPLOC4	81567953	81568075	0	123	0	7339	0	7216	0.0	0.0
chr17	NPLOC4	81563412	81563568	0	157	0	7339	0	7182	0.0	0.0
chr17	PDE6G	81653159	81653364	0	206	0	1101	0	895	0.0	0.0
chr17	ARL16	81683012	81683126	0	115	0	2599	0	2484	0.0	0.0
chr17	ARL16	81682490	81682675	0	186	0	2599	0	2413	0.0	0.0
chr17	ARL16	81682442	81682675	0	234	0	2599	0	2365	0.0	0.0
chr17	MCRIP1	81823411	81823513	0	103	0	3547	0	3444	0.0	0.0
chr17	MCRIP1	81826379	81826515	0	137	0	3547	0	3410	0.0	0.0
chr17	P4HB	81855452	81855586	0	135	0	4717	0	4582	0.0	0.0
chr17	P4HB	81859180	81859387	0	208	0	4717	0	4509	0.0	0.0
chr17	P4HB	81855141	81855279	0	139	0	4717	0	4578	0.0	0.0
chr17	P4HB	81855452	81855505	0	54	0	4717	0	4663	0.0	0.0
chr17	ARHGDIA	81869329	81869406	0	78	0	2533	0	2455	0.0	0.0
chr17	ARHGDIA	81869055	81869075	0	21	0	2533	0	2512	0.0	0.0
chr17	PCYT2	81905381	81905447	0	67	0	6666	0	6599	0.0	0.0
chr17	PCYT2	81906099	81906177	0	79	0	6666	0	6587	0.0	0.0
chr17	PCYT2	81907553	81907598	0	46	0	6666	0	6620	0.0	0.0
chr17	PCYT2	81908875	81909037	0	163	0	6666	0	6503	0.0	0.0
chr17	PCYT2	81908875	81909321	0	447	0	6666	0	6219	0.0	0.0
chr17	PCYT2	81907203	81907257	0	55	0	6666	0	6611	0.0	0.0
chr17	PCYT2	81910900	81911015	0	116	0	6666	0	6550	0.0	0.0
chr17	PCYT2	81909161	81909321	0	161	0	6666	0	6505	0.0	0.0
chr17	SIRT7	81917614	81917719	0	106	0	5292	0	5186	0.0	0.0
chr17	SIRT7	81917829	81917967	0	139	0	5292	0	5153	0.0	0.0
chr17	SIRT7	81916057	81916139	0	83	0	5292	0	5209	0.0	0.0
chr17	MAFG	81923352	81923416	0	65	0	5245	0	5180	0.0	0.0
chr17	PYCR1	81934325	81934489	0	165	0	2584	0	2419	0.0	0.0
chr17	PYCR1	81934652	81934745	0	94	0	2584	0	2490	0.0	0.0
chr17	CENPX	82019640	82019694	0	55	0	1407	0	1352	0.0	0.0
chr17	CENPX	82019509	82019694	0	186	0	1407	0	1221	0.0	0.0
chr17	DCXR	82037449	82037547	0	99	0	1446	0	1347	0.0	0.0
chr17	DCXR	82037449	82037541	0	93	0	1446	0	1353	0.0	0.0
chr17	RFNG	82049917	82050006	0	90	0	2763	0	2673	0.0	0.0
chr17	DUS1L	82063467	82063518	0	52	0	3907	0	3855	0.0	0.0
chr17	CCDC57	82179026	82179189	0	164	0	9455	0	9291	0.0	0.0
chr17	CCDC57	82207846	82208048	0	203	0	9455	0	9252	0.0	0.0
chr17	CCDC57	82107401	82107621	0	221	0	9455	0	9234	0.0	0.0
chr17	CCDC57	82108767	82108954	0	188	0	9455	0	9267	0.0	0.0
chr17	CCDC57	82207730	82208048	0	319	0	9455	0	9136	0.0	0.0
chr17	CSNK1D	82253015	82253244	0	230	0	8237	0	8007	0.0	0.0
chr17	CSNK1D	82255428	82255577	0	150	0	8237	0	8087	0.0	0.0
chr17	CSNK1D	82265685	82265796	0	112	0	8237	0	8125	0.0	0.0
chr17	CSNK1D	82245975	82246039	0	65	0	8237	0	8172	0.0	0.0
chr17	CSNK1D	82249697	82250179	0	483	0	8237	0	7754	0.0	0.0
chr17	CSNK1D	82266724	82266894	0	171	0	8237	0	8066	0.0	0.0
chr17	SECTM1	82323256	82323316	0	61	0	2913	0	2852	0.0	0.0
chr17	SECTM1	82329258	82329466	0	209	0	2913	0	2704	0.0	0.0
chr17	OGFOD3	82409367	82409410	0	44	0	3642	0	3598	0.0	0.0
chr17	OGFOD3	82394330	82394543	0	214	0	3642	0	3428	0.0	0.0
chr17	CYBC1	82446622	82446696	0	75	0	3566	0	3491	0.0	0.0
chr17	CYBC1	82447579	82447621	0	43	0	3566	0	3523	0.0	0.0
chr17	CYBC1	82449169	82449292	0	124	0	3566	0	3442	0.0	0.0
chr17	CYBC1	82449430	82449480	0	51	0	3566	0	3515	0.0	0.0
chr17	CYBC1	82447579	82447646	0	68	0	3566	0	3498	0.0	0.0
chr17	CYBC1	82446622	82446692	0	71	0	3566	0	3495	0.0	0.0
chr17	CYBC1	82450198	82450254	0	57	0	3566	0	3509	0.0	0.0
chr17	CYBC1	82447850	82447927	0	78	0	3566	0	3488	0.0	0.0
chr17	CYBC1	82449173	82449292	0	120	0	3566	0	3446	0.0	0.0
chr17	WDR45B	82630920	82631022	0	103	0	3536	0	3433	0.0	0.0
chr17	WDR45B	82629530	82629628	0	99	0	3536	0	3437	0.0	0.0
chr17	RAB40B	82658490	82658713	0	224	0	4927	0	4703	0.0	0.0
chr17	RAB40B	82696388	82696853	0	466	0	4927	0	4461	0.0	0.0
chr17	RAB40B	82658490	82658562	0	73	0	4927	0	4854	0.0	0.0
chr17	B3GNTL1	83005574	83005671	0	98	0	6597	0	6499	0.0	0.0
chr17	TLCD3A	737845	738047	0	203	255	2606	255	2403	0.0	0.10611735330836454
chr17	TLCD3A	740504	740600	0	97	255	2606	255	2509	0.0	0.10163411717815862
chr17	MRM3	783082	783327	216	246	555	1989	339	1743	0.8780487804878049	0.1944922547332186
chr17	WDR81	1731067	1731258	13976	192	20536	8095	6560	7903	72.79166666666667	0.8300645324560294
chr17	WDR81	1727989	1728626	48	638	20536	8095	20488	7457	0.07523510971786834	2.7474855840150196
chr17	WDR81	1730379	1730487	476	109	20536	8095	20060	7986	4.36697247706422	2.5118958176809416
chr17	SERPINF1	1766902	1766994	600	93	7858	2082	7258	1989	6.451612903225806	3.649069884364002
chr17	RPA1	1888674	1888851	0	178	4367	5478	4367	5300	0.0	0.8239622641509434
chr17	DPH1	2035969	2036091	484	123	8460	4551	7976	4428	3.934959349593496	1.80126467931346
chr17	SRR	2309776	2309990	3683	215	143032	3263	139349	3048	17.130232558139536	45.71817585301837
chr17	SRR	2315556	2315728	0	173	143032	3263	143032	3090	0.0	46.288673139158576
chr17	SGSM2	2343544	2343620	0	77	5914	7230	5914	7153	0.0	0.8267859639312176
chr17	SGSM2	2362837	2362905	0	69	5914	7230	5914	7161	0.0	0.8258623097332775
chr17	SGSM2	2367270	2367405	51	136	5914	7230	5863	7094	0.375	0.826473075838737
chr17	SGSM2	2379431	2379493	0	63	5914	7230	5914	7167	0.0	0.8251709222826845
chr17	PAFAH1B1	2665371	2665456	51	86	135004	9736	134953	9650	0.5930232558139535	13.984766839378239
chr17	PAFAH1B1	2666015	2666090	0	76	135004	9736	135004	9660	0.0	13.975569358178054
chr17	PAFAH1B1	2638098	2638320	88	223	135004	9736	134916	9513	0.39461883408071746	14.18227688426364
chr17	PAFAH1B1	2672654	2672757	0	104	135004	9736	135004	9632	0.0	14.016196013289036
chr17	PAFAH1B1	2676504	2676606	0	103	135004	9736	135004	9633	0.0	14.01474099449808
chr17	PAFAH1B1	2613657	2613862	2061	206	135004	9736	132943	9530	10.004854368932039	13.949947534102833
chr17	PAFAH1B1	2653853	2653951	0	99	135004	9736	135004	9637	0.0	14.008923938985161
chr17	PAFAH1B1	2662780	2662834	0	55	135004	9736	135004	9681	0.0	13.945253589505217
chr17	PAFAH1B1	2605760	2605837	0	78	135004	9736	135004	9658	0.0	13.978463449989645
chr17	PAFAH1B1	2635382	2635510	78	129	135004	9736	134926	9607	0.6046511627906976	14.044550848339751
chr17	RAP1GAP2	2962669	2962714	0	46	102	6883	102	6837	0.0	0.01491882404563405
chr17	CTNS	3640187	3640267	0	81	1581	4697	1581	4616	0.0	0.3425043327556326
chr17	CTNS	3648846	3648931	0	86	1581	4697	1581	4611	0.0	0.3428757319453481
chr17	CTNS	3647443	3647522	0	80	1581	4697	1581	4617	0.0	0.3424301494476933
chr17	SPNS3	4445031	4445168	33746	138	55571	2445	21825	2307	244.53623188405797	9.460338101430429
chr17	SPNS3	4449234	4449387	2459	154	55571	2445	53112	2291	15.967532467532468	23.18288956787429
chr17	SPNS2	4536262	4536426	0	165	408	4080	408	3915	0.0	0.10421455938697317
chr17	SMTNL2	4592928	4593171	64	244	607340	2410	607276	2166	0.26229508196721313	280.3674976915974
chr17	ARRB2	4715012	4715043	424	32	141399	3784	140975	3752	13.25	37.573294243070364
chr17	ARRB2	4715972	4716033	1184	62	141399	3784	140215	3722	19.096774193548388	37.671950564212786
chr17	ARRB2	4716146	4716191	1005	46	141399	3784	140394	3738	21.847826086956523	37.558587479935795
chr17	ARRB2	4718260	4718345	0	86	141399	3784	141399	3698	0.0	38.23661438615468
chr17	ARRB2	4716411	4716608	3540	198	141399	3784	137859	3586	17.87878787878788	38.44366982710541
chr17	ARRB2	4715199	4715336	1121	138	141399	3784	140278	3646	8.123188405797102	38.474492594624245
chr17	MED11	4731775	4731906	0	132	175	1478	175	1346	0.0	0.1300148588410104
chr17	ZMYND15	4743990	4744107	0	118	18996	3339	18996	3221	0.0	5.8975473455448615
chr17	PLD2	4818001	4818106	0	106	6591	4796	6591	4690	0.0	1.4053304904051174
chr17	MINK1	4892401	4892512	19581	112	458480	6924	438899	6812	174.83035714285714	64.43027011156782
chr17	MINK1	4893285	4893309	1109	25	458480	6924	457371	6899	44.36	66.29526018263516
chr17	MINK1	4859212	4859328	7641	117	458480	6924	450839	6807	65.3076923076923	66.23167327750845
chr17	MINK1	4890221	4890308	370	88	458480	6924	458110	6836	4.204545454545454	67.0143358689292
chr17	RNF167	4940486	4940726	0	241	0	2282	0	2041	0.0	0.0
chr17	RNF167	4941076	4941157	0	82	0	2282	0	2200	0.0	0.0
chr17	RNF167	4940872	4940993	0	122	0	2282	0	2160	0.0	0.0
chr17	RNF167	4940486	4940642	0	157	0	2282	0	2125	0.0	0.0
chr17	RNF167	4940486	4940993	0	508	0	2282	0	1774	0.0	0.0
chr17	RNF167	4944557	4944638	0	82	0	2282	0	2200	0.0	0.0
chr17	ENO3	4952024	4952147	0	124	492	4037	492	3913	0.0	0.12573473038589317
chr17	KIF1C	4999012	4999046	5924	35	59262	8604	53338	8569	169.25714285714287	6.224530283580347
chr17	USP6	5147082	5147194	0	113	102149	11312	102149	11199	0.0	9.12126082685954
chr17	USP6	5138970	5139181	51	212	102149	11312	102098	11100	0.24056603773584906	9.198018018018018
chr17	RABEP1	5283883	5284069	1878	187	743836	7080	741958	6893	10.042780748663102	107.63934426229508
chr17	RABEP1	5308693	5308822	317	130	743836	7080	743519	6950	2.4384615384615387	106.9811510791367
chr17	RABEP1	5380363	5380462	2181	100	743836	7080	741655	6980	21.81	106.25429799426934
chr17	RABEP1	5356507	5356573	576	67	743836	7080	743260	7013	8.597014925373134	105.98317410523313
chr17	RPAIN	5425970	5426082	0	113	449	7435	449	7322	0.0	0.06132204315760721
chr17	RPAIN	5426235	5426299	0	65	449	7435	449	7370	0.0	0.060922659430122116
chr17	RPAIN	5428070	5428211	0	142	449	7435	449	7293	0.0	0.06156588509529686
chr17	MIS12	5487556	5487694	4496	139	5414	3162	918	3023	32.34532374100719	0.3036718491564671
chr17	MIS12	5488195	5488589	714	395	5414	3162	4700	2767	1.8075949367088608	1.698590531261294
chr17	WSCD1	6087989	6088104	0	116	51	7099	51	6983	0.0	0.007303451238722612
chr17	PIMREG	6450027	6450072	0	46	255	2570	255	2524	0.0	0.10103011093502377
chr17	PIMREG	6449703	6449778	0	76	255	2570	255	2494	0.0	0.10224538893344026
chr17	PIMREG	6446094	6446187	0	94	255	2570	255	2476	0.0	0.10298869143780291
chr17	TXNDC17	6642248	6642324	0	77	0	2558	0	2481	0.0	0.0
chr17	ALOX15P1	6658481	6658554	0	74	9187	4096	9187	4022	0.0	2.2841869716558927
chr17	XAF1	6759255	6759718	0	464	2958	6341	2958	5877	0.0	0.5033180193976519
chr17	XAF1	6762154	6762240	0	87	2958	6341	2958	6254	0.0	0.47297729453149984
chr17	XAF1	6759661	6759718	0	58	2958	6341	2958	6283	0.0	0.47079420658920895
chr17	XAF1	6760405	6760601	0	197	2958	6341	2958	6144	0.0	0.4814453125
chr17	XAF1	6761885	6762037	0	153	2958	6341	2958	6188	0.0	0.47802197802197804
chr17	XAF1	6759840	6759881	0	42	2958	6341	2958	6299	0.0	0.4695983489442769
chr17	XAF1	6758861	6758959	0	99	2958	6341	2958	6242	0.0	0.4738865748157642
chr17	XAF1	6759255	6759519	0	265	2958	6341	2958	6076	0.0	0.4868334430546412
chr17	FBXO39	6789700	6789760	0	61	4699	2933	4699	2872	0.0	1.636142061281337
chr17	ALOX12P2	6894317	6894513	0	197	154147	5629	154147	5432	0.0	28.37757731958763
chr17	ALOX12P2	6894317	6894519	0	203	154147	5629	154147	5426	0.0	28.408956874308885
chr17	ALOX12P2	6894738	6894793	0	56	154147	5629	154147	5573	0.0	27.659608828279204
chr17	ALOX12P2	6898203	6898290	6166	88	154147	5629	147981	5541	70.06818181818181	26.70655116404981
chr17	RNASEK	7013318	7013516	0	199	0	1124	0	925	0.0	0.0
chr17	C17ORF49	7015773	7015875	0	103	0	1569	0	1466	0.0	0.0
chr17	RNASEK	7013318	7013535	0	218	0	1124	0	906	0.0	0.0
chr17	C17ORF49	7016909	7017014	0	106	0	1569	0	1463	0.0	0.0
chr17	C17ORF49	7016949	7017014	0	66	0	1569	0	1503	0.0	0.0
chr17	ACADVL	7220463	7220529	1023	67	147589	3886	146566	3819	15.26865671641791	38.37810945273632
chr17	ACADVL	7220923	7221058	7952	136	147589	3886	139637	3750	58.470588235294116	37.236533333333334
chr17	ACADVL	7221537	7221682	23793	146	147589	3886	123796	3740	162.96575342465752	33.10053475935829
chr17	ACADVL	7224145	7224243	7523	99	147589	3886	140066	3787	75.98989898989899	36.98600475310272
chr17	ACADVL	7220603	7220676	7939	74	147589	3886	139650	3812	107.28378378378379	36.634312696747116
chr17	ACADVL	7221518	7221682	25802	165	147589	3886	121787	3721	156.37575757575758	32.72964256920183
chr17	ELP5	7256856	7257038	7736	183	14478	2734	6742	2551	42.27322404371585	2.642885143081145
chr17	ELP5	7258825	7258926	0	102	14478	2734	14478	2632	0.0	5.500759878419453
chr17	SLC2A4	7283973	7284089	699	117	27329	4007	26630	3890	5.9743589743589745	6.845758354755784
chr17	EIF5A	7308480	7308575	9927	96	161522	2599	151595	2503	103.40625	60.56532161406312
chr17	ACAP1	7337311	7337369	0	59	85596	3412	85596	3353	0.0	25.528183716075155
chr17	ACAP1	7337262	7337369	0	108	85596	3412	85596	3304	0.0	25.906779661016948
chr17	NLGN2	7412156	7412207	0	52	919641	5110	919641	5058	0.0	181.8190984578885
chr17	CHRNB1	7448578	7448788	0	211	18659	3862	18659	3651	0.0	5.110654615173925
chr17	CHRNB1	7446397	7446472	0	76	18659	3862	18659	3786	0.0	4.9284204965662965
chr17	TNFSF12	7553586	7553825	0	240	2969	1920	2969	1680	0.0	1.7672619047619047
chr17	TNFSF13	7559845	7559893	228	49	1036	2282	808	2233	4.653061224489796	0.3618450515002239
chr17	SENP3	7566926	7567004	0	79	546890	3150	546890	3071	0.0	178.08205796157603
chr17	SENP3	7570882	7570933	0	52	546890	3150	546890	3098	0.0	176.53001936733375
chr17	EIF4A1	7574259	7574308	540	50	1451973	4446	1451433	4396	10.8	330.17129208371244
chr17	EIF4A1	7575118	7575258	6283	141	1451973	4446	1445690	4305	44.56028368794326	335.8164924506388
chr17	EIF4A1	7576523	7576692	12481	170	1451973	4446	1439492	4276	73.41764705882353	336.644527595884
chr17	EIF4A1	7578164	7578244	133182	81	1451973	4446	1318791	4365	1644.2222222222222	302.1285223367698
chr17	SENP3	7570680	7570764	1775	85	546890	3150	545115	3065	20.88235294117647	177.8515497553018
chr17	EIF4A1	7573399	7573547	1023	149	1451973	4446	1450950	4297	6.865771812080537	337.66581335815687
chr17	EIF4A1	7576529	7576692	12113	164	1451973	4446	1439860	4282	73.85975609756098	336.2587575899113
chr17	EIF4A1	7574545	7574678	51	134	1451973	4446	1451922	4312	0.3805970149253731	336.7166048237477
chr17	EIF4A1	7574265	7574308	380	44	1451973	4446	1451593	4402	8.636363636363637	329.7576101771922
chr17	EIF4A1	7578226	7578244	37941	19	1451973	4446	1414032	4427	1996.8947368421052	319.41088773435735
chr17	EIF4A1	7578119	7578244	133292	126	1451973	4446	1318681	4320	1057.873015873016	305.2502314814815
chr17	MPDU1	7586655	7586777	0	123	48263	2956	48263	2833	0.0	17.036004235792447
chr17	MPDU1	7586898	7587017	1275	120	48263	2956	46988	2836	10.625	16.568406205923836
chr17	MPDU1	7585950	7586078	153	129	48263	2956	48110	2827	1.186046511627907	17.018040325433322
chr17	MPDU1	7586691	7586777	0	87	48263	2956	48263	2869	0.0	16.82223771348902
chr17	MPDU1	7585945	7586078	153	134	48263	2956	48110	2822	1.1417910447761195	17.048192771084338
chr17	MPDU1	7586691	7586838	0	148	48263	2956	48263	2808	0.0	17.187678062678064
chr17	MPDU1	7585731	7585797	927	67	48263	2956	47336	2889	13.835820895522389	16.38490827275874
chr17	SHBG	7631199	7631361	0	163	103669	1850	103669	1687	0.0	61.451689389448724
chr17	SHBG	7632751	7632959	0	209	103669	1850	103669	1641	0.0	63.17428397318708
chr17	SHBG	7631878	7632015	0	138	103669	1850	103669	1712	0.0	60.55432242990654
chr17	SHBG	7631588	7631748	0	161	103669	1850	103669	1689	0.0	61.3789224393132
chr17	WRAP53	7689223	7689322	0	100	102	3629	102	3529	0.0	0.028903372060073675
chr17	WRAP53	7702343	7702552	0	210	102	3629	102	3419	0.0	0.029833284586136297
chr17	DNAH2	7766317	7766481	2437	165	534685	16910	532248	16745	14.76969696969697	31.785488205434458
chr17	DNAH2	7804957	7805074	17	118	534685	16910	534668	16792	0.1440677966101695	31.840638399237733
chr17	KDM6B	7846818	7847016	7391	199	345336	7166	337945	6967	37.14070351758794	48.506530788000575
chr17	CHD3	7907600	7907702	0	103	154	10249	154	10146	0.0	0.01517839542676917
chr17	CHD3	7910427	7910591	0	165	154	10249	154	10084	0.0	0.015271717572391909
chr17	CHD3	7910438	7910591	0	154	154	10249	154	10095	0.0	0.015255076770678553
chr17	CNTROB	7944475	7944638	0	164	245	5814	245	5650	0.0	0.04336283185840708
chr17	ALOX15B	8046667	8046754	1566	88	8397	3024	6831	2936	17.795454545454547	2.3266348773841963
chr17	PFAS	8263774	8263936	5481	163	72300	6403	66819	6240	33.625766871165645	10.708173076923076
chr17	PFAS	8255501	8255691	0	191	72300	6403	72300	6212	0.0	11.638763683193819
chr17	RANGRF	8289502	8289588	13	87	268	1335	255	1248	0.14942528735632185	0.20432692307692307
chr17	ARHGEF15	8310827	8310863	0	37	100	4978	100	4941	0.0	0.020238818053025704
chr17	ODF4	8344872	8345042	0	171	1938	1326	1938	1155	0.0	1.6779220779220778
chr17	NDEL1	8444623	8444742	0	120	25893	5059	25893	4939	0.0	5.242559222514679
chr17	NDEL1	8460008	8460160	0	153	25893	5059	25893	4906	0.0	5.277823073787199
chr17	NDEL1	8463319	8463354	0	36	25893	5059	25893	5023	0.0	5.154887517419868
chr17	NDEL1	8443926	8444176	1322	251	25893	5059	24571	4808	5.266932270916334	5.110440931780366
chr17	CFAP52	9641723	9641835	0	113	4077	3084	4077	2971	0.0	1.3722652305621004
chr17	CFAP52	9597511	9597621	0	111	4077	3084	4077	2973	0.0	1.3713420787083754
chr17	CFAP52	9585772	9585972	0	201	4077	3084	4077	2883	0.0	1.4141519250780437
chr17	CFAP52	9610290	9610342	0	53	4077	3084	4077	3031	0.0	1.3451006268558232
chr17	CFAP52	9584181	9584371	51	191	4077	3084	4026	2893	0.2670157068062827	1.391634980988593
chr17	USP43	9666647	9666751	0	105	0	4991	0	4886	0.0	0.0
chr17	GLP2R	9834537	9834783	0	247	0	5712	0	5465	0.0	0.0
chr17	AC005323.1	10621574	10621749	2448	176	42885	1481	40437	1305	13.909090909090908	30.986206896551725
chr17	TMEM220-AS1	10736604	10736638	0	35	0	2726	0	2691	0.0	0.0
chr17	TMEM220-AS1	10766678	10766856	0	179	0	2726	0	2547	0.0	0.0
chr17	SHISA6	11551895	11551952	0	58	102	8583	102	8525	0.0	0.011964809384164223
chr17	SHISA6	11379413	11379509	0	97	102	8583	102	8486	0.0	0.012019797313221777
chr17	DNAH9	11871597	11871786	0	190	42738	17017	42738	16827	0.0	2.5398466749866286
chr17	DNAH9	11929865	11930093	0	229	42738	17017	42738	16788	0.0	2.545746962115797
chr17	MAP2K4	12107789	12107909	0	121	228	4535	228	4414	0.0	0.051653828726778435
chr17	MAP2K4	12032265	12032298	80	34	228	4535	148	4501	2.3529411764705883	0.0328815818706954
chr17	MAP2K4	12081355	12081530	0	176	228	4535	228	4359	0.0	0.05230557467309016
chr17	MAP2K4	12129138	12129287	0	150	228	4535	228	4385	0.0	0.05199543899657925
chr17	MAP2K4	12054888	12054991	0	104	228	4535	228	4431	0.0	0.05145565335138795
chr17	LINC00670	12584559	12584721	0	163	51	4762	51	4599	0.0	0.011089367253750815
chr17	MYOCD	12710494	12710538	0	45	867	8891	867	8846	0.0	0.09801040018087272
chr17	MYOCD	12756413	12756557	0	145	867	8891	867	8746	0.0	0.09913103132860736
chr17	MYOCD	12758084	12758213	0	130	867	8891	867	8761	0.0	0.09896130578701061
chr17	ARHGAP44	12928928	12929046	0	119	7881	7135	7881	7016	0.0	1.1232896237172179
chr17	ARHGAP44	12973301	12973319	0	19	7881	7135	7881	7116	0.0	1.107504215851602
chr17	ARHGAP44	12987100	12987152	0	53	7881	7135	7881	7082	0.0	1.1128212369387178
chr17	AC005303.1	13096847	13097019	0	173	0	1139	0	966	0.0	0.0
chr17	COX10	14076734	14077056	0	323	6002	6769	6002	6446	0.0	0.9311200744647844
chr17	COX10	14102117	14102242	0	126	6002	6769	6002	6643	0.0	0.903507451452657
chr17	COX10	14215809	14215937	0	129	6002	6769	6002	6640	0.0	0.9039156626506024
chr17	AC022816.1	14377283	14377421	0	139	0	1255	0	1116	0.0	0.0
chr17	LINC02096	14837940	14838216	0	277	160	3329	160	3052	0.0	0.05242463958060288
chr17	ZNF286A	15700134	15700366	0	233	0	3177	0	2944	0.0	0.0
chr17	ZNF286A	15700047	15700366	0	320	0	3177	0	2857	0.0	0.0
chr17	ZNF286A	15706386	15706501	0	116	0	3177	0	3061	0.0	0.0
chr17	ZNF286A	15716058	15717313	0	1256	0	3177	0	1921	0.0	0.0
chr17	TBC1D26	15735347	15735423	0	77	204	5061	204	4984	0.0	0.040930979133226325
chr17	ZNF286A	15700272	15700366	0	95	0	3177	0	3082	0.0	0.0
chr17	ZNF286A	15700047	15700168	0	122	0	3177	0	3055	0.0	0.0
chr17	ZNF286A	15700207	15700366	0	160	0	3177	0	3017	0.0	0.0
chr17	TBC1D26	15734041	15734088	0	48	204	5061	204	5013	0.0	0.040694195092758824
chr17	PIGL	16233970	16234070	0	101	1812996	6013	1812996	5912	0.0	306.6637347767253
chr17	PIGL	16316680	16316712	0	33	1812996	6013	1812996	5980	0.0	303.17658862876254
chr17	UBB	16381901	16382130	663	230	1075	1438	412	1208	2.882608695652174	0.34105960264900664
chr17	TRPV2	16431783	16431850	0	68	51	3397	51	3329	0.0	0.015319915890657855
chr17	TRPV2	16433573	16433698	0	126	51	3397	51	3271	0.0	0.0155915622133904
chr17	TRPV2	16434889	16434969	0	81	51	3397	51	3316	0.0	0.015379975874547648
chr17	TRPV2	16434858	16434969	0	112	51	3397	51	3285	0.0	0.015525114155251141
chr17	SNHG29	16439326	16439414	132	89	86309	5724	86177	5635	1.4831460674157304	15.293167701863354
chr17	SNHG29	16441073	16441130	0	58	86309	5724	86309	5666	0.0	15.232792093187435
chr17	SNHG29	16439580	16439703	51	124	86309	5724	86258	5600	0.4112903225806452	15.403214285714286
chr17	SNHG29	16439527	16439703	83	177	86309	5724	86226	5547	0.4689265536723164	15.544618712817739
chr17	SNHG29	16439659	16439703	11	45	86309	5724	86298	5679	0.24444444444444444	15.195985208663497
chr17	SNHG29	16439326	16439393	42	68	86309	5724	86267	5656	0.6176470588235294	15.252298444130128
chr17	SNHG29	16439326	16439703	288	378	86309	5724	86021	5346	0.7619047619047619	16.09072203516648
chr17	SNHG29	16439531	16439703	79	173	86309	5724	86230	5551	0.45664739884393063	15.534137993154387
chr17	SNHG29	16460892	16461245	0	354	86309	5724	86309	5370	0.0	16.07243947858473
chr17	CCDC144A	16707471	16707542	9750	72	211253	15009	201503	14937	135.41666666666666	13.490192140322689
chr17	CCDC144A	16708795	16709635	0	841	211253	15009	211253	14168	0.0	14.910573122529645
chr17	CCDC144A	16707468	16707542	9992	75	211253	15009	201261	14934	133.22666666666666	13.476697468862998
chr17	USP32P1	16787934	16788135	0	202	51	5336	51	5134	0.0	0.009933774834437087
chr17	CCDC144A	16737537	16737675	0	139	211253	15009	211253	14870	0.0	14.20665770006725
chr17	CCDC144A	16772599	16772709	0	111	211253	15009	211253	14898	0.0	14.179957041213585
chr17	USP32P1	16791826	16792053	0	228	51	5336	51	5108	0.0	0.009984338292873924
chr17	USP32P1	16799101	16799194	0	94	51	5336	51	5242	0.0	0.009729111026325829
chr17	MPRIP	17143555	17143669	590	115	316713	14685	316123	14570	5.130434782608695	21.696842827728208
chr17	MPRIP	17164108	17167915	95463	3808	316713	14685	221250	10877	25.069065126050422	20.341086696699456
chr17	MPRIP	17175292	17175412	0	121	316713	14685	316713	14564	0.0	21.746292227410052
chr17	MPRIP	17180606	17180669	25	64	316713	14685	316688	14621	0.390625	21.659804390944533
chr17	MPRIP	17173915	17174075	2667	161	316713	14685	314046	14524	16.565217391304348	21.622555769760396
chr17	NT5M	17304363	17304481	0	119	339	1969	339	1850	0.0	0.18324324324324323
chr17	NT5M	17304363	17304477	0	115	339	1969	339	1854	0.0	0.18284789644012944
chr17	MED9	17485299	17485433	0	135	3162	5710	3162	5575	0.0	0.5671748878923767
chr17	DRC3	17973851	17973962	0	112	24777	4609	24777	4497	0.0	5.509673115410274
chr17	DRC3	17981231	17981291	0	61	24777	4609	24777	4548	0.0	5.447889182058048
chr17	DRC3	17973925	17973962	0	38	24777	4609	24777	4571	0.0	5.420476919711223
chr17	DRC3	17973664	17973962	0	299	24777	4609	24777	4310	0.0	5.748723897911833
chr17	DRC3	17973664	17973753	0	90	24777	4609	24777	4519	0.0	5.482850188094711
chr17	DRC3	17973664	17973751	0	88	24777	4609	24777	4521	0.0	5.480424684804247
chr17	GID4	18056702	18056759	0	58	2369	2891	2369	2833	0.0	0.8362160254147547
chr17	DRG2	18099016	18099093	896	78	186286	6021	185390	5943	11.487179487179487	31.194682820124516
chr17	DRG2	18099016	18099077	608	62	186286	6021	185678	5959	9.806451612903226	31.1592549085417
chr17	DRG2	18095420	18095489	0	70	186286	6021	186286	5951	0.0	31.303310368005377
chr17	DRG2	18091917	18092074	563	158	186286	6021	185723	5863	3.5632911392405062	31.67712775029848
chr17	MYO15A	18148495	18148568	94066	74	2057429	16458	1963363	16384	1271.162162162162	119.83416748046875
chr17	MYO15A	18154679	18154755	41686	77	2057429	16458	2015743	16381	541.3766233766233	123.05372077406751
chr17	MYO15A	18159605	18159679	908	75	2057429	16458	2056521	16383	12.106666666666667	125.5277421717634
chr17	MYO15A	18166360	18166521	12174	162	2057429	16458	2045255	16296	75.14814814814815	125.50656602847324
chr17	MYO15A	18173780	18173921	4845	142	2057429	16458	2052584	16316	34.11971830985915	125.80191223339054
chr17	MYO15A	18167589	18167723	7381	135	2057429	16458	2050048	16323	54.67407407407408	125.59259939962017
chr17	MYO15A	18169481	18169621	12252	141	2057429	16458	2045177	16317	86.8936170212766	125.34025862597291
chr17	MYO15A	18158522	18158638	54137	117	2057429	16458	2003292	16341	462.70940170940173	122.592986965302
chr17	MYO15A	18158924	18158997	0	74	2057429	16458	2057429	16384	0.0	125.57550048828125
chr17	KRT17P5	18423656	18423734	0	79	13519	3166	13519	3087	0.0	4.379332685455134
chr17	LGALS9C	18483874	18483966	448	93	3620	4399	3172	4306	4.817204301075269	0.7366465397120298
chr17	LGALS9C	18490732	18490768	0	37	3620	4399	3620	4362	0.0	0.8298945437872536
chr17	LGALS9C	18488940	18489036	0	97	3620	4399	3620	4302	0.0	0.8414690841469085
chr17	LGALS9C	18492696	18492859	0	164	3620	4399	3620	4235	0.0	0.8547815820543093
chr17	LGALS9C	18486754	18486940	51	187	3620	4399	3569	4212	0.2727272727272727	0.847340930674264
chr17	TRIM16L	18699359	18699457	459	99	6969	3780	6510	3681	4.636363636363637	1.7685411572942136
chr17	TRIM16L	18731069	18731235	0	167	6969	3780	6969	3613	0.0	1.9288679767506227
chr17	TRIM16L	18732038	18732134	0	97	6969	3780	6969	3683	0.0	1.892207439587293
chr17	FBXW10	18769926	18770085	0	160	735	3798	735	3638	0.0	0.20203408466190215
chr17	TVP23B	18790895	18790960	0	66	23155	5755	23155	5689	0.0	4.070135348918966
chr17	TVP23B	18790895	18791040	0	146	23155	5755	23155	5609	0.0	4.128186842574434
chr17	PRPSAP2	18867281	18867334	0	54	10100	4727	10100	4673	0.0	2.1613524502460946
chr17	PRPSAP2	18872582	18872649	5887	68	10100	4727	4213	4659	86.57352941176471	0.9042713028546898
chr17	PRPSAP2	18882567	18882683	1165	117	10100	4727	8935	4610	9.957264957264957	1.938177874186551
chr17	PRPSAP2	18928810	18928957	0	148	10100	4727	10100	4579	0.0	2.2057217733129506
chr17	PRPSAP2	18857783	18857853	0	71	10100	4727	10100	4656	0.0	2.1692439862542954
chr17	PRPSAP2	18867256	18867334	0	79	10100	4727	10100	4648	0.0	2.1729776247848536
chr17	PRPSAP2	18865468	18865564	0	97	10100	4727	10100	4630	0.0	2.1814254859611233
chr17	PRPSAP2	18859339	18859475	51	137	10100	4727	10049	4590	0.3722627737226277	2.1893246187363835
chr17	PRPSAP2	18864867	18864941	0	75	10100	4727	10100	4652	0.0	2.1711092003439383
chr17	PRPSAP2	18860565	18860691	0	127	10100	4727	10100	4600	0.0	2.1956521739130435
chr17	PRPSAP2	18917431	18917536	0	106	10100	4727	10100	4621	0.0	2.1856740965159056
chr17	SLC5A10	19013361	19013517	0	157	913	6468	913	6311	0.0	0.14466803993028046
chr17	SLC5A10	19017283	19017394	0	112	913	6468	913	6356	0.0	0.1436438011327879
chr17	SLC5A10	18969341	18969422	0	82	913	6468	913	6386	0.0	0.14296899467585342
chr17	SLC5A10	19013409	19013517	0	109	913	6468	913	6359	0.0	0.14357603396760496
chr17	GRAPL	19144102	19144170	557	69	761	1979	204	1910	8.072463768115941	0.1068062827225131
chr17	EPN2	19281954	19282077	295	124	115264	7670	114969	7546	2.379032258064516	15.235754041876492
chr17	EPN2	19285619	19285790	24424	172	115264	7670	90840	7498	142.0	12.115230728194184
chr17	EPN2	19276396	19276538	12	143	115264	7670	115252	7527	0.08391608391608392	15.311810814401488
chr17	EPN2	19249370	19249526	2061	157	115264	7670	113203	7513	13.127388535031848	15.0676161320378
chr17	EPN2	19279861	19279980	0	120	115264	7670	115264	7550	0.0	15.266754966887417
chr17	MAPK7	19380607	19381686	0	1080	689	4017	689	2937	0.0	0.23459312223357168
chr17	MAPK7	19379592	19379605	0	14	689	4017	689	4003	0.0	0.1721209093180115
chr17	MAPK7	19380483	19380501	0	19	689	4017	689	3998	0.0	0.172336168084042
chr17	RNF112	19412937	19413144	0	208	57	3532	57	3324	0.0	0.017148014440433214
chr17	SLC47A1	19546434	19546503	32	70	129540	5036	129508	4966	0.45714285714285713	26.078936770036247
chr17	SLC47A1	19555795	19555909	23924	115	129540	5036	105616	4921	208.03478260869565	21.462304409672832
chr17	SLC47A1	19572779	19572861	0	83	129540	5036	129540	4953	0.0	26.153846153846153
chr17	SLC47A1	19571477	19571572	0	96	129540	5036	129540	4940	0.0	26.222672064777328
chr17	SLC47A1	19578027	19578128	714	102	129540	5036	128826	4934	7.0	26.10985002026753
chr17	ALDH3A2	19651546	19651778	0	233	26972	10618	26972	10385	0.0	2.597207510832932
chr17	ALDH3A2	19657744	19657862	51	119	26972	10618	26921	10499	0.42857142857142855	2.5641489665682444
chr17	ALDH3A2	19664947	19665047	0	101	26972	10618	26972	10517	0.0	2.5646096795664164
chr17	ALDH3A2	19671720	19671956	0	237	26972	10618	26972	10381	0.0	2.5982082650997014
chr17	ALDH3A2	19673150	19673275	0	126	26972	10618	26972	10492	0.0	2.5707205489897063
chr17	ALDH3A2	19656365	19656574	0	210	26972	10618	26972	10408	0.0	2.591468101460415
chr17	ALDH3A2	19655280	19655387	0	108	26972	10618	26972	10510	0.0	2.566317792578497
chr17	ALDH3A2	19657720	19657862	51	143	26972	10618	26921	10475	0.35664335664335667	2.5700238663484485
chr17	ALDH3A2	19673199	19673275	0	77	26972	10618	26972	10541	0.0	2.5587705151313918
chr17	ALDH3A2	19673206	19673275	0	70	26972	10618	26972	10548	0.0	2.557072430792567
chr17	SPECC1	20204332	20205912	1326	1581	77772	19316	76446	17735	0.8387096774193549	4.310459543276008
chr17	SPECC1	20296960	20297077	0	118	77772	19316	77772	19198	0.0	4.051046984060839
chr17	SPECC1	20306022	20306082	800	61	77772	19316	76972	19255	13.114754098360656	3.997507141002337
chr17	SPECC1	20017986	20018102	0	117	77772	19316	77772	19199	0.0	4.050835981040679
chr17	SPECC1	20124899	20124997	0	99	77772	19316	77772	19217	0.0	4.047041681844201
chr17	SPECC1	20067193	20067378	34	186	77772	19316	77738	19130	0.1827956989247312	4.063669628855202
chr17	SPECC1	20057676	20057817	0	142	77772	19316	77772	19174	0.0	4.056117659330343
chr17	USP32P3	20419855	20420113	0	259	1146	7899	1146	7640	0.0	0.15
chr17	NOS2P3	20443273	20443395	0	123	3000	3650	3000	3527	0.0	0.8505812305075134
chr17	USP32P3	20418182	20418391	0	210	1146	7899	1146	7689	0.0	0.14904408895825205
chr17	NOS2P3	20444950	20445143	0	194	3000	3650	3000	3456	0.0	0.8680555555555556
chr17	AC087499.2	20721210	20721467	0	258	0	1512	0	1254	0.0	0.0
chr17	CCDC144NL-AS1	20887591	20887849	506	259	5125497	10522	5124991	10263	1.9536679536679538	499.36577998635875
chr17	CCDC144NL-AS1	20981486	20981624	0	139	5125497	10522	5125497	10383	0.0	493.6431667148223
chr17	CCDC144NL-AS1	20924358	20924833	282995	476	5125497	10522	4842502	10046	594.5273109243698	482.0328488950826
chr17	CCDC144NL-AS1	20949102	20949441	2601	340	5125497	10522	5122896	10182	7.65	503.13258691809074
chr17	CCDC144NL-AS1	20956193	20956353	0	161	5125497	10522	5125497	10361	0.0	494.6913425345044
chr17	CCDC144NL-AS1	20955965	20956353	0	389	5125497	10522	5125497	10133	0.0	505.82226389025953
chr17	LINC01563	21084770	21084884	51	115	24268	3155	24217	3040	0.4434782608695652	7.966118421052632
chr17	LINC01563	21084760	21084884	57	125	24268	3155	24211	3030	0.456	7.990429042904291
chr17	LINC01563	21084751	21084884	66	134	24268	3155	24202	3021	0.4925373134328358	8.011254551473023
chr17	DHRS7B	21178232	21178342	695	111	12493	5554	11798	5443	6.261261261261262	2.1675546573580746
chr17	DHRS7B	21188710	21188863	51	154	12493	5554	12442	5400	0.33116883116883117	2.304074074074074
chr17	MAP2K3	21296085	21296210	0	126	1785	3685	1785	3559	0.0	0.5015453779151448
chr17	MAP2K3	21303182	21303234	0	53	1785	3685	1785	3632	0.0	0.4914647577092511
chr17	MAP2K3	21287990	21288091	0	102	1785	3685	1785	3583	0.0	0.4981858777560703
chr17	MAP2K3	21295674	21295769	0	96	1785	3685	1785	3589	0.0	0.497353023126219
chr17	AC138761.1	22285004	22285128	0	125	0	2159	0	2034	0.0	0.0
chr17	WSB1	27301766	27301956	0	191	765	7403	765	7212	0.0	0.10607321131447588
chr17	WSB1	27303366	27303635	0	270	765	7403	765	7133	0.0	0.10724800224309547
chr17	WSB1	27301817	27301956	0	140	765	7403	765	7263	0.0	0.10532837670384139
chr17	WSB1	27301787	27301956	0	170	765	7403	765	7233	0.0	0.10576524263790958
chr17	WSB1	27304779	27304911	0	133	765	7403	765	7270	0.0	0.10522696011004126
chr17	WSB1	27301880	27301956	0	77	765	7403	765	7326	0.0	0.10442260442260443
chr17	AC026254.2	27334259	27334377	0	119	306566	990	306566	871	0.0	351.97014925373134
chr17	TBC1D3P5	27421627	27422248	27500	622	41531	4122	14031	3500	44.21221864951769	4.008857142857143
chr17	TBC1D3P5	27426459	27426559	0	101	41531	4122	41531	4021	0.0	10.328525242476996
chr17	TBC1D3P5	27424538	27424659	0	122	41531	4122	41531	4000	0.0	10.38275
chr17	KSR1	27577491	27577639	0	149	91952	11040	91952	10891	0.0	8.442934533100726
chr17	KSR1	27601359	27601401	684	43	91952	11040	91268	10997	15.906976744186046	8.299354369373466
chr17	KSR1	27621192	27621273	538	82	91952	11040	91414	10958	6.560975609756097	8.342215732797955
chr17	KSR1	27558045	27558187	0	143	91952	11040	91952	10897	0.0	8.438285766724787
chr17	KSR1	27601892	27601958	267	67	91952	11040	91685	10973	3.985074626865672	8.355508976578875
chr17	LGALS9	27638262	27638354	0	93	275	5110	275	5017	0.0	0.054813633645604945
chr17	LGALS9	27645313	27645349	0	37	275	5110	275	5073	0.0	0.054208555095604176
chr17	LGALS9	27647269	27647432	0	164	275	5110	275	4946	0.0	0.05560048524059846
chr17	LGALS9	27643524	27643620	0	97	275	5110	275	5013	0.0	0.05485737083582685
chr17	TMEM97	28325502	28325647	0	146	0	2932	0	2786	0.0	0.0
chr17	TNFAIP1	28340308	28340478	55	171	2308	3846	2253	3675	0.3216374269005848	0.6130612244897959
chr17	TNFAIP1	28339407	28339726	79	320	2308	3846	2229	3526	0.246875	0.632161089052751
chr17	TMEM199	28360150	28360238	51	89	276	4566	225	4477	0.5730337078651685	0.05025686843868662
chr17	SARM1	28386607	28386681	0	75	43831	9683	43831	9608	0.0	4.561927560366361
chr17	SLC13A2	28489213	28489342	20	130	1972	3238	1952	3108	0.15384615384615385	0.6280566280566281
chr17	SLC13A2	28487409	28487550	714	142	1972	3238	1258	3096	5.028169014084507	0.40633074935400515
chr17	SLC13A2	28490306	28490368	0	63	1972	3238	1972	3175	0.0	0.6211023622047244
chr17	SPAG5-AS1	28606295	28606460	0	166	101862	2896	101862	2730	0.0	37.31208791208791
chr17	SUPT6H	28672756	28672858	0	103	153	9640	153	9537	0.0	0.016042780748663103
chr17	RPL23A	28720413	28720430	0	18	0	2219	0	2201	0.0	0.0
chr17	ERAL1	28857938	28857985	0	48	1179	2084	1179	2036	0.0	0.5790766208251473
chr17	ERAL1	28858575	28858824	0	250	1179	2084	1179	1834	0.0	0.6428571428571429
chr17	ERAL1	28858575	28858633	0	59	1179	2084	1179	2025	0.0	0.5822222222222222
chr17	PIPOX	28953363	28953408	0	46	17957	3797	17957	3751	0.0	4.787256731538257
chr17	PIPOX	29040682	29040790	0	109	17957	3797	17957	3688	0.0	4.8690347071583515
chr17	PIPOX	29010959	29011146	0	188	17957	3797	17957	3609	0.0	4.9756165142698805
chr17	CRYBA1	29252063	29252205	0	143	0	804	0	661	0.0	0.0
chr17	EFCAB5	29968790	29969367	0	578	7110	6957	7110	6379	0.0	1.1145947640696034
chr17	EFCAB5	30090420	30090674	0	255	7110	6957	7110	6702	0.0	1.0608773500447628
chr17	EFCAB5	30059544	30059701	0	158	7110	6957	7110	6799	0.0	1.0457420208854242
chr17	NSRP1	30118079	30118173	0	95	307518	4823	307518	4728	0.0	65.04187817258884
chr17	NSRP1	30168813	30168925	0	113	307518	4823	307518	4710	0.0	65.2904458598726
chr17	NSRP1	30163066	30163162	280	97	307518	4823	307238	4726	2.88659793814433	65.01015658061786
chr17	NSRP1	30156539	30156662	0	124	307518	4823	307518	4699	0.0	65.44328580549053
chr17	NSRP1	30117301	30117332	0	32	307518	4823	307518	4791	0.0	64.18659987476518
chr17	CPD	30449552	30449748	0	197	48830	9203	48830	9006	0.0	5.421940928270042
chr17	GOSR1	30510879	30510909	0	31	62971	9580	62971	9549	0.0	6.594512514399414
chr17	GOSR1	30495425	30495582	0	158	62971	9580	62971	9422	0.0	6.683400551899809
chr17	GOSR1	30482899	30483056	1764	158	62971	9580	61207	9422	11.164556962025317	6.496179155168754
chr17	TBC1D29P	30562868	30562917	0	50	1755	2944	1755	2894	0.0	0.6064270905321355
chr17	AC005562.1	30615895	30615980	0	86	80961	8636	80961	8550	0.0	9.469122807017543
chr17	AC005562.1	30631754	30631979	0	226	80961	8636	80961	8410	0.0	9.626753864447087
chr17	AC005562.1	30631754	30631895	0	142	80961	8636	80961	8494	0.0	9.531551683541323
chr17	SUZ12P1	30759490	30759539	0	50	3232	3792	3232	3742	0.0	0.8637092463923036
chr17	SUZ12P1	30732485	30732608	210	124	3232	3792	3022	3668	1.6935483870967742	0.8238822246455835
chr17	ADAP2	30949286	30949370	0	85	51	3738	51	3653	0.0	0.013961127840131399
chr17	ADAP2	30953287	30953350	0	64	51	3738	51	3674	0.0	0.013881328252585737
chr17	ADAP2	30926808	30926918	51	111	51	3738	0	3627	0.4594594594594595	0.0
chr17	ADAP2	30931888	30931968	0	81	51	3738	51	3657	0.0	0.01394585726004922
chr17	ADAP2	30926826	30926918	42	93	51	3738	9	3645	0.45161290322580644	0.0024691358024691358
chr17	ADAP2	30922939	30923070	0	132	51	3738	51	3606	0.0	0.014143094841930116
chr17	RNF135	30984616	30984760	0	145	51	2253	51	2108	0.0	0.024193548387096774
chr17	RNF135	30987943	30988106	0	164	51	2253	51	2089	0.0	0.024413595021541407
chr17	RNF135	30993839	30993904	0	66	51	2253	51	2187	0.0	0.023319615912208505
chr17	NF1	31169890	31169997	48	108	99	20076	51	19968	0.4444444444444444	0.0025540865384615385
chr17	NF1	31352256	31352414	0	159	99	20076	99	19917	0.0	0.004970628106642567
chr17	NF1	31252937	31253000	0	64	99	20076	99	20012	0.0	0.004947031780931441
chr17	NF1	31299509	31299606	0	98	99	20076	99	19978	0.0	0.004955450996095705
chr17	NF1	31367224	31367278	0	55	99	20076	99	20021	0.0	0.004944807951650767
chr17	NF1	31257686	31257726	0	41	99	20076	99	20035	0.0	0.0049413526328924385
chr17	NF1	31334663	31334730	0	68	99	20076	99	20008	0.0	0.0049480207916833266
chr17	NF1	31379105	31379357	0	253	99	20076	99	19823	0.0	0.004994198658124401
chr17	RAB11FIP4	31509076	31509481	0	406	0	12597	0	12191	0.0	0.0
chr17	SUZ12	31947616	31947685	0	70	0	6115	0	6045	0.0	0.0
chr17	LRRC37B	32020696	32020803	0	108	0	5911	0	5803	0.0	0.0
chr17	LRRC37B	32017971	32018054	0	84	0	5911	0	5827	0.0	0.0
chr17	LRRC37B	32045699	32045818	0	120	0	5911	0	5791	0.0	0.0
chr17	LRRC37B	32027768	32027840	0	73	0	5911	0	5838	0.0	0.0
chr17	RHOT1	32209349	32209445	51	97	202	5502	151	5405	0.5257731958762887	0.027937095282146163
chr17	RHOT1	32211115	32211238	0	124	202	5502	202	5378	0.0	0.03756043138713276
chr17	RHOT1	32172936	32173060	0	125	202	5502	202	5377	0.0	0.037567416775153434
chr17	RHOT1	32221048	32221186	0	139	202	5502	202	5363	0.0	0.03766548573559575
chr17	RHOT1	32207511	32207563	49	53	202	5502	153	5449	0.9245283018867925	0.02807854652229767
chr17	RHOT1	32222758	32222902	0	145	202	5502	202	5357	0.0	0.037707672204592126
chr17	RHOT1	32222828	32222902	0	75	202	5502	202	5427	0.0	0.03722130090289294
chr17	RHBDL3	32267901	32267925	0	25	0	5756	0	5731	0.0	0.0
chr17	RHBDL3	32284658	32284817	0	160	0	5756	0	5596	0.0	0.0
chr17	RHBDL3	32305340	32305441	0	102	0	5756	0	5654	0.0	0.0
chr17	RHBDL3	32288231	32288369	0	139	0	5756	0	5617	0.0	0.0
chr17	ZNF207	32366664	32366757	18247	94	48418	8928	30171	8834	194.11702127659575	3.415327145121123
chr17	ZNF207	32361467	32361515	0	49	48418	8928	48418	8879	0.0	5.453091564365357
chr17	ZNF207	32351464	32351629	0	166	48418	8928	48418	8762	0.0	5.525907327094271
chr17	PSMD11	32454751	32454877	0	127	0	6502	0	6375	0.0	0.0
chr17	TMEM98	32939476	32939536	0	61	0	4903	0	4842	0.0	0.0
chr17	TMEM98	32931326	32931402	0	77	0	4903	0	4826	0.0	0.0
chr17	TMEM98	32930899	32930971	0	73	0	4903	0	4830	0.0	0.0
chr17	SPACA3	32995408	32995717	0	310	0	1260	0	950	0.0	0.0
chr17	CCL7	34271145	34271263	0	119	0	866	0	747	0.0	0.0
chr17	CCL7	34271092	34271263	0	172	0	866	0	694	0.0	0.0
chr17	AC011193.1	34479803	34479895	0	93	0	1763	0	1670	0.0	0.0
chr17	LIG3	34983001	34983552	51	552	2162	10453	2111	9901	0.09239130434782608	0.2132107867892132
chr17	LIG3	34983231	34983552	0	322	2162	10453	2162	10131	0.0	0.21340440232948377
chr17	SLFN5	35264182	35264903	0	722	0	10679	0	9957	0.0	0.0
chr17	AC022706.1	35321734	35321865	0	132	68	1393	68	1261	0.0	0.05392545598731166
chr17	AC022706.1	35321736	35321865	0	130	68	1393	68	1263	0.0	0.053840063341250986
chr17	AC022706.1	35316355	35316409	0	55	68	1393	68	1338	0.0	0.05082212257100149
chr17	SNHG30	35573579	35573723	0	145	4790	1597	4790	1452	0.0	3.298898071625344
chr17	AP2B1	35670856	35670898	0	43	13768	7621	13768	7578	0.0	1.8168382158880971
chr17	AP2B1	35600985	35601071	0	87	13768	7621	13768	7534	0.0	1.8274488983275816
chr17	AP2B1	35605704	35605840	0	137	13768	7621	13768	7484	0.0	1.8396579369321218
chr17	AP2B1	35600936	35601071	0	136	13768	7621	13768	7485	0.0	1.8394121576486306
chr17	AP2B1	35588624	35588733	0	110	13768	7621	13768	7511	0.0	1.833044867527626
chr17	AP2B1	35650913	35651005	18	93	13768	7621	13750	7528	0.1935483870967742	1.8265143464399576
chr17	TAF15	35820163	35820239	0	77	20390	5459	20390	5382	0.0	3.788554440728354
chr17	TAF15	35833906	35833941	315	36	20390	5459	20075	5423	8.75	3.7018255578093306
chr17	TAF15	35809971	35810063	722	93	20390	5459	19668	5366	7.763440860215054	3.665300037271711
chr17	TAF15	35820163	35820248	0	86	20390	5459	20390	5373	0.0	3.7949004280662573
chr17	TAF15	35817239	35817317	36	79	20390	5459	20354	5380	0.45569620253164556	3.783271375464684
chr17	AC243829.4	36073655	36073671	0	17	0	1508	0	1491	0.0	0.0
chr17	CCL4	36104527	36104642	0	116	0	1251	0	1135	0.0	0.0
chr17	CCL4L2	36211775	36211890	0	116	0	988	0	872	0.0	0.0
chr17	ZNHIT3	36486934	36486966	0	33	255	3627	255	3594	0.0	0.0709515859766277
chr17	DHRS11	36599670	36599763	0	94	0	2104	0	2010	0.0	0.0
chr17	AATF	37031613	37031685	0	73	41408	2875	41408	2802	0.0	14.778015703069237
chr17	TADA2A	37423508	37423615	0	108	8597	5170	8597	5062	0.0	1.698340576847096
chr17	TADA2A	37426949	37427009	0	61	8597	5170	8597	5109	0.0	1.6827167743198277
chr17	TADA2A	37442563	37442652	0	90	8597	5170	8597	5080	0.0	1.6923228346456693
chr17	MRPL45	38320617	38320767	1251	151	27538	1712	26287	1561	8.28476821192053	16.839846252402307
chr17	SOCS7	38365307	38365409	0	103	8811	9016	8811	8913	0.0	0.988556041736789
chr17	SOCS7	38364751	38364856	0	106	8811	9016	8811	8910	0.0	0.9888888888888889
chr17	ARHGAP23	38498413	38498510	0	98	70009	8109	70009	8011	0.0	8.739108725502435
chr17	ARHGAP23	38498931	38498954	0	24	70009	8109	70009	8085	0.0	8.659121830550403
chr17	ARHGAP23	38477578	38477705	0	128	70009	8109	70009	7981	0.0	8.771958401202857
chr17	ARHGAP23	38489757	38489917	0	161	70009	8109	70009	7948	0.0	8.808379466532461
chr17	PSMB3	38760430	38760608	0	179	0	1122	0	943	0.0	0.0
chr17	PSMB3	38760507	38760608	0	102	0	1122	0	1020	0.0	0.0
chr17	LASP1	38890419	38890504	0	86	0	6747	0	6661	0.0	0.0
chr17	LASP1	38896901	38897071	0	171	0	6747	0	6576	0.0	0.0
chr17	LRRC37A11P	39043198	39043279	0	82	833	5878	833	5796	0.0	0.14371980676328502
chr17	RDM1P5	39061096	39061188	0	93	0	3938	0	3845	0.0	0.0
chr17	CDK12	39490556	39490733	0	178	51	10968	51	10790	0.0	0.004726598702502317
chr17	CDK12	39556863	39557058	0	196	51	10968	51	10772	0.0	0.004734496843668771
chr17	PPP1R1B	39629971	39630047	0	77	0	2807	0	2730	0.0	0.0
chr17	STARD3	39657007	39657085	0	79	0	4382	0	4303	0.0	0.0
chr17	STARD3	39657972	39658026	0	55	0	4382	0	4327	0.0	0.0
chr17	STARD3	39658721	39658820	0	100	0	4382	0	4282	0.0	0.0
chr17	STARD3	39658708	39658820	0	113	0	4382	0	4269	0.0	0.0
chr17	STARD3	39662250	39662344	0	95	0	4382	0	4287	0.0	0.0
chr17	STARD3	39651751	39651845	0	95	0	4382	0	4287	0.0	0.0
chr17	STARD3	39651754	39651845	0	92	0	4382	0	4290	0.0	0.0
chr17	STARD3	39662250	39662367	0	118	0	4382	0	4264	0.0	0.0
chr17	ERBB2	39699536	39699587	0	52	0	8554	0	8502	0.0	0.0
chr17	ERBB2	39719786	39719834	0	49	0	8554	0	8505	0.0	0.0
chr17	ERBB2	39727294	39727547	0	254	0	8554	0	8300	0.0	0.0
chr17	ERBB2	39706989	39707141	0	153	0	8554	0	8401	0.0	0.0
chr17	ERBB2	39713152	39713269	0	118	0	8554	0	8436	0.0	0.0
chr17	GRB7	39742897	39743054	0	158	0	3325	0	3167	0.0	0.0
chr17	GRB7	39745912	39746000	0	89	0	3325	0	3236	0.0	0.0
chr17	ZPBP2	39868548	39868614	0	67	183	2265	183	2198	0.0	0.0832575068243858
chr17	ZPBP2	39872269	39872488	0	220	183	2265	183	2045	0.0	0.08948655256723716
chr17	PSMD3	39996700	39996793	0	94	40219	4755	40219	4661	0.0	8.628835013945505
chr17	CSF3	40015690	40015845	0	156	0	2223	0	2067	0.0	0.0
chr17	CSF3	40016232	40016340	0	109	0	2223	0	2114	0.0	0.0
chr17	CSF3	40015690	40015854	0	165	0	2223	0	2058	0.0	0.0
chr17	MSL1	40131536	40131584	0	49	384879	6837	384879	6788	0.0	56.69991160872127
chr17	MSL1	40131219	40131345	0	127	384879	6837	384879	6710	0.0	57.35901639344262
chr17	RAPGEFL1	40181298	40181486	0	189	77238	5363	77238	5174	0.0	14.928102048705064
chr17	RAPGEFL1	40181298	40181373	0	76	77238	5363	77238	5287	0.0	14.609041044070361
chr17	WIPF2	40256390	40256522	282	133	531879	8133	531597	8000	2.1203007518796992	66.449625
chr17	WIPF2	40260534	40260667	0	134	531879	8133	531879	7999	0.0	66.49318664833105
chr17	WIPF2	40220414	40220538	0	125	531879	8133	531879	8008	0.0	66.41845654345654
chr17	RARA	40326474	40326551	0	78	182115	4723	182115	4645	0.0	39.20667384284177
chr17	TMEM99	40828056	40828296	459	241	48202	3058	47743	2817	1.904564315352697	16.94817181398651
chr17	TMEM99	40828103	40828296	459	194	48202	3058	47743	2864	2.365979381443299	16.67004189944134
chr17	EIF1	41689777	41689941	0	165	255	3114	255	2949	0.0	0.08646998982706001
chr17	FKBP10	41817057	41817203	0	147	51	4057	51	3910	0.0	0.013043478260869565
chr17	FKBP10	41819840	41820023	51	184	51	4057	0	3873	0.27717391304347827	0.0
chr17	CNP	41968067	41968740	851	674	6100	6383	5249	5709	1.2626112759643917	0.9194254685584166
chr17	CNP	41968072	41968740	806	669	6100	6383	5294	5714	1.2047832585949179	0.9264963248162408
chr17	NKIRAS2	42022398	42022640	0	243	0	4020	0	3777	0.0	0.0
chr17	NKIRAS2	42021563	42021671	0	109	0	4020	0	3911	0.0	0.0
chr17	NKIRAS2	42022569	42022640	0	72	0	4020	0	3948	0.0	0.0
chr17	NKIRAS2	42022564	42022640	0	77	0	4020	0	3943	0.0	0.0
chr17	NKIRAS2	42021544	42021671	0	128	0	4020	0	3892	0.0	0.0
chr17	NKIRAS2	42022375	42022640	0	266	0	4020	0	3754	0.0	0.0
chr17	NKIRAS2	42022398	42022472	0	75	0	4020	0	3945	0.0	0.0
chr17	NKIRAS2	42023027	42023141	0	115	0	4020	0	3905	0.0	0.0
chr17	STAT5A	42289401	42289539	0	139	300458	5445	300458	5306	0.0	56.62608367885413
chr17	STAT5A	42291971	42292061	1079	91	300458	5445	299379	5354	11.857142857142858	55.916884572282406
chr17	STAT5A	42305609	42305702	0	94	300458	5445	300458	5351	0.0	56.14987852737806
chr17	STAT5A	42289429	42289539	0	111	300458	5445	300458	5334	0.0	56.32883389576303
chr17	STAT5A	42289369	42289539	3906	171	300458	5445	296552	5274	22.842105263157894	56.22904816078878
chr17	ATP6V0A1	42468009	42468107	0	99	40672	7310	40672	7211	0.0	5.640271806961587
chr17	ATP6V0A1	42470089	42470218	0	130	40672	7310	40672	7180	0.0	5.664623955431755
chr17	ATP6V0A1	42514288	42514460	630	173	40672	7310	40042	7137	3.6416184971098264	5.610480594087152
chr17	ATP6V0A1	42466428	42466507	0	80	40672	7310	40672	7230	0.0	5.625449515905948
chr17	ATP6V0A1	42508571	42508589	0	19	40672	7310	40672	7291	0.0	5.578384309422575
chr17	ATP6V0A1	42478926	42479049	0	124	40672	7310	40672	7186	0.0	5.659894238797662
chr17	ATP6V0A1	42510058	42510183	0	126	40672	7310	40672	7184	0.0	5.661469933184855
chr17	ATP6V0A1	42502793	42502868	0	76	40672	7310	40672	7234	0.0	5.622338954935029
chr17	NAGLU	42537397	42537545	490	149	9874	2885	9384	2736	3.2885906040268456	3.4298245614035086
chr17	NAGLU	42540949	42541206	0	258	9874	2885	9874	2627	0.0	3.7586600685192235
chr17	HSD17B1	42553793	42553887	0	95	100	1635	100	1540	0.0	0.06493506493506493
chr17	COASY	42562295	42562487	0	193	1901	3038	1901	2845	0.0	0.6681898066783831
chr17	COASY	42562355	42562487	0	133	1901	3038	1901	2905	0.0	0.6543889845094665
chr17	MLX	42568469	42568559	816	91	6314	3476	5498	3385	8.967032967032967	1.6242245199409158
chr17	MLX	42569203	42569303	1581	101	6314	3476	4733	3375	15.653465346534654	1.4023703703703703
chr17	TUBG1	42610107	42610220	0	114	183	2419	183	2305	0.0	0.07939262472885032
chr17	TUBG1	42612426	42612506	0	81	183	2419	183	2338	0.0	0.07827202737382379
chr17	TUBG2	42662972	42663052	0	81	0	2803	0	2722	0.0	0.0
chr17	RAMP2	42762354	42762463	0	110	13016	1121	13016	1011	0.0	12.874381800197824
chr17	RAMP2	42762339	42762463	0	125	13016	1121	13016	996	0.0	13.068273092369479
chr17	WNK4	42785096	42785185	0	90	8406	5306	8406	5216	0.0	1.611579754601227
chr17	WNK4	42787777	42787899	255	123	8406	5306	8151	5183	2.073170731707317	1.572641327416554
chr17	CNTD1	42803619	42803695	0	77	88092	3323	88092	3246	0.0	27.138632162661736
chr17	PSME3	42838092	42838205	0	114	66961	4720	66961	4606	0.0	14.537776812852801
chr17	PSME3	42838730	42838799	0	70	66961	4720	66961	4650	0.0	14.400215053763441
chr17	PSME3	42833775	42833939	751	165	66961	4720	66210	4555	4.551515151515152	14.535675082327113
chr17	PSME3	42834093	42834256	663	164	66961	4720	66298	4556	4.0426829268292686	14.551799824407375
chr17	PSME3	42838691	42838799	0	109	66961	4720	66961	4611	0.0	14.522012578616351
chr17	AOC3	42855443	42855573	64	131	23283	4529	23219	4398	0.48854961832061067	5.279445202364712
chr17	G6PC	42909302	42909418	0	117	845	4370	845	4253	0.0	0.19868328238890196
chr17	RUNDC1	42989340	42989539	0	200	11918	4762	11918	4562	0.0	2.6124506795265234
chr17	RPL27	42999932	43000102	0	171	21746	2030	21746	1859	0.0	11.697686928456159
chr17	RPL27	42999185	42999292	0	108	21746	2030	21746	1922	0.0	11.314255983350677
chr17	NBR2	43131207	43131270	0	64	30888	3057	30888	2993	0.0	10.32008018710324
chr17	NBR1	43177935	43177998	81	64	149792	7964	149711	7900	1.265625	18.950759493670887
chr17	TMEM106A	43212314	43212394	133	81	69150	3586	69017	3505	1.6419753086419753	19.69101283880171
chr17	TMEM106A	43216448	43216589	2378	142	69150	3586	66772	3444	16.746478873239436	19.387921022067363
chr17	TMEM106A	43212204	43212394	714	191	69150	3586	68436	3395	3.738219895287958	20.157879234167893
chr17	TMEM106A	43212226	43212394	693	169	69150	3586	68457	3417	4.100591715976331	20.0342405618964
chr17	DHX8	43489448	43489534	0	87	77727	10358	77727	10271	0.0	7.567617564015189
chr17	DHX8	43523627	43524185	2455	559	77727	10358	75272	9799	4.391771019677996	7.681600163281968
chr17	CD300LG	43852911	43853013	0	103	510	4765	510	4662	0.0	0.1093951093951094
chr17	G6PC3	44074968	44075087	0	120	213	4172	213	4052	0.0	0.052566633761105624
chr17	G6PC3	44071627	44071811	0	185	213	4172	213	3987	0.0	0.05342362678705794
chr17	G6PC3	44071627	44071821	0	195	213	4172	213	3977	0.0	0.05355795825999497
chr17	HROB	44150960	44151044	0	85	1290	3015	1290	2930	0.0	0.4402730375426621
chr17	HROB	44157832	44157941	0	110	1290	3015	1290	2905	0.0	0.4440619621342513
chr17	TMUB2	44187906	44188009	347	104	2028	3574	1681	3470	3.3365384615384617	0.48443804034582133
chr17	TMUB2	44189410	44189588	0	179	2028	3574	2028	3395	0.0	0.5973490427098674
chr17	TMUB2	44187675	44187743	663	69	2028	3574	1365	3505	9.608695652173912	0.38944365192582026
chr17	TMUB2	44187616	44187743	663	128	2028	3574	1365	3446	5.1796875	0.3961114335461405
chr17	TMUB2	44189423	44189588	0	166	2028	3574	2028	3408	0.0	0.5950704225352113
chr17	GRN	44345609	44345741	1100	133	1277	3085	177	2952	8.270676691729323	0.059959349593495935
chr17	GRN	44345565	44345605	0	41	1277	3085	1277	3044	0.0	0.4195137976346912
chr17	GRN	44346088	44346228	24	141	1277	3085	1253	2944	0.1702127659574468	0.42561141304347827
chr17	GRN	44345530	44345605	0	76	1277	3085	1277	3009	0.0	0.4243934862080425
chr17	MEIOC	44665383	44665488	0	106	3530	8627	3530	8521	0.0	0.4142706255134374
chr17	DBF4B	44709303	44709366	0	64	2730	5975	2730	5911	0.0	0.4618507866689224
chr17	DBF4B	44732177	44732265	0	89	2730	5975	2730	5886	0.0	0.46381243628950053
chr17	HIGD1B	44849253	44849388	0	136	898	861	898	725	0.0	1.2386206896551724
chr17	HIGD1B	44849105	44849388	0	284	898	861	898	577	0.0	1.5563258232235702
chr17	NMT1	45093684	45093803	1381	120	10294	7711	8913	7591	11.508333333333333	1.1741536029508628
chr17	NMT1	45097127	45097244	82	118	10294	7711	10212	7593	0.6949152542372882	1.3449229553536153
chr17	NMT1	45081643	45081752	150	110	10294	7711	10144	7601	1.3636363636363635	1.3345612419418498
chr17	NMT1	45104120	45104224	0	105	10294	7711	10294	7606	0.0	1.3534052064159874
chr17	NMT1	45078082	45078149	0	68	10294	7711	10294	7643	0.0	1.346853329844302
chr17	NMT1	45083657	45083755	0	99	10294	7711	10294	7612	0.0	1.3523384130320546
chr17	ACBD4	45136499	45136620	75	122	17035	3521	16960	3399	0.6147540983606558	4.989702853780524
chr17	ACBD4	45139020	45139160	0	141	17035	3521	17035	3380	0.0	5.039940828402367
chr17	HEXIM2	45162487	45162635	47	149	6364	1994	6317	1845	0.31543624161073824	3.423848238482385
chr17	FMNL1	45245631	45245733	51	103	39242	6173	39191	6070	0.49514563106796117	6.456507413509061
chr17	FMNL1	45246504	45246604	0	101	39242	6173	39242	6072	0.0	6.462779973649539
chr17	FMNL1	45245618	45245733	51	116	39242	6173	39191	6057	0.4396551724137931	6.470364867095922
chr17	MAP3K14-AS1	45255137	45255218	1088	82	13506	4874	12418	4792	13.268292682926829	2.5914023372287147
chr17	MAP3K14-AS1	45255134	45255218	1088	85	13506	4874	12418	4789	12.8	2.5930256838588432
chr17	MAP3K14-AS1	45249533	45249632	0	100	13506	4874	13506	4774	0.0	2.829074151654797
chr17	MAP3K14-AS1	45266249	45266518	2461	270	13506	4874	11045	4604	9.114814814814816	2.399000868809731
chr17	MAP3K14-AS1	45266249	45266699	11704	451	13506	4874	1802	4423	25.951219512195124	0.4074157811440199
chr17	CRHR1	45816462	45816582	0	121	878	3298	878	3177	0.0	0.2763613471828769
chr17	CRHR1	45821354	45821440	0	87	878	3298	878	3211	0.0	0.27343506695733416
chr17	CRHR1	45830416	45830570	0	155	878	3298	878	3143	0.0	0.2793509385937003
chr17	CRHR1	45833451	45833537	0	87	878	3298	878	3211	0.0	0.27343506695733416
chr17	CRHR1	45833713	45833849	0	137	878	3298	878	3161	0.0	0.27776020246757355
chr17	CRHR1	45834006	45834048	0	43	878	3298	878	3255	0.0	0.2697388632872504
chr17	LINC02210	45635300	45635398	39	99	21519	14607	21480	14508	0.3939393939393939	1.4805624483043838
chr17	LINC02210	45627375	45627682	51	308	21519	14607	21468	14299	0.16558441558441558	1.5013637317294917
chr17	LINC02210	45640388	45640455	0	68	21519	14607	21519	14539	0.0	1.480088039067336
chr17	CRHR1	45829560	45829647	0	88	878	3298	878	3210	0.0	0.2735202492211838
chr17	CRHR1	45825485	45825595	0	111	878	3298	878	3187	0.0	0.2754941951678695
chr17	MAPT	45971858	45971945	0	88	341449	9263	341449	9175	0.0	37.21514986376022
chr17	MAPT	46014242	46014324	0	83	341449	9263	341449	9180	0.0	37.19488017429194
chr17	MAPT	45982865	45983930	1881	1066	341449	9263	339568	8197	1.7645403377110693	41.42588751982433
chr17	MAPT	45989877	45990075	0	199	341449	9263	341449	9064	0.0	37.67089585172109
chr17	MAPT	46010309	46010402	0	94	341449	9263	341449	9169	0.0	37.23950267204712
chr17	MAPT	45974384	45974471	1007	88	341449	9263	340442	9175	11.443181818181818	37.10539509536785
chr17	MAPT	45969164	45969299	491	136	341449	9263	340958	9127	3.610294117647059	37.357072422482744
chr17	MAPT	45983177	45983930	1126	754	341449	9263	340323	8509	1.493368700265252	39.995651662945114
chr17	MAPT	45993923	45993977	727	55	341449	9263	340722	9208	13.218181818181819	37.00282363162467
chr17	NSF	46630410	46630450	6817	41	120100	5030	113283	4989	166.26829268292684	22.706554419723393
chr17	NSF	46755498	46755597	0	100	120100	5030	120100	4930	0.0	24.36105476673428
chr17	GOSR2	46931098	46931207	0	110	279358	11566	279358	11456	0.0	24.38530027932961
chr17	GOSR2	46935028	46935169	51	142	279358	11566	279307	11424	0.3591549295774648	24.449142156862745
chr17	GOSR2	46963696	46965039	82	1344	279358	11566	279276	10222	0.06101190476190476	27.321072197221678
chr17	GOSR2	46931101	46931207	0	107	279358	11566	279358	11459	0.0	24.37891613578846
chr17	GOSR2	46963834	46965039	0	1206	279358	11566	279358	10360	0.0	26.965057915057915
chr17	GOSR2	46935028	46935225	51	198	279358	11566	279307	11368	0.25757575757575757	24.569581280788178
chr17	GOSR2	46931104	46931207	0	104	279358	11566	279358	11462	0.0	24.372535334147617
chr17	GOSR2	46964343	46965039	0	697	279358	11566	279358	10869	0.0	25.702272518170943
chr17	GOSR2	46963696	46963779	82	84	279358	11566	279276	11482	0.9761904761904762	24.322940254311096
chr17	GOSR2	46955500	46955712	0	213	279358	11566	279358	11353	0.0	24.606535717431516
chr17	GOSR2	46923816	46923865	261	50	279358	11566	279097	11516	5.22	24.23558527266412
chr17	GOSR2	46932066	46932199	204	134	279358	11566	279154	11432	1.5223880597014925	24.418649405178446
chr17	GOSR2	46924260	46924468	2054	209	279358	11566	277304	11357	9.82775119617225	24.417011534736286
chr17	GOSR2	46923508	46923632	1303	125	279358	11566	278055	11441	10.424	24.303382571453543
chr17	GOSR2	46964001	46965039	0	1039	279358	11566	279358	10527	0.0	26.53728507647003
chr17	GOSR2	46937892	46938010	0	119	279358	11566	279358	11447	0.0	24.404472787629945
chr17	MYL4	47213798	47213826	0	29	0	1645	0	1616	0.0	0.0
chr17	MYL4	47213798	47213919	0	122	0	1645	0	1523	0.0	0.0
chr17	EFCAB13	47335195	47335356	0	162	6496	6489	6496	6327	0.0	1.0267109214477637
chr17	EFCAB13	47328792	47329038	0	247	6496	6489	6496	6242	0.0	1.0406920858699136
chr17	EFCAB13	47347807	47347951	0	145	6496	6489	6496	6344	0.0	1.0239596469104666
chr17	EFCAB13	47361377	47361521	0	145	6496	6489	6496	6344	0.0	1.0239596469104666
chr17	NPEPPS	47531416	47531555	0	140	36399	9467	36399	9327	0.0	3.902541009971052
chr17	NPEPPS	47545908	47545993	0	86	36399	9467	36399	9381	0.0	3.880076750879437
chr17	NPEPPS	47577044	47577160	44	117	36399	9467	36355	9350	0.37606837606837606	3.888235294117647
chr17	NPEPPS	47531389	47531555	0	167	36399	9467	36399	9300	0.0	3.9138709677419357
chr17	NPEPPS	47577080	47577160	8	81	36399	9467	36391	9386	0.09876543209876543	3.877157468570211
chr17	NPEPPS	47559611	47559687	0	77	36399	9467	36399	9390	0.0	3.8763578274760384
chr17	NPEPPS	47619277	47619372	0	96	36399	9467	36399	9371	0.0	3.8842172660335077
chr17	NPEPPS	47619277	47619495	0	219	36399	9467	36399	9248	0.0	3.9358780276816607
chr17	NPEPPS	47586147	47586244	0	98	36399	9467	36399	9369	0.0	3.885046429715018
chr17	NPEPPS	47619277	47619322	0	46	36399	9467	36399	9421	0.0	3.863602589958603
chr17	KPNB1	47671709	47671862	0	154	89471	8415	89471	8261	0.0	10.830528991647501
chr17	LRRC46	47833968	47834047	0	80	51	2544	51	2464	0.0	0.020698051948051948
chr17	LRRC46	47834817	47834940	0	124	51	2544	51	2420	0.0	0.021074380165289255
chr17	SP2	47897814	47897927	0	114	3815	3654	3815	3540	0.0	1.0776836158192091
chr17	SP2	47914725	47914861	66	137	3815	3654	3749	3517	0.48175182481751827	1.0659653113448961
chr17	PNPO	47945558	47945612	0	55	0	4987	0	4932	0.0	0.0
chr17	PNPO	47945860	47945989	0	130	0	4987	0	4857	0.0	0.0
chr17	PNPO	47943342	47943430	0	89	0	4987	0	4898	0.0	0.0
chr17	PNPO	47943305	47943430	0	126	0	4987	0	4861	0.0	0.0
chr17	PNPO	47945597	47945612	0	16	0	4987	0	4971	0.0	0.0
chr17	NFE2L1	48057031	48057121	0	91	10434	5475	10434	5384	0.0	1.937964338781575
chr17	NFE2L1	48054929	48055150	0	222	10434	5475	10434	5253	0.0	1.9862935465448315
chr17	SNX11	48113300	48113401	0	102	51	4144	51	4042	0.0	0.012617516081147946
chr17	SNX11	48112750	48112873	0	124	51	4144	51	4020	0.0	0.012686567164179104
chr17	SNX11	48110707	48110767	0	61	51	4144	51	4083	0.0	0.012490815576781777
chr17	THRA1/BTR	48295545	48295605	0	61	0	1575	0	1514	0.0	0.0
chr17	HOXB-AS3	48601427	48601663	1329	237	7409	1897	6080	1660	5.6075949367088604	3.6626506024096384
chr17	HOXB-AS3	48600446	48600545	204	100	7409	1897	7205	1797	2.04	4.0094602114635505
chr17	LINC02086	48687496	48687710	0	215	40	3504	40	3289	0.0	0.012161751292186074
chr17	LINC02086	48700611	48700696	40	86	40	3504	0	3418	0.46511627906976744	0.0
chr17	CALCOCO2	48841697	48841887	0	191	11977	7200	11977	7009	0.0	1.708802967613069
chr17	CALCOCO2	48846033	48846096	0	64	11977	7200	11977	7136	0.0	1.6783912556053813
chr17	CALCOCO2	48849251	48849377	0	127	11977	7200	11977	7073	0.0	1.6933408737452282
chr17	CALCOCO2	48860313	48860449	153	137	11977	7200	11824	7063	1.1167883211678833	1.6740761715984709
chr17	CALCOCO2	48846442	48846514	0	73	11977	7200	11977	7127	0.0	1.6805107338291005
chr17	CALCOCO2	48843902	48844026	0	125	11977	7200	11977	7075	0.0	1.6928621908127208
chr17	CALCOCO2	48839375	48839511	0	137	11977	7200	11977	7063	0.0	1.6957383548067393
chr17	CALCOCO2	48841773	48841887	0	115	11977	7200	11977	7085	0.0	1.6904728299223712
chr17	CALCOCO2	48848800	48848827	0	28	11977	7200	11977	7172	0.0	1.6699665365309537
chr17	CALCOCO2	48856578	48856616	0	39	11977	7200	11977	7161	0.0	1.672531769305963
chr17	ATP5MC1	48894371	48894449	0	79	0	1499	0	1420	0.0	0.0
chr17	UBE2Z	48912833	48913021	0	189	0	3711	0	3522	0.0	0.0
chr17	UBE2Z	48912833	48912965	0	133	0	3711	0	3578	0.0	0.0
chr17	FLJ40194	49252853	49252918	0	66	85156	4893	85156	4827	0.0	17.641599337062356
chr17	FLJ40194	49253040	49253133	0	94	85156	4893	85156	4799	0.0	17.744530110439676
chr17	FLJ40194	49288905	49289046	510	142	85156	4893	84646	4751	3.591549295774648	17.816459692696274
chr17	KAT7	49798318	49798558	0	241	61	11487	61	11246	0.0	0.005424150809176596
chr17	KAT7	49809118	49809208	10	91	61	11487	51	11396	0.10989010989010989	0.004475254475254475
chr17	KAT7	49817819	49818011	0	193	61	11487	61	11294	0.0	0.005401097928103418
chr17	KAT7	49796749	49796926	0	178	61	11487	61	11309	0.0	0.005393934034839508
chr17	ITGA3	50068055	50068305	0	251	0	8655	0	8404	0.0	0.0
chr17	ITGA3	50088224	50088366	0	143	0	8655	0	8512	0.0	0.0
chr17	ITGA3	50081096	50081193	0	98	0	8655	0	8557	0.0	0.0
chr17	PDK2	50096131	50096286	0	156	0	4742	0	4586	0.0	0.0
chr17	SGCA	50167581	50167736	0	156	0	2358	0	2202	0.0	0.0
chr17	SGCA	50169091	50169254	0	164	0	2358	0	2194	0.0	0.0
chr17	SGCA	50170142	50170351	0	210	0	2358	0	2148	0.0	0.0
chr17	SGCA	50167367	50167487	0	121	0	2358	0	2237	0.0	0.0
chr17	AC015909.1	50211945	50212121	0	177	0	2615	0	2438	0.0	0.0
chr17	AC015909.1	50214100	50214174	0	75	0	2615	0	2540	0.0	0.0
chr17	AC015909.1	50210620	50210802	0	183	0	2615	0	2432	0.0	0.0
chr17	AC015909.1	50210467	50210802	0	336	0	2615	0	2279	0.0	0.0
chr17	AC015909.1	50214100	50214530	0	431	0	2615	0	2184	0.0	0.0
chr17	XYLT2	50357056	50357252	0	197	0	5479	0	5282	0.0	0.0
chr17	XYLT2	50357117	50357252	0	136	0	5479	0	5343	0.0	0.0
chr17	EME1	50378594	50378681	0	88	0	3178	0	3090	0.0	0.0
chr17	EME1	50375796	50375983	0	188	0	3178	0	2990	0.0	0.0
chr17	EME1	50378599	50378681	0	83	0	3178	0	3095	0.0	0.0
chr17	ACSF2	50463817	50463909	0	93	0	5152	0	5059	0.0	0.0
chr17	ACSF2	50472427	50472579	0	153	0	5152	0	4999	0.0	0.0
chr17	ACSF2	50460201	50460363	0	163	0	5152	0	4989	0.0	0.0
chr17	ACSF2	50461241	50461287	0	47	0	5152	0	5105	0.0	0.0
chr17	ACSF2	50460676	50460872	0	197	0	5152	0	4955	0.0	0.0
chr17	ACSF2	50461241	50461370	0	130	0	5152	0	5022	0.0	0.0
chr17	ACSF2	50426904	50426979	0	76	0	5152	0	5076	0.0	0.0
chr17	ACSF2	50464525	50464599	0	75	0	5152	0	5077	0.0	0.0
chr17	RSAD1	50479879	50480084	0	206	507	4146	507	3940	0.0	0.12868020304568528
chr17	RSAD1	50482642	50482706	0	65	507	4146	507	4081	0.0	0.12423425630972801
chr17	RSAD1	50483705	50483760	0	56	507	4146	507	4090	0.0	0.12396088019559902
chr17	RSAD1	50479628	50479762	0	135	507	4146	507	4011	0.0	0.12640239341810022
chr17	MYCBPAP	50514844	50514949	0	106	0	6482	0	6376	0.0	0.0
chr17	EPN3	50536028	50536199	0	172	153	4499	153	4327	0.0	0.035359371388953086
chr17	EPN3	50538883	50538964	0	82	153	4499	153	4417	0.0	0.03463889517772244
chr17	EPN3	50540246	50540334	0	89	153	4499	153	4410	0.0	0.03469387755102041
chr17	EPN3	50536048	50536199	0	152	153	4499	153	4347	0.0	0.035196687370600416
chr17	EPN3	50536028	50536278	0	251	153	4499	153	4248	0.0	0.036016949152542374
chr17	EPN3	50540203	50540334	0	132	153	4499	153	4367	0.0	0.03503549347378063
chr17	SPATA20	50547664	50547767	0	104	0	4742	0	4638	0.0	0.0
chr17	SPATA20	50548553	50548618	0	66	0	4742	0	4676	0.0	0.0
chr17	SPATA20	50549285	50549487	0	203	0	4742	0	4539	0.0	0.0
chr17	SPATA20	50550997	50551190	0	194	0	4742	0	4548	0.0	0.0
chr17	SPATA20	50547719	50547954	0	236	0	4742	0	4506	0.0	0.0
chr17	SPATA20	50548042	50548161	0	120	0	4742	0	4622	0.0	0.0
chr17	SPATA20	50547719	50547767	0	49	0	4742	0	4693	0.0	0.0
chr17	SPATA20	50547664	50547954	0	291	0	4742	0	4451	0.0	0.0
chr17	SPATA20	50550997	50551222	0	226	0	4742	0	4516	0.0	0.0
chr17	CACNA1G	50594992	50595061	0	70	357	10101	357	10031	0.0	0.03558967201674808
chr17	CACNA1G	50609881	50609935	0	55	357	10101	357	10046	0.0	0.03553653195301613
chr17	CACNA1G	50619682	50619826	0	145	357	10101	357	9956	0.0	0.03585777420650864
chr17	CACNA1G	50621659	50621794	0	136	357	10101	357	9965	0.0	0.035825388861013545
chr17	ABCC3	50643548	50643661	0	114	0	8868	0	8754	0.0	0.0
chr17	ABCC3	50660922	50661114	0	193	0	8868	0	8675	0.0	0.0
chr17	ABCC3	50668852	50668919	0	68	0	8868	0	8800	0.0	0.0
chr17	LUC7L3	50738136	50738199	0	64	2856	7501	2856	7437	0.0	0.3840258168616378
chr17	LUC7L3	50736959	50737026	0	68	2856	7501	2856	7433	0.0	0.3842324767926813
chr17	LUC7L3	50737286	50737479	0	194	2856	7501	2856	7307	0.0	0.39085808129191185
chr17	LUC7L3	50750500	50750641	0	142	2856	7501	2856	7359	0.0	0.3880962087240114
chr17	LUC7L3	50723818	50723965	0	148	2856	7501	2856	7353	0.0	0.3884128926968584
chr17	LUC7L3	50722663	50722745	0	83	2856	7501	2856	7418	0.0	0.3850094365057967
chr17	LUC7L3	50738140	50738199	0	60	2856	7501	2856	7441	0.0	0.38381937911571024
chr17	LUC7L3	50749218	50749344	0	127	2856	7501	2856	7374	0.0	0.387306753458096
chr17	LUC7L3	50749223	50749344	0	122	2856	7501	2856	7379	0.0	0.38704431494782493
chr17	LUC7L3	50751296	50751362	0	67	2856	7501	2856	7434	0.0	0.384180790960452
chr17	TOB1-AS1	50893767	50893858	0	92	0	3034	0	2942	0.0	0.0
chr17	NME1	51154224	51154444	0	221	0	3281	0	3060	0.0	0.0
chr17	NME2	51169936	51170049	0	114	0	2502	0	2388	0.0	0.0
chr17	UTP18	51277129	51277304	0	176	0	2719	0	2543	0.0	0.0
chr17	UTP18	51293902	51294045	0	144	0	2719	0	2575	0.0	0.0
chr17	UTP18	51286482	51286552	0	71	0	2719	0	2648	0.0	0.0
chr17	UTP18	51288547	51288591	0	45	0	2719	0	2674	0.0	0.0
chr17	TOM1L1	54903707	54903792	488	86	28863	7265	28375	7179	5.674418604651163	3.952500348237916
chr17	TOM1L1	54905488	54905567	0	80	28863	7265	28863	7185	0.0	4.017118997912317
chr17	TOM1L1	54912665	54912815	649	151	28863	7265	28214	7114	4.298013245033113	3.9659825695811075
chr17	TOM1L1	54914638	54914743	0	106	28863	7265	28863	7159	0.0	4.031708339153513
chr17	TOM1L1	54903679	54903792	543	114	28863	7265	28320	7151	4.7631578947368425	3.960285274786743
chr17	TOM1L1	54903712	54903792	468	81	28863	7265	28395	7184	5.777777777777778	3.9525334075723833
chr17	TOM1L1	54942288	54942491	2047	204	28863	7265	26816	7061	10.034313725490197	3.797762356606713
chr17	TOM1L1	54912686	54912815	432	130	28863	7265	28431	7135	3.3230769230769233	3.9847231955150666
chr17	TOM1L1	54906778	54906786	675	9	28863	7265	28188	7256	75.0	3.884785005512679
chr17	STXBP4	54985613	54985691	969	79	238467	18075	237498	17996	12.265822784810126	13.19726605912425
chr17	STXBP4	54990824	54990957	31383	134	238467	18075	207084	17941	234.20149253731344	11.542500418036898
chr17	STXBP4	55007505	55007597	0	93	238467	18075	238467	17982	0.0	13.261428094761428
chr17	STXBP4	55047088	55047154	0	67	238467	18075	238467	18008	0.0	13.242281208351844
chr17	PCTP	55787565	55787654	0	90	2601	5817	2601	5727	0.0	0.4541644840230487
chr17	SCPEP1	56981116	56981230	0	115	204	2897	204	2782	0.0	0.07332854061826025
chr17	SCPEP1	56985377	56985467	0	91	204	2897	204	2806	0.0	0.07270135424091233
chr17	SCPEP1	56998384	56998498	0	115	204	2897	204	2782	0.0	0.07332854061826025
chr17	SCPEP1	56981081	56981230	0	150	204	2897	204	2747	0.0	0.07426283218056061
chr17	SCPEP1	56998373	56998498	0	126	204	2897	204	2771	0.0	0.0736196319018405
chr17	AKAP1	57116110	57116261	67	152	27339	5359	27272	5207	0.4407894736842105	5.237564816593048
chr17	AKAP1	57086372	57086537	1001	166	27339	5359	26338	5193	6.030120481927711	5.071827460042365
chr17	AKAP1	57096590	57096763	0	174	27339	5359	27339	5185	0.0	5.272709739633559
chr17	AKAP1	57107945	57108048	0	104	27339	5359	27339	5255	0.0	5.202473834443388
chr17	AKAP1	57101593	57101730	0	138	27339	5359	27339	5221	0.0	5.2363531890442445
chr17	AKAP1	57120249	57120293	78	45	27339	5359	27261	5314	1.7333333333333334	5.13003387278886
chr17	MSI2	57676986	57677059	11	74	150709	16085	150698	16011	0.14864864864864866	9.412154144025981
chr17	MSI2	57259976	57260054	0	79	150709	16085	150709	16006	0.0	9.415781581906785
chr17	MSI2	57370948	57370991	0	44	150709	16085	150709	16041	0.0	9.39523720466305
chr17	MSI2	57650649	57650673	0	25	150709	16085	150709	16060	0.0	9.38412204234122
chr17	MSI2	57263487	57263569	0	83	150709	16085	150709	16002	0.0	9.418135233095864
chr17	MSI2	57310130	57310326	0	197	150709	16085	150709	15888	0.0	9.485712487411883
chr17	MSI2	57556989	57557131	0	143	150709	16085	150709	15942	0.0	9.45358173378497
chr17	MSI2	57655694	57655744	210	51	150709	16085	150499	16034	4.117647058823529	9.38624173631034
chr17	LPO	58243993	58244081	47	89	14999	6060	14952	5971	0.5280898876404494	2.504103165298945
chr17	LPO	58247477	58247638	0	162	14999	6060	14999	5898	0.0	2.5430654459138693
chr17	LPO	58254552	58254611	960	60	14999	6060	14039	6000	16.0	2.3398333333333334
chr17	TSPOAP1-AS1	58325918	58326036	0	119	0	3888	0	3769	0.0	0.0
chr17	TSPOAP1-AS1	58346279	58346343	0	65	0	3888	0	3823	0.0	0.0
chr17	TSPOAP1-AS1	58339242	58339447	0	206	0	3888	0	3682	0.0	0.0
chr17	RAD51C	58696692	58696859	0	168	8508	5705	8508	5537	0.0	1.5365721509842876
chr17	RAD51C	58694930	58695189	460	260	8508	5705	8048	5445	1.7692307692307692	1.4780532598714418
chr17	RAD51C	58720745	58720812	0	68	8508	5705	8508	5637	0.0	1.5093134646088344
chr17	RAD51C	58724039	58724100	0	62	8508	5705	8508	5643	0.0	1.5077086656034024
chr17	RAD51C	58705877	58706022	708	146	8508	5705	7800	5559	4.8493150684931505	1.4031300593631948
chr17	RAD51C	58706488	58706608	0	121	8508	5705	8508	5584	0.0	1.5236389684813754
chr17	RAD51C	58732483	58732544	0	62	8508	5705	8508	5643	0.0	1.5077086656034024
chr17	PRR11	59160758	59160876	0	119	10011	4818	10011	4699	0.0	2.130453287933603
chr17	PRR11	59163598	59163664	0	67	10011	4818	10011	4751	0.0	2.107135339928436
chr17	GDPD1	59267040	59267174	0	135	160	2336	160	2201	0.0	0.07269422989550205
chr17	GDPD1	59257121	59257240	0	120	160	2336	160	2216	0.0	0.07220216606498195
chr17	YPEL2	59353214	59353526	0	313	255	8707	255	8394	0.0	0.030378842030021443
chr17	DHX40	59566626	59566794	0	169	0	5857	0	5688	0.0	0.0
chr17	DHX40	59570517	59570663	0	147	0	5857	0	5710	0.0	0.0
chr17	DHX40	59586152	59586233	0	82	0	5857	0	5775	0.0	0.0
chr17	DHX40	59566626	59566709	0	84	0	5857	0	5773	0.0	0.0
chr17	CLTC	59647397	59647666	0	270	127	11871	127	11601	0.0	0.010947332126540815
chr17	CLTC	59658661	59658804	0	144	127	11871	127	11727	0.0	0.010829709218043831
chr17	CLTC	59687000	59687021	0	22	127	11871	127	11849	0.0	0.010718204067853827
chr17	VMP1	59731420	59731522	0	103	0	5500	0	5397	0.0	0.0
chr17	VMP1	59738836	59738947	0	112	0	5500	0	5388	0.0	0.0
chr17	VMP1	59735337	59735473	0	137	0	5500	0	5363	0.0	0.0
chr17	VMP1	59737452	59737543	0	92	0	5500	0	5408	0.0	0.0
chr17	VMP1	59834011	59834050	0	40	0	5500	0	5460	0.0	0.0
chr17	RPS6KB1	59893795	59893924	0	130	26722	5329	26722	5199	0.0	5.139834583573764
chr17	RPS6KB1	59914634	59914703	0	70	26722	5329	26722	5259	0.0	5.081194143373265
chr17	RPS6KB1	59930799	59931052	0	254	26722	5329	26722	5075	0.0	5.265418719211823
chr17	RPS6KB1	59930357	59930432	0	76	26722	5329	26722	5253	0.0	5.0869979059584995
chr17	CA4	60151441	60151529	0	89	0	2428	0	2339	0.0	0.0
chr17	PPM1D	60656931	60657042	1428	112	9288	5052	7860	4940	12.75	1.591093117408907
chr17	BCAS3	60688931	60689046	788	116	5291	8054	4503	7938	6.793103448275862	0.5672713529856387
chr17	BCAS3	61388617	61388708	0	92	5291	8054	5291	7962	0.0	0.664531524742527
chr17	BCAS3	60688019	60688195	546	177	5291	8054	4745	7877	3.0847457627118646	0.6023866954424273
chr17	BCAS3	61026865	61026910	0	46	5291	8054	5291	8008	0.0	0.6607142857142857
chr17	BCAS3	61380505	61380571	0	67	5291	8054	5291	7987	0.0	0.6624514836609491
chr17	BCAS3	61356848	61356986	0	139	5291	8054	5291	7915	0.0	0.6684775742261528
chr17	METTL2A	62424218	62424310	0	93	0	6390	0	6297	0.0	0.0
chr17	TLK2	62508407	62508553	0	147	73800	8314	73800	8167	0.0	9.036365862617853
chr17	TLK2	62524235	62524331	1020	97	73800	8314	72780	8217	10.515463917525773	8.857247170500182
chr17	TLK2	62552301	62552397	876	97	73800	8314	72924	8217	9.030927835051546	8.87477181453085
chr17	TLK2	62553662	62553755	9819	94	73800	8314	63981	8220	104.45744680851064	7.783576642335767
chr17	TLK2	62477495	62477697	5152	203	73800	8314	68648	8111	25.379310344827587	8.46356799408211
chr17	TLK2	62507380	62507449	0	70	73800	8314	73800	8244	0.0	8.951965065502183
chr17	TLK2	62574344	62574410	0	67	73800	8314	73800	8247	0.0	8.948708621316843
chr17	MRC2	62689521	62689760	612	240	14577	6443	13965	6203	2.55	2.251330001612123
chr17	AC005821.1	62707431	62707607	863	177	26278	3916	25415	3739	4.875706214689266	6.79727199786039
chr17	AC005821.1	62726255	62726600	0	346	26278	3916	26278	3570	0.0	7.36078431372549
chr17	TANC2	63418306	63418407	0	102	14764	19851	14764	19749	0.0	0.7475821560585346
chr17	TANC2	63412679	63412709	0	31	14764	19851	14764	19820	0.0	0.7449041372351161
chr17	TANC2	63151269	63151380	0	112	14764	19851	14764	19739	0.0	0.7479608896094027
chr17	ACE	63479006	63479100	0	95	7143	8236	7143	8141	0.0	0.877410637513819
chr17	ACE	63483028	63483173	0	146	7143	8236	7143	8090	0.0	0.8829419035846724
chr17	ACE	63488940	63489132	0	193	7143	8236	7143	8043	0.0	0.8881014546810891
chr17	ACE	63496393	63496516	528	124	7143	8236	6615	8112	4.258064516129032	0.8154585798816568
chr17	ACE	63486358	63486371	0	14	7143	8236	7143	8222	0.0	0.8687667234249574
chr17	AC113554.1	63507240	63507369	0	130	3532	4893	3532	4763	0.0	0.7415494436279656
chr17	AC113554.1	63508638	63508827	0	190	3532	4893	3532	4703	0.0	0.7510099936210929
chr17	ACE	63486291	63486371	0	81	7143	8236	7143	8155	0.0	0.8759043531575721
chr17	KCNH6	63544011	63544119	0	109	5852	4226	5852	4117	0.0	1.421423366529026
chr17	DCAF7	63578469	63578628	0	160	0	2259	0	2099	0.0	0.0
chr17	DCAF7	63590990	63591084	0	95	0	2259	0	2164	0.0	0.0
chr17	MAP3K3	63634708	63634801	0	94	89	5824	89	5730	0.0	0.015532286212914486
chr17	DDX42	63775107	63775178	0	72	1275	6612	1275	6540	0.0	0.19495412844036697
chr17	DDX42	63799588	63799625	0	38	1275	6612	1275	6574	0.0	0.19394584727715242
chr17	DDX42	63787033	63787270	0	238	1275	6612	1275	6374	0.0	0.20003137747097585
chr17	DDX42	63799479	63799523	0	45	1275	6612	1275	6567	0.0	0.19415258108725444
chr17	PSMC5	63829493	63829563	0	71	102	2629	102	2558	0.0	0.0398749022673964
chr17	PSMC5	63830132	63830189	0	58	102	2629	102	2571	0.0	0.039673278879813305
chr17	PSMC5	63830808	63830935	0	128	102	2629	102	2501	0.0	0.04078368652538984
chr17	PSMC5	63827828	63827923	0	96	102	2629	102	2533	0.0	0.040268456375838924
chr17	PSMC5	63827850	63827923	0	74	102	2629	102	2555	0.0	0.039921722113502936
chr17	PSMC5	63827673	63827923	0	251	102	2629	102	2378	0.0	0.04289318755256518
chr17	TCAM1P	63860687	63860954	0	268	11	3554	11	3286	0.0	0.0033475349969567863
chr17	PRR29	63998706	63998782	0	77	54	3570	54	3493	0.0	0.015459490409390209
chr17	PRR29	64001083	64001310	0	228	54	3570	54	3342	0.0	0.01615798922800718
chr17	PRR29	63998727	63998782	0	56	54	3570	54	3514	0.0	0.015367103016505406
chr17	MILR1	64452596	64452866	76	271	184	1826	108	1555	0.28044280442804426	0.06945337620578779
chr17	MILR1	64457399	64457684	0	286	184	1826	184	1540	0.0	0.11948051948051948
chr17	CEP95	64516722	64516828	0	107	3660	6734	3660	6627	0.0	0.552286102308737
chr17	CEP95	64530925	64531018	0	94	3660	6734	3660	6640	0.0	0.5512048192771084
chr17	CEP95	64530925	64531022	0	98	3660	6734	3660	6636	0.0	0.5515370705244123
chr17	CEP95	64520485	64520576	0	92	3660	6734	3660	6642	0.0	0.5510388437217706
chr17	PRKCA	66554518	66554579	0	62	5945	11196	5945	11134	0.0	0.5339500628704869
chr17	PITPNC1	67553609	67553617	0	9	0	7830	0	7821	0.0	0.0
chr17	PITPNC1	67687065	67687184	0	120	0	7830	0	7710	0.0	0.0
chr17	NOL11	67719110	67719167	0	58	179	4480	179	4422	0.0	0.040479421076436005
chr17	NOL11	67722579	67722637	0	59	179	4480	179	4421	0.0	0.040488577244967204
chr17	BPTF	67975771	67975958	0	188	0	14493	0	14305	0.0	0.0
chr17	BPTF	67875555	67875744	0	190	0	14493	0	14303	0.0	0.0
chr17	BPTF	67886127	67886316	0	190	0	14493	0	14303	0.0	0.0
chr17	BPTF	67963332	67963506	0	175	0	14493	0	14318	0.0	0.0
chr17	BPTF	67928958	67929120	0	163	0	14493	0	14330	0.0	0.0
chr17	AMZ2	68250793	68250967	0	175	0	3654	0	3479	0.0	0.0
chr17	AMZ2	68249010	68249096	0	87	0	3654	0	3567	0.0	0.0
chr17	ARSG	68306942	68307711	0	770	0	6604	0	5834	0.0	0.0
chr17	PRKAR1A	68514986	68515119	0	134	255	6098	255	5964	0.0	0.04275653923541248
chr17	PRKAR1A	68512909	68512978	0	70	255	6098	255	6028	0.0	0.04230258792302588
chr17	PRKAR1A	68528630	68528719	0	90	255	6098	255	6008	0.0	0.04244340878828229
chr17	MAP2K6	69504458	69504579	0	122	204	15176	204	15054	0.0	0.013551215623754484
chr17	LINC01497	69964381	69964552	0	172	0	1827	0	1655	0.0	0.0
chr17	LINC01028	70062210	70062328	0	119	306	1166	306	1047	0.0	0.2922636103151863
chr17	KCNJ16	70108300	70108381	0	82	224	6349	224	6267	0.0	0.035742779639380884
chr17	KCNJ16	70131352	70131480	0	129	224	6349	224	6220	0.0	0.0360128617363344
chr17	LINC01152	72036238	72036311	0	74	51	4169	51	4095	0.0	0.012454212454212455
chr17	LINC02003	72347920	72348061	0	142	0	2500	0	2358	0.0	0.0
chr17	COG1	73207701	73207739	6	39	17914	4290	17908	4251	0.15384615384615385	4.2126558456833685
chr17	C17ORF80	73235475	73236995	98316	1521	192496	4671	94180	3150	64.63905325443787	29.8984126984127
chr17	C17ORF80	73242243	73242351	0	109	192496	4671	192496	4562	0.0	42.19552827707146
chr17	AC125421.1	73748124	73748308	15	185	2244	2465	2229	2280	0.08108108108108109	0.9776315789473684
chr17	LINC02092	73790562	73790710	0	149	32886	3086	32886	2937	0.0	11.197139938712972
chr17	LINC02092	73791712	73791802	75	91	32886	3086	32811	2995	0.8241758241758241	10.955258764607679
chr17	LINC02092	73799229	73799668	2856	440	32886	3086	30030	2646	6.490909090909091	11.34920634920635
chr17	TTYH2	74251868	74252014	0	147	175361	5335	175361	5188	0.0	33.80127216653816
chr17	DNAI2	74286976	74287098	610	123	9837	2878	9227	2755	4.959349593495935	3.3491833030852995
chr17	KIF19	74344222	74344348	0	127	25597	5660	25597	5533	0.0	4.6262425447316105
chr17	CD300A	74481725	74481833	764	109	26442	2709	25678	2600	7.009174311926605	9.876153846153846
chr17	CD300A	74473535	74473874	6448	340	26442	2709	19994	2369	18.96470588235294	8.439848037146476
chr17	RAB37	74745007	74745084	58	78	40497	4785	40439	4707	0.7435897435897436	8.59124707881878
chr17	RAB37	74740767	74740878	0	112	40497	4785	40497	4673	0.0	8.666167344318424
chr17	SLC9A3R1	74766935	74766976	0	42	4593	2345	4593	2303	0.0	1.9943551888840643
chr17	MRPL58	75018585	75018694	0	110	0	1094	0	984	0.0	0.0
chr17	SLC16A5	75089150	75089304	4431	155	12934	2997	8503	2842	28.587096774193547	2.9919071076706545
chr17	SLC16A5	75089113	75089304	4735	192	12934	2997	8199	2805	24.661458333333332	2.922994652406417
chr17	NUP85	75208503	75208620	261	118	31814	4297	31553	4179	2.211864406779661	7.550370902129696
chr17	NUP85	75208526	75208620	261	95	31814	4297	31553	4202	2.7473684210526317	7.5090433127082346
chr17	NUP85	75218184	75218306	12	123	31814	4297	31802	4174	0.0975609756097561	7.619070436032582
chr17	NUP85	75225102	75225237	0	136	31814	4297	31814	4161	0.0	7.645758231194424
chr17	NUP85	75225697	75225829	0	133	31814	4297	31814	4164	0.0	7.640249759846301
chr17	NUP85	75231339	75231423	0	85	31814	4297	31814	4212	0.0	7.55318138651472
chr17	NUP85	75208536	75208620	261	85	31814	4297	31553	4212	3.070588235294118	7.4912155745489075
chr17	NUP85	75225341	75225464	0	124	31814	4297	31814	4173	0.0	7.623771866762521
chr17	NUP85	75225123	75225237	0	115	31814	4297	31814	4182	0.0	7.607364897178384
chr17	NUP85	75228997	75229131	0	135	31814	4297	31814	4162	0.0	7.6439211917347425
chr17	NUP85	75235421	75235480	0	60	31814	4297	31814	4237	0.0	7.508614585791834
chr17	TMEM94	75496729	75496807	0	79	201749	7638	201749	7559	0.0	26.689906072231775
chr17	TMEM94	75457293	75457477	0	185	201749	7638	201749	7453	0.0	27.06950221387361
chr17	TMEM94	75487277	75487380	0	104	201749	7638	201749	7534	0.0	26.77847093177595
chr17	TMEM94	75492238	75492337	1303	100	201749	7638	200446	7538	13.03	26.591403555319715
chr17	TSEN54	75516745	75516910	0	166	0	2942	0	2776	0.0	0.0
chr17	LLGL2	75574452	75574495	0	44	850	6610	850	6566	0.0	0.12945476698141944
chr17	LLGL2	75533641	75533705	0	65	850	6610	850	6545	0.0	0.12987012987012986
chr17	LLGL2	75538530	75538636	0	107	850	6610	850	6503	0.0	0.13070890358296172
chr17	MYO15B	75592463	75592541	0	79	194	12656	194	12577	0.0	0.015424982110201161
chr17	MYO15B	75610899	75610959	0	61	194	12656	194	12595	0.0	0.015402937673680032
chr17	MYO15B	75613980	75614033	0	54	194	12656	194	12602	0.0	0.015394381844151721
chr17	MYO15B	75592427	75592541	0	115	194	12656	194	12541	0.0	0.015469260824495654
chr17	MYO15B	75600605	75600680	0	76	194	12656	194	12580	0.0	0.015421303656597773
chr17	MYO15B	75620466	75620636	0	171	194	12656	194	12485	0.0	0.015538646375650781
chr17	MYO15B	75590906	75591016	0	111	194	12656	194	12545	0.0	0.015464328417696294
chr17	MYO15B	75600630	75600680	0	51	194	12656	194	12605	0.0	0.015390717969059897
chr17	MYO15B	75624369	75624447	0	79	194	12656	194	12577	0.0	0.015424982110201161
chr17	MYO15B	75606932	75607003	0	72	194	12656	194	12584	0.0	0.015416401780038143
chr17	SAP30BP	75668048	75668169	0	122	0	7603	0	7481	0.0	0.0
chr17	SAP30BP	75668515	75668625	0	111	0	7603	0	7492	0.0	0.0
chr17	SAP30BP	75671815	75671863	0	49	0	7603	0	7554	0.0	0.0
chr17	SAP30BP	75703310	75703371	0	62	0	7603	0	7541	0.0	0.0
chr17	SAP30BP	75705610	75705693	0	84	0	7603	0	7519	0.0	0.0
chr17	SAP30BP	75703807	75703859	0	53	0	7603	0	7550	0.0	0.0
chr17	SAP30BP	75690670	75690772	0	103	0	7603	0	7500	0.0	0.0
chr17	ITGB4	75737537	75737644	0	108	0	6607	0	6499	0.0	0.0
chr17	ITGB4	75755700	75755850	0	151	0	6607	0	6456	0.0	0.0
chr17	ITGB4	75753764	75753974	0	211	0	6607	0	6396	0.0	0.0
chr17	ITGB4	75755054	75755213	0	160	0	6607	0	6447	0.0	0.0
chr17	UNK	75791759	75792019	0	261	153	5560	153	5299	0.0	0.02887337233440272
chr17	UNK	75808947	75809039	0	93	153	5560	153	5467	0.0	0.02798609840863362
chr17	TEN1	75984580	75984718	0	139	663	1289	663	1150	0.0	0.5765217391304348
chr17	TEN1	75984891	75985012	0	122	663	1289	663	1167	0.0	0.5681233933161953
chr17	PRCD	76542552	76542633	0	82	102	5045	102	4963	0.0	0.020552085432198268
chr17	PRCD	76544231	76544370	0	140	102	5045	102	4905	0.0	0.020795107033639144
chr17	PRCD	76545895	76546131	0	237	102	5045	102	4808	0.0	0.021214642262895173
chr17	SNHG16	76558944	76559043	0	100	102	5256	102	5156	0.0	0.01978277734678045
chr17	SNHG16	76557969	76558279	0	311	102	5256	102	4945	0.0	0.02062689585439838
chr17	SNHG16	76557969	76558600	0	632	102	5256	102	4624	0.0	0.022058823529411766
chr17	SNHG16	76558373	76558600	0	228	102	5256	102	5028	0.0	0.02028639618138425
chr17	SNHG16	76558373	76559043	0	671	102	5256	102	4585	0.0	0.022246455834242094
chr17	METTL23	76729689	76729794	0	106	210	1838	210	1732	0.0	0.12124711316397228
chr17	METTL23	76726969	76727213	50	245	210	1838	160	1593	0.20408163265306123	0.10043942247332077
chr17	METTL23	76726969	76727178	50	210	210	1838	160	1628	0.23809523809523808	0.09828009828009827
chr17	METTL23	76732977	76733215	42	239	210	1838	168	1599	0.17573221757322174	0.1050656660412758
chr17	MFSD11	76743397	76743456	0	60	11553	5442	11553	5382	0.0	2.1465997770345595
chr17	MFSD11	76742176	76742273	0	98	11553	5442	11553	5344	0.0	2.16186377245509
chr17	MFSD11	76745392	76745439	0	48	11553	5442	11553	5394	0.0	2.1418242491657398
chr17	LINC00868	76856169	76856264	23	96	2044940	1387	2044917	1291	0.23958333333333334	1583.9790859798607
chr17	LINC00868	76858266	76858355	502	90	2044940	1387	2044438	1297	5.5777777777777775	1576.2821896684657
chr17	MGAT5B	76933291	76933297	0	7	5474	6459	5474	6452	0.0	0.8484190948543088
chr17	MGAT5B	76932644	76932775	0	132	5474	6459	5474	6327	0.0	0.8651809704441283
chr17	SNHG20	77093243	77093347	0	105	0	4357	0	4252	0.0	0.0
chr17	SEPTIN9	77294773	77294903	0	131	51	13488	51	13357	0.0	0.003818222654787752
chr17	SEPTIN9	77307140	77307197	0	58	51	13488	51	13430	0.0	0.0037974683544303796
chr17	SEPTIN9	77322788	77322948	0	161	51	13488	51	13327	0.0	0.003826817738425752
chr17	SEPTIN9	77451366	77451528	0	163	51	13488	51	13325	0.0	0.003827392120075047
chr17	SEPTIN9	77496213	77496389	0	177	51	13488	51	13311	0.0	0.0038314176245210726
chr17	AC021683.3	77533177	77533266	0	90	0	5420	0	5330	0.0	0.0
chr17	AC021683.3	77530460	77530939	0	480	0	5420	0	4940	0.0	0.0
chr17	AC021683.3	77533180	77533266	0	87	0	5420	0	5333	0.0	0.0
chr17	AC021683.3	77530601	77530939	0	339	0	5420	0	5081	0.0	0.0
chr17	TNRC6C	78097744	78097861	0	118	88002	11136	88002	11018	0.0	7.987111998547831
chr17	TNRC6C	78012002	78012060	0	59	88002	11136	88002	11077	0.0	7.944569829376185
chr17	SYNGR2	78170816	78171054	0	239	2358	2669	2358	2430	0.0	0.9703703703703703
chr17	SYNGR2	78171509	78171649	0	141	2358	2669	2358	2528	0.0	0.932753164556962
chr17	AFMID	78202498	78202603	280	106	27331	4061	27051	3955	2.641509433962264	6.839696586599241
chr17	AFMID	78204655	78204741	0	87	27331	4061	27331	3974	0.0	6.877453447408153
chr17	AFMID	78205602	78205738	1020	137	27331	4061	26311	3924	7.445255474452555	6.705147808358817
chr17	AFMID	78192636	78192785	0	150	27331	4061	27331	3911	0.0	6.988238302224495
chr17	AFMID	78205439	78205518	1332	80	27331	4061	25999	3981	16.65	6.530771163024366
chr17	AFMID	78205602	78205753	1020	152	27331	4061	26311	3909	6.7105263157894735	6.730877462266564
chr17	AFMID	78204827	78204900	19	74	27331	4061	27312	3987	0.25675675675675674	6.850263355906697
chr17	BIRC5	78215965	78216034	0	70	48990	3820	48990	3750	0.0	13.064
chr17	BIRC5	78216663	78216781	34	119	48990	3820	48956	3701	0.2857142857142857	13.227776276681977
chr17	BIRC5	78222827	78222992	4508	166	48990	3820	44482	3654	27.156626506024097	12.173508483853311
chr17	BIRC5	78215965	78216066	0	102	48990	3820	48990	3718	0.0	13.176438945669714
chr17	TMEM235	78234592	78234730	0	139	614	2609	614	2470	0.0	0.248582995951417
chr17	TMEM235	78233894	78233975	0	82	614	2609	614	2527	0.0	0.24297586070439256
chr17	TMEM235	78234233	78234344	0	112	614	2609	614	2497	0.0	0.24589507408890668
chr17	PGS1	78382663	78382785	204	123	13900	4741	13696	4618	1.6585365853658536	2.9657860545690777
chr17	PGS1	78396307	78396385	0	79	13900	4741	13900	4662	0.0	2.9815529815529818
chr17	PGS1	78414878	78415027	0	150	13900	4741	13900	4591	0.0	3.0276628185580483
chr17	PGS1	78392475	78392665	2384	191	13900	4741	11516	4550	12.481675392670157	2.530989010989011
chr17	PGS1	78414951	78415027	0	77	13900	4741	13900	4664	0.0	2.9802744425385934
chr17	PGS1	78392513	78392665	1087	153	13900	4741	12813	4588	7.104575163398692	2.792720139494333
chr17	C1QTNF1	79024235	79024494	1582	260	1939	4765	357	4505	6.084615384615384	0.07924528301886792
chr17	C1QTNF1	79043954	79044123	0	170	1939	4765	1939	4595	0.0	0.4219804134929271
chr17	C1QTNF1	79034316	79034533	0	218	1939	4765	1939	4547	0.0	0.4264350120958874
chr17	ENGASE	79079488	79079637	0	150	43529	6011	43529	5861	0.0	7.426889609281693
chr17	CCDC40	80037951	80038028	3119	78	167078	8392	163959	8314	39.98717948717949	19.720832331007937
chr17	CCDC40	80038122	80038186	429	65	167078	8392	166649	8327	6.6	20.013089948360754
chr17	GAA	80101810	80101925	0	116	60511	5083	60511	4967	0.0	12.182605194282264
chr17	GAA	80101810	80101890	0	81	60511	5083	60511	5002	0.0	12.09736105557777
chr17	CARD14	80179103	80179301	0	199	541794	9239	541794	9040	0.0	59.93296460176991
chr17	CARD14	80198098	80198162	14	65	541794	9239	541780	9174	0.2153846153846154	59.05602790494877
chr17	CARD14	80201743	80201870	43870	128	541794	9239	497924	9111	342.734375	54.65086159587312
chr17	CARD14	80172905	80173228	3706	324	541794	9239	538088	8915	11.438271604938272	60.357599551318
chr17	CARD14	80201468	80201592	51563	125	541794	9239	490231	9114	412.504	53.78878648233487
chr17	CARD14	80198098	80198173	25	76	541794	9239	541769	9163	0.32894736842105265	59.12572301647932
chr17	CARD14	80187501	80187659	106	159	541794	9239	541688	9080	0.6666666666666666	59.65726872246696
chr17	SLC26A11	80222654	80222847	144	194	33961	4397	33817	4203	0.7422680412371134	8.045919581251487
chr17	SLC26A11	80220915	80221115	32	201	33961	4397	33929	4196	0.15920398009950248	8.086034318398475
chr17	SLC26A11	80249153	80249287	0	135	33961	4397	33961	4262	0.0	7.968324730173627
chr17	SLC26A11	80220918	80221115	26	198	33961	4397	33935	4199	0.13131313131313133	8.081686115741844
chr17	SLC26A11	80237307	80237439	460	133	33961	4397	33501	4264	3.4586466165413534	7.8567073170731705
chr17	RNF213	80278763	80278910	0	148	144873	28383	144873	28235	0.0	5.130972197627059
chr17	ENDOV	80425031	80425100	0	70	124386	6269	124386	6199	0.0	20.065494434586224
chr17	ENDOV	80425491	80425620	0	130	124386	6269	124386	6139	0.0	20.261606124776023
chr17	ENDOV	80415649	80415821	4798	173	124386	6269	119588	6096	27.734104046242773	19.61745406824147
chr17	ENDOV	80422205	80422245	16293	41	124386	6269	108093	6228	397.390243902439	17.35597302504817
chr17	ENDOV	80421827	80421962	0	136	124386	6269	124386	6133	0.0	20.281428338496656
chr17	ENDOV	80422139	80422245	31668	107	124386	6269	92718	6162	295.9626168224299	15.046738072054527
chr17	ENDOV	80419585	80419720	1659	136	124386	6269	122727	6133	12.198529411764707	20.01092450676667
chr17	ENDOV	80417780	80417945	14731	166	124386	6269	109655	6103	88.74096385542168	17.967393085367853
chr17	ENDOV	80417810	80417945	14731	136	124386	6269	109655	6133	108.31617647058823	17.879504320887005
chr17	ENDOV	80425458	80425620	0	163	124386	6269	124386	6106	0.0	20.37111038322961
chr17	ENDOV	80427667	80427850	255	184	124386	6269	124131	6085	1.3858695652173914	20.399506984387838
chr17	RPTOR	80643727	80643810	0	84	175689	10341	175689	10257	0.0	17.12869260017549
chr17	BAIAP2	81036862	81036961	0	100	444	8058	444	7958	0.0	0.05579291279215883
chr17	BAIAP2	81110913	81110955	0	43	444	8058	444	8015	0.0	0.05539613225202745
chr17	BAIAP2	81110913	81110959	0	47	444	8058	444	8011	0.0	0.05542379228560729
chr17	BAHCC1	81446737	81446830	0	94	0	13175	0	13081	0.0	0.0
chr17	TSPAN10	81647456	81647724	0	269	0	4751	0	4482	0.0	0.0
chr17	CCDC137	81670001	81670028	0	28	0	2396	0	2368	0.0	0.0
chr17	HGS	81690181	81690234	0	54	0	8542	0	8488	0.0	0.0
chr17	HGS	81693502	81693581	0	80	0	8542	0	8462	0.0	0.0
chr17	HGS	81693869	81693965	0	97	0	8542	0	8445	0.0	0.0
chr17	HGS	81694814	81694853	0	40	0	8542	0	8502	0.0	0.0
chr17	HGS	81700694	81700814	0	121	0	8542	0	8421	0.0	0.0
chr17	HGS	81685604	81685689	0	86	0	8542	0	8456	0.0	0.0
chr17	HGS	81694923	81695067	0	145	0	8542	0	8397	0.0	0.0
chr17	HGS	81695163	81695223	0	61	0	8542	0	8481	0.0	0.0
chr17	HGS	81695785	81695999	0	215	0	8542	0	8327	0.0	0.0
chr17	HGS	81684970	81685069	0	100	0	8542	0	8442	0.0	0.0
chr17	HGS	81694959	81695067	0	109	0	8542	0	8433	0.0	0.0
chr17	HGS	81693484	81693581	0	98	0	8542	0	8444	0.0	0.0
chr17	HGS	81684812	81684891	0	80	0	8542	0	8462	0.0	0.0
chr17	HGS	81686667	81686717	0	51	0	8542	0	8491	0.0	0.0
chr17	HGS	81684812	81685069	0	258	0	8542	0	8284	0.0	0.0
chr17	HGS	81695785	81696041	0	257	0	8542	0	8285	0.0	0.0
chr17	HGS	81685604	81685693	0	90	0	8542	0	8452	0.0	0.0
chr17	HGS	81692422	81692553	0	132	0	8542	0	8410	0.0	0.0
chr17	HGS	81692384	81692553	0	170	0	8542	0	8372	0.0	0.0
chr17	HGS	81694255	81694326	0	72	0	8542	0	8470	0.0	0.0
chr17	HGS	81695938	81695999	0	62	0	8542	0	8480	0.0	0.0
chr17	HGS	81695766	81695999	0	234	0	8542	0	8308	0.0	0.0
chr17	HGS	81697865	81698116	0	252	0	8542	0	8290	0.0	0.0
chr17	HGS	81699741	81699837	0	97	0	8542	0	8445	0.0	0.0
chr17	HGS	81701243	81701422	0	180	0	8542	0	8362	0.0	0.0
chr17	HGS	81701214	81701422	0	209	0	8542	0	8333	0.0	0.0
chr17	SLC25A10	81713261	81713506	0	246	0	2543	0	2297	0.0	0.0
chr17	ANAPC11	81893551	81893614	0	64	0	2490	0	2426	0.0	0.0
chr17	ANAPC11	81899241	81899542	0	302	0	2490	0	2188	0.0	0.0
chr17	ANAPC11	81893103	81893187	0	85	0	2490	0	2405	0.0	0.0
chr17	ANAPC11	81899241	81899327	0	87	0	2490	0	2403	0.0	0.0
chr17	ASPSCR1	81979183	81979239	0	57	0	8568	0	8511	0.0	0.0
chr17	ASPSCR1	82015074	82015356	0	283	0	8568	0	8285	0.0	0.0
chr17	ASPSCR1	81982613	81982676	0	64	0	8568	0	8504	0.0	0.0
chr17	ASPSCR1	82009931	82010052	0	122	0	8568	0	8446	0.0	0.0
chr17	LRRC45	82024277	82024339	0	63	0	3563	0	3500	0.0	0.0
chr17	LRRC45	82029542	82029635	0	94	0	3563	0	3469	0.0	0.0
chr17	GPS1	82052255	82052459	0	205	0	3905	0	3700	0.0	0.0
chr17	GPS1	82056469	82056550	0	82	0	3905	0	3823	0.0	0.0
chr17	GPS1	82056839	82056974	0	136	0	3905	0	3769	0.0	0.0
chr17	GPS1	82052374	82052459	0	86	0	3905	0	3819	0.0	0.0
chr17	GPS1	82052377	82052459	0	83	0	3905	0	3822	0.0	0.0
chr17	GPS1	82052258	82052459	0	202	0	3905	0	3703	0.0	0.0
chr17	GPS1	82052255	82052442	0	188	0	3905	0	3717	0.0	0.0
chr17	SLC16A3	82236728	82236872	0	145	0	5874	0	5729	0.0	0.0
chr17	SLC16A3	82236728	82236844	0	117	0	5874	0	5757	0.0	0.0
chr17	AC132872.5	82274891	82275073	0	183	0	4275	0	4092	0.0	0.0
chr17	HEXD	82424393	82424503	0	111	0	4126	0	4015	0.0	0.0
chr17	HEXD	82428029	82428127	0	99	0	4126	0	4027	0.0	0.0
chr17	HEXD	82440262	82440334	0	73	0	4126	0	4053	0.0	0.0
chr17	HEXD	82424418	82424503	0	86	0	4126	0	4040	0.0	0.0
chr17	HEXD	82440472	82440613	0	142	0	4126	0	3984	0.0	0.0
chr17	NARF	82464286	82464430	0	145	0	6641	0	6496	0.0	0.0
chr17	NARF	82472563	82472698	0	136	0	6641	0	6505	0.0	0.0
chr17	NARF	82484812	82484950	0	139	0	6641	0	6502	0.0	0.0
chr17	NARF	82459274	82459448	0	175	0	6641	0	6466	0.0	0.0
chr17	NARF	82480406	82480544	0	139	0	6641	0	6502	0.0	0.0
chr17	NARF	82478570	82478667	0	98	0	6641	0	6543	0.0	0.0
chr17	FOXK2	82568053	82568201	0	149	0	7313	0	7164	0.0	0.0
chr17	FOXK2	82595781	82596191	0	411	0	7313	0	6902	0.0	0.0
chr17	FN3KRP	82718443	82718571	0	129	0	2954	0	2825	0.0	0.0
chr17	FN3KRP	82720760	82720965	0	206	0	2954	0	2748	0.0	0.0
chr17	FN3KRP	82720760	82720841	0	82	0	2954	0	2872	0.0	0.0
chr17	TBCD	82900650	82900731	0	82	0	11720	0	11638	0.0	0.0
chr17	TBCD	82932657	82932735	0	79	0	11720	0	11641	0.0	0.0
chr17	TBCD	82937845	82937959	0	115	0	11720	0	11605	0.0	0.0
chr18	LINC02564	13151	13354	0	204	0	1435	0	1231	0.0	0.0
chr18	USP14	166786	166819	24479	34	1224229	6004	1199750	5970	719.9705882352941	200.96314907872696
chr18	USP14	192841	192900	12390	60	1224229	6004	1211839	5944	206.5	203.87600942126514
chr18	USP14	178932	179037	58721	106	1224229	6004	1165508	5898	553.9716981132076	197.61071549677857
chr18	USP14	162982	163174	0	193	1224229	6004	1224229	5811	0.0	210.6744106005851
chr18	USP14	178900	179037	59805	138	1224229	6004	1164424	5866	433.3695652173913	198.5039209001023
chr18	CLUL1	598499	598582	0	84	8307	3861	8307	3777	0.0	2.199364575059571
chr18	CLUL1	606977	607099	0	123	8307	3861	8307	3738	0.0	2.2223113964687
chr18	CLUL1	644909	645097	0	189	8307	3861	8307	3672	0.0	2.2622549019607843
chr18	CLUL1	613158	613281	0	124	8307	3861	8307	3737	0.0	2.222906074391223
chr18	TYMS	669071	669173	343940	103	2926350	2430	2582410	2327	3339.223300970874	1109.759346798453
chr18	AP000829.1	1137813	1137864	0	52	102	2283	102	2231	0.0	0.04571940833706858
chr18	AP000829.1	1061462	1061535	0	74	102	2283	102	2209	0.0	0.046174739701222274
chr18	AP000829.1	1133842	1133952	0	111	102	2283	102	2172	0.0	0.04696132596685083
chr18	AP000829.1	1165093	1165185	0	93	102	2283	102	2190	0.0	0.04657534246575343
chr18	AP000829.1	1133842	1133894	0	53	102	2283	102	2230	0.0	0.045739910313901344
chr18	AP005262.1	1626238	1626367	0	130	240	9198	240	9068	0.0	0.02646669607410675
chr18	AP005262.1	1649685	1649793	0	109	240	9198	240	9089	0.0	0.026405545164484543
chr18	AP005262.1	1587583	1587654	0	72	240	9198	240	9126	0.0	0.026298487836949377
chr18	AP005262.1	1531497	1531557	0	61	240	9198	240	9137	0.0	0.026266827186166138
chr18	AP005262.1	1690602	1690676	0	75	240	9198	240	9123	0.0	0.026307135810588623
chr18	AP005262.1	1824777	1824852	0	76	240	9198	240	9122	0.0	0.0263100197325148
chr18	AP005262.1	2020036	2020145	0	110	240	9198	240	9088	0.0	0.02640845070422535
chr18	AP005262.1	1562773	1562861	0	89	240	9198	240	9109	0.0	0.026347568339005378
chr18	NDC80	2577235	2577357	42	123	556375	3574	556333	3451	0.34146341463414637	161.2092147203709
chr18	SMCHD1	2722518	2722663	5374	146	538769	12458	533395	12312	36.80821917808219	43.32318063677713
chr18	SMCHD1	2778168	2778239	3045	72	538769	12458	535724	12386	42.291666666666664	43.25238172129824
chr18	SMCHD1	2784844	2784987	0	144	538769	12458	538769	12314	0.0	43.752558063992204
chr18	SMCHD1	2796767	2796860	0	94	538769	12458	538769	12364	0.0	43.57562277580071
chr18	MYL12A	3249360	3249443	5791	84	4552819	2866	4547028	2782	68.94047619047619	1634.4457225017973
chr18	MYL12A	3249561	3249723	12009	163	4552819	2866	4540810	2703	73.67484662576688	1679.9149093599704
chr18	TGIF1	3450321	3450505	38883	185	698394	7818	659511	7633	210.17837837837837	86.40259399973797
chr18	TGIF1	3450324	3450505	38406	182	698394	7818	659988	7636	211.02197802197801	86.4311157674175
chr18	GAPLINC	3473953	3474142	0	190	2753	1056	2753	866	0.0	3.178983833718245
chr18	DLGAP1-AS1	3594419	3594484	1813	66	40956	1621	39143	1555	27.46969696969697	25.17234726688103
chr18	DLGAP1-AS1	3596578	3596675	7676	98	40956	1621	33280	1523	78.3265306122449	21.8516086671044
chr18	DLGAP1-AS4	3998455	3998536	0	82	0	2553	0	2471	0.0	0.0
chr18	DLGAP1-AS4	3998482	3998536	0	55	0	2553	0	2498	0.0	0.0
chr18	DLGAP1-AS5	4280729	4280766	0	38	0	2882	0	2844	0.0	0.0
chr18	DLGAP1-AS5	4275300	4275379	0	80	0	2882	0	2802	0.0	0.0
chr18	LINC01892	5084996	5085228	0	233	102	2813	102	2580	0.0	0.03953488372093023
chr18	LINC01892	5084996	5085962	0	967	102	2813	102	1846	0.0	0.0552546045503792
chr18	LINC00667	5241698	5241889	8384	192	386439	9559	378055	9367	43.666666666666664	40.360307462367885
chr18	LINC00667	5240647	5240708	3440	62	386439	9559	382999	9497	55.483870967741936	40.328419500895016
chr18	LINC00667	5241698	5241812	6065	115	386439	9559	380374	9444	52.73913043478261	40.27678949597628
chr18	LINC00667	5240186	5240277	553	92	386439	9559	385886	9467	6.010869565217392	40.761170381324604
chr18	LINC00667	5240647	5241255	11766	609	386439	9559	374673	8950	19.320197044334975	41.86290502793296
chr18	LINC00667	5240647	5240819	6074	173	386439	9559	380365	9386	35.10982658959538	40.52471766460686
chr18	LINC00667	5240183	5240277	598	95	386439	9559	385841	9464	6.294736842105263	40.76933643279797
chr18	LINC00667	5240542	5240615	2161	74	386439	9559	384278	9485	29.2027027027027	40.51428571428571
chr18	LINC00667	5240647	5240964	7235	318	386439	9559	379204	9241	22.751572327044027	41.034952927172384
chr18	MIR3976HG	5738362	5739327	0	966	0	12474	0	11508	0.0	0.0
chr18	MIR3976HG	5769762	5769866	0	105	0	12474	0	12369	0.0	0.0
chr18	MIR3976HG	5750779	5750904	0	126	0	12474	0	12348	0.0	0.0
chr18	MIR3976HG	5760987	5761047	0	61	0	12474	0	12413	0.0	0.0
chr18	MIR3976HG	5789017	5789220	0	204	0	12474	0	12270	0.0	0.0
chr18	MIR3976HG	5759975	5760081	0	107	0	12474	0	12367	0.0	0.0
chr18	MIR3976HG	5847219	5847452	0	234	0	12474	0	12240	0.0	0.0
chr18	MIR3976HG	5784482	5784575	0	94	0	12474	0	12380	0.0	0.0
chr18	MIR3976HG	5758118	5758321	0	204	0	12474	0	12270	0.0	0.0
chr18	MIR3976HG	5751334	5751594	0	261	0	12474	0	12213	0.0	0.0
chr18	MIR3976HG	5779944	5780024	0	81	0	12474	0	12393	0.0	0.0
chr18	MIR3976HG	5750779	5750832	0	54	0	12474	0	12420	0.0	0.0
chr18	MIR3976HG	5758263	5758321	0	59	0	12474	0	12415	0.0	0.0
chr18	MIR3976HG	5810863	5811222	0	360	0	12474	0	12114	0.0	0.0
chr18	MIR3976HG	5769743	5769866	0	124	0	12474	0	12350	0.0	0.0
chr18	ARHGAP28	6876130	6876208	0	79	51	11935	51	11856	0.0	0.00430161943319838
chr18	ARHGAP28	6836097	6836175	0	79	51	11935	51	11856	0.0	0.00430161943319838
chr18	PTPRM	8253226	8253414	594	189	1503	9910	909	9721	3.142857142857143	0.09350889826149573
chr18	PTPRM	8122241	8122316	0	76	1503	9910	1503	9834	0.0	0.15283709579011592
chr18	PTPRM	8248149	8248176	0	28	1503	9910	1503	9882	0.0	0.15209471766848817
chr18	PTPRM	8371759	8371810	0	52	1503	9910	1503	9858	0.0	0.15246500304321364
chr18	MTCL1	8828907	8828964	847	58	1558682	10872	1557835	10814	14.60344827586207	144.05724061401887
chr18	MTCL1	8717903	8717962	528	60	1558682	10872	1558154	10812	8.8	144.11339252682205
chr18	MTCL1	8792997	8793120	2835	124	1558682	10872	1555847	10748	22.862903225806452	144.7568850018608
chr18	MTCL1	8785689	8785726	60	38	1558682	10872	1558622	10834	1.5789473684210527	143.86394683404097
chr18	MTCL1	8809447	8809561	21201	115	1558682	10872	1537481	10757	184.35652173913044	142.92841870409967
chr18	ANKRD12	9204475	9204544	0	70	79457	12266	79457	12196	0.0	6.5150049196457855
chr18	ANKRD12	9200513	9200644	0	132	79457	12266	79457	12134	0.0	6.548294049777485
chr18	ANKRD12	9195550	9195698	1887	149	79457	12266	77570	12117	12.664429530201343	6.401749607988776
chr18	ANKRD12	9239476	9239556	0	81	79457	12266	79457	12185	0.0	6.520886335658597
chr18	RALBP1	9479343	9479437	0	95	1743497	8055	1743497	7960	0.0	219.03228643216082
chr18	RALBP1	9476968	9477253	0	286	1743497	8055	1743497	7769	0.0	224.41717080705368
chr18	RAB31	9775277	9775357	28318	81	1649863	5492	1621545	5411	349.60493827160496	299.67566069118465
chr18	RAB31	9845581	9845691	37940	111	1649863	5492	1611923	5381	341.8018018018018	299.55826054636685
chr18	VAPA	9944923	9945058	7435	136	1903499	9075	1896064	8939	54.669117647058826	212.11142185926838
chr18	VAPA	9924902	9924995	0	94	1903499	9075	1903499	8981	0.0	211.94733325910255
chr18	APCDD1	10468468	10468652	0	185	4234	5944	4234	5759	0.0	0.7351970828268797
chr18	APCDD1	10471529	10472061	1785	533	4234	5944	2449	5411	3.348968105065666	0.4525965625577527
chr18	APCDD1	10474105	10474247	0	143	4234	5944	4234	5801	0.0	0.7298741596276505
chr18	NAPG	10530769	10530837	7916	69	461605	5602	453689	5533	114.72463768115942	81.99692752575456
chr18	LINC01255	11505781	11505924	0	144	0	8070	0	7926	0.0	0.0
chr18	LINC01255	11503733	11503884	0	152	0	8070	0	7918	0.0	0.0
chr18	LINC01255	11506531	11506636	0	106	0	8070	0	7964	0.0	0.0
chr18	LINC01255	11513196	11513335	0	140	0	8070	0	7930	0.0	0.0
chr18	LINC01255	11505781	11505956	0	176	0	8070	0	7894	0.0	0.0
chr18	LINC01255	11504827	11505057	0	231	0	8070	0	7839	0.0	0.0
chr18	LINC01255	11490379	11490647	0	269	0	8070	0	7801	0.0	0.0
chr18	LINC01255	11505486	11505956	0	471	0	8070	0	7599	0.0	0.0
chr18	LINC01255	11506479	11506636	0	158	0	8070	0	7912	0.0	0.0
chr18	LINC01255	11503740	11503884	0	145	0	8070	0	7925	0.0	0.0
chr18	LINC01255	11503133	11503299	0	167	0	8070	0	7903	0.0	0.0
chr18	IMPA2	12012169	12012215	10766	47	441647	3420	430881	3373	229.06382978723406	127.7441446783279
chr18	IMPA2	12012169	12012349	15050	181	441647	3420	426597	3239	83.14917127071823	131.70639086137697
chr18	IMPA2	12008332	12008591	4818	260	441647	3420	436829	3160	18.53076923076923	138.23702531645569
chr18	IMPA2	12021701	12021822	63	122	441647	3420	441584	3298	0.5163934426229508	133.8944815039418
chr18	CIDEA	12263599	12263866	0	268	0	1816	0	1548	0.0	0.0
chr18	CIDEA	12274092	12274274	0	183	0	1816	0	1633	0.0	0.0
chr18	TUBB6	12308686	12308795	93649	110	2923471	3691	2829822	3581	851.3545454545455	790.2323373359396
chr18	TUBB6	12310942	12311053	198592	112	2923471	3691	2724879	3579	1773.142857142857	761.35205364627
chr18	TUBB6	12320628	12320744	4458	117	2923471	3691	2919013	3574	38.1025641025641	816.7355903749301
chr18	TUBB6	12320535	12320744	8243	210	2923471	3691	2915228	3481	39.25238095238095	837.4685435219765
chr18	PRELID3A	12420324	12420493	13255	170	174838	2584	161583	2414	77.97058823529412	66.93579121789561
chr18	PRELID3A	12410717	12410858	2391	142	174838	2584	172447	2442	16.838028169014084	70.61711711711712
chr18	PRELID3A	12422247	12422341	259	95	174838	2584	174579	2489	2.7263157894736842	70.14021695460023
chr18	SEH1L	12951854	12951905	16946	52	900535	8031	883589	7979	325.88461538461536	110.73931570372227
chr18	SEH1L	12955462	12955609	49982	148	900535	8031	850553	7883	337.7162162162162	107.89712038563998
chr18	SEH1L	12964435	12964495	1378	61	900535	8031	899157	7970	22.59016393442623	112.8176913425345
chr18	CEP192	13038369	13038579	1648	211	223433	8599	221785	8388	7.81042654028436	26.440748688602767
chr18	CEP192	13071038	13071212	4029	175	223433	8599	219404	8424	23.02285714285714	26.045109211775877
chr18	CEP192	13087530	13087646	7327	117	223433	8599	216106	8482	62.623931623931625	25.478189106342843
chr18	CEP192	13114129	13114251	7994	123	223433	8599	215439	8476	64.99186991869918	25.41753185464842
chr18	CEP192	13037236	13037301	484	66	223433	8599	222949	8533	7.333333333333333	26.127856556896752
chr18	CEP192	13000311	13000486	0	176	223433	8599	223433	8423	0.0	26.526534488899443
chr18	CEP192	13103874	13103967	0	94	223433	8599	223433	8505	0.0	26.270781893004116
chr18	CEP192	13058293	13058435	0	143	223433	8599	223433	8456	0.0	26.42301324503311
chr18	LDLRAD4	13643358	13643412	0	55	3651	29113	3651	29058	0.0	0.12564526120173447
chr18	LDLRAD4	13438243	13438384	0	142	3651	29113	3651	28971	0.0	0.12602257429843636
chr18	LDLRAD4	13464990	13465111	0	122	3651	29113	3651	28991	0.0	0.12593563519713014
chr18	LDLRAD4	13583828	13584049	0	222	3651	29113	3651	28891	0.0	0.12637153438787166
chr18	LDLRAD4	13484036	13484119	0	84	3651	29113	3651	29029	0.0	0.12577078094319474
chr18	LDLRAD4	13491231	13491469	0	239	3651	29113	3651	28874	0.0	0.12644593752164576
chr18	LDLRAD4	13644644	13644925	0	282	3651	29113	3651	28831	0.0	0.12663452533731054
chr18	LDLRAD4	13615760	13615912	0	153	3651	29113	3651	28960	0.0	0.1260704419889503
chr18	RNMT	13731475	13731934	30752	460	415707	5239	384955	4779	66.85217391304347	80.55137057961916
chr18	RNMT	13759941	13760208	15043	268	415707	5239	400664	4971	56.13059701492537	80.60028163347415
chr18	RNMT	13730626	13730755	13024	130	415707	5239	402683	5109	100.18461538461538	78.81835975729105
chr18	ANKRD20A5P	14183651	14183766	0	116	413	6268	413	6152	0.0	0.06713263979193758
chr18	ANKRD20A5P	14242139	14242419	40	281	413	6268	373	5987	0.1423487544483986	0.06230165358276265
chr18	ANKRD20A5P	14211308	14211416	0	109	413	6268	413	6159	0.0	0.0670563403149862
chr18	ANKRD30B	14796220	14796249	0	30	561	6256	561	6226	0.0	0.09010600706713781
chr18	GREB1L	21449509	21449836	0	328	49501	10608	49501	10280	0.0	4.815272373540856
chr18	GREB1L	21473030	21473211	0	182	49501	10608	49501	10426	0.0	4.74784193362747
chr18	GREB1L	21434946	21435075	0	130	49501	10608	49501	10478	0.0	4.724279442641725
chr18	SNRPD1	21622724	21622801	0	78	1071	4209	1071	4131	0.0	0.25925925925925924
chr18	RBBP8	22929382	22929437	0	56	1373	5107	1373	5051	0.0	0.27182736091862997
chr18	RBBP8	22916940	22917026	0	87	1373	5107	1373	5020	0.0	0.27350597609561755
chr18	RBBP8	22915419	22915485	0	67	1373	5107	1373	5040	0.0	0.2724206349206349
chr18	RBBP8	23006362	23006432	0	71	1373	5107	1373	5036	0.0	0.27263701350277997
chr18	RBBP8	23016827	23016924	0	98	1373	5107	1373	5009	0.0	0.27410660810541027
chr18	RBBP8	22977789	22977887	0	99	1373	5107	1373	5008	0.0	0.27416134185303515
chr18	RIOK3	23467398	23467526	0	129	0	4777	0	4648	0.0	0.0
chr18	RMC1	23506969	23507054	0	86	0	3000	0	2914	0.0	0.0
chr18	RMC1	23507984	23508041	0	58	0	3000	0	2942	0.0	0.0
chr18	RMC1	23508654	23508776	0	123	0	3000	0	2877	0.0	0.0
chr18	LAMA3	23899287	23899455	0	169	221109	14351	221109	14182	0.0	15.590819348469891
chr18	LAMA3	23952989	23953109	0	121	221109	14351	221109	14230	0.0	15.538229093464512
chr18	TTC39C	24069156	24069271	64	116	27015	6969	26951	6853	0.5517241379310345	3.9327301911571575
chr18	CABYR	24143090	24143259	765	170	765	3482	0	3312	4.5	0.0
chr18	CABYR	24159471	24160069	0	599	765	3482	765	2883	0.0	0.26534859521331944
chr18	CABYR	24143359	24143413	0	55	765	3482	765	3427	0.0	0.22322731251823752
chr18	CABYR	24159945	24160069	0	125	765	3482	765	3357	0.0	0.22788203753351208
chr18	CABYR	24150537	24150624	0	88	765	3482	765	3394	0.0	0.22539776075427226
chr18	CABYR	24150537	24150631	0	95	765	3482	765	3387	0.0	0.22586359610274578
chr18	CABYR	24148574	24148725	0	152	765	3482	765	3330	0.0	0.22972972972972974
chr18	CABYR	24159942	24160069	0	128	765	3482	765	3354	0.0	0.22808586762075134
chr18	LINC01915	24630046	24630171	0	126	408	10136	408	10010	0.0	0.04075924075924076
chr18	LINC01915	24674274	24674459	0	186	408	10136	408	9950	0.0	0.04100502512562814
chr18	AC018697.1	24726674	24726757	0	84	0	8294	0	8210	0.0	0.0
chr18	AC018697.1	24766480	24766734	0	255	0	8294	0	8039	0.0	0.0
chr18	AC018697.1	24939973	24940575	0	603	0	8294	0	7691	0.0	0.0
chr18	AC018697.1	24726674	24726761	0	88	0	8294	0	8206	0.0	0.0
chr18	PSMA8	26140044	26140109	0	66	31	1902	31	1836	0.0	0.016884531590413945
chr18	TAF4B	26295194	26295314	0	121	1530	4902	1530	4781	0.0	0.32001673290106675
chr18	AQP4-AS1	26925816	26925862	0	47	0	9052	0	9005	0.0	0.0
chr18	AQP4-AS1	26892870	26892992	0	123	0	9052	0	8929	0.0	0.0
chr18	AQP4-AS1	26928244	26928398	0	155	0	9052	0	8897	0.0	0.0
chr18	AQP4-AS1	26930680	26930823	0	144	0	9052	0	8908	0.0	0.0
chr18	AC068408.1	27396705	27396726	0	22	0	1112	0	1090	0.0	0.0
chr18	AC068408.1	27396758	27396832	0	75	0	1112	0	1037	0.0	0.0
chr18	AC117569.1	29537362	29537500	0	139	89	994	89	855	0.0	0.10409356725146199
chr18	RNF125	32042178	32042273	0	96	91	6067	91	5971	0.0	0.015240328253223915
chr18	RNF125	32065901	32066009	0	109	91	6067	91	5958	0.0	0.015273581738838537
chr18	RNF138	32092699	32092886	0	188	0	3785	0	3597	0.0	0.0
chr18	RNF138	32111753	32111919	0	167	0	3785	0	3618	0.0	0.0
chr18	RNF138	32123517	32123574	0	58	0	3785	0	3727	0.0	0.0
chr18	ASXL3	33671746	33671866	0	121	536974	13548	536974	13427	0.0	39.99210545914948
chr18	ASXL3	33641820	33641823	0	4	536974	13548	536974	13544	0.0	39.64663319551093
chr18	ASXL3	33690241	33690319	20	79	536974	13548	536954	13469	0.25316455696202533	39.86591432177593
chr18	ASXL3	33626872	33627070	37	199	536974	13548	536937	13349	0.18592964824120603	40.22301295977227
chr18	ASXL3	33626861	33627070	48	210	536974	13548	536926	13338	0.22857142857142856	40.25536062378168
chr18	DTNA	34825266	34825275	80	10	2551	10501	2471	10491	8.0	0.2355352206653322
chr18	DTNA	34708173	34708226	0	54	2551	10501	2551	10447	0.0	0.24418493347372452
chr18	DTNA	34662853	34662980	0	128	2551	10501	2551	10373	0.0	0.24592692567241878
chr18	DTNA	34683481	34683694	0	214	2551	10501	2551	10287	0.0	0.24798289102751045
chr18	DTNA	34866110	34866131	0	22	2551	10501	2551	10479	0.0	0.2434392594713236
chr18	DTNA	34838744	34838837	0	94	2551	10501	2551	10407	0.0	0.24512347458441433
chr18	DTNA	34757157	34757288	0	132	2551	10501	2551	10369	0.0	0.24602179573729385
chr18	DTNA	34829399	34829489	0	91	2551	10501	2551	10410	0.0	0.24505283381364074
chr18	DTNA	34838093	34838171	0	79	2551	10501	2551	10422	0.0	0.24477067741316447
chr18	DTNA	34884727	34884776	0	50	2551	10501	2551	10451	0.0	0.24409147450004784
chr18	MAPRE2	34988592	34988848	0	257	0	6148	0	5891	0.0	0.0
chr18	MAPRE2	35070194	35070322	0	129	0	6148	0	6019	0.0	0.0
chr18	ZNF397	35242390	35242884	0	495	0	8716	0	8221	0.0	0.0
chr18	ZNF397	35245261	35245351	0	91	0	8716	0	8625	0.0	0.0
chr18	ZNF397	35254231	35254402	0	172	0	8716	0	8544	0.0	0.0
chr18	ZNF271P	35291009	35291232	0	224	0	7454	0	7230	0.0	0.0
chr18	GALNT1	35659857	35659930	0	74	0	5141	0	5067	0.0	0.0
chr18	C18ORF21	35977409	35977600	0	192	0	1621	0	1429	0.0	0.0
chr18	ELP2	36138794	36138872	0	79	0	11088	0	11009	0.0	0.0
chr18	ELP2	36133237	36133316	0	80	0	11088	0	11008	0.0	0.0
chr18	ELP2	36146249	36146381	0	133	0	11088	0	10955	0.0	0.0
chr18	ELP2	36159957	36160015	0	59	0	11088	0	11029	0.0	0.0
chr18	ELP2	36139418	36139613	0	196	0	11088	0	10892	0.0	0.0
chr18	FHOD3	36658074	36658188	0	115	24	7995	24	7880	0.0	0.003045685279187817
chr18	FHOD3	36687127	36687178	0	52	24	7995	24	7943	0.0	0.0030215283897771623
chr18	FHOD3	36760607	36760782	0	176	24	7995	24	7819	0.0	0.0030694462207443408
chr18	FHOD3	36759117	36759141	0	25	24	7995	24	7970	0.0	0.00301129234629862
chr18	KIAA1328	36844207	36844302	0	96	51	9612	51	9516	0.0	0.005359394703656999
chr18	KIAA1328	37084124	37084232	0	109	51	9612	51	9503	0.0	0.005366726296958855
chr18	KIAA1328	36946248	36946517	0	270	51	9612	51	9342	0.0	0.005459216441875401
chr18	KIAA1328	37193590	37193694	0	105	51	9612	51	9507	0.0	0.005364468286525718
chr18	AC090386.1	37275812	37275981	0	170	0	816	0	646	0.0	0.0
chr18	AC011139.1	39317817	39317931	0	115	0	613	0	498	0.0	0.0
chr18	LINC01902	39867128	39867374	0	247	3162	12838	3162	12591	0.0	0.2511317607815106
chr18	LINC01902	39875464	39875941	0	478	3162	12838	3162	12360	0.0	0.2558252427184466
chr18	LINC01902	39865239	39865400	0	162	3162	12838	3162	12676	0.0	0.2494477753234459
chr18	PIK3C3	41957569	41957758	0	190	280	14565	280	14375	0.0	0.019478260869565216
chr18	PIK3C3	42057882	42058051	0	170	280	14565	280	14395	0.0	0.019451198332754428
chr18	PIK3C3	41984879	41985107	0	229	280	14565	280	14336	0.0	0.01953125
chr18	LINC00907	42212363	42212526	0	164	1436	10985	1436	10821	0.0	0.13270492560761482
chr18	LINC00907	42289503	42289594	0	92	1436	10985	1436	10893	0.0	0.13182777930781236
chr18	LINC00907	42335083	42335303	0	221	1436	10985	1436	10764	0.0	0.13340765514678557
chr18	SETBP1	45038484	45038655	0	172	4350	14355	4350	14183	0.0	0.3067052104632306
chr18	AC021517.1	45492061	45492129	0	69	0	2775	0	2706	0.0	0.0
chr18	AC021517.1	45489906	45489945	0	40	0	2775	0	2735	0.0	0.0
chr18	SLC14A1	45730299	45730471	0	173	51	6081	51	5908	0.0	0.008632362897765741
chr18	SLC14A1	45739527	45739662	0	136	51	6081	51	5945	0.0	0.008578637510513036
chr18	SLC14A1	45729985	45730120	0	136	51	6081	51	5945	0.0	0.008578637510513036
chr18	SLC14A1	45727260	45727418	0	159	51	6081	51	5922	0.0	0.008611955420466059
chr18	SLC14A1	45736455	45736648	0	194	51	6081	51	5887	0.0	0.008663156106675726
chr18	SLC14A1	45739162	45739310	0	149	51	6081	51	5932	0.0	0.008597437626432907
chr18	SLC14A1	45727331	45727418	0	88	51	6081	51	5993	0.0	0.008509928249624562
chr18	SLC14A1	45724949	45725013	0	65	51	6081	51	6016	0.0	0.008477393617021276
chr18	SLC14A1	45731014	45731204	0	191	51	6081	51	5890	0.0	0.00865874363327674
chr18	SIGLEC15	45837512	45837896	0	385	0	3457	0	3072	0.0	0.0
chr18	SIGLEC15	45837512	45837885	0	374	0	3457	0	3083	0.0	0.0
chr18	HAUS1	46123298	46123364	0	67	51	2132	51	2065	0.0	0.024697336561743343
chr18	HAUS1	46124821	46124893	0	73	51	2132	51	2059	0.0	0.02476930548810102
chr18	HAUS1	46106704	46106833	0	130	51	2132	51	2002	0.0	0.025474525474525476
chr18	HAUS1	46122466	46122590	0	125	51	2132	51	2007	0.0	0.025411061285500747
chr18	HAUS1	46109646	46109784	0	139	51	2132	51	1993	0.0	0.025589563472152535
chr18	C18ORF25	46240004	46240187	0	184	1944	9585	1944	9401	0.0	0.20678651207318371
chr18	KATNAL2	47084331	47084442	0	112	0	4800	0	4688	0.0	0.0
chr18	KATNAL2	47046390	47046527	0	138	0	4800	0	4662	0.0	0.0
chr18	KATNAL2	47067020	47067119	0	100	0	4800	0	4700	0.0	0.0
chr18	KATNAL2	47046456	47046527	0	72	0	4800	0	4728	0.0	0.0
chr18	CTIF	48539757	48539831	0	75	1681	6386	1681	6311	0.0	0.26636032324512754
chr18	CTIF	48625188	48625236	0	49	1681	6386	1681	6337	0.0	0.2652674767240019
chr18	LIPG	49575368	49575590	0	223	0	11485	0	11262	0.0	0.0
chr18	SKA1	50380125	50380250	0	126	102	2904	102	2778	0.0	0.0367170626349892
chr18	SKA1	50385215	50385353	0	139	102	2904	102	2765	0.0	0.03688969258589512
chr18	MAPK4	50663088	50664504	0	1417	0	7604	0	6187	0.0	0.0
chr18	ME2	50895808	50895928	0	121	0	15460	0	15339	0.0	0.0
chr18	ME2	50912800	50912950	0	151	0	15460	0	15309	0.0	0.0
chr18	ME2	50921073	50921187	0	115	0	15460	0	15345	0.0	0.0
chr18	ME2	50939569	50939640	0	72	0	15460	0	15388	0.0	0.0
chr18	ME2	50916167	50916243	0	77	0	15460	0	15383	0.0	0.0
chr18	ME2	50917346	50917508	0	163	0	15460	0	15297	0.0	0.0
chr18	ME2	50940287	50940386	0	100	0	15460	0	15360	0.0	0.0
chr18	ME2	50945137	50945260	0	124	0	15460	0	15336	0.0	0.0
chr18	ME2	50942699	50942736	0	38	0	15460	0	15422	0.0	0.0
chr18	ELAC1	50984486	50984563	0	78	0	3975	0	3897	0.0	0.0
chr18	SMAD4	51046919	51047295	0	377	51	10684	51	10307	0.0	0.004948093528669836
chr18	SMAD4	51077306	51077419	0	114	51	10684	51	10570	0.0	0.0048249763481551565
chr18	LINC01630	51387171	51387301	0	131	103	17204	103	17073	0.0	0.006032917472031863
chr18	LINC01630	51532111	51532277	0	167	103	17204	103	17037	0.0	0.006045665316663732
chr18	LINC01630	51427732	51427814	0	83	103	17204	103	17121	0.0	0.00601600373809941
chr18	LINC01630	51524961	51525082	0	122	103	17204	103	17082	0.0	0.006029738906451235
chr18	LINC01630	51530364	51530395	0	32	103	17204	103	17172	0.0	0.005998136501281156
chr18	LINC01630	51569011	51569059	0	49	103	17204	103	17155	0.0	0.0060040804430195275
chr18	LINC01630	51561180	51561341	0	162	103	17204	103	17042	0.0	0.006043891562023237
chr18	DCC	53391654	53391887	51	234	2092	13013	2041	12779	0.21794871794871795	0.15971515768056968
chr18	DCC	52809298	52809422	0	125	2092	13013	2092	12888	0.0	0.16232153941651148
chr18	DCC	52892407	52892532	817	126	2092	13013	1275	12887	6.484126984126984	0.09893691316830915
chr18	DCC	52965030	52965126	0	97	2092	13013	2092	12916	0.0	0.161969650046454
chr18	DCC	53391714	53391887	25	174	2092	13013	2067	12839	0.14367816091954022	0.1609938468728094
chr18	DCC	53530346	53530416	0	71	2092	13013	2092	12942	0.0	0.1616442590016999
chr18	LINC01919	53577418	53577962	0	545	0	3770	0	3225	0.0	0.0
chr18	LINC01919	53582593	53582706	0	114	0	3770	0	3656	0.0	0.0
chr18	LINC01919	53578072	53578121	0	50	0	3770	0	3720	0.0	0.0
chr18	LINC01919	53609257	53609359	0	103	0	3770	0	3667	0.0	0.0
chr18	LINC01919	53594804	53594883	0	80	0	3770	0	3690	0.0	0.0
chr18	LINC01919	53571259	53571295	0	37	0	3770	0	3733	0.0	0.0
chr18	POLI	54271359	54271485	561	127	648582	9485	648021	9358	4.417322834645669	69.24780936097457
chr18	POLI	54280666	54280903	663	238	648582	9485	647919	9247	2.7857142857142856	70.06802206120904
chr18	POLI	54283742	54283815	0	74	648582	9485	648582	9411	0.0	68.91743704175964
chr18	DYNAP	54594938	54595103	0	166	1248	2141	1248	1975	0.0	0.6318987341772152
chr18	RAB27B	54884332	54884436	0	105	0	3304	0	3199	0.0	0.0
chr18	LINC01905	56088410	56088583	0	174	1272	3707	1272	3533	0.0	0.3600339654684404
chr18	LINC01905	56050079	56050177	80	99	1272	3707	1192	3608	0.8080808080808081	0.3303769401330377
chr18	LINC01905	56079436	56079621	0	186	1272	3707	1272	3521	0.0	0.36126100539619427
chr18	LINC01905	56091947	56092057	0	111	1272	3707	1272	3596	0.0	0.35372636262513907
chr18	LINC01905	56088414	56088583	0	170	1272	3707	1272	3537	0.0	0.359626802374894
chr18	LINC01905	56078707	56078794	0	88	1272	3707	1272	3619	0.0	0.35147830892511744
chr18	LINC01905	56077521	56077728	0	208	1272	3707	1272	3499	0.0	0.36353243783938266
chr18	LINC01905	56077043	56077115	0	73	1272	3707	1272	3634	0.0	0.3500275178866263
chr18	LINC01905	56078108	56078232	0	125	1272	3707	1272	3582	0.0	0.35510887772194305
chr18	LINC01905	56095920	56095990	0	71	1272	3707	1272	3636	0.0	0.34983498349834985
chr18	LINC01905	56102766	56102835	0	70	1272	3707	1272	3637	0.0	0.3497387957107506
chr18	LINC01905	56078700	56078794	0	95	1272	3707	1272	3612	0.0	0.3521594684385382
chr18	AC006305.3	56146567	56146731	0	165	23005	1531	23005	1366	0.0	16.841142020497802
chr18	AC006305.3	56139787	56140094	408	308	23005	1531	22597	1223	1.3246753246753247	18.4766966475879
chr18	AC006305.3	56139841	56140094	408	254	23005	1531	22597	1277	1.6062992125984252	17.69537979639781
chr18	WDR7	56776781	56776880	0	100	112782	8897	112782	8797	0.0	12.820506991019666
chr18	WDR7	56936180	56936229	0	50	112782	8897	112782	8847	0.0	12.7480501865039
chr18	AC027097.2	57737035	57737091	0	57	51	5460	51	5403	0.0	0.009439200444197668
chr18	NEDD4L	58248898	58248937	0	40	306	30352	306	30312	0.0	0.010095011876484561
chr18	NEDD4L	58315981	58316032	0	52	306	30352	306	30300	0.0	0.0100990099009901
chr18	NEDD4L	58335477	58335537	0	61	306	30352	306	30291	0.0	0.010102010498167772
chr18	NEDD4L	58341677	58341797	0	121	306	30352	306	30231	0.0	0.01012206013694552
chr18	NEDD4L	58054226	58054876	0	651	306	30352	306	29701	0.0	0.010302683411332952
chr18	NEDD4L	58341037	58341169	0	133	306	30352	306	30219	0.0	0.010126079618782886
chr18	NEDD4L	58342905	58343103	0	199	306	30352	306	30153	0.0	0.010148243955825292
chr18	NEDD4L	58227829	58227888	0	60	306	30352	306	30292	0.0	0.010101677010431798
chr18	NEDD4L	58099932	58100159	0	228	306	30352	306	30124	0.0	0.010158013544018058
chr18	NEDD4L	58165787	58165861	0	75	306	30352	306	30277	0.0	0.010106681639528355
chr18	NEDD4L	58227829	58227907	0	79	306	30352	306	30273	0.0	0.010108017044891487
chr18	NEDD4L	58245426	58245508	0	83	306	30352	306	30269	0.0	0.010109352803197991
chr18	MALT1	58709377	58709556	0	180	51	10585	51	10405	0.0	0.00490148966842864
chr18	MALT1	58710920	58710953	0	34	51	10585	51	10551	0.0	0.004833665055444982
chr18	MALT1	58733881	58733980	0	100	51	10585	51	10485	0.0	0.004864091559370529
chr18	MALT1	58720379	58720422	0	44	51	10585	51	10541	0.0	0.004838250640356702
chr18	ZNF532	58865303	58865385	0	83	51	9593	51	9510	0.0	0.005362776025236593
chr18	ZNF532	58865469	58865579	0	111	51	9593	51	9482	0.0	0.005378612107150391
chr18	ZNF532	58896424	58896622	0	199	51	9593	51	9394	0.0	0.005428997232275921
chr18	ZNF532	58931645	58931755	0	111	51	9593	51	9482	0.0	0.005378612107150391
chr18	ZNF532	58954233	58954334	0	102	51	9593	51	9491	0.0	0.005373511747971763
chr18	SEC11C	59157607	59157665	0	59	255	3813	255	3754	0.0	0.06792754395311668
chr18	PMAIP1	59900427	59900578	0	152	408	2189	408	2037	0.0	0.20029455081001474
chr18	AC091576.1	60535632	60535755	0	124	918	2317	918	2193	0.0	0.4186046511627907
chr18	RELCH	62269410	62269512	0	103	88	10758	88	10655	0.0	0.008259033317691225
chr18	RELCH	62280359	62280442	0	84	88	10758	88	10674	0.0	0.008244332021735057
chr18	TNFRSF11A	62366707	62366760	0	54	102	9007	102	8953	0.0	0.011392829219256115
chr18	TNFRSF11A	62361679	62361793	0	115	102	9007	102	8892	0.0	0.011470985155195682
chr18	TNFRSF11A	62368700	62369484	0	785	102	9007	102	8222	0.0	0.012405740695694478
chr18	ZCCHC2	62544801	62544873	0	73	0	9142	0	9069	0.0	0.0
chr18	PHLPP1	62941717	62941918	0	202	95	7967	95	7765	0.0	0.012234385061171926
chr18	SERPINB13	63594025	63594238	0	214	0	4545	0	4331	0.0	0.0
chr18	SERPINB11	63716034	63716152	0	119	153	3707	153	3588	0.0	0.042642140468227424
chr18	SERPINB11	63720012	63720155	0	144	153	3707	153	3563	0.0	0.042941341566095984
chr18	SERPINB7	63792392	63792443	0	52	0	2648	0	2596	0.0	0.0
chr18	SERPINB2	63889837	63890095	0	259	0	2753	0	2494	0.0	0.0
chr18	SERPINB10	63907959	63908040	0	82	51	2715	51	2633	0.0	0.019369540448157994
chr18	HMSD	63953353	63953527	0	175	102	2929	102	2754	0.0	0.037037037037037035
chr18	SERPINB8	63978298	63978476	0	179	0	5687	0	5508	0.0	0.0
chr18	CCDC102B	68823365	68823416	0	52	10	5794	10	5742	0.0	0.0017415534656913968
chr18	CCDC102B	68734733	68734766	0	34	10	5794	10	5760	0.0	0.001736111111111111
chr18	LINC02582	73327087	73327188	0	102	51	2498	51	2396	0.0	0.021285475792988316
chr18	LINC02582	73327030	73327188	0	159	51	2498	51	2339	0.0	0.021804189824711415
chr18	LINC02582	73326901	73327188	0	288	51	2498	51	2210	0.0	0.023076923076923078
chr18	CNDP2	74501101	74501238	0	138	51630	7642	51630	7504	0.0	6.880330490405117
chr18	CNDP2	74497508	74497595	0	88	51630	7642	51630	7554	0.0	6.834789515488483
chr18	CNDP2	74497508	74497726	0	219	51630	7642	51630	7423	0.0	6.955408864340563
chr18	CNDP1	74556337	74556466	144	130	7724	6780	7580	6650	1.1076923076923078	1.1398496240601503
chr18	CNDP1	74560855	74561018	102	164	7724	6780	7622	6616	0.6219512195121951	1.152055622732769
chr18	AC116003.1	75418006	75418093	0	88	0	2764	0	2676	0.0	0.0
chr18	LINC01893	76212026	76212419	0	394	0	1662	0	1268	0.0	0.0
chr18	AC103808.4	76249665	76249817	0	153	0	1823	0	1670	0.0	0.0
chr18	AC103808.4	76236463	76236614	0	152	0	1823	0	1671	0.0	0.0
chr18	AC018413.1	76492175	76492333	0	159	0	1577	0	1418	0.0	0.0
chr18	LINC00683	76530383	76530464	0	82	0	14982	0	14900	0.0	0.0
chr18	LINC00683	76621973	76622336	0	364	0	14982	0	14618	0.0	0.0
chr18	LINC00683	76570910	76571178	0	269	0	14982	0	14713	0.0	0.0
chr18	LINC00683	76610844	76610974	0	131	0	14982	0	14851	0.0	0.0
chr18	LINC00683	76622213	76622336	0	124	0	14982	0	14858	0.0	0.0
chr18	LINC00683	76620487	76621194	0	708	0	14982	0	14274	0.0	0.0
chr18	ZNF236	76871700	76871825	0	126	51	11185	51	11059	0.0	0.004611628537842481
chr18	ZNF236	76935979	76936061	0	83	51	11185	51	11102	0.0	0.0045937668888488565
chr18	ZNF236	76931066	76931228	0	163	51	11185	51	11022	0.0	0.004627109417528579
chr18	ATP9B	79077981	79078157	0	177	0	11884	0	11707	0.0	0.0
chr18	ATP9B	79096475	79096649	0	175	0	11884	0	11709	0.0	0.0
chr18	ATP9B	79176812	79176907	0	96	0	11884	0	11788	0.0	0.0
chr18	ATP9B	79213961	79214038	0	78	0	11884	0	11806	0.0	0.0
chr18	ATP9B	79348131	79348196	0	66	0	11884	0	11818	0.0	0.0
chr18	ATP9B	79375393	79375426	0	34	0	11884	0	11850	0.0	0.0
chr18	ATP9B	79372558	79372685	0	128	0	11884	0	11756	0.0	0.0
chr18	ATP9B	79361738	79361992	0	255	0	11884	0	11629	0.0	0.0
chr18	NFATC1	79410402	79411501	0	1100	0	9083	0	7983	0.0	0.0
chr18	NFATC1	79486247	79486630	0	384	0	9083	0	8699	0.0	0.0
chr18	NFATC1	79486247	79486937	0	691	0	9083	0	8392	0.0	0.0
chr18	CTDP1	79728906	79729069	0	164	0	5318	0	5154	0.0	0.0
chr18	CTDP1	79736354	79736521	0	168	0	5318	0	5150	0.0	0.0
chr18	AC090360.1	80079686	80079808	0	123	0	3912	0	3789	0.0	0.0
chr18	ADNP2	80133691	80133806	0	116	0	5664	0	5548	0.0	0.0
chr18	PARD6G-AS1	80162515	80162603	0	89	0	6002	0	5913	0.0	0.0
chr18	THOC1	264025	264092	7252	68	364470	7360	357218	7292	106.6470588235294	48.987657707076245
chr18	THOC1	260717	260759	1226	43	364470	7360	363244	7317	28.511627906976745	49.643843105097716
chr18	ENOSF1	678695	678737	19906	43	2564676	9343	2544770	9300	462.93023255813955	273.6311827956989
chr18	ENOSF1	691203	691276	11826	74	2564676	9343	2552850	9269	159.8108108108108	275.4180602006689
chr18	ENOSF1	697239	697355	15900	117	2564676	9343	2548776	9226	135.89743589743588	276.2601344027748
chr18	ENOSF1	706469	706578	20401	110	2564676	9343	2544275	9233	185.46363636363637	275.56319722733673
chr18	ENOSF1	691067	691106	9543	40	2564676	9343	2555133	9303	238.575	274.6568848758465
chr18	LINC00470	1278567	1278633	0	67	0	7735	0	7668	0.0	0.0
chr18	LINC00470	1275965	1276077	0	113	0	7735	0	7622	0.0	0.0
chr18	LINC00470	1361142	1361221	0	80	0	7735	0	7655	0.0	0.0
chr18	LINC00470	1358725	1358760	0	36	0	7735	0	7699	0.0	0.0
chr18	LINC00470	1275965	1276087	0	123	0	7735	0	7612	0.0	0.0
chr18	LINC00470	1273360	1273533	0	174	0	7735	0	7561	0.0	0.0
chr18	LINC00470	1267496	1267548	0	53	0	7735	0	7682	0.0	0.0
chr18	LINC00470	1271610	1271819	0	210	0	7735	0	7525	0.0	0.0
chr18	LINC00470	1361176	1361221	0	46	0	7735	0	7689	0.0	0.0
chr18	LINC00470	1278567	1278651	0	85	0	7735	0	7650	0.0	0.0
chr18	LINC00470	1361735	1361834	0	100	0	7735	0	7635	0.0	0.0
chr18	LINC00470	1353406	1353462	0	57	0	7735	0	7678	0.0	0.0
chr18	LINC00470	1365916	1366225	0	310	0	7735	0	7425	0.0	0.0
chr18	AP005230.1	1906363	1906430	0	68	26228	6672	26228	6604	0.0	3.9715324046032707
chr18	AP005230.1	2111643	2111736	0	94	26228	6672	26228	6578	0.0	3.987230161143205
chr18	AP005230.1	2126199	2126377	3885	179	26228	6672	22343	6493	21.70391061452514	3.441090405051594
chr18	AP005230.1	2131496	2131540	437	45	26228	6672	25791	6627	9.71111111111111	3.8918062471706656
chr18	METTL4	2544652	2544759	8964	108	149200	3516	140236	3408	83.0	41.14906103286385
chr18	METTL4	2544194	2544286	4020	93	149200	3516	145180	3423	43.225806451612904	42.41308793456033
chr18	MYOM1	3085044	3085132	24	89	7061	6472	7037	6383	0.2696629213483146	1.102459658467805
chr18	MYOM1	3129231	3129519	0	289	7061	6472	7061	6183	0.0	1.1420022642730066
chr18	LINC01895	3348132	3348250	0	119	0	2092	0	1973	0.0	0.0
chr18	LINC01895	3374763	3374959	0	197	0	2092	0	1895	0.0	0.0
chr18	LINC01895	3368560	3368688	0	129	0	2092	0	1963	0.0	0.0
chr18	DLGAP1	3656083	3656113	0	31	153	12099	153	12068	0.0	0.012678157109711635
chr18	ZBTB14	5293971	5294001	753	31	255666	4151	254913	4120	24.29032258064516	61.87208737864078
chr18	EPB41L3	5398020	5398143	0	124	510	9610	510	9486	0.0	0.053763440860215055
chr18	EPB41L3	5407700	5407736	0	37	510	9610	510	9573	0.0	0.0532748354747728
chr18	EPB41L3	5394676	5394793	0	118	510	9610	510	9492	0.0	0.053729456384323644
chr18	EPB41L3	5415817	5416378	0	562	510	9610	510	9048	0.0	0.05636604774535809
chr18	EPB41L3	5410565	5410619	0	55	510	9610	510	9555	0.0	0.05337519623233909
chr18	EPB41L3	5398650	5399385	0	736	510	9610	510	8874	0.0	0.05747126436781609
chr18	EPB41L3	5398020	5401043	29	3024	510	9610	481	6586	0.00958994708994709	0.07303370786516854
chr18	EPB41L3	5400968	5401043	29	76	510	9610	481	9534	0.3815789473684211	0.050451017411369835
chr18	EPB41L3	5400496	5400595	0	100	510	9610	510	9510	0.0	0.05362776025236593
chr18	EPB41L3	5539620	5539698	0	79	510	9610	510	9531	0.0	0.05350960025180988
chr18	EPB41L3	5508164	5508278	0	115	510	9610	510	9495	0.0	0.053712480252764615
chr18	EPB41L3	5518524	5518607	0	84	510	9610	510	9526	0.0	0.053537686332143605
chr18	L3MBTL4	6046727	6046754	0	28	51	7987	51	7959	0.0	0.006407840180927252
chr18	LINC00668	6926071	6926225	0	155	0	3701	0	3546	0.0	0.0
chr18	LINC00668	6926656	6927584	0	929	0	3701	0	2772	0.0	0.0
chr18	LINC00668	6929496	6929560	0	65	0	3701	0	3636	0.0	0.0
chr18	PPP4R1	9583116	9583275	28543	160	1112560	7841	1084017	7681	178.39375	141.12967061580522
chr18	PPP4R1	9593767	9593874	32888	108	1112560	7841	1079672	7733	304.51851851851853	139.61877667140826
chr18	PPP4R1	9562921	9563046	7858	126	1112560	7841	1104702	7715	62.36507936507937	143.1888528839922
chr18	PPP4R1	9594178	9594234	398	57	1112560	7841	1112162	7784	6.982456140350878	142.87795477903393
chr18	PPP4R1	9612456	9612690	51	235	1112560	7841	1112509	7606	0.2170212765957447	146.26728898238233
chr18	AP005209.1	10323533	10323694	0	162	0	2106	0	1944	0.0	0.0
chr18	PIEZO2	10801389	10801428	0	40	0	15683	0	15643	0.0	0.0
chr18	PIEZO2	10682103	10682292	0	190	0	15683	0	15493	0.0	0.0
chr18	PIEZO2	10708274	10708439	0	166	0	15683	0	15517	0.0	0.0
chr18	PIEZO2	10735231	10735330	0	100	0	15683	0	15583	0.0	0.0
chr18	PIEZO2	10774005	10774038	0	34	0	15683	0	15649	0.0	0.0
chr18	PIEZO2	10780324	10780366	0	43	0	15683	0	15640	0.0	0.0
chr18	MPPE1	11886712	11886778	6128	67	457280	5862	451152	5795	91.46268656716418	77.85194132873167
chr18	MPPE1	11888668	11888743	12656	76	457280	5862	444624	5786	166.52631578947367	76.84479778776357
chr18	MPPE1	11906202	11906309	5180	108	457280	5862	452100	5754	47.96296296296296	78.57142857142857
chr18	MPPE1	11884878	11885043	16991	166	457280	5862	440289	5696	102.355421686747	77.29792837078652
chr18	MPPE1	11895184	11895277	51	94	457280	5862	457229	5768	0.5425531914893617	79.26993758668516
chr18	MPPE1	11886498	11886621	16397	124	457280	5862	440883	5738	132.23387096774192	76.83565702335308
chr18	MPPE1	11886712	11886781	6312	70	457280	5862	450968	5792	90.17142857142858	77.86049723756906
chr18	MPPE1	11905737	11905953	11694	217	457280	5862	445586	5645	53.88940092165899	78.93463241806909
chr18	MPPE1	11897525	11897620	9057	96	457280	5862	448223	5766	94.34375	77.73551855705863
chr18	MPPE1	11905911	11905953	4071	43	457280	5862	453209	5819	94.67441860465117	77.88434438907029
chr18	MPPE1	11902266	11902358	1705	93	457280	5862	455575	5769	18.333333333333332	78.96949211301785
chr18	SPIRE1	12485958	12486000	982	43	1136960	6556	1135978	6513	22.837209302325583	174.417012129587
chr18	SPIRE1	12546673	12546904	38110	232	1136960	6556	1098850	6324	164.26724137931035	173.75869702719797
chr18	SPIRE1	12588375	12588419	45	45	1136960	6556	1136915	6511	1.0	174.61449854093073
chr18	SPIRE1	12653383	12653440	0	58	1136960	6556	1136960	6498	0.0	174.97076023391813
chr18	CEP76	12691358	12691487	9743	130	230834	5989	221091	5859	74.94615384615385	37.7352790578597
chr18	CEP76	12698978	12699203	28292	226	230834	5989	202542	5763	125.1858407079646	35.14523685580427
chr18	CEP76	12692167	12692312	0	146	230834	5989	230834	5843	0.0	39.506075646072226
chr18	CEP76	12698978	12699165	26862	188	230834	5989	203972	5801	142.88297872340425	35.16152387519393
chr18	LINC01882	12749293	12749533	0	241	0	1336	0	1095	0.0	0.0
chr18	LINC01882	12765276	12765455	0	180	0	1336	0	1156	0.0	0.0
chr18	PTPN2	12794383	12794485	34781	103	417855	7407	383074	7304	337.6796116504854	52.447152245345016
chr18	PTPN2	12825809	12825944	5434	136	417855	7407	412421	7271	39.955882352941174	56.7213588227204
chr18	PTPN2	12859163	12859254	11319	92	417855	7407	406536	7315	123.03260869565217	55.575666438824335
chr18	PTPN2	12793481	12793574	3972	94	417855	7407	413883	7313	42.255319148936174	56.59551483659237
chr18	PTPN2	12819213	12819282	0	70	417855	7407	417855	7337	0.0	56.95175139702876
chr18	PTPN2	12788064	12788150	567	87	417855	7407	417288	7320	6.517241379310345	57.006557377049184
chr18	PTPN2	12821335	12821425	0	91	417855	7407	417855	7316	0.0	57.11522689994533
chr18	FAM210A	13671861	13671973	20622	113	432243	4688	411621	4575	182.49557522123894	89.97180327868853
chr18	FAM210A	13697546	13697674	0	129	432243	4688	432243	4559	0.0	94.81092344812458
chr18	FAM210A	13681604	13682105	77617	502	432243	4688	354626	4186	154.61553784860558	84.71715241280458
chr18	FAM210A	13670870	13670968	612	99	432243	4688	431631	4589	6.181818181818182	94.0577467857921
chr18	FAM210A	13687742	13687882	300	141	432243	4688	431943	4547	2.127659574468085	94.99516164504068
chr18	ZNF519	14124349	14124476	3295	128	178176	15799	174881	15671	25.7421875	11.159530342671177
chr18	POTEC	14524912	14524983	0	72	0	7131	0	7059	0.0	0.0
chr18	AP005901.1	15322152	15322291	0	140	459	1803	459	1663	0.0	0.2760072158749248
chr18	ROCK1	20960662	20960711	0	50	675701	11109	675701	11059	0.0	61.09964734605299
chr18	ESCO1	21540576	21540700	0	125	23133	5300	23133	5175	0.0	4.470144927536232
chr18	ABHD3	21683919	21683965	0	47	3741	4348	3741	4301	0.0	0.8697977214601256
chr18	GATA6-AS1	22168043	22168162	0	120	0	2648	0	2528	0.0	0.0
chr18	GATA6-AS1	22168085	22168162	0	78	0	2648	0	2570	0.0	0.0
chr18	TMEM241	23368714	23368750	0	37	5	3480	5	3443	0.0	0.0014522218995062445
chr18	TMEM241	23370215	23370261	0	47	5	3480	5	3433	0.0	0.0014564520827264782
chr18	TMEM241	23371421	23371470	5	50	5	3480	0	3430	0.1	0.0
chr18	TMEM241	23376826	23376941	0	116	5	3480	5	3364	0.0	0.0014863258026159335
chr18	TMEM241	23421366	23421444	0	79	5	3480	5	3401	0.0	0.001470155836518671
chr18	TMEM241	23430630	23430677	0	48	5	3480	5	3432	0.0	0.001456876456876457
chr18	TMEM241	23399565	23399647	0	83	5	3480	5	3397	0.0	0.0014718869590815426
chr18	ANKRD29	23612091	23612190	0	100	31625	6292	31625	6192	0.0	5.107396640826873
chr18	ANKRD29	23638848	23638947	0	100	31625	6292	31625	6192	0.0	5.107396640826873
chr18	ANKRD29	23609223	23609291	0	69	31625	6292	31625	6223	0.0	5.081954041459103
chr18	OSBPL1A	24178012	24178195	0	184	18637	7984	18637	7800	0.0	2.3893589743589745
chr18	OSBPL1A	24341546	24341658	0	113	18637	7984	18637	7871	0.0	2.367805869648075
chr18	OSBPL1A	24301292	24301324	0	33	18637	7984	18637	7951	0.0	2.343981889070557
chr18	OSBPL1A	24368366	24368372	0	7	18637	7984	18637	7977	0.0	2.336341983201705
chr18	LINC01894	24946245	24946374	0	130	0	1736	0	1606	0.0	0.0
chr18	LINC01894	24977115	24977200	0	86	0	1736	0	1650	0.0	0.0
chr18	ZNF521	25350906	25350947	0	42	102	6243	102	6201	0.0	0.01644895984518626
chr18	ZNF521	25224035	25224115	0	81	102	6243	102	6162	0.0	0.016553067185978577
chr18	ZNF521	25350906	25350993	0	88	102	6243	102	6155	0.0	0.016571892770105606
chr18	SS18	26035830	26035923	0	94	51	6099	51	6005	0.0	0.008492922564529558
chr18	SS18	26078075	26078160	0	86	51	6099	51	6013	0.0	0.00848162314984201
chr18	SS18	26087500	26087577	0	78	51	6099	51	6021	0.0	0.008470353761833582
chr18	SS18	26082362	26082528	0	167	51	6099	51	5932	0.0	0.008597437626432907
chr18	SS18	26080304	26080423	0	120	51	6099	51	5979	0.0	0.008529854490717512
chr18	SS18	26068493	26068557	0	65	51	6099	51	6034	0.0	0.008452104739807755
chr18	SS18	26084051	26084175	0	125	51	6099	51	5974	0.0	0.008536993639102779
chr18	SS18	26079010	26079125	0	116	51	6099	51	5983	0.0	0.008524151763329433
chr18	SS18	26081224	26081365	0	142	51	6099	51	5957	0.0	0.008561356387443344
chr18	SS18	26079010	26079146	0	137	51	6099	51	5962	0.0	0.008554176450855417
chr18	KCTD1	26476514	26476659	0	146	153	8856	153	8710	0.0	0.01756601607347876
chr18	AQP4	26860771	26860852	0	82	0	5950	0	5868	0.0	0.0
chr18	CHST9	26944328	26944366	0	39	0	11518	0	11479	0.0	0.0
chr18	AC090403.1	27340496	27341131	0	636	0	3255	0	2619	0.0	0.0
chr18	AC090403.1	27592707	27592874	0	168	0	3255	0	3087	0.0	0.0
chr18	CDH2	28097062	28097254	0	193	0	7955	0	7762	0.0	0.0
chr18	CDH2	28159148	28159295	0	148	0	7955	0	7807	0.0	0.0
chr18	DSC3	30994453	30994496	0	44	0	7716	0	7672	0.0	0.0
chr18	DSC2	31068298	31068344	0	47	306	12520	306	12473	0.0	0.02453299126112403
chr18	DSC2	31091530	31091567	0	38	306	12520	306	12482	0.0	0.0245153020349303
chr18	DSC1	31130792	31130838	0	47	153	4288	153	4241	0.0	0.03607639707616128
chr18	DSG1-AS1	31364148	31364285	0	138	0	1157	0	1019	0.0	0.0
chr18	B4GALT6	31638643	31638760	0	118	0	5316	0	5198	0.0	0.0
chr18	B4GALT6	31666255	31666372	0	118	0	5316	0	5198	0.0	0.0
chr18	B4GALT6	31645354	31645479	0	126	0	5316	0	5190	0.0	0.0
chr18	CCDC178	33092760	33092910	0	151	10564	4504	10564	4353	0.0	2.426832069836894
chr18	CCDC178	33223105	33223219	0	115	10564	4504	10564	4389	0.0	2.406926406926407
chr18	CCDC178	32983280	32983352	0	73	10564	4504	10564	4431	0.0	2.3841119386143084
chr18	NOL4	33957325	33957517	0	193	918	5584	918	5391	0.0	0.17028380634390652
chr18	NOL4	34105048	34105160	0	113	918	5584	918	5471	0.0	0.16779382197038933
chr18	NOL4	33943064	33943178	0	115	918	5584	918	5469	0.0	0.16785518376302797
chr18	NOL4	34128848	34128889	0	42	918	5584	918	5542	0.0	0.1656441717791411
chr18	NOL4	34121233	34121316	0	84	918	5584	918	5500	0.0	0.1669090909090909
chr18	NOL4	34183517	34183626	0	110	918	5584	918	5474	0.0	0.16770186335403728
chr18	AC068506.1	34893159	34893644	0	486	0	1656	0	1170	0.0	0.0
chr18	ZSCAN30	35267475	35267679	0	205	51	5878	51	5673	0.0	0.008989952406134321
chr18	ZNF396	35376126	35376270	0	145	0	4789	0	4644	0.0	0.0
chr18	ZNF396	35374469	35374823	0	355	0	4789	0	4434	0.0	0.0
chr18	AC007998.3	35447484	35447542	0	59	0	921	0	862	0.0	0.0
chr18	INO80C	35478281	35478349	0	69	0	5014	0	4945	0.0	0.0
chr18	INO80C	35496774	35496882	0	109	0	5014	0	4905	0.0	0.0
chr18	AC118757.1	35952677	35952799	0	123	0	734	0	611	0.0	0.0
chr18	RPRD1A	35988731	35988835	0	105	0	5239	0	5134	0.0	0.0
chr18	RPRD1A	36040806	36040865	0	60	0	5239	0	5179	0.0	0.0
chr18	RPRD1A	36062977	36063075	0	99	0	5239	0	5140	0.0	0.0
chr18	SLC39A6	36126218	36127016	0	799	0	3680	0	2881	0.0	0.0
chr18	TPGS2	36781798	36781922	0	125	8842	9685	8842	9560	0.0	0.9248953974895398
chr18	TPGS2	36805373	36805502	0	130	8842	9685	8842	9555	0.0	0.9253793825222396
chr18	TPGS2	36805373	36805397	0	25	8842	9685	8842	9660	0.0	0.9153209109730849
chr18	TPGS2	36823802	36823871	0	70	8842	9685	8842	9615	0.0	0.9196047841913677
chr18	TPGS2	36820967	36821129	0	163	8842	9685	8842	9522	0.0	0.9285864314219702
chr18	TPGS2	36817594	36817771	0	178	8842	9685	8842	9507	0.0	0.9300515409698117
chr18	CELF4	37259180	37259264	0	85	765	4935	765	4850	0.0	0.1577319587628866
chr18	CELF4	37264673	37264757	0	85	765	4935	765	4850	0.0	0.1577319587628866
chr18	CELF4	37247185	37247270	51	86	765	4935	714	4849	0.5930232558139535	0.14724685502165394
chr18	CELF4	37264673	37264754	0	82	765	4935	765	4853	0.0	0.15763445291572223
chr18	CELF4	37259120	37259264	0	145	765	4935	765	4790	0.0	0.15970772442588727
chr18	MIR924HG	39233108	39233530	0	423	51	11691	51	11268	0.0	0.004526091586794462
chr18	MIR924HG	39699548	39699635	0	88	51	11691	51	11603	0.0	0.004395414978884771
chr18	MIR924HG	39208598	39208789	0	192	51	11691	51	11499	0.0	0.004435168275502218
chr18	MIR924HG	39388428	39388527	0	100	51	11691	51	11591	0.0	0.0043999654904667415
chr18	MIR924HG	39535457	39535615	0	159	51	11691	51	11532	0.0	0.004422476586888657
chr18	MIR924HG	39293185	39293304	0	120	51	11691	51	11571	0.0	0.0044075706507648435
chr18	MIR924HG	39214127	39214269	51	143	51	11691	0	11548	0.35664335664335667	0.0
chr18	MIR924HG	39751328	39751360	0	33	51	11691	51	11658	0.0	0.004374678332475553
chr18	MIR924HG	39233402	39233530	0	129	51	11691	51	11562	0.0	0.0044110015568240785
chr18	MIR924HG	39327765	39327951	0	187	51	11691	51	11504	0.0	0.004433240611961057
chr18	MIR924HG	39712655	39712803	0	149	51	11691	51	11542	0.0	0.004418644948882343
chr18	MIR924HG	39291014	39291114	0	101	51	11691	51	11590	0.0	0.004400345125107852
chr18	MIR924HG	39293185	39293406	0	222	51	11691	51	11469	0.0	0.004446769552707298
chr18	MIR924HG	39784074	39784242	0	169	51	11691	51	11522	0.0	0.004426314875889603
chr18	MIR924HG	39435437	39435533	0	97	51	11691	51	11594	0.0	0.004398826979472141
chr18	MIR924HG	39784099	39784242	0	144	51	11691	51	11547	0.0	0.004416731618602235
chr18	KC6	41521376	41521496	0	121	0	4708	0	4587	0.0	0.0
chr18	KC6	41564798	41564898	0	101	0	4708	0	4607	0.0	0.0
chr18	RIT2	42920696	42920760	0	65	0	2054	0	1989	0.0	0.0
chr18	RIT2	42948986	42949048	0	63	0	2054	0	1991	0.0	0.0
chr18	LINC01478	44325151	44325428	663	278	2608	4614	1945	4336	2.384892086330935	0.448570110701107
chr18	LINC01478	44423932	44423973	0	42	2608	4614	2608	4572	0.0	0.5704286964129484
chr18	LINC01478	44383295	44383428	0	134	2608	4614	2608	4480	0.0	0.5821428571428572
chr18	LINC01478	44393822	44393889	324	68	2608	4614	2284	4546	4.764705882352941	0.5024197096348438
chr18	LINC01478	44518224	44518368	0	145	2608	4614	2608	4469	0.0	0.5835757440143209
chr18	LINC01478	44518224	44518363	0	140	2608	4614	2608	4474	0.0	0.5829235583370586
chr18	LINC01478	44291699	44291787	0	89	2608	4614	2608	4525	0.0	0.576353591160221
chr18	LINC01478	44518224	44518404	0	181	2608	4614	2608	4433	0.0	0.5883149108955561
chr18	LINC01478	44419854	44419892	0	39	2608	4614	2608	4575	0.0	0.5700546448087431
chr18	LINC01478	44373284	44373483	0	200	2608	4614	2608	4414	0.0	0.5908473040326234
chr18	SLC14A2-AS1	45440376	45440472	0	97	306	1399	306	1302	0.0	0.2350230414746544
chr18	EPG5	45876235	45876342	0	108	48	13775	48	13667	0.0	0.00351210946074486
chr18	EPG5	45907163	45907289	0	127	48	13775	48	13648	0.0	0.0035169988276670576
chr18	EPG5	45870566	45870742	48	177	48	13775	0	13598	0.2711864406779661	0.0
chr18	PSTPIP2	45992105	45992202	0	98	51	3439	51	3341	0.0	0.015264890751272074
chr18	ATP5F1A	46098171	46098279	0	109	3591	7373	3591	7264	0.0	0.4943557268722467
chr18	ATP5F1A	46093179	46093365	580	187	3591	7373	3011	7186	3.1016042780748663	0.4190091845254662
chr18	ATP5F1A	46093179	46093362	520	184	3591	7373	3071	7189	2.8260869565217392	0.4271804145221867
chr18	LOXHD1	46521096	46521282	45	187	156997	8983	156952	8796	0.24064171122994651	17.84356525693497
chr18	LOXHD1	46557901	46558055	0	155	156997	8983	156997	8828	0.0	17.78398278205709
chr18	LOXHD1	46533705	46533759	0	55	156997	8983	156997	8928	0.0	17.584789426523297
chr18	ST8SIA5	46721361	46721469	0	109	4974	15684	4974	15575	0.0	0.31935794542536117
chr18	ST8SIA5	46704571	46704664	0	94	4974	15684	4974	15590	0.0	0.3190506735086594
chr18	PIAS2	46864163	46864248	0	86	52386	17092	52386	17006	0.0	3.0804421968716924
chr18	PIAS2	46890579	46891054	42	476	52386	17092	52344	16616	0.08823529411764706	3.1502166586422726
chr18	PIAS2	46903526	46903633	0	108	52386	17092	52386	16984	0.0	3.084432406971267
chr18	PIAS2	46904101	46904206	0	106	52386	17092	52386	16986	0.0	3.0840692334864004
chr18	PIAS2	46906226	46906315	448	90	52386	17092	51938	17002	4.977777777777778	3.054817080343489
chr18	HDHD2	47130243	47130328	0	86	51	4612	51	4526	0.0	0.011268228015908087
chr18	HDHD2	47137234	47137338	0	105	51	4612	51	4507	0.0	0.011315731084978922
chr18	HDHD2	47137234	47137296	0	63	51	4612	51	4549	0.0	0.011211255220927677
chr18	HDHD2	47149048	47149108	0	61	51	4612	51	4551	0.0	0.01120632827949901
chr18	SMAD2	47870474	47870564	0	91	872064	36439	872064	36348	0.0	23.99207659293496
chr18	SMAD2	47920071	47920169	54061	99	872064	36439	818003	36340	546.070707070707	22.509713813979086
chr18	SMAD2	47930360	47930446	0	87	872064	36439	872064	36352	0.0	23.989436619718308
chr18	ZBTB7C	48338173	48338398	0	226	282	7629	282	7403	0.0	0.03809266513575577
chr18	ZBTB7C	48162347	48162397	0	51	282	7629	282	7578	0.0	0.03721298495645289
chr18	ZBTB7C	48087669	48087798	0	130	282	7629	282	7499	0.0	0.037605014001866915
chr18	ZBTB7C	48088255	48088355	0	101	282	7629	282	7528	0.0	0.03746014877789586
chr18	ZBTB7C	48076935	48077003	0	69	282	7629	282	7560	0.0	0.0373015873015873
chr18	ZBTB7C	48180386	48180477	0	92	282	7629	282	7537	0.0	0.03741541727477776
chr18	ZBTB7C	48185323	48185455	0	133	282	7629	282	7496	0.0	0.037620064034151544
chr18	ZBTB7C	48165130	48165257	0	128	282	7629	282	7501	0.0	0.037594987335022
chr18	ZBTB7C	48072459	48072610	0	152	282	7629	282	7477	0.0	0.037715661361508626
chr18	ZBTB7C	48180329	48180477	0	149	282	7629	282	7480	0.0	0.037700534759358285
chr18	ZBTB7C	48408357	48408655	0	299	282	7629	282	7330	0.0	0.03847203274215553
chr18	ZBTB7C	48364153	48364214	27	62	282	7629	255	7567	0.43548387096774194	0.033698955993128055
chr18	ZBTB7C	48374221	48374313	0	93	282	7629	282	7536	0.0	0.037420382165605094
chr18	ZBTB7C	48252160	48252298	0	139	282	7629	282	7490	0.0	0.0376502002670227
chr18	ZBTB7C	48165130	48165253	0	124	282	7629	282	7505	0.0	0.03757495003331113
chr18	DYM	49209550	49209715	0	166	51	12141	51	11975	0.0	0.004258872651356994
chr18	DYM	49093216	49093311	0	96	51	12141	51	12045	0.0	0.004234122042341221
chr18	DYM	49329572	49329707	0	136	51	12141	51	12005	0.0	0.00424822990420658
chr18	DYM	49375647	49375724	0	78	51	12141	51	12063	0.0	0.004227804028848545
chr18	DYM	49393644	49393742	0	99	51	12141	51	12042	0.0	0.004235176880916791
chr18	DYM	49417934	49418057	0	124	51	12141	51	12017	0.0	0.004243987684114172
chr18	RPL17	49491404	49491445	0	42	102	2096	102	2054	0.0	0.04965920155793573
chr18	RPL17	49488499	49488566	0	68	102	2096	102	2028	0.0	0.05029585798816568
chr18	RPL17	49491745	49491833	0	89	102	2096	102	2007	0.0	0.05082212257100149
chr18	RPL17	49491735	49491833	0	99	102	2096	102	1997	0.0	0.05107661492238358
chr18	MYO5B	49856812	49856890	0	79	40	10608	40	10529	0.0	0.003799031247032007
chr18	MBD1	50273333	50273471	0	139	0	5812	0	5673	0.0	0.0
chr18	MBD1	50274185	50274350	0	166	0	5812	0	5646	0.0	0.0
chr18	MBD1	50274976	50275045	0	70	0	5812	0	5742	0.0	0.0
chr18	MBD1	50275369	50275444	0	76	0	5812	0	5736	0.0	0.0
chr18	MBD1	50271468	50271540	0	73	0	5812	0	5739	0.0	0.0
chr18	MBD1	50274185	50274353	0	169	0	5812	0	5643	0.0	0.0
chr18	MBD1	50275834	50275981	0	148	0	5812	0	5664	0.0	0.0
chr18	MBD1	50273333	50273426	0	94	0	5812	0	5718	0.0	0.0
chr18	CXXC1	50285324	50285351	0	28	153	3854	153	3826	0.0	0.03998954521693675
chr18	CXXC1	50287422	50287508	0	87	153	3854	153	3767	0.0	0.04061587470135386
chr18	MRO	50801348	50801504	0	157	0	5535	0	5378	0.0	0.0
chr18	MRO	50809301	50809404	0	104	0	5535	0	5431	0.0	0.0
chr18	MRO	50819580	50819702	0	123	0	5535	0	5412	0.0	0.0
chr18	MRO	50816123	50816162	0	40	0	5535	0	5495	0.0	0.0
chr18	MRO	50806703	50806850	0	148	0	5535	0	5387	0.0	0.0
chr18	MBD2	54187713	54187837	0	125	0	5695	0	5570	0.0	0.0
chr18	STARD6	54357054	54357167	0	114	3417	1745	3417	1631	0.0	2.095033721643164
chr18	STARD6	54355770	54355850	0	81	3417	1745	3417	1664	0.0	2.053485576923077
chr18	TCF4	55259948	55260027	0	80	105042	22459	105042	22379	0.0	4.693775414451048
chr18	TCF4	55275618	55275752	102	135	105042	22459	104940	22324	0.7555555555555555	4.700770471241713
chr18	TCF4	55587044	55587136	0	93	105042	22459	105042	22366	0.0	4.696503621568452
chr18	TCF4	55586920	55587136	0	217	105042	22459	105042	22242	0.0	4.722686808740221
chr18	TCF4	55284286	55284408	0	123	105042	22459	105042	22336	0.0	4.702811604584527
chr18	TCF4	55518981	55519024	0	44	105042	22459	105042	22415	0.0	4.686236894936426
chr18	TCF4	55401688	55401777	0	90	105042	22459	105042	22369	0.0	4.695873753855783
chr18	TCF4	55403453	55403518	58	66	105042	22459	104984	22393	0.8787878787878788	4.68825079265842
chr18	TCF4	55631297	55631388	0	92	105042	22459	105042	22367	0.0	4.696293646890508
chr18	TCF4	55482149	55482256	0	108	105042	22459	105042	22351	0.0	4.699655496398371
chr18	TCF4	55596105	55596226	0	122	105042	22459	105042	22337	0.0	4.70260106549671
chr18	AC006305.1	56037040	56037222	55	183	38949	3205	38894	3022	0.3005464480874317	12.87028457974851
chr18	LINC01539	56087638	56087760	0	123	0	4888	0	4765	0.0	0.0
chr18	LINC01539	56090184	56090303	0	120	0	4888	0	4768	0.0	0.0
chr18	LINC01539	56122292	56122529	0	238	0	4888	0	4650	0.0	0.0
chr18	LINC01539	56121277	56121446	0	170	0	4888	0	4718	0.0	0.0
chr18	LINC01539	56095829	56096096	0	268	0	4888	0	4620	0.0	0.0
chr18	LINC01539	56122292	56122488	0	197	0	4888	0	4691	0.0	0.0
chr18	LINC01539	56129800	56129973	0	174	0	4888	0	4714	0.0	0.0
chr18	LINC01539	56121622	56121957	0	336	0	4888	0	4552	0.0	0.0
chr18	LINC01539	56092751	56092959	0	209	0	4888	0	4679	0.0	0.0
chr18	LINC01539	56102690	56102829	0	140	0	4888	0	4748	0.0	0.0
chr18	LINC01539	56096006	56096096	0	91	0	4888	0	4797	0.0	0.0
chr18	LINC01539	56121622	56121722	0	101	0	4888	0	4787	0.0	0.0
chr18	TXNL1	56626161	56626266	384	106	231181	9274	230797	9168	3.6226415094339623	25.174192844677137
chr18	TXNL1	56638342	56639039	1377	698	231181	9274	229804	8576	1.972779369627507	26.79617537313433
chr18	TXNL1	56638961	56639039	0	79	231181	9274	231181	9195	0.0	25.142033713974985
chr18	TXNL1	56647448	56647535	408	88	231181	9274	230773	9186	4.636363636363637	25.122251251905073
chr18	LINC-ROR	57060352	57060516	0	165	305	3868	305	3703	0.0	0.08236564947339994
chr18	LINC-ROR	57058886	57059243	0	358	305	3868	305	3510	0.0	0.0868945868945869
chr18	LINC-ROR	57059202	57059243	0	42	305	3868	305	3826	0.0	0.07971772085729222
chr18	FECH	57559144	57559243	51	100	4164	8798	4113	8698	0.51	0.47286732582202806
chr18	FECH	57580072	57580199	0	128	4164	8798	4164	8670	0.0	0.4802768166089965
chr18	FECH	57580054	57580199	0	146	4164	8798	4164	8652	0.0	0.4812760055478502
chr18	FECH	57585863	57585973	0	111	4164	8798	4164	8687	0.0	0.4793369402555543
chr18	NARS1	57611636	57611707	0	72	0	3990	0	3918	0.0	0.0
chr18	NARS1	57615640	57615730	0	91	0	3990	0	3899	0.0	0.0
chr18	NARS1	57620568	57620651	0	84	0	3990	0	3906	0.0	0.0
chr18	ATP8B1	57704554	57704668	0	115	18616	7060	18616	6945	0.0	2.680489560835133
chr18	ATP8B1	57706489	57706587	0	99	18616	7060	18616	6961	0.0	2.674328401091797
chr18	ATP8B1	57659742	57659815	0	74	18616	7060	18616	6986	0.0	2.664758087603779
chr18	LINC01897	57961505	57961624	0	120	0	409	0	289	0.0	0.0
chr18	LINC01897	57961501	57961624	0	124	0	409	0	285	0.0	0.0
chr18	RAX	59272360	59272614	713	255	5488	3726	4775	3471	2.796078431372549	1.37568424085278
chr18	AC113137.1	60827741	60827794	0	54	7329	1770	7329	1716	0.0	4.270979020979021
chr18	AC090409.2	61573221	61573337	0	117	0	615	0	498	0.0	0.0
chr18	PIGN	62090475	62090578	0	104	0	17779	0	17675	0.0	0.0
chr18	PIGN	62113133	62113316	0	184	0	17779	0	17595	0.0	0.0
chr18	PIGN	62140419	62140479	0	61	0	17779	0	17718	0.0	0.0
chr18	PIGN	62162252	62162329	0	78	0	17779	0	17701	0.0	0.0
chr18	PIGN	62163530	62163656	0	127	0	17779	0	17652	0.0	0.0
chr18	PIGN	62154544	62154651	0	108	0	17779	0	17671	0.0	0.0
chr18	PIGN	62070389	62070506	0	118	0	17779	0	17661	0.0	0.0
chr18	PIGN	62103588	62103599	0	12	0	17779	0	17767	0.0	0.0
chr18	PIGN	62103718	62103799	0	82	0	17779	0	17697	0.0	0.0
chr18	BCL2	63301661	63301865	0	205	51	8671	51	8466	0.0	0.006024096385542169
chr18	BCL2	63280886	63281214	0	329	51	8671	51	8342	0.0	0.0061136418125149845
chr18	KDSR	63335256	63335358	0	103	0	8861	0	8758	0.0	0.0
chr18	KDSR	63350887	63351079	0	193	0	8861	0	8668	0.0	0.0
chr18	KDSR	63366404	63366674	0	271	0	8861	0	8590	0.0	0.0
chr18	KDSR	63366249	63366308	0	60	0	8861	0	8801	0.0	0.0
chr18	KDSR	63350887	63351077	0	191	0	8861	0	8670	0.0	0.0
chr18	VPS4B	63399241	63399323	0	83	0	3635	0	3552	0.0	0.0
chr18	VPS4B	63407431	63407499	0	69	0	3635	0	3566	0.0	0.0
chr18	SERPINB4	63641759	63641888	0	130	0	1979	0	1849	0.0	0.0
chr18	SERPINB3	63656830	63656986	0	157	0	1715	0	1558	0.0	0.0
chr18	LINC00305	64110854	64111107	0	254	40	2884	40	2630	0.0	0.015209125475285171
chr18	LINC00305	64111663	64111810	0	148	40	2884	40	2736	0.0	0.014619883040935672
chr18	LINC00305	64082830	64082901	0	72	40	2884	40	2812	0.0	0.01422475106685633
chr18	CDH19	66596158	66596303	0	146	7497	6878	7497	6732	0.0	1.1136363636363635
chr18	AC022655.1	67675054	67675302	0	249	24	634	24	385	0.0	0.06233766233766234
chr18	TMX3	68700404	68700485	0	82	2458	7188	2458	7106	0.0	0.3459048691246834
chr18	TMX3	68701744	68701790	0	47	2458	7188	2458	7141	0.0	0.3442094944685618
chr18	TMX3	68710020	68710144	0	125	2458	7188	2458	7063	0.0	0.34801076030015576
chr18	TMX3	68701615	68701667	0	53	2458	7188	2458	7135	0.0	0.3444989488437281
chr18	CD226	69944483	69944568	0	86	357	13672	357	13586	0.0	0.026277049904313263
chr18	RTTN	70053294	70053514	0	221	0	18645	0	18424	0.0	0.0
chr18	RTTN	70065828	70065922	0	95	0	18645	0	18550	0.0	0.0
chr18	RTTN	70127501	70127741	0	241	0	18645	0	18404	0.0	0.0
chr18	RTTN	70140099	70140188	0	90	0	18645	0	18555	0.0	0.0
chr18	RTTN	70022203	70022248	0	46	0	18645	0	18599	0.0	0.0
chr18	RTTN	70056318	70056387	0	70	0	18645	0	18575	0.0	0.0
chr18	RTTN	70078608	70078738	0	131	0	18645	0	18514	0.0	0.0
chr18	RTTN	70061311	70061400	0	90	0	18645	0	18555	0.0	0.0
chr18	RTTN	70128357	70128546	0	190	0	18645	0	18455	0.0	0.0
chr18	RTTN	70128053	70128098	0	46	0	18645	0	18599	0.0	0.0
chr18	CBLN2	72541803	72542326	0	524	0	5468	0	4944	0.0	0.0
chr18	LINC02864	73200652	73200789	0	138	0	8810	0	8672	0.0	0.0
chr18	FBXO15	74147493	74147579	0	87	5619	6149	5619	6062	0.0	0.9269218079841637
chr18	FBXO15	74140201	74140312	0	112	5619	6149	5619	6037	0.0	0.9307603114129535
chr18	FBXO15	74140723	74140773	0	51	5619	6149	5619	6098	0.0	0.921449655624795
chr18	CYB5A	74260914	74260944	0	31	561	8119	561	8088	0.0	0.0693620178041543
chr18	CYB5A	74256829	74256853	0	25	561	8119	561	8094	0.0	0.06931060044477391
chr18	SMIM21	75418785	75418916	0	132	0	4013	0	3881	0.0	0.0
chr18	ZNF516	76370527	76370595	0	69	153	7584	153	7515	0.0	0.02035928143712575
chr18	ZNF516	76371466	76371571	0	106	153	7584	153	7478	0.0	0.02046001604707141
chr18	LINC01927	76638207	76638276	0	70	0	1701	0	1631	0.0	0.0
chr18	LINC01927	76638548	76638688	0	141	0	1701	0	1560	0.0	0.0
chr18	MBP	76988494	76988527	0	34	51	6992	51	6958	0.0	0.007329692440356425
chr18	MBP	77009848	77009926	0	79	51	6992	51	6913	0.0	0.007377404889338927
chr18	MBP	77016831	77017268	0	438	51	6992	51	6554	0.0	0.00778150747635032
chr18	MBP	76984774	76984894	0	121	51	6992	51	6871	0.0	0.007422500363848057
chr18	MBP	76988299	76988527	0	229	51	6992	51	6763	0.0	0.007541032086352211
chr18	MBP	76985203	76985210	0	8	51	6992	51	6984	0.0	0.007302405498281787
chr18	MBP	77016831	77016846	0	16	51	6992	51	6976	0.0	0.007310779816513762
chr18	MBP	76982580	76982623	0	44	51	6992	51	6948	0.0	0.007340241796200345
chr18	MBP	76986905	76986983	0	79	51	6992	51	6913	0.0	0.007377404889338927
chr18	MBP	76990826	76990914	0	89	51	6992	51	6903	0.0	0.007388092133854845
chr18	LINC01029	77990092	77990174	0	83	204	4456	204	4373	0.0	0.046649897095815226
chr18	LINC01029	77979494	77979629	0	136	204	4456	204	4320	0.0	0.04722222222222222
chr18	SLC66A2	79919183	79919400	0	218	0	4902	0	4684	0.0	0.0
chr18	SLC66A2	79933968	79934022	0	55	0	4902	0	4847	0.0	0.0
chr18	SLC66A2	79949686	79949838	0	153	0	4902	0	4749	0.0	0.0
chr18	SLC66A2	79930227	79930311	0	85	0	4902	0	4817	0.0	0.0
chr18	SLC66A2	79949518	79949655	0	138	0	4902	0	4764	0.0	0.0
chr18	SLC66A2	79949518	79949636	0	119	0	4902	0	4783	0.0	0.0
chr18	SLC66A2	79947266	79947341	0	76	0	4902	0	4826	0.0	0.0
chr18	TXNL4A	79977597	79977701	0	105	0	5227	0	5122	0.0	0.0
chr18	TXNL4A	80030520	80030577	0	58	0	5227	0	5169	0.0	0.0
chr18	TXNL4A	79976717	79976787	0	71	0	5227	0	5156	0.0	0.0
chr18	TXNL4A	79986601	79986750	0	150	0	5227	0	5077	0.0	0.0
chr18	TXNL4A	79985796	79985866	0	71	0	5227	0	5156	0.0	0.0
chr18	TXNL4A	79979332	79979640	0	309	0	5227	0	4918	0.0	0.0
chr18	PARD6G	80201963	80202018	0	56	0	4197	0	4141	0.0	0.0
chr19	LINC01002	201755	201813	647	59	104844	7755	104197	7696	10.966101694915254	13.539111226611226
chr19	LINC01002	204833	205076	2038	244	104844	7755	102806	7511	8.352459016393443	13.68739182532286
chr19	LINC01002	204817	205076	2038	260	104844	7755	102806	7495	7.838461538461538	13.716611074049366
chr19	LINC01002	204843	205076	2038	234	104844	7755	102806	7521	8.709401709401709	13.669192926472544
chr19	LINC01002	208957	209014	4	58	104844	7755	104840	7697	0.06896551724137931	13.620891256333637
chr19	LINC01002	205169	205227	1725	59	104844	7755	103119	7696	29.23728813559322	13.399038461538462
chr19	LINC01002	223966	224048	3685	83	104844	7755	101159	7672	44.397590361445786	13.185479666319083
chr19	LINC01002	229635	230164	15707	530	104844	7755	89137	7225	29.635849056603774	12.337301038062284
chr19	MIER2	336082	336173	5279	92	249456	7934	244177	7842	57.380434782608695	31.137082376944658
chr19	THEG	373939	374011	0	73	1632	2094	1632	2021	0.0	0.8075210291934686
chr19	SHC2	439232	439491	0	260	89262	4146	89262	3886	0.0	22.970149253731343
chr19	ODF3L2	472393	472501	0	109	0	1722	0	1613	0.0	0.0
chr19	MED16	871925	872118	19818	194	326503	3907	306685	3713	102.15463917525773	82.59762994882844
chr19	MED16	876973	877180	22174	208	326503	3907	304329	3699	106.60576923076923	82.27331711273317
chr19	MED16	885769	886201	61446	433	326503	3907	265057	3474	141.90762124711316	76.29735175590098
chr19	MED16	889637	889807	11016	171	326503	3907	315487	3736	64.42105263157895	84.44512847965738
chr19	MED16	871605	871662	99	58	326503	3907	326404	3849	1.706896551724138	84.80228630813198
chr19	MED16	872912	873009	204	98	326503	3907	326299	3809	2.0816326530612246	85.6652664741402
chr19	R3HDM4	901421	901546	17827	126	365294	2427	347467	2301	141.484126984127	151.00695349847894
chr19	R3HDM4	901419	901546	17827	128	365294	2427	347467	2299	139.2734375	151.13832100913442
chr19	TMEM259	1010990	1011095	1426	106	839035	3940	837609	3834	13.452830188679245	218.46870109546165
chr19	TMEM259	1011095	1011195	41863	101	839035	3940	797172	3839	414.48514851485146	207.65095076842928
chr19	POLR2E	1090907	1090988	55491	82	558582	2591	503091	2509	676.719512195122	200.51454762853726
chr19	POLR2E	1093903	1094078	76584	176	558582	2591	481998	2415	435.1363636363636	199.58509316770187
chr19	POLR2E	1093755	1093903	1299	149	558582	2591	557283	2442	8.718120805369127	228.2076167076167
chr19	CBARP	1235336	1235390	1401	55	54771	2939	53370	2884	25.472727272727273	18.505547850208046
chr19	PCSK4	1482895	1483020	5510	126	72689	3654	67179	3528	43.73015873015873	19.041666666666668
chr19	PCSK4	1487602	1487691	297	90	72689	3654	72392	3564	3.3	20.312008978675646
chr19	PCSK4	1489792	1489897	637	106	72689	3654	72052	3548	6.009433962264151	20.307779030439683
chr19	ADAMTSL5	1511624	1511727	0	104	9840	2885	9840	2781	0.0	3.5382955771305284
chr19	ADAMTSL5	1511624	1511772	0	149	9840	2885	9840	2736	0.0	3.5964912280701755
chr19	MBD3	1583252	1583380	0	129	522318	7530	522318	7401	0.0	70.57397648966356
chr19	TCF3	1619315	1619474	48723	160	1279548	5864	1230825	5704	304.51875	215.7827840112202
chr19	TCF3	1612206	1612433	71017	228	1279548	5864	1208531	5636	311.4780701754386	214.430624556423
chr19	TCF3	1615284	1615485	70026	202	1279548	5864	1209522	5662	346.66336633663366	213.62098198516426
chr19	TCF3	1615284	1615520	75032	237	1279548	5864	1204516	5627	316.59071729957805	214.06006753154435
chr19	TCF3	1615284	1615515	74435	232	1279548	5864	1205113	5632	320.8405172413793	213.97602982954547
chr19	TCF3	1619315	1619471	48220	157	1279548	5864	1231328	5707	307.13375796178343	215.757490800771
chr19	ATP8B3	1789889	1789989	0	101	319716	7043	319716	6942	0.0	46.05531547104581
chr19	ABHD17A	1884468	1884543	1982	76	286407	4179	284425	4103	26.07894736842105	69.32122836948574
chr19	ABHD17A	1880895	1881048	0	154	286407	4179	286407	4025	0.0	71.15701863354037
chr19	ABHD17A	1878663	1878904	16390	242	286407	4179	270017	3937	67.72727272727273	68.58445516891034
chr19	BTBD2	1991876	1992056	9985	181	1010412	5031	1000427	4850	55.16574585635359	206.2736082474227
chr19	BTBD2	2013546	2013880	6578	335	1010412	5031	1003834	4696	19.63582089552239	213.76362862010222
chr19	BTBD2	2028707	2028834	0	128	1010412	5031	1010412	4903	0.0	206.08035896389964
chr19	BTBD2	2017044	2017094	0	51	1010412	5031	1010412	4980	0.0	202.89397590361446
chr19	MKNK2	2039630	2039856	20895	227	410991	5232	390096	5005	92.04845814977973	77.94125874125874
chr19	MKNK2	2046185	2046283	15252	99	410991	5232	395739	5133	154.06060606060606	77.09701928696668
chr19	MOB3A	2095240	2095323	373	84	435655	4154	435282	4070	4.440476190476191	106.94889434889434
chr19	AP3D1	2127151	2127201	59649	51	2477556	8084	2417907	8033	1169.5882352941176	300.9967633511764
chr19	AP3D1	2133396	2133484	9	89	2477556	8084	2477547	7995	0.10112359550561797	309.88705440900566
chr19	PLEKHJ1	2234149	2234240	51200	92	439258	3179	388058	3087	556.5217391304348	125.70715905409783
chr19	LSM7	2325979	2326139	8957	161	203833	1691	194876	1530	55.63354037267081	127.36993464052287
chr19	GNG7	2516941	2517082	51	142	26001	4553	25950	4411	0.3591549295774648	5.883019723418726
chr19	DIRAS1	2719151	2719182	7	32	257819	3442	257812	3410	0.21875	75.60469208211144
chr19	SGTA	2759256	2759294	17561	39	1100870	7950	1083309	7911	450.28205128205127	136.93704967766402
chr19	SGTA	2767579	2767686	82693	108	1100870	7950	1018177	7842	765.675925925926	129.83639377709767
chr19	SGTA	2782569	2782658	1676	90	1100870	7950	1099194	7860	18.622222222222224	139.84656488549618
chr19	TLE2	3000646	3000723	2350	78	87042	4108	84692	4030	30.128205128205128	21.015384615384615
chr19	TLE2	3019698	3019773	1541	76	87042	4108	85501	4032	20.276315789473685	21.205605158730158
chr19	TLE2	3017839	3017859	0	21	87042	4108	87042	4087	0.0	21.297284071446047
chr19	TLE2	3025019	3025082	349	64	87042	4108	86693	4044	5.453125	21.437438180019782
chr19	TLE2	3028880	3028905	1308	26	87042	4108	85734	4082	50.30769230769231	21.002939735423812
chr19	MFSD12	3546254	3546425	59757	172	832398	4683	772641	4511	347.4244186046512	171.2793172245622
chr19	MFSD12	3542775	3542977	34573	203	832398	4683	797825	4480	170.31034482758622	178.0859375
chr19	MFSD12	3548122	3548267	33944	146	832398	4683	798454	4537	232.4931506849315	175.98721622217323
chr19	MFSD12	3572860	3573021	4544	162	832398	4683	827854	4521	28.049382716049383	183.11302809113027
chr19	CACTIN	3611228	3611364	2949	137	268594	5168	265645	5031	21.525547445255473	52.80162989465315
chr19	PIP5K1C	3633436	3633520	2293	85	551178	6975	548885	6890	26.976470588235294	79.66400580551525
chr19	MATK	3785063	3785286	0	224	869	4160	869	3936	0.0	0.22078252032520326
chr19	MATK	3789272	3789404	0	133	869	4160	869	4027	0.0	0.21579339458654084
chr19	MATK	3782817	3782937	207	121	869	4160	662	4039	1.7107438016528926	0.16390195592968557
chr19	ZFR2	3825229	3825407	0	179	25520	6111	25520	5932	0.0	4.3020903573836815
chr19	ZFR2	3855401	3855559	3874	159	25520	6111	21646	5952	24.364779874213838	3.636760752688172
chr19	ZFR2	3853391	3853423	132	33	25520	6111	25388	6078	4.0	4.177031918394209
chr19	ZFR2	3856959	3857021	0	63	25520	6111	25520	6048	0.0	4.21957671957672
chr19	MAP2K2	4099200	4099414	173790	215	917110	4765	743320	4550	808.3255813953489	163.36703296703297
chr19	MAP2K2	4097278	4097343	85360	66	917110	4765	831750	4699	1293.3333333333333	177.0057459033837
chr19	SIRT6	4179103	4179286	39711	184	174345	2675	134634	2491	215.82065217391303	54.04817342432758
chr19	SIRT6	4180781	4180909	15440	129	174345	2675	158905	2546	119.68992248062015	62.413589945011786
chr19	SIRT6	4175679	4175760	10369	82	174345	2675	163976	2593	126.45121951219512	63.23794832240648
chr19	TMIGD2	4297985	4298345	0	361	51	1267	51	906	0.0	0.056291390728476824
chr19	STAP2	4325395	4325545	1458	151	11533	2781	10075	2630	9.655629139072847	3.8307984790874525
chr19	STAP2	4324454	4324667	389	214	11533	2781	11144	2567	1.8177570093457944	4.341254382547721
chr19	STAP2	4328674	4328809	211	136	11533	2781	11322	2645	1.5514705882352942	4.280529300567108
chr19	STAP2	4324454	4324529	280	76	11533	2781	11253	2705	3.6842105263157894	4.160073937153419
chr19	STAP2	4324454	4324664	389	211	11533	2781	11144	2570	1.8436018957345972	4.336186770428015
chr19	STAP2	4338214	4338264	0	51	11533	2781	11533	2730	0.0	4.224542124542125
chr19	SH3GL1	4365481	4365625	47124	145	796089	3698	748965	3553	324.99310344827586	210.79791725302562
chr19	UBXN6	4446282	4446413	14716	132	775084	4117	760368	3985	111.48484848484848	190.80752823086576
chr19	UBXN6	4452363	4452492	112188	130	775084	4117	662896	3987	862.9846153846154	166.2643591672937
chr19	SEMA6B	4554155	4554263	0	109	37502	4408	37502	4299	0.0	8.723424052105141
chr19	DPP9	4682695	4682838	83927	144	1325046	6781	1241119	6637	582.8263888888889	187.0
chr19	DPP9	4695377	4695555	77059	179	1325046	6781	1247987	6602	430.4972067039106	189.03165707361407
chr19	DPP9	4722498	4722551	12633	54	1325046	6781	1312413	6727	233.94444444444446	195.0963282295228
chr19	DPP9	4683189	4683324	4786	136	1325046	6781	1320260	6645	35.19117647058823	198.6847253574116
chr19	DPP9	4715528	4715726	12106	199	1325046	6781	1312940	6582	60.834170854271356	199.47432391370404
chr19	DPP9	4719202	4719324	1380	123	1325046	6781	1323666	6658	11.21951219512195	198.80835085611295
chr19	DPP9	4722194	4722304	3866	111	1325046	6781	1321180	6670	34.828828828828826	198.07796101949026
chr19	PLIN3	4861328	4861411	35316	84	1133862	1780	1098546	1696	420.42857142857144	647.7275943396227
chr19	PLIN3	4866879	4866994	1530	116	1133862	1780	1132332	1664	13.189655172413794	680.4879807692307
chr19	PTPRS	5216719	5216767	165	49	2457764	7856	2457599	7807	3.36734693877551	314.7942871781734
chr19	PTPRS	5229315	5229342	0	28	2457764	7856	2457764	7828	0.0	313.97087378640776
chr19	PTPRS	5256107	5256119	517	13	2457764	7856	2457247	7843	39.76923076923077	313.30447532831823
chr19	SAFB2	5611119	5611630	104543	512	657904	5607	553361	5095	204.185546875	108.60863591756625
chr19	SAFB2	5616421	5616486	6610	66	657904	5607	651294	5541	100.15151515151516	117.54087709799676
chr19	LONP1	5707059	5707143	44865	85	1864515	5053	1819650	4968	527.8235294117648	366.27415458937196
chr19	LONP1	5711770	5712002	106711	233	1864515	5053	1757804	4820	457.9871244635193	364.6896265560166
chr19	LONP1	5711770	5712070	114928	301	1864515	5053	1749587	4752	381.8205980066445	368.1790824915825
chr19	LONP1	5711818	5712002	87999	185	1864515	5053	1776516	4868	475.6702702702703	364.93755135579295
chr19	DUS3L	5786748	5786845	18777	98	284136	2948	265359	2850	191.60204081632654	93.10842105263158
chr19	DUS3L	5786748	5786919	22009	172	284136	2948	262127	2776	127.95930232558139	94.42615273775216
chr19	FUT6	5834949	5835077	0	129	0	2530	0	2401	0.0	0.0
chr19	FUT6	5832860	5832905	0	46	0	2530	0	2484	0.0	0.0
chr19	FUT6	5834839	5835077	0	239	0	2530	0	2291	0.0	0.0
chr19	FUT6	5838173	5838373	0	201	0	2530	0	2329	0.0	0.0
chr19	FUT6	5838173	5838399	0	227	0	2530	0	2303	0.0	0.0
chr19	FUT3	5846425	5846966	0	542	0	3117	0	2575	0.0	0.0
chr19	FUT3	5846425	5846564	0	140	0	3117	0	2977	0.0	0.0
chr19	FUT3	5846425	5846618	0	194	0	3117	0	2923	0.0	0.0
chr19	FUT3	5846425	5846599	0	175	0	3117	0	2942	0.0	0.0
chr19	AC024592.3	5870464	5870623	0	160	662539	2198	662539	2038	0.0	325.0927379784102
chr19	RANBP3	5931418	5931531	29137	114	669290	7119	640153	7005	255.58771929824562	91.38515346181299
chr19	RANBP3	5951392	5951596	1430	205	669290	7119	667860	6914	6.975609756097561	96.59531385594445
chr19	RANBP3	5957917	5957973	5902	57	669290	7119	663388	7062	103.54385964912281	93.93769470404985
chr19	RANBP3	5931403	5931531	29959	129	669290	7119	639331	6990	232.24031007751938	91.46366237482117
chr19	RANBP3	5935684	5935839	6970	156	669290	7119	662320	6963	44.67948717948718	95.11991957489587
chr19	RANBP3	5957917	5957968	4897	52	669290	7119	664393	7067	94.17307692307692	94.01344276213386
chr19	RANBP3	5957917	5957935	260	19	669290	7119	669030	7100	13.68421052631579	94.22957746478873
chr19	RANBP3	5974349	5974431	0	83	669290	7119	669290	7036	0.0	95.1236498010233
chr19	RANBP3	5957906	5957973	5902	68	669290	7119	663388	7051	86.79411764705883	94.08424336973479
chr19	RANBP3	5976380	5976574	51	195	669290	7119	669239	6924	0.26153846153846155	96.65496822645869
chr19	RANBP3	5950716	5950872	5119	157	669290	7119	664171	6962	32.605095541401276	95.39945417983338
chr19	RANBP3	5965732	5965922	204	191	669290	7119	669086	6928	1.068062827225131	96.57707852193995
chr19	RFX2	6004200	6004298	153	99	75763	7521	75610	7422	1.5454545454545454	10.187281056319051
chr19	RFX2	6012985	6013105	2675	121	75763	7521	73088	7400	22.107438016528924	9.876756756756757
chr19	RFX2	6026162	6026237	863	76	75763	7521	74900	7445	11.355263157894736	10.060443250503694
chr19	RFX2	6042043	6042123	216	81	75763	7521	75547	7440	2.6666666666666665	10.154166666666667
chr19	RFX2	6044192	6044282	306	91	75763	7521	75457	7430	3.3626373626373627	10.1557200538358
chr19	RFX2	6047406	6047504	306	99	75763	7521	75457	7422	3.090909090909091	10.166666666666666
chr19	RFX2	6072004	6072147	0	144	75763	7521	75763	7377	0.0	10.270164023315711
chr19	GTF2F1	6387388	6387559	105493	172	1076480	2271	970987	2099	613.3313953488372	462.59504525964746
chr19	GTF2F1	6392202	6392410	51	209	1076480	2271	1076429	2062	0.24401913875598086	522.0315227934044
chr19	KHSRP	6420072	6420144	123201	73	2676589	4006	2553388	3933	1687.6849315068494	649.2214594457157
chr19	SLC25A41	6430520	6430618	941	99	4474	1657	3533	1558	9.505050505050505	2.267650834403081
chr19	SLC25A23	6438190	6438312	0	123	397155	3621	397155	3498	0.0	113.5377358490566
chr19	SLC25A23	6452311	6452479	13904	169	397155	3621	383251	3452	82.27218934911242	111.0228852838934
chr19	SLC25A23	6438446	6438534	51	89	397155	3621	397104	3532	0.5730337078651685	112.4303510758777
chr19	SLC25A23	6438723	6438821	0	99	397155	3621	397155	3522	0.0	112.7640545144804
chr19	SLC25A23	6455951	6456092	688	142	397155	3621	396467	3479	4.845070422535211	113.96004599022707
chr19	SLC25A23	6438723	6438771	0	49	397155	3621	397155	3572	0.0	111.18561030235162
chr19	SLC25A23	6453980	6454088	10260	109	397155	3621	386895	3512	94.12844036697248	110.16372437357631
chr19	DENND1C	6479986	6480051	0	66	1708	4369	1708	4303	0.0	0.3969323727631885
chr19	DENND1C	6479986	6479990	0	5	1708	4369	1708	4364	0.0	0.3913840513290559
chr19	DENND1C	6479858	6479902	0	45	1708	4369	1708	4324	0.0	0.395004625346901
chr19	TUBB4A	6496369	6496463	51	95	37197	1824	37146	1729	0.5368421052631579	21.484094852515906
chr19	TUBB4A	6500615	6500742	0	128	37197	1824	37197	1696	0.0	21.932193396226417
chr19	GPR108	6731890	6731934	8209	45	411943	2886	403734	2841	182.42222222222222	142.10982048574445
chr19	GPR108	6732986	6733062	11525	77	411943	2886	400418	2809	149.67532467532467	142.54823780704876
chr19	GPR108	6735621	6735704	17131	84	411943	2886	394812	2802	203.9404761904762	140.9036402569593
chr19	GPR108	6735907	6735958	14398	52	411943	2886	397545	2834	276.88461538461536	140.2769936485533
chr19	GPR108	6735539	6735704	18439	166	411943	2886	393504	2720	111.07831325301204	144.6705882352941
chr19	SH2D3A	6760637	6760987	0	351	9831	5600	9831	5249	0.0	1.87292817679558
chr19	SH2D3A	6759593	6759670	40	78	9831	5600	9791	5522	0.5128205128205128	1.7730894603404563
chr19	ADGRE4P	6960974	6961041	0	68	80	3337	80	3269	0.0	0.024472315692872438
chr19	INSR	7150496	7150532	0	37	635347	10854	635347	10817	0.0	58.735971156512896
chr19	FCER2	7697012	7697075	0	64	55761	2333	55761	2269	0.0	24.575143234905244
chr19	CLEC4G	7729820	7729936	0	117	71	1553	71	1436	0.0	0.04944289693593315
chr19	CLEC4G	7731025	7731088	0	64	71	1553	71	1489	0.0	0.04768300873069174
chr19	CD209	7744106	7744219	0	114	163105	4420	163105	4306	0.0	37.87854156990246
chr19	AC008763.4	7741566	7741897	0	332	122	4001	122	3669	0.0	0.033251567184518944
chr19	CD209	7746459	7746531	0	73	163105	4420	163105	4347	0.0	37.521279043018176
chr19	CD209	7747305	7747365	33593	61	163105	4420	129512	4359	550.7049180327868	29.711401697637072
chr19	CD209	7744106	7744201	0	96	163105	4420	163105	4324	0.0	37.72086031452359
chr19	TIMM44	7928076	7928166	2055	91	33601	3792	31546	3701	22.582417582417584	8.523642258848959
chr19	TIMM44	7941101	7941197	0	97	33601	3792	33601	3695	0.0	9.0936400541272
chr19	FBN3	8075282	8075411	0	130	4178	10051	4178	9921	0.0	0.4211269025299869
chr19	FBN3	8089893	8089959	0	67	4178	10051	4178	9984	0.0	0.41846955128205127
chr19	FBN3	8097288	8097414	0	127	4178	10051	4178	9924	0.0	0.42099959693671907
chr19	FBN3	8141456	8141582	0	127	4178	10051	4178	9924	0.0	0.42099959693671907
chr19	CD320	8305030	8305156	0	127	827	2284	827	2157	0.0	0.38340287436254056
chr19	NDUFA7	8316495	8316645	0	151	1072	1399	1072	1248	0.0	0.8589743589743589
chr19	NDUFA7	8319300	8319394	0	95	1072	1399	1072	1304	0.0	0.8220858895705522
chr19	KANK3	8334499	8335792	0	1294	1836	3505	1836	2211	0.0	0.830393487109905
chr19	ZNF414	8513028	8513341	1719	314	33583	2689	31864	2375	5.474522292993631	13.416421052631579
chr19	ZNF414	8512074	8512131	0	58	33583	2689	33583	2631	0.0	12.764348156594451
chr19	ADAMTS10	8605622	8605809	1086	188	19837	5729	18751	5541	5.776595744680851	3.3840462010467425
chr19	ADAMTS10	8608133	8608248	0	116	19837	5729	19837	5613	0.0	3.5341172278638875
chr19	MUC16	8865583	8865756	0	174	30241	43914	30241	43740	0.0	0.6913808870598994
chr19	MUC16	8866963	8867014	0	52	30241	43914	30241	43862	0.0	0.6894578450595048
chr19	MUC16	8884958	8885024	0	67	30241	43914	30241	43847	0.0	0.6896937076652907
chr19	ZNF699	9305071	9305124	0	54	4590	6764	4590	6710	0.0	0.684053651266766
chr19	ZNF266	9434797	9434859	0	63	11502	4513	11502	4450	0.0	2.5847191011235955
chr19	ZNF266	9418765	9418895	0	131	11502	4513	11502	4382	0.0	2.6248288452761295
chr19	ZNF266	9434064	9434235	0	172	11502	4513	11502	4341	0.0	2.6496199032480994
chr19	ZNF266	9418761	9418895	0	135	11502	4513	11502	4378	0.0	2.6272270443124714
chr19	ZNF426	9530984	9531067	904	84	443174	7553	442270	7469	10.761904761904763	59.214084884187976
chr19	ZNF426	9533839	9533966	178	128	443174	7553	442996	7425	1.390625	59.66276094276094
chr19	ZNF426	9535187	9535279	136	93	443174	7553	443038	7460	1.4623655913978495	59.38847184986595
chr19	ZNF121	9567647	9567705	0	59	1122	7252	1122	7193	0.0	0.15598498540247463
chr19	ZNF121	9584185	9584348	0	164	1122	7252	1122	7088	0.0	0.15829571106094809
chr19	ZNF561	9617620	9617758	0	139	245	5565	245	5426	0.0	0.0451529671949871
chr19	ZNF561	9614020	9614103	0	84	245	5565	245	5481	0.0	0.04469987228607918
chr19	ZNF561	9617044	9617171	0	128	245	5565	245	5437	0.0	0.045061614861136655
chr19	ZNF561	9618090	9618179	0	90	245	5565	245	5475	0.0	0.04474885844748858
chr19	ZNF561	9618090	9618166	0	77	245	5565	245	5488	0.0	0.044642857142857144
chr19	ZNF561	9617048	9617171	0	124	245	5565	245	5441	0.0	0.0450284874104025
chr19	ZNF561	9617044	9617226	0	183	245	5565	245	5382	0.0	0.04552211073950204
chr19	ZNF561	9620915	9620963	0	49	245	5565	245	5516	0.0	0.044416243654822336
chr19	ZNF561	9617620	9617768	0	149	245	5565	245	5416	0.0	0.045236336779911374
chr19	ZNF561	9620915	9621049	0	135	245	5565	245	5430	0.0	0.04511970534069982
chr19	ZNF562	9656546	9656653	0	108	44416	2122	44416	2014	0.0	22.05362462760675
chr19	ZNF562	9658008	9658135	1428	128	44416	2122	42988	1994	11.15625	21.558676028084253
chr19	ZNF562	9659378	9659467	0	90	44416	2122	44416	2032	0.0	21.858267716535433
chr19	ZNF812P	9700000	9700086	0	87	1279	2311	1279	2224	0.0	0.575089928057554
chr19	ZNF846	9755516	9755634	480	119	77122	3924	76642	3805	4.033613445378151	20.14244415243101
chr19	ZNF846	9759859	9759942	8554	84	77122	3924	68568	3840	101.83333333333333	17.85625
chr19	FBXL12	9813230	9813274	0	45	51	2784	51	2739	0.0	0.018619934282584884
chr19	FBXL12	9818544	9818617	0	74	51	2784	51	2710	0.0	0.018819188191881917
chr19	FBXL12	9814571	9814669	0	99	51	2784	51	2685	0.0	0.01899441340782123
chr19	FBXL12	9814137	9814339	0	203	51	2784	51	2581	0.0	0.0197597830298334
chr19	FBXL12	9814137	9814342	0	206	51	2784	51	2578	0.0	0.01978277734678045
chr19	EIF3G	10117083	10117188	0	106	40	3387	40	3281	0.0	0.0121914050594331
chr19	EIF3G	10118439	10118557	0	119	40	3387	40	3268	0.0	0.012239902080783354
chr19	DNMT1	10134216	10134307	0	92	29804	13688	29804	13596	0.0	2.192115328037658
chr19	DNMT1	10166597	10166685	0	89	29804	13688	29804	13599	0.0	2.1916317376277665
chr19	DNMT1	10180186	10180234	0	49	29804	13688	29804	13639	0.0	2.1852041938558546
chr19	DNMT1	10180349	10180569	0	221	29804	13688	29804	13467	0.0	2.2131135367936436
chr19	DNMT1	10166591	10166685	0	95	29804	13688	29804	13593	0.0	2.192599131906128
chr19	DNMT1	10180349	10180529	0	181	29804	13688	29804	13507	0.0	2.2065595617087435
chr19	DNMT1	10218751	10218869	29211	119	29804	13688	593	13569	245.47058823529412	0.04370255729972732
chr19	DNMT1	10194819	10195054	0	236	29804	13688	29804	13452	0.0	2.215581326196848
chr19	DNMT1	10179880	10179982	0	103	29804	13688	29804	13585	0.0	2.1938903202061097
chr19	RAVER1	10321047	10321259	0	213	6883	4719	6883	4506	0.0	1.5275188637372392
chr19	RAVER1	10330459	10330526	57	68	6883	4719	6826	4651	0.8382352941176471	1.4676413674478608
chr19	ICAM3	10339017	10339245	0	229	11984	2076	11984	1847	0.0	6.488359501894965
chr19	ICAM3	10339061	10339245	0	185	11984	2076	11984	1891	0.0	6.337387625594923
chr19	TYK2	10351051	10351162	0	112	24911	6234	24911	6122	0.0	4.0690950669715775
chr19	TYK2	10353527	10353646	0	120	24911	6234	24911	6114	0.0	4.074419365390906
chr19	TYK2	10364850	10365048	0	199	24911	6234	24911	6035	0.0	4.127754763877382
chr19	TYK2	10360961	10361073	0	113	24911	6234	24911	6121	0.0	4.069759843162882
chr19	TYK2	10369756	10369877	996	122	24911	6234	23915	6112	8.163934426229508	3.912794502617801
chr19	CDC37	10400574	10400693	367	120	767713	3052	767346	2932	3.058333333333333	261.71418826739426
chr19	KEAP1	10489191	10489368	0	178	1410	3562	1410	3384	0.0	0.4166666666666667
chr19	KEAP1	10489647	10489853	0	207	1410	3562	1410	3355	0.0	0.4202682563338301
chr19	KRI1	10558163	10558239	0	77	39030	3939	39030	3862	0.0	10.106162610046608
chr19	KRI1	10562728	10562837	102	110	39030	3939	38928	3829	0.9272727272727272	10.166623139200835
chr19	KRI1	10565716	10565790	0	75	39030	3939	39030	3864	0.0	10.100931677018634
chr19	KRI1	10564928	10565034	315	107	39030	3939	38715	3832	2.94392523364486	10.103079331941546
chr19	KRI1	10562728	10562821	72	94	39030	3939	38958	3845	0.7659574468085106	10.132119635890767
chr19	AP1M2	10574903	10575029	0	127	71883	2145	71883	2018	0.0	35.6209117938553
chr19	AP1M2	10583605	10584070	0	466	71883	2145	71883	1679	0.0	42.81298391899941
chr19	AP1M2	10584969	10585044	0	76	71883	2145	71883	2069	0.0	34.742870952150795
chr19	TMED1	10834933	10835117	176	185	3341	1889	3165	1704	0.9513513513513514	1.857394366197183
chr19	TMED1	10835255	10835353	20	99	3341	1889	3321	1790	0.20202020202020202	1.8553072625698324
chr19	TMED1	10835290	10835353	20	64	3341	1889	3321	1825	0.3125	1.8197260273972602
chr19	TMED1	10834933	10835063	99	131	3341	1889	3242	1758	0.7557251908396947	1.8441410693970421
chr19	YIPF2	10924075	10924192	204	118	96909	2417	96705	2299	1.728813559322034	42.06394084384515
chr19	YIPF2	10927629	10927716	32	88	96909	2417	96877	2329	0.36363636363636365	41.59596393301846
chr19	YIPF2	10928379	10928440	0	62	96909	2417	96909	2355	0.0	41.15031847133758
chr19	KANK2	11169876	11169966	1587	91	19075	7137	17488	7046	17.439560439560438	2.4819755889866593
chr19	KANK2	11196049	11196227	0	179	19075	7137	19075	6958	0.0	2.7414486921529173
chr19	DOCK6	11232184	11232289	0	106	225403	9585	225403	9479	0.0	23.77919611773394
chr19	DOCK6	11229297	11229390	0	94	225403	9585	225403	9491	0.0	23.749130755452533
chr19	TMEM205	11345251	11345415	0	165	18687	1389	18687	1224	0.0	15.267156862745098
chr19	TMEM205	11345519	11345628	0	110	18687	1389	18687	1279	0.0	14.610633307271305
chr19	TMEM205	11345519	11345737	0	219	18687	1389	18687	1170	0.0	15.971794871794872
chr19	EPOR	11382846	11382949	0	104	224	3001	224	2897	0.0	0.07732136693130826
chr19	EPOR	11383430	11383535	0	106	224	3001	224	2895	0.0	0.0773747841105354
chr19	EPOR	11382846	11382982	0	137	224	3001	224	2864	0.0	0.0782122905027933
chr19	RGL3	11405322	11405426	75	105	165	3935	90	3830	0.7142857142857143	0.02349869451697128
chr19	RGL3	11411252	11411444	0	193	165	3935	165	3742	0.0	0.04409406734366649
chr19	CCDC151	11426682	11426784	0	103	55843	2696	55843	2593	0.0	21.536058619359814
chr19	CCDC151	11430698	11430776	0	79	55843	2696	55843	2617	0.0	21.33855559801299
chr19	ZNF653	11485655	11485770	612	116	9765	3095	9153	2979	5.275862068965517	3.0725075528700905
chr19	ZNF653	11500677	11500815	0	139	9765	3095	9765	2956	0.0	3.3034506089309876
chr19	ECSIT	11507701	11507850	0	150	2186	2365	2186	2215	0.0	0.9869074492099322
chr19	ECSIT	11513055	11513279	94	225	2186	2365	2092	2140	0.4177777777777778	0.9775700934579439
chr19	ECSIT	11519074	11519193	0	120	2186	2365	2186	2245	0.0	0.9737193763919821
chr19	ECSIT	11510616	11510660	0	45	2186	2365	2186	2320	0.0	0.9422413793103448
chr19	ECSIT	11507701	11507729	0	29	2186	2365	2186	2336	0.0	0.9357876712328768
chr19	ECSIT	11513055	11513284	94	230	2186	2365	2092	2135	0.40869565217391307	0.9798594847775176
chr19	ECSIT	11525639	11525737	0	99	2186	2365	2186	2266	0.0	0.9646954986760812
chr19	ECSIT	11519843	11519966	0	124	2186	2365	2186	2241	0.0	0.9754573850959393
chr19	ELOF1	11555173	11555253	368	81	1580769	4090	1580401	4009	4.54320987654321	394.2132701421801
chr19	ELOF1	11554819	11554946	682	128	1580769	4090	1580087	3962	5.328125	398.81044926804645
chr19	ACP5	11578584	11578657	0	74	450	2095	450	2021	0.0	0.22266204849084612
chr19	ACP5	11578479	11578657	0	179	450	2095	450	1916	0.0	0.2348643006263048
chr19	ACP5	11578023	11578194	14	172	450	2095	436	1923	0.08139534883720931	0.2267290691627665
chr19	ACP5	11578584	11578764	0	181	450	2095	450	1914	0.0	0.23510971786833856
chr19	ZNF823	11724193	11724254	0	62	9378	2463	9378	2401	0.0	3.9058725531028737
chr19	ZNF823	11725200	11725327	765	128	9378	2463	8613	2335	5.9765625	3.6886509635974303
chr19	ZNF433	12034827	12034874	0	48	13605	3086	13605	3038	0.0	4.478275181040158
chr19	ZNF433	12030139	12030198	0	60	13605	3086	13605	3026	0.0	4.496034368803701
chr19	ZNF433	12021929	12022189	3467	261	13605	3086	10138	2825	13.28352490421456	3.5886725663716814
chr19	ZNF20	12136850	12136876	4	27	27508	4090	27504	4063	0.14814814814814814	6.769382229879399
chr19	ZNF44	12293231	12293375	561	145	20850	6082	20289	5937	3.8689655172413793	3.4173825164224354
chr19	ZNF44	12291219	12291250	0	32	20850	6082	20850	6050	0.0	3.446280991735537
chr19	ZNF563	12324918	12324979	1496	62	3281	1142	1785	1080	24.129032258064516	1.6527777777777777
chr19	ZNF442	12352987	12353114	296	128	42040	6603	41744	6475	2.3125	6.446949806949807
chr19	ZNF799	12398133	12398251	0	119	73717	5061	73717	4942	0.0	14.91643059490085
chr19	ZNF564	12550462	12550652	0	191	8107	3626	8107	3435	0.0	2.3601164483260555
chr19	ZNF564	12541424	12541537	1488	114	8107	3626	6619	3512	13.052631578947368	1.8846810933940774
chr19	ZNF490	12609869	12609974	0	106	15204	6803	15204	6697	0.0	2.27027027027027
chr19	MAN2B1	12658427	12658510	0	84	3872	4627	3872	4543	0.0	0.8523002421307506
chr19	MAN2B1	12664791	12664985	0	195	3872	4627	3872	4432	0.0	0.8736462093862816
chr19	MAN2B1	12665702	12665805	0	104	3872	4627	3872	4523	0.0	0.856068980764979
chr19	MAN2B1	12658427	12658507	0	81	3872	4627	3872	4546	0.0	0.8517377914650242
chr19	MAN2B1	12665702	12665832	0	131	3872	4627	3872	4496	0.0	0.8612099644128114
chr19	DHPS	12677107	12677211	0	105	2510	2991	2510	2886	0.0	0.8697158697158697
chr19	DHPS	12679800	12679922	0	123	2510	2991	2510	2868	0.0	0.8751743375174338
chr19	DHPS	12679800	12680030	0	231	2510	2991	2510	2760	0.0	0.9094202898550725
chr19	FBXW9	12691341	12691454	2600	114	32569	2086	29969	1972	22.80701754385965	15.197261663286005
chr19	FBXW9	12694798	12694938	1	141	32569	2086	32568	1945	0.0070921985815602835	16.74447300771208
chr19	TNPO2	12706009	12706109	533	101	13813	6955	13280	6854	5.2772277227722775	1.9375547125765975
chr19	TRIR	12731343	12731557	0	215	4359	1314	4359	1099	0.0	3.9663330300272976
chr19	TRIR	12731343	12731421	0	79	4359	1314	4359	1235	0.0	3.529554655870445
chr19	HOOK2	12765828	12765834	357	7	352780	5239	352423	5232	51.0	67.35913608562691
chr19	PRDX2	12799858	12799989	5904	132	57102	1852	51198	1720	44.72727272727273	29.766279069767442
chr19	DNASE2	12878669	12878834	7358	166	92872	2394	85514	2228	44.325301204819276	38.381508078994614
chr19	FARSA	12928754	12928847	0	94	95842	2378	95842	2284	0.0	41.962346760070055
chr19	TRMT1	13109914	13110001	0	88	422	3150	422	3062	0.0	0.1378184193337688
chr19	TRMT1	13115625	13115768	0	144	422	3150	422	3006	0.0	0.14038589487691283
chr19	TRMT1	13112704	13112817	0	114	422	3150	422	3036	0.0	0.13899868247694336
chr19	TRMT1	13116145	13116431	0	287	422	3150	422	2863	0.0	0.14739783443939924
chr19	TRMT1	13116105	13116431	0	327	422	3150	422	2823	0.0	0.14948636202621324
chr19	CACNA1A	13210616	13210652	0	37	1097868	33625	1097868	33588	0.0	32.686316541622006
chr19	CACNA1A	13227430	13227527	28778	98	1097868	33625	1069090	33527	293.6530612244898	31.88743400841113
chr19	CACNA1A	13235208	13235274	0	67	1097868	33625	1097868	33558	0.0	32.71553727874129
chr19	CACNA1A	13241520	13241526	0	7	1097868	33625	1097868	33618	0.0	32.6571479564519
chr19	CACNA1A	13228698	13228795	1404	98	1097868	33625	1096464	33527	14.326530612244898	32.70391028126585
chr19	CACNA1A	13230081	13230209	510	129	1097868	33625	1097358	33496	3.953488372093023	32.76086696919035
chr19	CACNA1A	13236448	13236618	1020	171	1097868	33625	1096848	33454	5.964912280701754	32.78675195791236
chr19	C19ORF57	13883307	13883400	424	94	209813	3853	209389	3759	4.51063829787234	55.70337855812716
chr19	C19ORF57	13889187	13890462	31977	1276	209813	3853	177836	2577	25.060344827586206	69.00892510671324
chr19	C19ORF57	13895371	13895546	0	176	209813	3853	209813	3677	0.0	57.060919227631224
chr19	PODNL1	13934253	13934410	12912	158	63023	3221	50111	3063	81.72151898734177	16.360104472739145
chr19	PODNL1	13935979	13936044	0	66	63023	3221	63023	3155	0.0	19.975594294770207
chr19	PODNL1	13934253	13934385	12896	133	63023	3221	50127	3088	96.9624060150376	16.232836787564768
chr19	PODNL1	13935720	13935830	272	111	63023	3221	62751	3110	2.4504504504504503	20.17717041800643
chr19	RFX1	13993524	13993895	11864	372	30936	5497	19072	5125	31.892473118279568	3.721365853658537
chr19	RFX1	13998117	13998317	1764	201	30936	5497	29172	5296	8.776119402985074	5.508308157099698
chr19	C19ORF67	14083732	14083877	2554	146	6163	1541	3609	1395	17.493150684931507	2.587096774193548
chr19	PRKACA	14093627	14093792	0	166	10388	6320	10388	6154	0.0	1.688007799805005
chr19	ASF1B	14121531	14121708	0	178	0	1717	0	1539	0.0	0.0
chr19	ASF1B	14126121	14126237	0	117	0	1717	0	1600	0.0	0.0
chr19	ASF1B	14121531	14121677	0	147	0	1717	0	1570	0.0	0.0
chr19	ADGRL1	14152132	14152150	0	19	53406	8318	53406	8299	0.0	6.435233160621761
chr19	ADGRL1	14160592	14160696	0	105	53406	8318	53406	8213	0.0	6.50261780104712
chr19	ADGRL1	14167015	14167030	0	16	53406	8318	53406	8302	0.0	6.432907733076367
chr19	ADGRL1	14152132	14152222	0	91	53406	8318	53406	8227	0.0	6.49155220615048
chr19	DDX39A	14409535	14409645	0	111	1145	3413	1145	3302	0.0	0.3467595396729255
chr19	DDX39A	14410420	14410605	0	186	1145	3413	1145	3227	0.0	0.3548187170746824
chr19	DDX39A	14410547	14410605	0	59	1145	3413	1145	3354	0.0	0.3413834227787716
chr19	DDX39A	14413979	14414014	0	36	1145	3413	1145	3377	0.0	0.3390583358010068
chr19	DDX39A	14415947	14415988	0	42	1145	3413	1145	3371	0.0	0.33966182141797685
chr19	DDX39A	14416268	14416405	44	138	1145	3413	1101	3275	0.3188405797101449	0.33618320610687025
chr19	GIPC1	14480304	14480485	0	182	447	2445	447	2263	0.0	0.19752540874944763
chr19	GIPC1	14482688	14483006	0	319	447	2445	447	2126	0.0	0.21025399811853246
chr19	GIPC1	14492856	14492912	447	57	447	2445	0	2388	7.842105263157895	0.0
chr19	GIPC1	14491655	14491743	0	89	447	2445	447	2356	0.0	0.1897283531409168
chr19	GIPC1	14483488	14483579	0	92	447	2445	447	2353	0.0	0.18997025074373142
chr19	DNAJB1	14518138	14518268	408	131	141620	7011	141212	6880	3.114503816793893	20.525
chr19	DNAJB1	14516465	14517046	6927	582	141620	7011	134693	6429	11.902061855670103	20.950847721263028
chr19	DNAJB1	14552457	14554318	27481	1862	141620	7011	114139	5149	14.758861439312566	22.167216935327247
chr19	DNAJB1	14526122	14526198	1256	77	141620	7011	140364	6934	16.31168831168831	20.242861263340064
chr19	ADGRE3	14661962	14662118	867	157	199304	2854	198437	2697	5.522292993630574	73.57693733778272
chr19	ADGRE2	14746231	14746323	40	93	6213854	8203	6213814	8110	0.43010752688172044	766.1916152897658
chr19	ADGRE2	14754953	14755127	0	175	6213854	8203	6213854	8028	0.0	774.0226706527155
chr19	ADGRE2	14755653	14755877	0	225	6213854	8203	6213854	7978	0.0	778.8736525444974
chr19	ADGRE2	14766234	14766381	0	148	6213854	8203	6213854	8055	0.0	771.4281812538795
chr19	ADGRE2	14755653	14755844	0	192	6213854	8203	6213854	8011	0.0	775.6652103357883
chr19	ADGRE2	14765657	14765804	0	148	6213854	8203	6213854	8055	0.0	771.4281812538795
chr19	ADGRE2	14766977	14767109	0	133	6213854	8203	6213854	8070	0.0	769.9942998760843
chr19	ADGRE2	14752328	14752526	0	199	6213854	8203	6213854	8004	0.0	776.3435782108945
chr19	OR7C1	14821418	14821485	208	68	6274	12216	6066	12148	3.0588235294117645	0.49934145538360225
chr19	SLC1A6	14956475	14956709	0	235	0	7643	0	7408	0.0	0.0
chr19	SLC1A6	14968302	14968507	0	206	0	7643	0	7437	0.0	0.0
chr19	ILVBL	15123374	15123576	0	203	0	4314	0	4111	0.0	0.0
chr19	ILVBL	15124924	15125069	0	146	0	4314	0	4168	0.0	0.0
chr19	NOTCH3	15165786	15166091	0	306	1726	9441	1726	9135	0.0	0.18894362342638205
chr19	NOTCH3	15184294	15184450	0	157	1726	9441	1726	9284	0.0	0.18591124515295132
chr19	BRD4	15268153	15268281	0	129	23069	13803	23069	13674	0.0	1.6870703524937838
chr19	BRD4	15268153	15268240	0	88	23069	13803	23069	13715	0.0	1.6820269777615748
chr19	BRD4	15275656	15275839	0	184	23069	13803	23069	13619	0.0	1.6938835450473604
chr19	AKAP8	15373785	15374065	845	281	165852	4312	165007	4031	3.00711743772242	40.93450756636071
chr19	AKAP8	15369066	15369224	0	159	165852	4312	165852	4153	0.0	39.93546833614255
chr19	AKAP8L	15404009	15404042	0	34	3971	4512	3971	4478	0.0	0.8867798124162573
chr19	AKAP8L	15398629	15398766	0	138	3971	4512	3971	4374	0.0	0.9078646547782351
chr19	AKAP8L	15403474	15403555	18	82	3971	4512	3953	4430	0.21951219512195122	0.8923250564334085
chr19	AKAP8L	15403657	15403715	0	59	3971	4512	3971	4453	0.0	0.8917583651470918
chr19	AKAP8L	15403652	15403715	0	64	3971	4512	3971	4448	0.0	0.8927607913669064
chr19	AKAP8L	15398629	15398703	0	75	3971	4512	3971	4437	0.0	0.8949740815866577
chr19	WIZ	15428109	15428508	816	400	15669	10053	14853	9653	2.04	1.5386926344141718
chr19	WIZ	15431011	15431182	0	172	15669	10053	15669	9881	0.0	1.5857706709847181
chr19	WIZ	15438577	15440715	3009	2139	15669	10053	12660	7914	1.4067321178120618	1.599696739954511
chr19	WIZ	15429585	15430089	0	505	15669	10053	15669	9548	0.0	1.6410766652702136
chr19	WIZ	15442675	15442748	1	74	15669	10053	15668	9979	0.013513513513513514	1.5700972041286703
chr19	RASAL3	15452044	15452815	0	772	20251	4353	20251	3581	0.0	5.655124266964535
chr19	CLEC4O	15857917	15858068	0	152	0	780	0	628	0.0	0.0
chr19	CYP4F2	15886241	15886308	0	68	0	2924	0	2856	0.0	0.0
chr19	CYP4F2	15895505	15895650	0	146	0	2924	0	2778	0.0	0.0
chr19	CYP4F2	15897413	15897612	0	200	0	2924	0	2724	0.0	0.0
chr19	CYP4F2	15893736	15893881	0	146	0	2924	0	2778	0.0	0.0
chr19	CYP4F11	15924760	15924882	0	123	0	4039	0	3916	0.0	0.0
chr19	CYP4F11	15914601	15914666	0	66	0	4039	0	3973	0.0	0.0
chr19	EPS15L1	16377121	16377254	0	134	59138	8149	59138	8015	0.0	7.37841547099189
chr19	CALR3	16490366	16490570	0	205	6975	1440	6975	1235	0.0	5.647773279352227
chr19	SLC35E1	16555151	16555397	917	247	22256	4652	21339	4405	3.7125506072874495	4.844267877412031
chr19	SLC35E1	16568031	16568169	0	139	22256	4652	22256	4513	0.0	4.931531132284511
chr19	SLC35E1	16565036	16565132	0	97	22256	4652	22256	4555	0.0	4.886059275521405
chr19	SMIM7	16654034	16654125	1227	92	242901	4512	241674	4420	13.33695652173913	54.67737556561086
chr19	SMIM7	16659394	16659447	196	54	242901	4512	242705	4458	3.6296296296296298	54.44257514580529
chr19	AC008764.4	16630467	16630559	16863	93	18478	1192	1615	1099	181.32258064516128	1.4695177434030937
chr19	SMIM7	16647095	16647261	90	167	242901	4512	242811	4345	0.5389221556886228	55.882853855005756
chr19	SMIM7	16652604	16652961	48794	358	242901	4512	194107	4154	136.29608938547486	46.72773230621088
chr19	SMIM7	16659157	16659255	0	99	242901	4512	242901	4413	0.0	55.04214819850442
chr19	SMIM7	16655237	16655368	230	132	242901	4512	242671	4380	1.7424242424242424	55.40433789954338
chr19	CPAMD8	16896455	16896665	0	211	69925	7832	69925	7621	0.0	9.175305078073743
chr19	CPAMD8	16951968	16952200	217	233	69925	7832	69708	7599	0.9313304721030042	9.173312277931307
chr19	HAUS8	17062697	17062779	0	83	0	4402	0	4319	0.0	0.0
chr19	AC020913.1	17157294	17157390	0	97	0	499	0	402	0.0	0.0
chr19	USHBP1	17264001	17264150	0	150	17973	5041	17973	4891	0.0	3.674708648538131
chr19	USHBP1	17258583	17258701	0	119	17973	5041	17973	4922	0.0	3.651564404713531
chr19	ABHD8	17302182	17302232	0	51	10402	2169	10402	2118	0.0	4.91123701605288
chr19	BST2	17404370	17404437	0	68	59043	1106	59043	1038	0.0	56.88150289017341
chr19	UNC13A	17649338	17649344	0	7	241773	11233	241773	11226	0.0	21.536878674505612
chr19	UNC13A	17616407	17616464	1246	58	241773	11233	240527	11175	21.482758620689655	21.52366890380313
chr19	INSL3	17820395	17820490	0	96	0	926	0	830	0.0	0.0
chr19	JAK3	17843776	17843900	916	125	67214	6837	66298	6712	7.328	9.877532777115613
chr19	IL12RB1	18091443	18091545	0	103	0	4312	0	4209	0.0	0.0
chr19	IL12RB1	18090649	18090769	0	121	0	4312	0	4191	0.0	0.0
chr19	RAB3A	18202512	18202740	0	229	27	1791	27	1562	0.0	0.017285531370038413
chr19	RAB3A	18202512	18202855	0	344	27	1791	27	1447	0.0	0.018659295093296474
chr19	PDE4C	18218333	18218498	0	166	5773	6384	5773	6218	0.0	0.9284335799292377
chr19	PDE4C	18220873	18220923	0	51	5773	6384	5773	6333	0.0	0.9115742933838623
chr19	PDE4C	18220402	18220515	0	114	5773	6384	5773	6270	0.0	0.9207336523125996
chr19	PDE4C	18220402	18220769	0	368	5773	6384	5773	6016	0.0	0.9596077127659575
chr19	PDE4C	18220402	18220708	0	307	5773	6384	5773	6077	0.0	0.9499753167681422
chr19	IQCN	18267771	18267967	0	197	91375	7022	91375	6825	0.0	13.388278388278389
chr19	LSM4	18316023	18316065	0	43	96994	2867	96994	2824	0.0	34.346317280453256
chr19	LSM4	18310109	18310214	0	106	96994	2867	96994	2761	0.0	35.13002535313292
chr19	ISYNA1	18436683	18436877	0	195	0	3012	0	2817	0.0	0.0
chr19	ISYNA1	18437598	18437760	0	163	0	3012	0	2849	0.0	0.0
chr19	ISYNA1	18436972	18437105	0	134	0	3012	0	2878	0.0	0.0
chr19	ELL	18470975	18471035	729	61	62414	4932	61685	4871	11.950819672131148	12.663724081297476
chr19	FKBP8	18533269	18533347	10695	79	75043	2467	64348	2388	135.37974683544303	26.946398659966498
chr19	FKBP8	18539550	18539720	1829	171	75043	2467	73214	2296	10.695906432748538	31.887630662020907
chr19	COPE	18903267	18903423	0	157	0	2637	0	2480	0.0	0.0
chr19	COPE	18906959	18907112	0	154	0	2637	0	2483	0.0	0.0
chr19	COPE	18910970	18911071	0	102	0	2637	0	2535	0.0	0.0
chr19	COPE	18905866	18905935	0	70	0	2637	0	2567	0.0	0.0
chr19	HOMER3	18931975	18932132	0	158	153	3433	153	3275	0.0	0.0467175572519084
chr19	HOMER3	18934302	18934410	0	109	153	3433	153	3324	0.0	0.046028880866425995
chr19	HOMER3	18940320	18940404	0	85	153	3433	153	3348	0.0	0.0456989247311828
chr19	SUGP2	18993637	18993740	47	104	278945	6566	278898	6462	0.4519230769230769	43.159702878365835
chr19	SUGP2	18998923	18998985	0	63	278945	6566	278945	6503	0.0	42.89481777641089
chr19	SUGP2	18993647	18993740	37	94	278945	6566	278908	6472	0.39361702127659576	43.09456118665018
chr19	SUGP2	18991339	18991553	435	215	278945	6566	278510	6351	2.0232558139534884	43.85293654542592
chr19	SUGP2	19030950	19031082	306	133	278945	6566	278639	6433	2.300751879699248	43.31400590704182
chr19	SUGP2	19003495	19003608	0	114	278945	6566	278945	6452	0.0	43.23388096714197
chr19	SUGP2	19007346	19007447	0	102	278945	6566	278945	6464	0.0	43.15362004950495
chr19	TMEM161A	19121307	19121421	0	115	230239	3291	230239	3176	0.0	72.49338790931989
chr19	TMEM161A	19134783	19134887	0	105	230239	3291	230239	3186	0.0	72.26585059635907
chr19	TMEM161A	19121317	19121421	0	105	230239	3291	230239	3186	0.0	72.26585059635907
chr19	TMEM161A	19134783	19134916	0	134	230239	3291	230239	3157	0.0	72.92968007602154
chr19	MEF2B	19146272	19146384	33	113	4822	2099	4789	1986	0.2920353982300885	2.4113796576032227
chr19	MEF2B	19146741	19146875	46	135	4822	2099	4776	1964	0.34074074074074073	2.4317718940936865
chr19	BORCS8-MEF2B	19180685	19180761	0	77	4478	1944	4478	1867	0.0	2.39850026780932
chr19	MEF2B	19146272	19146405	54	134	4822	2099	4768	1965	0.40298507462686567	2.4264631043256997
chr19	BORCS8-MEF2B	19157215	19157283	0	69	4478	1944	4478	1875	0.0	2.3882666666666665
chr19	NR2C2AP	19202469	19202575	0	107	306	1637	306	1530	0.0	0.2
chr19	TM6SF2	19268629	19268754	0	126	2483	1794	2483	1668	0.0	1.4886091127098322
chr19	SUGP1	19302264	19302443	0	180	43067	4861	43067	4681	0.0	9.200384533219397
chr19	SUGP1	19302264	19302388	0	125	43067	4861	43067	4736	0.0	9.09353885135135
chr19	SUGP1	19303723	19303847	25107	125	43067	4861	17960	4736	200.856	3.79222972972973
chr19	SUGP1	19310096	19310200	157	105	43067	4861	42910	4756	1.4952380952380953	9.02228763666947
chr19	SUGP1	19316421	19316593	0	173	43067	4861	43067	4688	0.0	9.186646757679181
chr19	SUGP1	19303723	19304043	34063	321	43067	4861	9004	4540	106.11526479750779	1.983259911894273
chr19	SUGP1	19316421	19316522	0	102	43067	4861	43067	4759	0.0	9.049590250052532
chr19	SUGP1	19316246	19316593	0	348	43067	4861	43067	4513	0.0	9.542876135608243
chr19	LPAR2	19627753	19627969	561	217	139691	2979	139130	2762	2.585253456221198	50.372918175235334
chr19	GMIP	19634506	19634703	0	198	72535	3751	72535	3553	0.0	20.415142133408388
chr19	GMIP	19635643	19635721	96	79	72535	3751	72439	3672	1.2151898734177216	19.72739651416122
chr19	GMIP	19640295	19640360	1154	66	72535	3751	71381	3685	17.484848484848484	19.370691994572592
chr19	GMIP	19643099	19643227	2711	129	72535	3751	69824	3622	21.015503875968992	19.277747101049144
chr19	LINC00663	19761325	19761421	1061	97	167324	1894	166263	1797	10.938144329896907	92.52253756260434
chr19	LINC00663	19761256	19761421	1942	166	167324	1894	165382	1728	11.698795180722891	95.70717592592592
chr19	LINC00663	19761203	19761421	2460	219	167324	1894	164864	1675	11.232876712328768	98.42626865671642
chr19	ZNF506	19793833	19795660	32926	1828	99417	6969	66491	5141	18.01203501094092	12.933475977436297
chr19	ZNF506	19806030	19806126	0	97	99417	6969	99417	6872	0.0	14.46696740395809
chr19	ZNF506	19806941	19807068	0	128	99417	6969	99417	6841	0.0	14.532524484724455
chr19	ZNF682	20015773	20015837	134	65	25290	2583	25156	2518	2.0615384615384613	9.990468625893566
chr19	ZNF682	20015174	20015266	0	93	25290	2583	25290	2490	0.0	10.156626506024097
chr19	ZNF826P	20406008	20406132	0	125	918	6017	918	5892	0.0	0.15580448065173116
chr19	ZNF737	20553708	20553835	0	128	0	2358	0	2230	0.0	0.0
chr19	ZNF737	20564040	20564138	0	99	0	2358	0	2259	0.0	0.0
chr19	ZNF708	21310500	21310627	0	128	44676	4331	44676	4203	0.0	10.629550321199144
chr19	ZNF708	21327959	21328141	51	183	44676	4331	44625	4148	0.2786885245901639	10.758196721311476
chr19	ZNF708	21306817	21306941	4303	125	44676	4331	40373	4206	34.424	9.598906324298621
chr19	AC010615.2	21456460	21456588	371	129	17385	4522	17014	4393	2.875968992248062	3.872979740496244
chr19	ZNF100	21746815	21746889	0	75	1683	2806	1683	2731	0.0	0.6162577810325888
chr19	ZNF43	21819094	21819221	0	128	1091	8432	1091	8304	0.0	0.1313824662813102
chr19	ZNF43	21850937	21851027	0	91	1091	8432	1091	8341	0.0	0.13079966430883588
chr19	ZNF43	21850937	21851162	0	226	1091	8432	1091	8206	0.0	0.13295149890324154
chr19	ZNF208	22009487	22009581	1351	95	7835	6782	6484	6687	14.221052631578948	0.9696425901001944
chr19	ZNF208	21991438	21991737	1690	300	7835	6782	6145	6482	5.633333333333334	0.9480098734958347
chr19	AC003973.1	22022471	22022599	16447	129	100872	5670	84425	5541	127.49612403100775	15.236419418877459
chr19	AC003973.1	22034880	22034998	0	119	100872	5670	100872	5551	0.0	18.171860925959287
chr19	AC003973.1	22034672	22034797	2890	126	100872	5670	97982	5544	22.936507936507937	17.673520923520922
chr19	AC003973.1	22035550	22035702	0	153	100872	5670	100872	5517	0.0	18.28384991843393
chr19	AC003973.1	22035550	22035659	0	110	100872	5670	100872	5560	0.0	18.142446043165467
chr19	AC003973.1	22037414	22037518	0	105	100872	5670	100872	5565	0.0	18.126145552560647
chr19	LINC01785	22619577	22619715	0	139	51	1717	51	1578	0.0	0.03231939163498099
chr19	ZNF728	22985654	22985831	1	178	1	2782	0	2604	0.0056179775280898875	0.0
chr19	LINC01859	23015449	23015569	0	121	102	3966	102	3845	0.0	0.026527958387516256
chr19	LINC01858	23058464	23058579	0	116	102	3187	102	3071	0.0	0.03321393682839466
chr19	AC092329.4	23270217	23270292	0	76	51	4965	51	4889	0.0	0.010431581100429535
chr19	ZNF724	23242588	23242710	0	123	0	3331	0	3208	0.0	0.0
chr19	AC092329.4	23272618	23272723	0	106	51	4965	51	4859	0.0	0.010495986828565548
chr19	AC092329.4	23272618	23272719	0	102	51	4965	51	4863	0.0	0.010487353485502776
chr19	ZNF91	23307315	23307402	0	88	1785	7683	1785	7595	0.0	0.2350230414746544
chr19	ZNF91	23373741	23373837	0	97	1785	7683	1785	7586	0.0	0.2353018718692328
chr19	ZNF91	23374637	23374764	0	128	1785	7683	1785	7555	0.0	0.23626737260092653
chr19	LINC01224	23405257	23405335	2409	79	48072	3998	45663	3919	30.49367088607595	11.651696861444245
chr19	LINC01224	23402176	23402512	1155	337	48072	3998	46917	3661	3.427299703264095	12.815350996995356
chr19	LINC01224	23404950	23405108	3515	159	48072	3998	44557	3839	22.10691823899371	11.606407918728836
chr19	ZNF675	23656721	23656822	0	102	13327	4781	13327	4679	0.0	2.8482581748236804
chr19	ZNF681	23755424	23755551	0	128	71489	6501	71489	6373	0.0	11.21747999372352
chr19	LINC00662	27686871	27686998	0	128	255	28747	255	28619	0.0	0.008910164575980992
chr19	LINC00662	27684694	27685275	0	582	255	28747	255	28165	0.0	0.009053790165098526
chr19	LINC00662	27685056	27685275	0	220	255	28747	255	28527	0.0	0.008938899989483646
chr19	LINC00662	27732795	27732967	0	173	255	28747	255	28574	0.0	0.008924196822285995
chr19	LINC00662	27727816	27727979	0	164	255	28747	255	28583	0.0	0.008921386838330476
chr19	LINC00662	27746097	27746340	0	244	255	28747	255	28503	0.0	0.008946426691927165
chr19	LINC00662	27778710	27779043	0	334	255	28747	255	28413	0.0	0.008974765072326049
chr19	LINC00662	27739568	27739716	0	149	255	28747	255	28598	0.0	0.008916707462060284
chr19	LINC00662	27771663	27771989	204	327	255	28747	51	28420	0.6238532110091743	0.0017945109078114005
chr19	LINC00662	27771543	27771989	204	447	255	28747	51	28300	0.4563758389261745	0.0018021201413427562
chr19	LINC00662	27775792	27775906	0	115	255	28747	255	28632	0.0	0.008906119027661358
chr19	AC005381.1	28461286	28461497	0	212	0	1279	0	1067	0.0	0.0
chr19	AC005381.1	28453843	28453935	0	93	0	1279	0	1186	0.0	0.0
chr19	C19ORF12	29708253	29708423	0	171	5173	2513	5173	2342	0.0	2.208795900939368
chr19	C19ORF12	29705273	29705394	0	122	5173	2513	5173	2391	0.0	2.163529903805939
chr19	LINC01837	31887754	31887926	0	173	1692	7200	1692	7027	0.0	0.24078554148285186
chr19	LINC01837	31941620	31941662	0	43	1692	7200	1692	7157	0.0	0.23641190442923013
chr19	LINC01837	31942309	31942447	0	139	1692	7200	1692	7061	0.0	0.23962611528112165
chr19	LINC01837	31922728	31922910	0	183	1692	7200	1692	7017	0.0	0.24112868747327917
chr19	LINC01837	31930851	31930946	0	96	1692	7200	1692	7104	0.0	0.23817567567567569
chr19	LINC01837	31859871	31859943	0	73	1692	7200	1692	7127	0.0	0.23740704363687387
chr19	LINC01837	31908195	31908294	0	100	1692	7200	1692	7100	0.0	0.23830985915492958
chr19	LINC01837	31930287	31930421	0	135	1692	7200	1692	7065	0.0	0.2394904458598726
chr19	LINC01837	32010423	32010556	0	134	1692	7200	1692	7066	0.0	0.2394565525049533
chr19	LINC01837	31976726	31976973	102	248	1692	7200	1590	6952	0.4112903225806452	0.22871116225546606
chr19	ANKRD27	32642023	32642145	0	123	78	7660	78	7537	0.0	0.010348945203661935
chr19	ANKRD27	32643430	32643484	0	55	78	7660	78	7605	0.0	0.010256410256410256
chr19	ANKRD27	32646458	32646615	0	158	78	7660	78	7502	0.0	0.01039722740602506
chr19	ANKRD27	32658913	32659045	0	133	78	7660	78	7527	0.0	0.010362694300518135
chr19	SLC7A9	32843854	32843951	2272	98	3219	2601	947	2503	23.183673469387756	0.37834598481821813
chr19	SLC7A9	32864628	32864776	252	149	3219	2601	2967	2452	1.691275167785235	1.2100326264274062
chr19	CEP89	32923438	32923542	0	105	21700	4642	21700	4537	0.0	4.7828961869076485
chr19	CEP89	32937012	32937120	0	109	21700	4642	21700	4533	0.0	4.787116699757335
chr19	RHPN2	33011678	33011803	0	126	67	4821	67	4695	0.0	0.014270500532481363
chr19	RHPN2	33021570	33021646	0	77	67	4821	67	4744	0.0	0.01412310286677909
chr19	SLC7A10	33210801	33210898	0	98	768	2710	768	2612	0.0	0.29402756508422667
chr19	SLC7A10	33215768	33215973	0	206	768	2710	768	2504	0.0	0.30670926517571884
chr19	PEPD	33500937	33501001	0	65	23588	4498	23588	4433	0.0	5.321001579066095
chr19	PEPD	33396089	33396155	0	67	23588	4498	23588	4431	0.0	5.323403294967276
chr19	PEPD	33387654	33387744	0	91	23588	4498	23588	4407	0.0	5.3523939187656
chr19	PEPD	33477079	33477299	0	221	23588	4498	23588	4277	0.0	5.515080664016835
chr19	ZNF599	34772335	34772473	0	139	11872	6455	11872	6316	0.0	1.8796706776440786
chr19	LINC01801	34829163	34829253	0	91	59823	2628	59823	2537	0.0	23.580212849822626
chr19	AC008555.4	34850668	34850794	388	127	2601	1105	2213	978	3.0551181102362204	2.2627811860940694
chr19	LINC00904	34904150	34904752	29219	603	205839	3576	176620	2973	48.456053067993366	59.40800538176926
chr19	LINC00904	34904658	34904752	23906	95	205839	3576	181933	3481	251.6421052631579	52.26457914392416
chr19	LINC00904	34897534	34897610	0	77	205839	3576	205839	3499	0.0	58.82795084309803
chr19	HPN-AS1	35099204	35099387	26	184	26	4733	0	4549	0.14130434782608695	0.0
chr19	KRTDAP	35488661	35488703	0	43	6190	668	6190	625	0.0	9.904
chr19	DMKN	35498873	35498897	0	25	193822	4934	193822	4909	0.0	39.482990425748625
chr19	DMKN	35497646	35497681	54	36	193822	4934	193768	4898	1.5	39.56063699469171
chr19	DMKN	35500377	35500419	0	43	193822	4934	193822	4891	0.0	39.628296871805354
chr19	DMKN	35502829	35502886	1664	58	193822	4934	192158	4876	28.689655172413794	39.40894175553733
chr19	DMKN	35507457	35507511	0	55	193822	4934	193822	4879	0.0	39.725763476122154
chr19	DMKN	35505938	35505986	352	49	193822	4934	193470	4885	7.183673469387755	39.60491299897646
chr19	DMKN	35509910	35509961	0	52	193822	4934	193822	4882	0.0	39.70135190495699
chr19	DMKN	35511410	35511593	153	184	193822	4934	193669	4750	0.8315217391304348	40.77242105263158
chr19	DMKN	35502135	35502183	393	49	193822	4934	193429	4885	8.020408163265307	39.59651995905834
chr19	DMKN	35508204	35508240	892	37	193822	4934	192930	4897	24.10810810810811	39.397590361445786
chr19	DMKN	35506125	35506185	46	61	193822	4934	193776	4873	0.7540983606557377	39.76523702031603
chr19	DMKN	35505938	35506049	352	112	193822	4934	193470	4822	3.142857142857143	40.12235586893405
chr19	DMKN	35506509	35506665	642	157	193822	4934	193180	4777	4.089171974522293	40.43960644756123
chr19	SBSN	35526643	35526877	2590	235	8660	962	6070	727	11.02127659574468	8.349381017881706
chr19	ATP4A	35555165	35555334	0	170	153	3922	153	3752	0.0	0.04077825159914712
chr19	ATP4A	35556912	35557088	0	177	153	3922	153	3745	0.0	0.04085447263017356
chr19	IGFLR1	35739709	35739769	38	61	6404	1961	6366	1900	0.6229508196721312	3.3505263157894736
chr19	U2AF1L4	35744625	35744738	0	114	102	2606	102	2492	0.0	0.040930979133226325
chr19	U2AF1L4	35745124	35745212	0	89	102	2606	102	2517	0.0	0.04052443384982122
chr19	U2AF1L4	35744490	35744540	0	51	102	2606	102	2555	0.0	0.039921722113502936
chr19	U2AF1L4	35744625	35744692	0	68	102	2606	102	2538	0.0	0.04018912529550828
chr19	U2AF1L4	35743154	35743345	0	192	102	2606	102	2414	0.0	0.04225352112676056
chr19	U2AF1L4	35745124	35745187	0	64	102	2606	102	2542	0.0	0.04012588512981904
chr19	LINC01529	35791016	35791138	0	123	12	4162	12	4039	0.0	0.0029710324337707352
chr19	LINC01529	35791016	35791353	0	338	12	4162	12	3824	0.0	0.0031380753138075313
chr19	PRODH2	35802190	35802276	0	87	0	2577	0	2490	0.0	0.0
chr19	NPHS1	35831642	35831762	0	121	102	6717	102	6596	0.0	0.015463917525773196
chr19	NFKBID	35890577	35890696	0	120	0	2959	0	2839	0.0	0.0
chr19	NFKBID	35897650	35897856	0	207	0	2959	0	2752	0.0	0.0
chr19	TYROBP	35907729	35907762	0	34	0	910	0	876	0.0	0.0
chr19	SYNE4	36005332	36005437	0	106	1088	2554	1088	2448	0.0	0.4444444444444444
chr19	SYNE4	36003612	36003671	0	60	1088	2554	1088	2494	0.0	0.4362469927826784
chr19	SYNE4	36006422	36006671	9	250	1088	2554	1079	2304	0.036	0.4683159722222222
chr19	ALKBH6	36013020	36013089	0	70	408	2256	408	2186	0.0	0.18664226898444647
chr19	ALKBH6	36013343	36013422	0	80	408	2256	408	2176	0.0	0.1875
chr19	ALKBH6	36010893	36011065	0	173	408	2256	408	2083	0.0	0.1958713394143063
chr19	ALKBH6	36010893	36011077	0	185	408	2256	408	2071	0.0	0.1970062771607919
chr19	ALKBH6	36010893	36011045	0	153	408	2256	408	2103	0.0	0.19400855920114124
chr19	ALKBH6	36013513	36013588	0	76	408	2256	408	2180	0.0	0.1871559633027523
chr19	ALKBH6	36013327	36013422	0	96	408	2256	408	2160	0.0	0.18888888888888888
chr19	THAP8	36039943	36040136	0	194	83618	1807	83618	1613	0.0	51.840049597024176
chr19	POLR2I	36114658	36114713	2877	56	58282	1141	55405	1085	51.375	51.064516129032256
chr19	ZNF565	36201976	36202050	0	75	28081	3747	28081	3672	0.0	7.647331154684096
chr19	LINC00665	36322129	36322225	0	97	75161	10527	75161	10430	0.0	7.206232023010546
chr19	LINC00665	36316177	36316348	0	172	75161	10527	75161	10355	0.0	7.258425881216803
chr19	LINC00665	36316177	36316257	0	81	75161	10527	75161	10446	0.0	7.195194332758951
chr19	LINC00665	36322129	36322384	0	256	75161	10527	75161	10271	0.0	7.317787946645896
chr19	LINC00665	36322129	36322222	0	94	75161	10527	75161	10433	0.0	7.2041598773123745
chr19	LINC00665	36326289	36327225	51	937	75161	10527	75110	9590	0.054429028815368194	7.8321167883211675
chr19	LINC00665	36326052	36327225	51	1174	75161	10527	75110	9353	0.0434412265758092	8.030578424035069
chr19	LINC00665	36326481	36327225	51	745	75161	10527	75110	9782	0.06845637583892618	7.678388877530158
chr19	ZNF260	36518029	36518143	19652	115	77322	5512	57670	5397	170.88695652173914	10.68556605521586
chr19	ZNF260	36517285	36517393	462	109	77322	5512	76860	5403	4.238532110091743	14.225430316490838
chr19	ZNF529	36551876	36551977	42	102	158091	4665	158049	4563	0.4117647058823529	34.6370808678501
chr19	ZNF529	36572332	36572392	4606	61	158091	4665	153485	4604	75.50819672131148	33.337315377932235
chr19	ZNF529	36556103	36556197	816	95	158091	4665	157275	4570	8.589473684210526	34.41466083150985
chr19	ZNF461	36643793	36643862	240	70	20395	2885	20155	2815	3.4285714285714284	7.159857904085258
chr19	ZNF461	36658298	36658425	0	128	20395	2885	20395	2757	0.0	7.39753355096119
chr19	ZNF461	36658335	36658425	0	91	20395	2885	20395	2794	0.0	7.299570508231926
chr19	ZNF461	36657652	36657750	0	99	20395	2885	20395	2786	0.0	7.320531227566404
chr19	ZNF461	36658298	36658446	0	149	20395	2885	20395	2736	0.0	7.454312865497076
chr19	ZNF850	36761642	36761738	102	97	34991	7856	34889	7759	1.0515463917525774	4.496584611418998
chr19	ZNF585A	37150834	37150879	216	46	14187	5475	13971	5429	4.695652173913044	2.5734020998342237
chr19	ZNF585A	37165594	37165696	38	103	14187	5475	14149	5372	0.36893203883495146	2.633842144452718
chr19	ZNF585B	37198938	37199054	0	117	6109	4304	6109	4187	0.0	1.459039885359446
chr19	ZNF585B	37207039	37207254	0	216	6109	4304	6109	4088	0.0	1.4943737769080234
chr19	ZNF585B	37195880	37196019	0	140	6109	4304	6109	4164	0.0	1.4670989433237271
chr19	ZNF585B	37199399	37199497	0	99	6109	4304	6109	4205	0.0	1.452794292508918
chr19	AC016590.1	37267217	37267611	778	395	25837	2744	25059	2349	1.969620253164557	10.66794380587484
chr19	AC016590.1	37267217	37267799	2984	583	25837	2744	22853	2161	5.1183533447684395	10.575196668209163
chr19	ZNF569	37454833	37455073	0	241	25477	5026	25477	4785	0.0	5.324346917450366
chr19	ZNF569	37466738	37466804	0	67	25477	5026	25477	4959	0.0	5.137527727364388
chr19	ZNF793-AS1	37498023	37498183	0	161	3475	1411	3475	1250	0.0	2.78
chr19	ZNF571	37594219	37594319	0	101	21688	6081	21688	5980	0.0	3.6267558528428094
chr19	ZNF607	37707913	37708009	0	97	33396	4710	33396	4613	0.0	7.239540429221765
chr19	ZNF607	37707913	37708012	0	100	33396	4710	33396	4610	0.0	7.2442516268980475
chr19	ZNF607	37706381	37706583	0	203	33396	4710	33396	4507	0.0	7.409806966940315
chr19	ZNF573	37772937	37772982	0	46	65043	2912	65043	2866	0.0	22.6946964410328
chr19	ZNF573	37770004	37770097	0	94	65043	2912	65043	2818	0.0	23.08126330731015
chr19	ZNF573	37771563	37771696	0	134	65043	2912	65043	2778	0.0	23.413606911447083
chr19	ZNF573	37773660	37773751	0	92	65043	2912	65043	2820	0.0	23.064893617021276
chr19	ZNF573	37770406	37770597	0	192	65043	2912	65043	2720	0.0	23.912867647058825
chr19	ZNF573	37740640	37740710	0	71	65043	2912	65043	2841	0.0	22.89440337909187
chr19	ZNF573	37771563	37771690	0	128	65043	2912	65043	2784	0.0	23.36314655172414
chr19	ZNF573	37778432	37778546	50	115	65043	2912	64993	2797	0.43478260869565216	23.23668215945656
chr19	DPF1	38216352	38216403	0	52	42124	4499	42124	4447	0.0	9.472453339329885
chr19	DPF1	38217459	38217591	11	133	42124	4499	42113	4366	0.08270676691729323	9.645671094823637
chr19	PPP1R14A	38252893	38252974	12	82	1070	1446	1058	1364	0.14634146341463414	0.7756598240469208
chr19	YIF1B	38307596	38307752	1091	157	12321	4073	11230	3916	6.949044585987261	2.8677221654749743
chr19	YIF1B	38309223	38309328	64	106	12321	4073	12257	3967	0.6037735849056604	3.0897403579531133
chr19	YIF1B	38306913	38306990	0	78	12321	4073	12321	3995	0.0	3.084105131414268
chr19	GGN	38385646	38387014	51	1369	51	2303	0	934	0.03725346968590212	0.0
chr19	RASGRP4	38414847	38415123	51	277	4005	4074	3954	3797	0.18411552346570398	1.0413484329734
chr19	RASGRP4	38414847	38414916	20	70	4005	4074	3985	4004	0.2857142857142857	0.9952547452547452
chr19	MAP4K1	38589177	38589275	0	99	23888	3852	23888	3753	0.0	6.365041300293099
chr19	MAP4K1	38599924	38599985	136	62	23888	3852	23752	3790	2.193548387096774	6.267018469656992
chr19	CAPN12	38733702	38733781	0	80	198	4591	198	4511	0.0	0.04389270671691421
chr19	CAPN12	38734812	38734870	0	59	198	4591	198	4532	0.0	0.043689320388349516
chr19	CAPN12	38734141	38734204	0	64	198	4591	198	4527	0.0	0.0437375745526839
chr19	CAPN12	38734318	38734389	0	72	198	4591	198	4519	0.0	0.04381500331931843
chr19	LGALS4	38803741	38803780	0	40	5088	1410	5088	1370	0.0	3.713868613138686
chr19	LGALS4	38808743	38808948	0	206	5088	1410	5088	1204	0.0	4.225913621262459
chr19	ECH1	38816283	38816355	0	73	5430	2085	5430	2012	0.0	2.698807157057654
chr19	ECH1	38831308	38831516	0	209	5430	2085	5430	1876	0.0	2.894456289978678
chr19	HNRNPL	38841612	38841682	0	71	391	5612	391	5541	0.0	0.07056487998556217
chr19	RINL	38873885	38873988	115747	104	536345	3567	420598	3463	1112.951923076923	121.45480796996823
chr19	SIRT2	38898378	38898425	0	48	34903	4562	34903	4514	0.0	7.73216659282233
chr19	SIRT2	38898793	38898918	1785	126	34903	4562	33118	4436	14.166666666666666	7.465734896302975
chr19	SIRT2	38889253	38889323	1303	71	34903	4562	33600	4491	18.35211267605634	7.481629926519706
chr19	SIRT2	38890564	38890662	0	99	34903	4562	34903	4463	0.0	7.820524311001568
chr19	SIRT2	38891793	38891966	357	174	34903	4562	34546	4388	2.0517241379310347	7.872835004557885
chr19	SARS2	38920085	38920149	0	65	2	2934	2	2869	0.0	0.0006971070059254096
chr19	SARS2	38922001	38922078	0	78	2	2934	2	2856	0.0	0.0007002801120448179
chr19	SARS2	38928268	38928350	0	83	2	2934	2	2851	0.0	0.0007015082427218519
chr19	IFNL4	39247707	39247851	0	145	0	1842	0	1697	0.0	0.0
chr19	IFNL4	39247923	39247995	0	73	0	1842	0	1769	0.0	0.0
chr19	GMFG	39329543	39329626	490105	84	698429	1395	208324	1311	5834.583333333333	158.90465293668956
chr19	GMFG	39335260	39335310	2111	51	698429	1395	696318	1344	41.3921568627451	518.09375
chr19	GMFG	39329547	39329626	485215	80	698429	1395	213214	1315	6065.1875	162.13992395437262
chr19	GMFG	39335434	39335531	1061	98	698429	1395	697368	1297	10.826530612244898	537.6777178103315
chr19	GMFG	39333076	39333126	5129	51	698429	1395	693300	1344	100.56862745098039	515.8482142857143
chr19	GMFG	39335434	39335554	1168	121	698429	1395	697261	1274	9.652892561983471	547.3006279434851
chr19	PAF1	39389639	39389761	6322	123	112307	2637	105985	2514	51.39837398373984	42.15791567223548
chr19	PAF1	39390259	39390289	2044	31	112307	2637	110263	2606	65.93548387096774	42.31120491174213
chr19	PAF1	39387158	39387227	3582	70	112307	2637	108725	2567	51.17142857142857	42.35488897545773
chr19	DYRK1B	39826951	39826987	0	37	2488	3204	2488	3167	0.0	0.7856015156299337
chr19	FBL	39840232	39840327	3654	96	35643	2147	31989	2051	38.0625	15.596782057532911
chr19	FBL	39840616	39840787	7701	172	35643	2147	27942	1975	44.77325581395349	14.147848101265822
chr19	FBL	39840619	39840787	7617	169	35643	2147	28026	1978	45.071005917159766	14.168857431749242
chr19	FBL	39840655	39840787	6254	133	35643	2147	29389	2014	47.02255639097744	14.592353525322741
chr19	ZNF780B	40048917	40049056	0	140	227315	9246	227315	9106	0.0	24.963211069624425
chr19	ZNF780B	40055415	40055576	0	162	227315	9246	227315	9084	0.0	25.02366798767063
chr19	ZNF780A	40090165	40090235	0	71	0	5940	0	5869	0.0	0.0
chr19	ZNF780A	40089259	40089414	0	156	0	5940	0	5784	0.0	0.0
chr19	CCNP	40224721	40224811	0	91	51	2051	51	1960	0.0	0.026020408163265306
chr19	AKT2	40236256	40236385	0	130	102	12439	102	12309	0.0	0.008286619546673165
chr19	AKT2	40240044	40240110	0	67	102	12439	102	12372	0.0	0.008244422890397672
chr19	AKT2	40265221	40265351	0	131	102	12439	102	12308	0.0	0.008287292817679558
chr19	AKT2	40265258	40265351	0	94	102	12439	102	12345	0.0	0.008262454434993925
chr19	AKT2	40234448	40234571	0	124	102	12439	102	12315	0.0	0.008282582216808769
chr19	AKT2	40240044	40240121	0	78	102	12439	102	12361	0.0	0.008251759566378124
chr19	AKT2	40244318	40244414	0	97	102	12439	102	12342	0.0	0.008264462809917356
chr19	AKT2	40282216	40282304	0	89	102	12439	102	12350	0.0	0.00825910931174089
chr19	C19ORF47	40341838	40341890	0	53	253999	2632	253999	2579	0.0	98.48739821636293
chr19	C19ORF47	40332521	40332643	372	123	253999	2632	253627	2509	3.024390243902439	101.0868872060582
chr19	C19ORF47	40334834	40334904	350	71	253999	2632	253649	2561	4.929577464788732	99.04295197188598
chr19	PRX	40398619	40398816	0	198	0	6803	0	6605	0.0	0.0
chr19	PRX	40408157	40408256	0	100	0	6803	0	6703	0.0	0.0
chr19	PRX	40408339	40408383	0	45	0	6803	0	6758	0.0	0.0
chr19	PRX	40398113	40398259	0	147	0	6803	0	6656	0.0	0.0
chr19	SERTAD3	40442322	40442515	0	194	56	1709	56	1515	0.0	0.036963696369636964
chr19	BLVRB	40451363	40451492	1828	130	5655	1617	3827	1487	14.061538461538461	2.573638197713517
chr19	NUMBL	40686910	40686995	51	86	400	5408	349	5322	0.5930232558139535	0.06557685080796694
chr19	COQ8B	40703714	40703855	0	142	37112	11023	37112	10881	0.0	3.410715926844959
chr19	COQ8B	40705324	40705447	49	124	37112	11023	37063	10899	0.3951612903225806	3.4005872098357646
chr19	COQ8B	40710058	40710136	82	79	37112	11023	37030	10944	1.0379746835443038	3.3835891812865495
chr19	COQ8B	40714066	40714133	0	68	37112	11023	37112	10955	0.0	3.3876768598813327
chr19	COQ8B	40714530	40714635	1545	106	37112	11023	35567	10917	14.575471698113208	3.2579463222497025
chr19	COQ8B	40713739	40713869	351	131	37112	11023	36761	10892	2.6793893129770994	3.375045905251561
chr19	COQ8B	40705349	40705447	49	99	37112	11023	37063	10924	0.494949494949495	3.392804833394361
chr19	COQ8B	40716586	40716703	670	118	37112	11023	36442	10905	5.677966101694915	3.341769830353049
chr19	COQ8B	40705095	40705447	4218	353	37112	11023	32894	10670	11.94900849858357	3.0828491096532336
chr19	COQ8B	40714066	40714153	0	88	37112	11023	37112	10935	0.0	3.39387288523091
chr19	CYP2A6	40849817	40849980	0	164	4995	2222	4995	2058	0.0	2.427113702623907
chr19	CYP2A7	40881588	40881751	867	164	538947	2583	538080	2419	5.286585365853658	222.4390243902439
chr19	TGFB1	41341882	41342030	408	149	3718	3272	3310	3123	2.738255033557047	1.0598783221261607
chr19	TGFB1	41342169	41342247	0	79	3718	3272	3718	3193	0.0	1.1644221735045412
chr19	B9D2	41362982	41363077	102	96	690	1486	588	1390	1.0625	0.42302158273381296
chr19	EXOSC5	41392866	41392980	0	115	0	1373	0	1258	0.0	0.0
chr19	EXOSC5	41392080	41392146	0	67	0	1373	0	1306	0.0	0.0
chr19	DMAC2	41433271	41433434	0	164	102	2624	102	2460	0.0	0.041463414634146344
chr19	DMAC2	41436391	41436472	0	82	102	2624	102	2542	0.0	0.04012588512981904
chr19	DMAC2	41438217	41438414	0	198	102	2624	102	2426	0.0	0.04204451772464963
chr19	PCAT19	41479080	41479284	0	205	152	5541	152	5336	0.0	0.02848575712143928
chr19	PCAT19	41494539	41495427	0	889	152	5541	152	4652	0.0	0.03267411865864144
chr19	PCAT19	41456615	41456918	0	304	152	5541	152	5237	0.0	0.029024250525109797
chr19	PCAT19	41474465	41474539	0	75	152	5541	152	5466	0.0	0.027808269301134284
chr19	PCAT19	41494539	41494648	0	110	152	5541	152	5431	0.0	0.027987479285582765
chr19	PCAT19	41495301	41495427	0	127	152	5541	152	5414	0.0	0.028075360177318064
chr19	PCAT19	41456590	41456923	0	334	152	5541	152	5207	0.0	0.029191473017092375
chr19	PCAT19	41456615	41456923	0	309	152	5541	152	5232	0.0	0.0290519877675841
chr19	CEACAM7	41683784	41684063	51	280	51	2660	0	2380	0.18214285714285713	0.0
chr19	LYPD4	41839507	41839583	0	77	114702	2171	114702	2094	0.0	54.77650429799427
chr19	RABAC1	41958285	41958383	0	99	51	1564	51	1465	0.0	0.0348122866894198
chr19	RABAC1	41957017	41957119	0	103	51	1564	51	1461	0.0	0.03490759753593429
chr19	GRIK5	42063300	42063525	0	226	31	5036	31	4810	0.0	0.006444906444906445
chr19	POU2F2	42117249	42117366	0	118	116	8966	116	8848	0.0	0.013110307414104882
chr19	POU2F2	42091866	42091940	0	75	116	8966	116	8891	0.0	0.01304690136092678
chr19	POU2F2	42092068	42092270	0	203	116	8966	116	8763	0.0	0.01323747575031382
chr19	POU2F2	42117249	42117432	0	184	116	8966	116	8782	0.0	0.013208836255978138
chr19	POU2F2	42116708	42117005	0	298	116	8966	116	8668	0.0	0.01338255652976465
chr19	DEDD2	42216679	42217045	0	367	0	2616	0	2249	0.0	0.0
chr19	DEDD2	42202050	42202072	0	23	0	2616	0	2593	0.0	0.0
chr19	DEDD2	42201988	42202072	0	85	0	2616	0	2531	0.0	0.0
chr19	GSK3A	42232495	42232682	0	188	51	5487	51	5299	0.0	0.009624457444800906
chr19	GSK3A	42234352	42234459	0	108	51	5487	51	5379	0.0	0.009481316229782488
chr19	GSK3A	42236857	42236941	0	85	51	5487	51	5402	0.0	0.00944094779711218
chr19	GSK3A	42239954	42240142	0	189	51	5487	51	5298	0.0	0.009626274065685165
chr19	GSK3A	42230678	42230867	0	190	51	5487	51	5297	0.0	0.009628091372474987
chr19	GSK3A	42231046	42231192	0	147	51	5487	51	5340	0.0	0.009550561797752809
chr19	GSK3A	42231562	42231764	0	203	51	5487	51	5284	0.0	0.009651778955336867
chr19	GSK3A	42232495	42232594	0	100	51	5487	51	5387	0.0	0.00946723593837015
chr19	GSK3A	42233285	42233383	0	99	51	5487	51	5388	0.0	0.009465478841870824
chr19	GSK3A	42233842	42233866	0	25	51	5487	51	5462	0.0	0.009337239106554375
chr19	GSK3A	42233842	42233869	0	28	51	5487	51	5459	0.0	0.0093423703975087
chr19	GSK3A	42233842	42233931	0	90	51	5487	51	5397	0.0	0.009449694274596998
chr19	GSK3A	42233995	42234191	51	197	51	5487	0	5290	0.25888324873096447	0.0
chr19	GSK3A	42235001	42235119	0	119	51	5487	51	5368	0.0	0.009500745156482861
chr19	GSK3A	42235001	42235115	0	115	51	5487	51	5372	0.0	0.00949367088607595
chr19	GSK3A	42236006	42236141	0	136	51	5487	51	5351	0.0	0.009530928798355447
chr19	CNFN	42389488	42389568	0	81	2084	618	2084	537	0.0	3.8808193668528865
chr19	LIPE	42406160	42406388	11435	229	107004	5175	95569	4946	49.93449781659389	19.32248281439547
chr19	LIPE	42410306	42410842	33306	537	107004	5175	73698	4638	62.022346368715084	15.890038809831823
chr19	CEACAM1	42511575	42511628	0	54	837	5542	837	5488	0.0	0.15251457725947523
chr19	CEACAM1	42518947	42519235	0	289	837	5542	837	5253	0.0	0.15933752141633353
chr19	CEACAM1	42515010	42515103	0	94	837	5542	837	5448	0.0	0.15363436123348018
chr19	CEACAM1	42516772	42516865	0	94	837	5542	837	5448	0.0	0.15363436123348018
chr19	PSG3	42723941	42724025	9	85	118268	3408	118259	3323	0.10588235294117647	35.58802287089979
chr19	PSG3	42733386	42733726	12869	341	118268	3408	105399	3067	37.73900293255132	34.365503749592435
chr19	PSG8	42754987	42755266	14743	280	258228	3697	243485	3417	52.65357142857143	71.25695054141059
chr19	PSG8	42758001	42758280	252	280	258228	3697	257976	3417	0.9	75.49780509218613
chr19	PSG8	42763915	42764281	147	367	258228	3697	258081	3330	0.40054495912806537	77.5018018018018
chr19	PSG8	42758601	42758911	459	311	258228	3697	257769	3386	1.4758842443729903	76.12787950383934
chr19	PSG8	42758601	42758941	468	341	258228	3697	257760	3356	1.3724340175953078	76.80572109654351
chr19	PSG1	42868755	42869034	0	280	55962	4967	55962	4687	0.0	11.939833582248774
chr19	PSG1	42871766	42872045	765	280	55962	4967	55197	4687	2.732142857142857	11.776616172391721
chr19	PSG6	42916124	42916487	1154	364	8828	3437	7674	3073	3.17032967032967	2.497233973315978
chr19	PSG6	42907575	42907854	0	280	8828	3437	8828	3157	0.0	2.7963256255939184
chr19	PSG6	42907575	42907937	0	363	8828	3437	8828	3074	0.0	2.871828236824984
chr19	PSG7	42935403	42935769	0	367	4012	4421	4012	4054	0.0	0.9896398618648249
chr19	PSG11	43018769	43019048	0	280	714	3090	714	2810	0.0	0.25409252669039145
chr19	PSG11	43024690	43025056	0	367	714	3090	714	2723	0.0	0.2622107969151671
chr19	PSG11	43019372	43019712	0	341	714	3090	714	2749	0.0	0.2597308112040742
chr19	PSG11	43015766	43016045	714	280	714	3090	0	2810	2.55	0.0
chr19	PSG5	43178878	43179157	255	280	13058	4688	12803	4408	0.9107142857142857	2.904491833030853
chr19	PSG4	43194994	43195273	0	280	0	5236	0	4956	0.0	0.0
chr19	PSG4	43197996	43198275	0	280	0	5236	0	4956	0.0	0.0
chr19	PSG4	43203885	43204251	0	367	0	5236	0	4869	0.0	0.0
chr19	PSG4	43198597	43198937	0	341	0	5236	0	4895	0.0	0.0
chr19	PSG4	43204762	43204947	0	186	0	5236	0	5050	0.0	0.0
chr19	PSG9	43258856	43259135	1020	280	7275	5055	6255	4775	3.642857142857143	1.3099476439790576
chr19	PSG9	43261859	43262138	0	280	7275	5055	7275	4775	0.0	1.5235602094240839
chr19	PHLDB3	43487023	43487123	0	101	856	4568	856	4467	0.0	0.19162749048578465
chr19	ETHE1	43526200	43526349	0	150	1662	1596	1662	1446	0.0	1.1493775933609958
chr19	XRCC1	43560909	43561020	0	112	650	2762	650	2650	0.0	0.24528301886792453
chr19	XRCC1	43574909	43575002	510	94	650	2762	140	2668	5.425531914893617	0.05247376311844078
chr19	ZNF428	43608504	43608603	0	100	1479	1557	1479	1457	0.0	1.0150995195607413
chr19	PLAUR	43655438	43655573	0	136	2361	4200	2361	4064	0.0	0.5809547244094488
chr19	PLAUR	43665315	43665459	0	145	2361	4200	2361	4055	0.0	0.5822441430332922
chr19	PLAUR	43652224	43652371	0	148	2361	4200	2361	4052	0.0	0.582675222112537
chr19	ZNF112	44340415	44340542	0	128	985	3854	985	3726	0.0	0.26435856146001074
chr19	ZNF112	44343253	44343302	665	50	985	3854	320	3804	13.3	0.08412197686645637
chr19	ZNF285	44392339	44392466	0	128	61172	6726	61172	6598	0.0	9.27129433161564
chr19	ZNF285	44394519	44394540	0	22	61172	6726	61172	6704	0.0	9.124701670644392
chr19	ZNF180	44479282	44479409	1176	128	26553	4714	25377	4586	9.1875	5.533580462276493
chr19	ZNF180	44484360	44484435	51	76	26553	4714	26502	4638	0.6710526315789473	5.714100905562742
chr19	CEACAM20	44511636	44511672	0	37	13484	2207	13484	2170	0.0	6.2138248847926265
chr19	CEACAM20	44516945	44517224	2408	280	13484	2207	11076	1927	8.6	5.747794499221588
chr19	TRAPPC6A	45165126	45165194	26719	69	54730	939	28011	870	387.231884057971	32.19655172413793
chr19	ERCC2	45355664	45355728	0	65	56764	5327	56764	5262	0.0	10.78753325731661
chr19	ERCC2	45364423	45364547	240	125	56764	5327	56524	5202	1.92	10.865820838139177
chr19	ERCC2	45369069	45369147	1147	79	56764	5327	55617	5248	14.518987341772151	10.597751524390244
chr19	ERCC2	45370132	45370232	24	101	56764	5327	56740	5226	0.2376237623762376	10.857252200535783
chr19	PPP1R13L	45382526	45382726	408	201	260919	5042	260511	4841	2.029850746268657	53.81346829167527
chr19	PPP1R13L	45404998	45405081	392	84	260919	5042	260527	4958	4.666666666666667	52.54679306171843
chr19	PPP1R13L	45401998	45402124	0	127	260919	5042	260919	4915	0.0	53.08626653102747
chr19	ERCC1	45413962	45414034	0	73	13301	5262	13301	5189	0.0	2.563306995567547
chr19	ERCC1	45421177	45421393	36	217	13301	5262	13265	5045	0.16589861751152074	2.6293359762140733
chr19	ERCC1	45414860	45414960	0	101	13301	5262	13301	5161	0.0	2.577213718271653
chr19	ERCC1	45413676	45413745	0	70	13301	5262	13301	5192	0.0	2.561825885978428
chr19	ERCC1	45419410	45419489	5116	80	13301	5262	8185	5182	63.95	1.579505982246237
chr19	RTN2	45488636	45488706	146	71	306531	3171	306385	3100	2.056338028169014	98.83387096774193
chr19	RTN2	45489345	45489553	510	209	306531	3171	306021	2962	2.4401913875598087	103.31566509115463
chr19	RTN2	45493159	45493378	552	220	306531	3171	305979	2951	2.5090909090909093	103.68654693324297
chr19	EML2	45616460	45616558	102	99	38578	6562	38476	6463	1.0303030303030303	5.953272474083243
chr19	EML2	45617629	45617697	276	69	38578	6562	38302	6493	4.0	5.898968119513322
chr19	EML2	45619059	45619191	0	133	38578	6562	38578	6429	0.0	6.000622180743506
chr19	EML2	45621482	45621637	0	156	38578	6562	38578	6406	0.0	6.022166718701218
chr19	EML2	45624718	45624818	654	101	38578	6562	37924	6461	6.475247524752476	5.869679616158489
chr19	EML2	45629950	45630046	588	97	38578	6562	37990	6465	6.061855670103093	5.8762567672080435
chr19	EML2	45614825	45615036	765	212	38578	6562	37813	6350	3.608490566037736	5.954803149606299
chr19	EML2	45618821	45618943	153	123	38578	6562	38425	6439	1.2439024390243902	5.967541543717968
chr19	EML2	45628697	45628795	260	99	38578	6562	38318	6463	2.6262626262626263	5.9288256227758005
chr19	SNRPD2	45690571	45690667	339	97	785	1443	446	1346	3.4948453608247423	0.3313521545319465
chr19	SNRPD2	45689232	45689347	0	116	785	1443	785	1327	0.0	0.5915599095704597
chr19	SIX5	45766349	45767155	44525	807	86329	3497	41804	2690	55.17348203221809	15.540520446096654
chr19	DMPK	45771770	45771928	0	159	19126	4865	19126	4706	0.0	4.064173395665108
chr19	DMPK	45780322	45780381	0	60	19126	4865	19126	4805	0.0	3.980437044745057
chr19	AC011530.1	45784640	45784715	0	76	90	865	90	789	0.0	0.11406844106463879
chr19	DMPK	45780213	45780381	0	169	19126	4865	19126	4696	0.0	4.072827938671209
chr19	DMPK	45782192	45782250	0	59	19126	4865	19126	4806	0.0	3.9796088223054515
chr19	SYMPK	45861899	45862027	6243	129	344768	10339	338525	10210	48.395348837209305	33.156219392752206
chr19	IGFL2-AS1	46195677	46195838	2	162	52041	3342	52039	3180	0.012345679012345678	16.36446540880503
chr19	IGFL2-AS1	46198407	46198442	2112	36	52041	3342	49929	3306	58.666666666666664	15.102540834845735
chr19	IGFL2-AS1	46190284	46190414	0	131	52041	3342	52041	3211	0.0	16.207100591715978
chr19	IGFL2-AS1	46190223	46190414	0	192	52041	3342	52041	3150	0.0	16.52095238095238
chr19	IGFL2-AS1	46202534	46202734	844	201	52041	3342	51197	3141	4.199004975124378	16.29958611907036
chr19	PRKD2	46713862	46714001	2858	140	53693	5270	50835	5130	20.414285714285715	9.909356725146198
chr19	PRKD2	46685424	46685521	0	98	53693	5270	53693	5172	0.0	10.381477184841454
chr19	STRN4	46746148	46746211	0	64	20985	7060	20985	6996	0.0	2.9995711835334475
chr19	STRN4	46740163	46740285	0	123	20985	7060	20985	6937	0.0	3.0250828888568546
chr19	STRN4	46733815	46733875	0	61	20985	7060	20985	6999	0.0	2.9982854693527647
chr19	AP2S1	46839464	46839620	0	157	531	1456	531	1299	0.0	0.40877598152424943
chr19	AP2S1	46839464	46839578	0	115	531	1456	531	1341	0.0	0.3959731543624161
chr19	AP2S1	46845992	46846142	0	151	531	1456	531	1305	0.0	0.4068965517241379
chr19	ZC3H4	47069091	47069343	0	253	666084	5871	666084	5618	0.0	118.562477750089
chr19	ZC3H4	47086383	47086538	0	156	666084	5871	666084	5715	0.0	116.5501312335958
chr19	BBC3	47226563	47226754	254	192	42118	3188	41864	2996	1.3229166666666667	13.973297730307076
chr19	BBC3	47228157	47228446	9987	290	42118	3188	32131	2898	34.43793103448276	11.087301587301587
chr19	MEIS3	47406459	47406526	0	68	5319	4243	5319	4175	0.0	1.2740119760479043
chr19	MEIS3	47415050	47415101	8	52	5319	4243	5311	4191	0.15384615384615385	1.2672393223574325
chr19	SLC8A2	47465728	47466419	1878	692	9415	5282	7537	4590	2.713872832369942	1.6420479302832245
chr19	SLC8A2	47465728	47466147	1788	420	9415	5282	7627	4862	4.257142857142857	1.5686960098724805
chr19	NAPA	47500632	47500749	612	118	69860	4857	69248	4739	5.186440677966102	14.612365477948934
chr19	NAPA	47503422	47503502	0	81	69860	4857	69860	4776	0.0	14.627303182579565
chr19	NAPA	47503392	47503502	0	111	69860	4857	69860	4746	0.0	14.71976401179941
chr19	NAPA	47505336	47505543	13920	208	69860	4857	55940	4649	66.92307692307692	12.03269520326952
chr19	ZNF541	47538141	47538439	0	299	58468	4670	58468	4371	0.0	13.376344086021506
chr19	ZNF541	47539704	47539878	0	175	58468	4670	58468	4495	0.0	13.00734149054505
chr19	ZNF541	47538141	47538496	0	356	58468	4670	58468	4314	0.0	13.553082985628187
chr19	PLA2G4C	48088685	48088712	0	28	925	5764	925	5736	0.0	0.16126220362622037
chr19	PLA2G4C	48090363	48090417	0	55	925	5764	925	5709	0.0	0.16202487300753196
chr19	PLA2G4C	48104587	48104724	0	138	925	5764	925	5626	0.0	0.16441521507287593
chr19	PLA2G4C	48096698	48097127	0	430	925	5764	925	5334	0.0	0.17341582302212225
chr19	PLA2G4C	48108783	48108901	0	119	925	5764	925	5645	0.0	0.16386182462356066
chr19	PLA2G4C	48108783	48108922	0	140	925	5764	925	5624	0.0	0.16447368421052633
chr19	LIG1	48133980	48134066	0	87	9796	6607	9796	6520	0.0	1.5024539877300613
chr19	LIG1	48153871	48153967	0	97	9796	6607	9796	6510	0.0	1.5047619047619047
chr19	LIG1	48162261	48162351	828	91	9796	6607	8968	6516	9.098901098901099	1.376304481276857
chr19	LIG1	48151231	48151339	0	109	9796	6607	9796	6498	0.0	1.507540781779009
chr19	CARD8	48206383	48206520	14463	138	357235	11518	342772	11380	104.80434782608695	30.120562390158174
chr19	CARD8	48218870	48219012	306	143	357235	11518	356929	11375	2.13986013986014	31.378373626373627
chr19	CARD8	48232452	48232493	159	42	357235	11518	357076	11476	3.7857142857142856	31.115022655977693
chr19	CARD8	48238382	48238532	0	151	357235	11518	357235	11367	0.0	31.427377496261105
chr19	CARD8	48249522	48249633	1858	112	357235	11518	355377	11406	16.589285714285715	31.157022619673857
chr19	CARD8	48221729	48221855	85053	127	357235	11518	272182	11391	669.7086614173228	23.894478096743043
chr19	CARD8	48246074	48246381	147688	308	357235	11518	209547	11210	479.5064935064935	18.692863514719
chr19	CARD8	48233271	48233404	71	134	357235	11518	357164	11384	0.5298507462686567	31.37420941672523
chr19	CARD8	48232452	48232789	524	338	357235	11518	356711	11180	1.5502958579881656	31.906171735241504
chr19	CARD8	48223718	48223868	5680	151	357235	11518	351555	11367	37.615894039735096	30.927685405120084
chr19	CARD8	48238382	48238526	0	145	357235	11518	357235	11373	0.0	31.410797502857644
chr19	CARD8	48242539	48242644	0	106	357235	11518	357235	11412	0.0	31.303452506133894
chr19	CCDC114	48318712	48318812	0	101	386	5076	386	4975	0.0	0.07758793969849247
chr19	TMEM143	48345159	48345354	0	196	0	3499	0	3303	0.0	0.0
chr19	TMEM143	48360071	48360176	0	106	0	3499	0	3393	0.0	0.0
chr19	TMEM143	48360318	48360568	0	251	0	3499	0	3248	0.0	0.0
chr19	TMEM143	48360318	48360410	0	93	0	3499	0	3406	0.0	0.0
chr19	KDELR1	48387754	48387821	0	68	51	2250	51	2182	0.0	0.023373052245646196
chr19	LMTK3	48509134	48509248	0	115	51	6113	51	5998	0.0	0.008502834278092697
chr19	RPL18	48617790	48617877	95	88	72742	1757	72647	1669	1.0795454545454546	43.527261833433194
chr19	RPL18	48615876	48615905	0	30	72742	1757	72742	1727	0.0	42.12044006948466
chr19	AC022154.1	48620798	48620893	373	96	58824	1038	58451	942	3.8854166666666665	62.04989384288747
chr19	CA11	48638239	48638293	341	55	72961	1956	72620	1901	6.2	38.200946870068385
chr19	NTN5	48670355	48671006	0	652	42825	2133	42825	1481	0.0	28.916272788656315
chr19	MAMSTR	48714365	48714560	33696	196	125416	2296	91720	2100	171.91836734693877	43.67619047619048
chr19	BCAT2	48807755	48808236	522	482	11539	4283	11017	3801	1.0829875518672198	2.8984477769008157
chr19	BCAT2	48796146	48796329	102	184	11539	4283	11437	4099	0.5543478260869565	2.7901927299341303
chr19	HSD17B14	48813432	48813552	0	121	196236	1121	196236	1000	0.0	196.236
chr19	HSD17B14	48813455	48813552	0	98	196236	1121	196236	1023	0.0	191.8240469208211
chr19	HSD17B14	48831667	48831759	0	93	196236	1121	196236	1028	0.0	190.89105058365757
chr19	PLEKHA4	48861619	48861692	0	74	12520	3788	12520	3714	0.0	3.3710285406569738
chr19	PLEKHA4	48865502	48865610	0	109	12520	3788	12520	3679	0.0	3.403098668116336
chr19	PLEKHA4	48839204	48839263	0	60	12520	3788	12520	3728	0.0	3.3583690987124464
chr19	PLEKHA4	48857421	48857496	0	76	12520	3788	12520	3712	0.0	3.372844827586207
chr19	PLEKHA4	48841148	48841310	200	163	12520	3788	12320	3625	1.2269938650306749	3.3986206896551723
chr19	TULP2	48895365	48895503	0	139	5807	2263	5807	2124	0.0	2.7339924670433144
chr19	GYS1	48987193	48987385	0	193	218830	4257	218830	4064	0.0	53.84596456692913
chr19	NTF4	49064152	49064295	0	144	0	1474	0	1330	0.0	0.0
chr19	HRC	49152309	49152378	0	70	191	2613	191	2543	0.0	0.07510813999213527
chr19	SLC6A16	49309300	49309411	0	112	37821	3601	37821	3489	0.0	10.840068787618229
chr19	TEAD2	49355958	49355970	65	13	36224	2995	36159	2982	5.0	12.125754527162979
chr19	TEAD2	49359843	49360081	0	239	36224	2995	36224	2756	0.0	13.143686502177069
chr19	PIH1D1	49447337	49447467	0	131	964	2510	964	2379	0.0	0.4052122740647331
chr19	PIH1D1	49448000	49448062	42	63	964	2510	922	2447	0.6666666666666666	0.37678790355537395
chr19	PIH1D1	49447337	49447417	0	81	964	2510	964	2429	0.0	0.3968711403869905
chr19	PIH1D1	49447337	49447420	0	84	964	2510	964	2426	0.0	0.3973619126133553
chr19	NOSIP	49556548	49556736	0	189	2520	2911	2520	2722	0.0	0.925789860396767
chr19	NOSIP	49556548	49556657	0	110	2520	2911	2520	2801	0.0	0.8996786861835059
chr19	IRF3	49660712	49660828	0	117	39279	3464	39279	3347	0.0	11.735584105168808
chr19	IRF3	49661947	49662328	8717	382	39279	3464	30562	3082	22.819371727748692	9.91628812459442
chr19	IRF3	49663342	49663514	0	173	39279	3464	39279	3291	0.0	11.935278030993619
chr19	IRF3	49660712	49660844	0	133	39279	3464	39279	3331	0.0	11.79195436805764
chr19	IRF3	49664673	49664846	0	174	39279	3464	39279	3290	0.0	11.938905775075987
chr19	IRF3	49661449	49662328	27133	880	39279	3464	12146	2584	30.832954545454545	4.70046439628483
chr19	IRF3	49664442	49664673	102	232	39279	3464	39177	3232	0.4396551724137931	12.121596534653465
chr19	IRF3	49664552	49664673	51	122	39279	3464	39228	3342	0.4180327868852459	11.737881508078994
chr19	FUZ	49812250	49812335	2603	86	39393	2967	36790	2881	30.267441860465116	12.769871572370704
chr19	FUZ	49812614	49812736	6024	123	39393	2967	33369	2844	48.97560975609756	11.733122362869198
chr19	FUZ	49808114	49808159	130	46	39393	2967	39263	2921	2.8260869565217392	13.441629578911332
chr19	FUZ	49812637	49812736	6001	100	39393	2967	33392	2867	60.01	11.64701778862923
chr19	FUZ	49812446	49812736	10361	291	39393	2967	29032	2676	35.60481099656357	10.849028400597907
chr19	FUZ	49812446	49812685	6803	240	39393	2967	32590	2727	28.345833333333335	11.95086175284195
chr19	PTOV1-AS2	49858553	49858626	15049	74	60426	1026	45377	952	203.36486486486487	47.66491596638655
chr19	PNKP	49861771	49861881	55	111	39166	3802	39111	3691	0.4954954954954955	10.596315361690598
chr19	PNKP	49862184	49862281	0	98	39166	3802	39166	3704	0.0	10.573974082073434
chr19	PNKP	49862370	49862463	0	94	39166	3802	39166	3708	0.0	10.562567421790723
chr19	PNKP	49863963	49864071	751	109	39166	3802	38415	3693	6.889908256880734	10.402112103980503
chr19	PNKP	49864178	49864236	409	59	39166	3802	38757	3743	6.932203389830509	10.354528453112477
chr19	PNKP	49864323	49864403	2291	81	39166	3802	36875	3721	28.28395061728395	9.909970438054286
chr19	PNKP	49867468	49867532	0	65	39166	3802	39166	3737	0.0	10.48059941129248
chr19	IL4I1	49896147	49896182	0	36	139	2507	139	2471	0.0	0.05625252934034804
chr19	IL4I1	49901638	49901821	0	184	139	2507	139	2323	0.0	0.05983641842445114
chr19	NUP62	49927693	49927815	0	123	97	2772	97	2649	0.0	0.03661759154397886
chr19	NUP62	49927693	49927848	0	156	97	2772	97	2616	0.0	0.03707951070336391
chr19	NUP62	49918507	49918621	0	115	97	2772	97	2657	0.0	0.03650733910425292
chr19	NUP62	49911104	49911366	0	263	97	2772	97	2509	0.0	0.038660821044240734
chr19	NUP62	49911104	49911370	0	267	97	2772	97	2505	0.0	0.038722554890219564
chr19	NUP62	49911104	49911343	0	240	97	2772	97	2532	0.0	0.03830963665086888
chr19	SIGLEC11	49952297	49952394	8055	98	97541	3184	89486	3086	82.1938775510204	28.997407647440053
chr19	SIGLEC11	49958282	49958570	0	289	97541	3184	97541	2895	0.0	33.692918825561314
chr19	VRK3	49997503	49997570	0	68	3049350	7489	3049350	7421	0.0	410.9082333917262
chr19	VRK3	50009235	50009385	0	151	3049350	7489	3049350	7338	0.0	415.5560098119379
chr19	VRK3	50015731	50015793	0	63	3049350	7489	3049350	7426	0.0	410.6315647724212
chr19	VRK3	49995190	49995275	534738	86	3049350	7489	2514612	7403	6217.883720930233	339.674726462245
chr19	VRK3	50009235	50009289	0	55	3049350	7489	3049350	7434	0.0	410.18966908797415
chr19	IZUMO2	50153676	50153806	1574	131	92559	1521	90985	1390	12.01526717557252	65.4568345323741
chr19	KCNC3	50316032	50316091	0	60	247146	6800	247146	6740	0.0	36.66854599406528
chr19	KCNC3	50320222	50320349	0	128	247146	6800	247146	6672	0.0	37.04226618705036
chr19	NAPSA	50361968	50362092	5180	125	208202	2059	203022	1934	41.44	104.97518097207859
chr19	JOSD2	50507573	50507699	0	127	119	1198	119	1071	0.0	0.1111111111111111
chr19	ASPDH	50512926	50513011	51	86	14858	1675	14807	1589	0.5930232558139535	9.31843926998112
chr19	ASPDH	50512660	50512810	0	151	14858	1675	14858	1524	0.0	9.749343832020998
chr19	SHANK1	50697095	50697122	0	28	668	10516	668	10488	0.0	0.06369183829138063
chr19	SHANK1	50687016	50687040	25	25	668	10516	643	10491	1.0	0.06129063006386427
chr19	SHANK1	50663096	50663169	34	74	668	10516	634	10442	0.4594594594594595	0.06071633786630914
chr19	C19ORF48	50799293	50799357	0	65	153	2224	153	2159	0.0	0.07086614173228346
chr19	C19ORF48	50802453	50802614	0	162	153	2224	153	2062	0.0	0.07419980601357905
chr19	C19ORF48	50801182	50801349	0	168	153	2224	153	2056	0.0	0.07441634241245136
chr19	C19ORF48	50799271	50799357	0	87	153	2224	153	2137	0.0	0.07159569489939167
chr19	KLK15	50826620	50826757	0	138	816	1623	816	1485	0.0	0.5494949494949495
chr19	KLK4	50908358	50908495	674	138	107594	1350	106920	1212	4.884057971014493	88.21782178217822
chr19	KLK4	50908358	50908491	666	134	107594	1350	106928	1216	4.970149253731344	87.9342105263158
chr19	KLK5	50952746	50952814	0	69	0	1576	0	1507	0.0	0.0
chr19	KLK6	50967168	50967325	24	158	24	1983	0	1825	0.1518987341772152	0.0
chr19	KLK6	50968064	50968112	0	49	24	1983	24	1934	0.0	0.012409513960703205
chr19	KLK7	50981766	50981914	0	149	55279	2454	55279	2305	0.0	23.982212581344903
chr19	KLK7	50982326	50982457	9	132	55279	2454	55270	2322	0.06818181818181818	23.80275624461671
chr19	KLK8	51000423	51000718	0	296	51	1834	51	1538	0.0	0.03315994798439532
chr19	KLK8	50999995	51000258	0	264	51	1834	51	1570	0.0	0.03248407643312102
chr19	KLK8	51000423	51000583	0	161	51	1834	51	1673	0.0	0.030484160191273164
chr19	KLK8	51001531	51001709	0	179	51	1834	51	1655	0.0	0.03081570996978852
chr19	KLK8	50997750	50997884	0	135	51	1834	51	1699	0.0	0.03001765744555621
chr19	KLK9	51009182	51009339	12938	158	15253	1448	2315	1290	81.88607594936708	1.7945736434108528
chr19	KLK12	51031875	51032135	0	261	0	1762	0	1501	0.0	0.0
chr19	KLK12	51031779	51032135	0	357	0	1762	0	1405	0.0	0.0
chr19	KLK13	51063585	51063861	0	277	38	2594	38	2317	0.0	0.01640051791109193
chr19	ETFB	51353131	51353290	0	160	235	5290	235	5130	0.0	0.04580896686159844
chr19	NKG7	51371939	51372074	0	136	0	924	0	788	0.0	0.0
chr19	NKG7	51372160	51372307	0	148	0	924	0	776	0.0	0.0
chr19	NKG7	51372160	51372202	0	43	0	924	0	881	0.0	0.0
chr19	SIGLEC10	51414823	51415108	0	286	51	3547	51	3261	0.0	0.015639374425023
chr19	SIGLEC10	51415897	51416167	0	271	51	3547	51	3276	0.0	0.015567765567765568
chr19	SIGLEC10	51417081	51417465	0	385	51	3547	51	3162	0.0	0.016129032258064516
chr19	SIGLEC10	51417081	51417358	0	278	51	3547	51	3269	0.0	0.01560110125420618
chr19	SIGLEC8	51457460	51457739	0	280	6	3178	6	2898	0.0	0.002070393374741201
chr19	SIGLEC8	51457183	51457231	0	49	6	3178	6	3129	0.0	0.0019175455417066154
chr19	SIGLEC6	51527746	51527828	0	83	0	4288	0	4205	0.0	0.0
chr19	SIGLEC6	51530436	51530484	0	49	0	4288	0	4239	0.0	0.0
chr19	SIGLEC6	51528159	51528253	0	95	0	4288	0	4193	0.0	0.0
chr19	SIGLEC6	51530436	51530517	0	82	0	4288	0	4206	0.0	0.0
chr19	FPR1	51750202	51750253	0	52	51	2584	51	2532	0.0	0.02014218009478673
chr19	ZNF577	51886820	51886912	0	93	3742	5101	3742	5008	0.0	0.7472044728434505
chr19	ZNF577	51886115	51886145	0	31	3742	5101	3742	5070	0.0	0.7380670611439842
chr19	ZNF649	51904132	51904245	0	114	3724	3541	3724	3427	0.0	1.0866647213306098
chr19	ZNF649	51899797	51899912	0	116	3724	3541	3724	3425	0.0	1.0872992700729927
chr19	ZNF350	51984047	51984169	0	123	408	4552	408	4429	0.0	0.09212011740799278
chr19	ZNF615	52003696	52003900	0	205	0	4909	0	4704	0.0	0.0
chr19	ZNF615	52000345	52000378	0	34	0	4909	0	4875	0.0	0.0
chr19	ZNF615	52007292	52007330	0	39	0	4909	0	4870	0.0	0.0
chr19	ZNF615	52000258	52000378	0	121	0	4909	0	4788	0.0	0.0
chr19	ZNF615	52000357	52000378	0	22	0	4909	0	4887	0.0	0.0
chr19	ZNF615	52004416	52004723	0	308	0	4909	0	4601	0.0	0.0
chr19	ZNF614	52017575	52017697	0	123	408	5631	408	5508	0.0	0.07407407407407407
chr19	ZNF616	52122359	52122457	0	99	154	4913	154	4814	0.0	0.03199002908184462
chr19	ZNF616	52122407	52122457	0	51	154	4913	154	4862	0.0	0.03167420814479638
chr19	ZNF528-AS1	52396609	52396752	0	144	68922	4684	68922	4540	0.0	15.181057268722467
chr19	ZNF528-AS1	52396315	52396499	0	185	68922	4684	68922	4499	0.0	15.319404312069349
chr19	ZNF528-AS1	52396609	52397267	153	659	68922	4684	68769	4025	0.2321699544764795	17.085465838509318
chr19	ZNF528-AS1	52397194	52397267	0	74	68922	4684	68922	4610	0.0	14.950542299349241
chr19	ZNF83	52614657	52614797	867	141	37951	7542	37084	7401	6.148936170212766	5.010674233211728
chr19	ZNF83	52618935	52619062	174	128	37951	7542	37777	7414	1.359375	5.095360129484758
chr19	ZNF83	52655560	52655687	771	128	37951	7542	37180	7414	6.0234375	5.014836795252226
chr19	ZNF83	52674181	52674253	0	73	37951	7542	37951	7469	0.0	5.081135359485875
chr19	ZNF83	52616717	52616875	1350	159	37951	7542	36601	7383	8.49056603773585	4.9574698631992415
chr19	ZNF83	52616717	52616841	1350	125	37951	7542	36601	7417	10.8	4.934744505864905
chr19	ZNF83	52617245	52617335	943	91	37951	7542	37008	7451	10.362637362637363	4.966850087236613
chr19	ZNF611	52707468	52707542	288	75	525131	6713	524843	6638	3.84	79.0664356733956
chr19	ZNF611	52716110	52716233	25844	124	525131	6713	499287	6589	208.41935483870967	75.77583851874336
chr19	ZNF611	52729905	52730005	77	101	525131	6713	525054	6612	0.7623762376237624	79.40925589836661
chr19	ZNF611	52714014	52714141	1706	128	525131	6713	523425	6585	13.328125	79.4874715261959
chr19	ZNF611	52728729	52728831	21	103	525131	6713	525110	6610	0.20388349514563106	79.44175491679273
chr19	ZNF611	52707391	52707538	612	148	525131	6713	524519	6565	4.135135135135135	79.8962680883473
chr19	ZNF611	52715831	52715913	501	83	525131	6713	524630	6630	6.036144578313253	79.12971342383108
chr19	ZNF611	52708176	52708326	0	151	525131	6713	525131	6562	0.0	80.02605912831454
chr19	ZNF611	52707420	52707542	612	123	525131	6713	524519	6590	4.975609756097561	79.59317147192716
chr19	ZNF611	52711206	52711304	590	99	525131	6713	524541	6614	5.959595959595959	79.30768067735107
chr19	ZNF600	52763147	52763229	0	83	11226	6973	11226	6890	0.0	1.6293178519593614
chr19	ZNF600	52774574	52774701	1859	128	11226	6973	9367	6845	14.5234375	1.368444119795471
chr19	ZNF600	52781316	52781464	309	149	11226	6973	10917	6824	2.0738255033557045	1.5997948417350527
chr19	ZNF28	52808006	52808133	0	128	4048	1934	4048	1806	0.0	2.241417497231451
chr19	ZNF28	52805144	52805262	1377	119	4048	1934	2671	1815	11.571428571428571	1.471625344352617
chr19	ZNF468	52845178	52845296	0	119	5664	4990	5664	4871	0.0	1.1628002463559843
chr19	ZNF468	52846557	52846611	0	55	5664	4990	5664	4935	0.0	1.1477203647416414
chr19	ZNF468	52853871	52854107	0	237	5664	4990	5664	4753	0.0	1.1916684199452976
chr19	ZNF468	52853871	52854126	0	256	5664	4990	5664	4734	0.0	1.1964512040557669
chr19	ZNF320	52893778	52893856	417	79	53514	6226	53097	6147	5.2784810126582276	8.637872132747681
chr19	ZNF320	52893778	52893927	1289	150	53514	6226	52225	6076	8.593333333333334	8.595292955892035
chr19	ZNF816	52960026	52960177	293	152	293	3076	0	2924	1.9276315789473684	0.0
chr19	ZNF816	52953283	52953389	0	107	293	3076	293	2969	0.0	0.09868642640619738
chr19	ZNF816	52956191	52956265	0	75	293	3076	293	3001	0.0	0.09763412195934688
chr19	ZNF702P	52974031	52974153	0	123	102	6512	102	6389	0.0	0.015964939740178433
chr19	ZNF702P	52990092	52990210	0	119	102	6512	102	6393	0.0	0.015954950727358048
chr19	ZNF702P	52990409	52990532	0	124	102	6512	102	6388	0.0	0.015967438948027553
chr19	ZNF160	53091412	53091497	826	86	95953	7275	95127	7189	9.604651162790697	13.232299346223396
chr19	ZNF160	53091412	53091529	826	118	95953	7275	95127	7157	7.0	13.291462903451167
chr19	ZNF160	53091412	53091553	826	142	95953	7275	95127	7133	5.816901408450704	13.336183933828684
chr19	ZNF415	53115703	53115924	40756	222	116925	3790	76169	3568	183.5855855855856	21.34781390134529
chr19	ZNF415	53115209	53115307	23	99	116925	3790	116902	3691	0.23232323232323232	31.67217556217827
chr19	ZNF415	53116312	53116433	23843	122	116925	3790	93082	3668	195.4344262295082	25.376772082878954
chr19	ZNF415	53115703	53115811	14392	109	116925	3790	102533	3681	132.03669724770643	27.854659060038035
chr19	ZNF415	53123500	53123655	1310	156	116925	3790	115615	3634	8.397435897435898	31.814804623004953
chr19	ZNF415	53123792	53123906	613	115	116925	3790	116312	3675	5.3304347826086955	31.64952380952381
chr19	ZNF415	53123500	53123708	2296	209	116925	3790	114629	3581	10.985645933014354	32.01033230941078
chr19	ZNF347	53149240	53149367	158	128	54978	9136	54820	9008	1.234375	6.085701598579041
chr19	ZNF665	53183951	53184080	0	130	4949	6185	4949	6055	0.0	0.8173410404624277
chr19	NLRP12	53798242	53798413	0	172	0	4961	0	4789	0.0	0.0
chr19	VSTM1	54042276	54042369	0	94	813	1416	813	1322	0.0	0.6149773071104387
chr19	VSTM1	54055505	54055799	51	295	813	1416	762	1121	0.17288135593220338	0.6797502230151651
chr19	OSCAR	54099589	54099601	0	13	51	2089	51	2076	0.0	0.024566473988439308
chr19	OSCAR	54099747	54099780	0	34	51	2089	51	2055	0.0	0.024817518248175182
chr19	TFPT	54110050	54110121	0	72	51	1247	51	1175	0.0	0.04340425531914894
chr19	TMC4	54165418	54165566	0	149	197	3077	197	2928	0.0	0.06728142076502733
chr19	MBOAT7	54188432	54188511	0	80	51	5300	51	5220	0.0	0.009770114942528735
chr19	MBOAT7	54187160	54187287	0	128	51	5300	51	5172	0.0	0.009860788863109048
chr19	LILRA6	54239900	54239951	0	52	0	2564	0	2512	0.0	0.0
chr19	LILRB5	54256042	54256342	0	301	102	3979	102	3678	0.0	0.02773246329526917
chr19	LILRB2	54276380	54276456	20737	77	71079	3214	50342	3137	269.31168831168833	16.047816385081287
chr19	LILRA5	54312334	54312370	0	37	70	1544	70	1507	0.0	0.046449900464499004
chr19	LAIR1	54360021	54360072	0	52	4794	7661	4794	7609	0.0	0.6300433696937837
chr19	LAIR1	54364294	54364330	0	37	4794	7661	4794	7624	0.0	0.628803777544596
chr19	NLRP7	54927604	54927775	0	172	146405	3927	146405	3755	0.0	38.98934753661784
chr19	NLRP7	54947642	54947849	0	208	146405	3927	146405	3719	0.0	39.366765259478356
chr19	NLRP7	54927604	54927738	0	135	146405	3927	146405	3792	0.0	38.60891350210971
chr19	NLRP7	54947468	54947505	0	38	146405	3927	146405	3889	0.0	37.64592440215994
chr19	NLRP7	54947631	54947758	0	128	146405	3927	146405	3799	0.0	38.537773098183735
chr19	GP6	55025217	55025271	0	55	51	2711	51	2656	0.0	0.019201807228915662
chr19	RDH13	55059156	55059275	0	120	0	7482	0	7362	0.0	0.0
chr19	RDH13	55048045	55048257	0	213	0	7482	0	7269	0.0	0.0
chr19	RDH13	55062967	55063217	0	251	0	7482	0	7231	0.0	0.0
chr19	TNNT1	55146433	55146466	0	34	0	2115	0	2081	0.0	0.0
chr19	TNNT1	55147998	55148093	0	96	0	2115	0	2019	0.0	0.0
chr19	TNNT1	55133552	55133674	0	123	0	2115	0	1992	0.0	0.0
chr19	SYT5	55178195	55178368	0	174	0	3349	0	3175	0.0	0.0
chr19	TMEM150B	55322647	55322743	0	97	0	1723	0	1626	0.0	0.0
chr19	TMEM150B	55320038	55320166	0	129	0	1723	0	1594	0.0	0.0
chr19	TMEM150B	55320390	55320458	0	69	0	1723	0	1654	0.0	0.0
chr19	COX6B2	55351698	55351890	0	193	0	2992	0	2799	0.0	0.0
chr19	COX6B2	55353311	55353393	0	83	0	2992	0	2909	0.0	0.0
chr19	FAM71E2	55361409	55361434	0	26	0	3231	0	3205	0.0	0.0
chr19	IL11	55368768	55368941	0	174	0	2683	0	2509	0.0	0.0
chr19	UBE2S	55404060	55404147	0	88	663	2804	663	2716	0.0	0.24410898379970544
chr19	SHISA7	55438560	55438610	0	51	3621	6088	3621	6037	0.0	0.5998012257743912
chr19	ISOC2	55455635	55455845	0	211	219	3172	219	2961	0.0	0.07396149949341439
chr19	ISOC2	55457091	55457212	0	122	219	3172	219	3050	0.0	0.0718032786885246
chr19	FIZ1	55595619	55595734	58	116	28138	3478	28080	3362	0.5	8.352171326591314
chr19	NLRP11	55807852	55808014	0	163	25009	4326	25009	4163	0.0	6.007446552966611
chr19	NLRP11	55817903	55818236	5332	334	25009	4326	19677	3992	15.964071856287426	4.929108216432866
chr19	NLRP11	55798228	55798304	342	77	25009	4326	24667	4249	4.441558441558442	5.8053659684631675
chr19	ZSCAN5B	56193119	56193179	0	61	182675	2064	182675	2003	0.0	91.20069895157265
chr19	ZNF667	56444130	56444281	0	152	255	8817	255	8665	0.0	0.029428736295441432
chr19	ZNF667	56449556	56449657	0	102	255	8817	255	8715	0.0	0.029259896729776247
chr19	AC005498.3	56565940	56566054	0	115	102	2162	102	2047	0.0	0.049829018075232046
chr19	PEG3	56826387	56826463	0	77	3485	8725	3485	8648	0.0	0.4029833487511563
chr19	ZIM2	56782399	56782471	1275	73	2251	3080	976	3007	17.465753424657535	0.3245759893581643
chr19	PEG3	56817745	56817838	0	94	3485	8725	3485	8631	0.0	0.4037770826091994
chr19	PEG3	56817745	56817835	0	91	3485	8725	3485	8634	0.0	0.40363678480426224
chr19	PEG3	56833289	56833420	46	132	3485	8725	3439	8593	0.3484848484848485	0.4002094728267194
chr19	PEG3	56829782	56829921	66	140	3485	8725	3419	8585	0.4714285714285714	0.3982527664531159
chr19	PEG3	56833642	56833763	0	122	3485	8725	3485	8603	0.0	0.4050912472393351
chr19	PEG3	56827133	56827246	63	114	3485	8725	3422	8611	0.5526315789473685	0.39739867611194984
chr19	ZNF460-AS1	57278115	57278182	0	68	4182	1616	4182	1548	0.0	2.701550387596899
chr19	ZNF460-AS1	57276934	57277056	0	123	4182	1616	4182	1493	0.0	2.8010716677829874
chr19	ZNF772	57475659	57475786	0	128	74	2414	74	2286	0.0	0.03237095363079615
chr19	ZNF772	57476633	57476672	0	40	74	2414	74	2374	0.0	0.031171019376579612
chr19	ZNF772	57475023	57475146	0	124	74	2414	74	2290	0.0	0.032314410480349345
chr19	ZNF772	57475032	57475146	0	115	74	2414	74	2299	0.0	0.03218790778599391
chr19	ZNF772	57475047	57475146	0	100	74	2414	74	2314	0.0	0.03197925669835782
chr19	ZNF772	57476379	57476672	0	294	74	2414	74	2120	0.0	0.03490566037735849
chr19	ZNF550	57552626	57552722	0	97	0	5093	0	4996	0.0	0.0
chr19	ZNF550	57544236	57544583	0	348	0	5093	0	4745	0.0	0.0
chr19	ZNF550	57543650	57544583	0	934	0	5093	0	4159	0.0	0.0
chr19	ZNF671	57723213	57723340	7458	128	28880	2912	21422	2784	58.265625	7.694683908045977
chr19	ZNF671	57726907	57727025	3550	119	28880	2912	25330	2793	29.831932773109244	9.069101324740423
chr19	ZNF814	57885882	57885969	0	88	124424	9024	124424	8936	0.0	13.923903312444047
chr19	ZNF814	57875155	57875226	42	72	124424	9024	124382	8952	0.5833333333333334	13.89432529043789
chr19	ZNF814	57870721	57870812	5102	92	124424	9024	119322	8932	55.45652173913044	13.358934169278998
chr19	ZNF417	57915564	57915665	0	102	66552	5283	66552	5181	0.0	12.845396641574986
chr19	ZNF417	57915337	57915531	942	195	66552	5283	65610	5088	4.8307692307692305	12.89504716981132
chr19	ZNF418	57923191	57923289	0	99	12631	4415	12631	4316	0.0	2.926552363299351
chr19	ZNF418	57932429	57932646	5035	218	12631	4415	7596	4197	23.09633027522936	1.8098641887062188
chr19	ZNF256	57943933	57944060	0	128	15014	2210	15014	2082	0.0	7.21133525456292
chr19	ZNF606	57999807	57999896	0	90	29416	7642	29416	7552	0.0	3.895127118644068
chr19	ZSCAN18	58086905	58087008	0	104	69126	6534	69126	6430	0.0	10.75054432348367
chr19	ZSCAN18	58093227	58093398	0	172	69126	6534	69126	6362	0.0	10.865451116001257
chr19	ZSCAN18	58089864	58090386	2634	523	69126	6534	66492	6011	5.036328871892925	11.061720179670603
chr19	ZSCAN18	58092449	58092568	3	120	69126	6534	69123	6414	0.025	10.776894293732461
chr19	ZNF329	58132241	58132676	31184	436	34597	4234	3413	3798	71.5229357798165	0.8986308583464981
chr19	AC010642.2	58312969	58313113	126	145	34354	4472	34228	4327	0.8689655172413793	7.910330483013635
chr19	AC010642.2	58325274	58325361	0	88	34354	4472	34354	4384	0.0	7.836222627737226
chr19	AC010642.2	58322361	58322494	1395	134	34354	4472	32959	4338	10.41044776119403	7.597740894421392
chr19	ZNF497	58357951	58358286	408	336	130478	3901	130070	3565	1.2142857142857142	36.48527349228611
chr19	A1BG	58352097	58352184	500	88	58196	3597	57696	3509	5.681818181818182	16.44229125106868
chr19	ZNF497	58358488	58358585	2409	98	130478	3901	128069	3803	24.581632653061224	33.67578227714962
chr19	SLC27A5	58498784	58498915	0	132	62811	4687	62811	4555	0.0	13.78946212952799
chr19	MZF1	58572549	58572719	0	171	8047	5903	8047	5732	0.0	1.4038729937194696
chr19	OR4G1P	100275	100432	0	158	0	1758	0	1600	0.0	0.0
chr19	OR4F17	107472	107555	0	84	51	3269	51	3185	0.0	0.016012558869701727
chr19	MADCAM1	497832	498117	0	286	4006	2662	4006	2376	0.0	1.686026936026936
chr19	MADCAM1	500111	500159	0	49	4006	2662	4006	2613	0.0	1.5331037122081899
chr19	MADCAM1	501668	501929	0	262	4006	2662	4006	2400	0.0	1.6691666666666667
chr19	BSG	579499	579656	661350	158	6083686	3151	5422336	2993	4185.7594936708865	1811.672569328433
chr19	BSG	577773	578121	1292	349	6083686	3151	6082394	2802	3.702005730659026	2170.7330478229837
chr19	PALM	740351	740483	12852	133	172123	4924	159271	4791	96.63157894736842	33.2437904404091
chr19	PTBP1	799412	799443	38542	32	4591127	6449	4552585	6417	1204.4375	709.4569113292816
chr19	PTBP1	805491	805569	63783	79	4591127	6449	4527344	6370	807.379746835443	710.7290423861853
chr19	PTBP1	807868	807902	33110	35	4591127	6449	4558017	6414	946.0	710.6356407857811
chr19	PTBP1	805831	805902	2572	72	4591127	6449	4588555	6377	35.72222222222222	719.5475929120277
chr19	PTBP1	805512	805569	46013	58	4591127	6449	4545114	6391	793.3275862068965	711.1741511500547
chr19	KISS1R	918543	918668	0	126	102	1675	102	1549	0.0	0.065848934796643
chr19	KISS1R	919873	920106	0	234	102	1675	102	1441	0.0	0.07078417765440666
chr19	ARID3A	966571	966868	23342	298	196629	7229	173287	6931	78.32885906040268	25.001731351897273
chr19	ARID3A	961761	961940	102	180	196629	7229	196527	7049	0.5666666666666667	27.880124840402893
chr19	WDR18	985864	985975	13992	112	124301	2003	110309	1891	124.92857142857143	58.33368588048651
chr19	WDR18	994019	994088	3188	70	124301	2003	121113	1933	45.542857142857144	62.6554578375582
chr19	CNN2	1026976	1027074	281	99	2178034	3020	2177753	2921	2.8383838383838382	745.5504964053406
chr19	CNN2	1036129	1036246	93903	118	2178034	3020	2084131	2902	795.7881355932203	718.1705720192971
chr19	CNN2	1036066	1036246	96458	181	2178034	3020	2081576	2839	532.9171270718232	733.207467418105
chr19	CNN2	1036878	1037000	5341	123	2178034	3020	2172693	2897	43.422764227642276	749.9803244735933
chr19	ABCA7	1057914	1058059	3251	146	187592	8487	184341	8341	22.267123287671232	22.100587459537227
chr19	ABCA7	1054569	1054694	405	126	187592	8487	187187	8361	3.2142857142857144	22.388111469919867
chr19	ABCA7	1055096	1055351	2008	256	187592	8487	185584	8231	7.84375	22.54695662738428
chr19	ABCA7	1055082	1055351	2008	270	187592	8487	185584	8217	7.437037037037037	22.58537179019107
chr19	ABCA7	1057968	1058059	2421	92	187592	8487	185171	8395	26.315217391304348	22.05729600952948
chr19	ARHGAP45	1068413	1068744	6011	332	605581	6133	599570	5801	18.10542168674699	103.35631787622823
chr19	ARHGAP45	1068332	1068744	6011	413	605581	6133	599570	5720	14.5544794188862	104.81993006993007
chr19	GPX4	1106241	1106266	85639	26	2741694	1885	2656055	1859	3293.8076923076924	1428.7547068316298
chr19	GPX4	1106180	1106266	86053	87	2741694	1885	2655641	1798	989.1149425287356	1476.9972191323693
chr19	STK11	1216267	1216398	918	132	525923	5175	525005	5043	6.954545454545454	104.10569105691057
chr19	MIDN	1253953	1254082	5086	130	403406	4501	398320	4371	39.12307692307692	91.12788835506748
chr19	CIRBP	1271139	1271246	113805	108	2975831	5567	2862026	5459	1053.75	524.2766074372596
chr19	CIRBP	1269911	1269915	200	5	2975831	5567	2975631	5562	40.0	534.9929881337648
chr19	CIRBP	1271328	1271467	46110	140	2975831	5567	2929721	5427	329.35714285714283	539.8417173392298
chr19	CIRBP	1271139	1271467	160784	329	2975831	5567	2815047	5238	488.7051671732523	537.4278350515464
chr19	CIRBP	1271120	1271246	113975	127	2975831	5567	2861856	5440	897.4409448818898	526.0764705882353
chr19	CIRBP	1271139	1271365	133732	227	2975831	5567	2842099	5340	589.1277533039647	532.228277153558
chr19	CIRBP	1273493	1273715	64584	223	2975831	5567	2911247	5344	289.6143497757848	544.7692739520958
chr19	CIRBP	1273600	1273715	44027	116	2975831	5567	2931804	5451	379.5431034482759	537.8470005503577
chr19	PWWP3A	1356323	1356449	8721	127	784575	9648	775854	9521	68.66929133858268	81.48870916920491
chr19	PWWP3A	1358587	1358700	11794	114	784575	9648	772781	9534	103.45614035087719	81.05527585483533
chr19	PWWP3A	1358587	1358693	11256	107	784575	9648	773319	9541	105.19626168224299	81.05219578660518
chr19	PWWP3A	1371233	1371390	1818	158	784575	9648	782757	9490	11.50632911392405	82.4822971548999
chr19	NDUFS7	1386517	1386639	0	123	242247	4310	242247	4187	0.0	57.85693814186769
chr19	DAZAP1	1418665	1418731	71504	67	2623231	4295	2551727	4228	1067.2238805970148	603.5305108798486
chr19	DAZAP1	1425877	1425960	197503	84	2623231	4295	2425728	4211	2351.2261904761904	576.045594870577
chr19	DAZAP1	1433738	1433827	2201	90	2623231	4295	2621030	4205	24.455555555555556	623.3127229488704
chr19	RPS15	1439715	1439826	3627	112	2178720	1135	2175093	1023	32.38392857142857	2126.190615835777
chr19	RPS15	1439605	1439826	6055	222	2178720	1135	2172665	913	27.274774774774773	2379.6987951807228
chr19	REEP6	1496590	1496671	0	82	7205	1718	7205	1636	0.0	4.404034229828851
chr19	PLK5	1533930	1534041	0	112	306	3988	306	3876	0.0	0.07894736842105263
chr19	PLK5	1533718	1533848	0	131	306	3988	306	3857	0.0	0.07933627171376717
chr19	SCAMP4	1914978	1915026	1631	49	712462	6808	710831	6759	33.285714285714285	105.16807220002958
chr19	SCAMP4	1918888	1918990	21685	103	712462	6808	690777	6705	210.53398058252426	103.0241610738255
chr19	SCAMP4	1915431	1915544	486	114	712462	6808	711976	6694	4.2631578947368425	106.3603226770242
chr19	CSNK1G2	1979162	1979248	20528	87	430261	3302	409733	3215	235.95402298850576	127.44416796267497
chr19	IZUMO4	2097928	2097955	0	28	2464	2228	2464	2200	0.0	1.12
chr19	IZUMO4	2098051	2098127	0	77	2464	2228	2464	2151	0.0	1.1455137145513714
chr19	IZUMO4	2098786	2098804	0	19	2464	2228	2464	2209	0.0	1.1154368492530558
chr19	IZUMO4	2098975	2099029	0	55	2464	2228	2464	2173	0.0	1.1339162448228255
chr19	DOT1L	2188196	2188289	332	94	646918	9654	646586	9560	3.5319148936170213	67.63451882845189
chr19	DOT1L	2227362	2227467	0	106	646918	9654	646918	9548	0.0	67.75429409300376
chr19	AMH	2250336	2250479	1750	144	15487	1828	13737	1684	12.152777777777779	8.157363420427554
chr19	OAZ1	2271384	2271530	401724	147	2684215	2110	2282491	1963	2732.816326530612	1162.7564951604686
chr19	SPPL2B	2337114	2337333	546	220	498031	7292	497485	7072	2.481818181818182	70.34572963800905
chr19	SPPL2B	2330296	2330419	131	124	498031	7292	497900	7168	1.0564516129032258	69.46149553571429
chr19	THOP1	2786948	2787034	295	87	564445	6896	564150	6809	3.3908045977011496	82.85357614921428
chr19	THOP1	2812198	2812372	5899	175	564445	6896	558546	6721	33.70857142857143	83.10459753012944
chr19	ZNF554	2826249	2826346	87	98	102042	5660	101955	5562	0.8877551020408163	18.330636461704422
chr19	ZNF554	2833162	2833269	0	108	102042	5660	102042	5552	0.0	18.379322766570606
chr19	ZNF57	2912135	2912261	92	127	43415	2312	43323	2185	0.7244094488188977	19.827459954233408
chr19	TLE6	2978197	2978284	0	88	9070	3014	9070	2926	0.0	3.099794941900205
chr19	GNA11	3110148	3110333	42896	186	591700	4595	548804	4409	230.6236559139785	124.47357677477886
chr19	GNA15	3146402	3146591	0	190	1348	2761	1348	2571	0.0	0.5243096071567483
chr19	NFIC	3425105	3425177	29120	73	1817628	9816	1788508	9743	398.90410958904107	183.5685107256492
chr19	NFIC	3453762	3453916	19631	155	1817628	9816	1797997	9661	126.65161290322581	186.10878791015423
chr19	NFIC	3456549	3456635	40553	87	1817628	9816	1777075	9729	466.1264367816092	182.65751875835133
chr19	TJP3	3728423	3728480	0	58	4536	3987	4536	3929	0.0	1.1544922372104862
chr19	ATCAY	3895126	3895197	0	72	53390	5037	53390	4965	0.0	10.753272910372608
chr19	ATCAY	3922158	3922222	108	65	53390	5037	53282	4972	1.6615384615384616	10.716411906677394
chr19	NMRK2	3933457	3933697	0	241	346	1149	346	908	0.0	0.381057268722467
chr19	PIAS4	4024035	4024120	10676	86	256863	3520	246187	3434	124.13953488372093	71.69103086779266
chr19	CREB3L3	4168350	4168457	0	108	102	2658	102	2550	0.0	0.04
chr19	ANKRD24	4199682	4199769	0	88	3288	4499	3288	4411	0.0	0.7454092042620721
chr19	SHD	4288242	4288362	0	121	867	2071	867	1950	0.0	0.44461538461538463
chr19	MPND	4358082	4358172	8768	91	110818	2062	102050	1971	96.35164835164835	51.77574835109082
chr19	MPND	4357950	4358172	11290	223	110818	2062	99528	1839	50.62780269058296	54.12071778140294
chr19	CHAF1A	4405911	4405962	17942	52	1127690	4343	1109748	4291	345.03846153846155	258.6222325798182
chr19	CHAF1A	4418019	4418076	12001	58	1127690	4343	1115689	4285	206.91379310344828	260.3708284714119
chr19	CHAF1A	4422565	4422795	57582	231	1127690	4343	1070108	4112	249.27272727272728	260.24027237354085
chr19	HDGFL2	4501190	4501317	34144	128	1001214	3828	967070	3700	266.75	261.3702702702703
chr19	MIR7-3HG	4770545	4770614	0	70	0	2134	0	2064	0.0	0.0
chr19	MIR7-3HG	4770282	4770449	0	168	0	2134	0	1966	0.0	0.0
chr19	MIR7-3HG	4770084	4770221	0	138	0	2134	0	1996	0.0	0.0
chr19	MIR7-3HG	4770548	4770614	0	67	0	2134	0	2067	0.0	0.0
chr19	MIR7-3HG	4770347	4770449	0	103	0	2134	0	2031	0.0	0.0
chr19	MIR7-3HG	4770087	4770221	0	135	0	2134	0	1999	0.0	0.0
chr19	MIR7-3HG	4770523	4770614	0	92	0	2134	0	2042	0.0	0.0
chr19	MIR7-3HG	4770528	4770614	0	87	0	2134	0	2047	0.0	0.0
chr19	KDM4B	5016256	5016339	4985	84	509545	10890	504560	10806	59.345238095238095	46.6925781972978
chr19	KDM4B	5119117	5119219	6463	103	509545	10890	503082	10787	62.74757281553398	46.637804764994904
chr19	SAFB	5648988	5649499	122518	512	1203865	4981	1081347	4469	239.29296875	241.96621168046542
chr19	SAFB	5641739	5641946	135430	208	1203865	4981	1068435	4773	651.1057692307693	223.8497800125707
chr19	SAFB	5641593	5641658	19748	66	1203865	4981	1184117	4915	299.2121212121212	240.91902339776195
chr19	HSD11B1L	5684988	5685119	5225	132	94088	2790	88863	2658	39.583333333333336	33.432279909706544
chr19	HSD11B1L	5686415	5686527	818	113	94088	2790	93270	2677	7.238938053097345	34.84124019424729
chr19	HSD11B1L	5684818	5684905	4279	88	94088	2790	89809	2702	48.625	33.2379718726869
chr19	HSD11B1L	5686899	5686991	928	93	94088	2790	93160	2697	9.978494623655914	34.54208379681127
chr19	HSD11B1L	5684964	5685119	5556	156	94088	2790	88532	2634	35.61538461538461	33.61123766135156
chr19	HSD11B1L	5684021	5684121	657	101	94088	2790	93431	2689	6.5049504950495045	34.74563034585348
chr19	HSD11B1L	5684992	5685119	5162	128	94088	2790	88926	2662	40.328125	33.405709992486855
chr19	ACSBG2	6156430	6156551	0	122	6700	3462	6700	3340	0.0	2.0059880239520957
chr19	ACSBG2	6190583	6190692	1168	110	6700	3462	5532	3352	10.618181818181819	1.6503579952267302
chr19	ACSBG2	6137311	6137415	0	105	6700	3462	6700	3357	0.0	1.9958296097706285
chr19	ACSBG2	6175290	6175429	0	140	6700	3462	6700	3322	0.0	2.0168573148705597
chr19	CLPP	6364451	6364639	139245	189	462189	3032	322944	2843	736.7460317460317	113.59268378473443
chr19	CLPP	6366257	6366363	44795	107	462189	3032	417394	2925	418.6448598130841	142.6988034188034
chr19	AC011491.1	6400107	6400221	0	115	0	710	0	595	0.0	0.0
chr19	TRIP10	6741224	6741281	44714	58	1308165	3888	1263451	3830	770.9310344827586	329.8827676240209
chr19	TRIP10	6746028	6746196	19295	169	1308165	3888	1288870	3719	114.17159763313609	346.5635923635386
chr19	VAV1	6822418	6822514	0	97	462	4339	462	4242	0.0	0.10891089108910891
chr19	VAV1	6836984	6837050	0	67	462	4339	462	4272	0.0	0.10814606741573034
chr19	ADGRE1	6897148	6897304	0	157	0	3729	0	3572	0.0	0.0
chr19	ADGRE1	6904035	6904182	0	148	0	3729	0	3581	0.0	0.0
chr19	ADGRE1	6924677	6924872	0	196	0	3729	0	3533	0.0	0.0
chr19	MCOLN1	7527519	7527628	0	110	42621	3878	42621	3768	0.0	11.311305732484076
chr19	PNPLA6	7534378	7534446	0	69	65533	6495	65533	6426	0.0	10.198101462807346
chr19	PNPLA6	7541983	7542067	897	85	65533	6495	64636	6410	10.552941176470588	10.08361934477379
chr19	PNPLA6	7543006	7543084	1355	79	65533	6495	64178	6416	17.151898734177216	10.00280548628429
chr19	PNPLA6	7560647	7560764	0	118	65533	6495	65533	6377	0.0	10.27646228634154
chr19	PNPLA6	7535126	7535213	5014	88	65533	6495	60519	6407	56.97727272727273	9.44576244732324
chr19	PNPLA6	7535126	7535202	4416	77	65533	6495	61117	6418	57.35064935064935	9.522748519788095
chr19	PET100	7630572	7630659	0	88	0	1104	0	1016	0.0	0.0
chr19	STXBP2	7641704	7641853	0	150	306	4772	306	4622	0.0	0.06620510601471224
chr19	PET100	7631231	7631321	0	91	0	1104	0	1013	0.0	0.0
chr19	STXBP2	7643164	7643245	0	82	306	4772	306	4690	0.0	0.06524520255863539
chr19	STXBP2	7646248	7646344	0	97	306	4772	306	4675	0.0	0.06545454545454546
chr19	STXBP2	7647353	7647511	0	159	306	4772	306	4613	0.0	0.06633427270756558
chr19	STXBP2	7644878	7644934	0	57	306	4772	306	4715	0.0	0.06489925768822906
chr19	STXBP2	7646171	7646344	0	174	306	4772	306	4598	0.0	0.0665506742061766
chr19	RETN	7669820	7669898	0	79	550	520	550	441	0.0	1.2471655328798186
chr19	MCEMP1	7677636	7677726	240	91	4494	1913	4254	1822	2.6373626373626373	2.3347969264544455
chr19	CLEC4M	7763392	7763476	0	85	51	3275	51	3190	0.0	0.01598746081504702
chr19	CLEC4M	7767515	7767628	0	114	51	3275	51	3161	0.0	0.016134134767478645
chr19	CLEC4M	7765184	7765268	0	85	51	3275	51	3190	0.0	0.01598746081504702
chr19	EVI5L	7857091	7857124	0	34	9	5020	9	4986	0.0	0.0018050541516245488
chr19	LRRC8E	7893716	7893859	0	144	456	4333	456	4189	0.0	0.10885652900453568
chr19	LRRC8E	7895598	7895741	0	144	456	4333	456	4189	0.0	0.10885652900453568
chr19	MAP2K7	7905807	7905855	0	49	22240	5033	22240	4984	0.0	4.462279293739968
chr19	CCL25	8056365	8056499	5508	135	9458	995	3950	860	40.8	4.593023255813954
chr19	CERS4	8251043	8251249	0	207	204	3466	204	3259	0.0	0.06259588830929733
chr19	CERS4	8210682	8210862	0	181	204	3466	204	3285	0.0	0.062100456621004566
chr19	CERS4	8251075	8251249	0	175	204	3466	204	3291	0.0	0.06198723792160438
chr19	CERS4	8251109	8251249	0	141	204	3466	204	3325	0.0	0.06135338345864662
chr19	CERS4	8210705	8210862	0	158	204	3466	204	3308	0.0	0.06166868198307134
chr19	ANGPTL4	8369218	8369332	612	115	8411	2482	7799	2367	5.321739130434783	3.2948880439374735
chr19	RAB11B	8399862	8400058	0	197	193	2315	193	2118	0.0	0.091123701605288
chr19	MARCHF2	8418536	8418807	51	272	89344	2076	89293	1804	0.1875	49.497228381374725
chr19	MARCHF2	8418741	8418807	0	67	89344	2076	89344	2009	0.0	44.47187655550025
chr19	MARCHF2	8430657	8430867	6081	211	89344	2076	83263	1865	28.819905213270143	44.64504021447721
chr19	HNRNPM	8462528	8462581	0	54	26584	4301	26584	4247	0.0	6.259477278078644
chr19	HNRNPM	8465479	8465515	0	37	26584	4301	26584	4264	0.0	6.23452157598499
chr19	HNRNPM	8473663	8473708	0	46	26584	4301	26584	4255	0.0	6.247708578143361
chr19	HNRNPM	8483157	8483211	4449	55	26584	4301	22135	4246	80.89090909090909	5.213141780499294
chr19	HNRNPM	8488008	8488066	0	59	26584	4301	26584	4242	0.0	6.266855256954267
chr19	NFILZ	8638492	8638656	0	165	419	1698	419	1533	0.0	0.27332028701891714
chr19	ZNF317	9155924	9156041	0	118	0	5054	0	4936	0.0	0.0
chr19	ZNF317	9157979	9158075	0	97	0	5054	0	4957	0.0	0.0
chr19	ZNF317	9157833	9158075	0	243	0	5054	0	4811	0.0	0.0
chr19	OR7D2	9180697	9180788	49	92	49	3289	0	3197	0.532608695652174	0.0
chr19	ZNF559-ZNF177	9339192	9339319	0	128	3	3733	3	3605	0.0	0.0008321775312066575
chr19	ZNF559-ZNF177	9337795	9337858	0	64	3	3733	3	3669	0.0	0.0008176614881439084
chr19	ZNF559-ZNF177	9371609	9371752	0	144	3	3733	3	3589	0.0	0.0008358874338255781
chr19	ZNF559-ZNF177	9333014	9333113	0	100	3	3733	3	3633	0.0	0.0008257638315441783
chr19	ZNF559-ZNF177	9341101	9341184	0	84	3	3733	3	3649	0.0	0.000822143052891203
chr19	ZNF559-ZNF177	9364861	9364948	0	88	3	3733	3	3645	0.0	0.0008230452674897119
chr19	ZNF561-AS1	9627715	9627806	0	92	94379	6441	94379	6349	0.0	14.865175618207592
chr19	ZNF561-AS1	9626783	9626860	0	78	94379	6441	94379	6363	0.0	14.832468961181833
chr19	ZNF561-AS1	9626783	9627806	0	1024	94379	6441	94379	5417	0.0	17.422743215802104
chr19	PIN1	9838011	9838075	0	65	421	2938	421	2873	0.0	0.14653672119735467
chr19	RDH8	10018730	10018910	0	181	0	2007	0	1826	0.0	0.0
chr19	C3P1	10044070	10044199	51	130	590	4999	539	4869	0.3923076923076923	0.11070034914766892
chr19	C3P1	10052761	10052974	0	214	590	4999	590	4785	0.0	0.12330198537095088
chr19	SHFL	10089110	10089378	0	269	0	3788	0	3519	0.0	0.0
chr19	PPAN	10106822	10107005	0	184	395	2799	395	2615	0.0	0.15105162523900573
chr19	MRPL4	10256707	10256825	360	119	258290	3641	257930	3522	3.0252100840336134	73.23395797842136
chr19	PDE4A	10459594	10459759	0	166	332723	6586	332723	6420	0.0	51.82601246105919
chr19	ATG4D	10546838	10547115	473	278	1544	2174	1071	1896	1.7014388489208634	0.564873417721519
chr19	ATG4D	10552204	10552324	0	121	1544	2174	1544	2053	0.0	0.7520701412566975
chr19	ATG4D	10546838	10547071	473	234	1544	2174	1071	1940	2.0213675213675213	0.5520618556701031
chr19	ATG4D	10547188	10547253	0	66	1544	2174	1544	2108	0.0	0.7324478178368121
chr19	ATG4D	10548903	10549034	0	132	1544	2174	1544	2042	0.0	0.7561214495592556
chr19	ATG4D	10546838	10547082	473	245	1544	2174	1071	1929	1.9306122448979592	0.5552099533437014
chr19	SLC44A2	10627721	10627795	0	75	13539	4084	13539	4009	0.0	3.37715140932901
chr19	SLC44A2	10638022	10638093	0	72	13539	4084	13539	4012	0.0	3.3746261216350946
chr19	SLC44A2	10627919	10628004	0	86	13539	4084	13539	3998	0.0	3.3864432216108056
chr19	SLC44A2	10642896	10643021	0	126	13539	4084	13539	3958	0.0	3.42066700353714
chr19	ILF3	10671357	10671535	1716	179	61657	9698	59941	9519	9.58659217877095	6.296984977413594
chr19	ILF3	10678612	10678704	0	93	61657	9698	61657	9605	0.0	6.419260801665799
chr19	ILF3	10680345	10680443	51	99	61657	9698	61606	9599	0.5151515151515151	6.417960204187937
chr19	ILF3	10687345	10687708	0	364	61657	9698	61657	9334	0.0	6.605635311763446
chr19	ILF3	10684415	10684476	0	62	61657	9698	61657	9636	0.0	6.398609381486094
chr19	ILF3	10666491	10666649	785	159	61657	9698	60872	9539	4.937106918238993	6.38138169619457
chr19	QTRT1	10706709	10706825	0	117	15045	2287	15045	2170	0.0	6.933179723502304
chr19	QTRT1	10709280	10709364	0	85	15045	2287	15045	2202	0.0	6.832425068119891
chr19	DNM2	10808568	10808580	0	13	1887767	9503	1887767	9490	0.0	198.92170706006323
chr19	DNM2	10803638	10803668	0	31	1887767	9503	1887767	9472	0.0	199.29972550675674
chr19	CARM1	10904950	10905076	0	127	241107	4435	241107	4308	0.0	55.96727019498607
chr19	CARM1	10920435	10920573	2275	139	241107	4435	238832	4296	16.366906474820144	55.59404096834265
chr19	CARM1	10921374	10921443	247	70	241107	4435	240860	4365	3.5285714285714285	55.179839633447884
chr19	CARM1	10908549	10908747	3651	199	241107	4435	237456	4236	18.34673366834171	56.05665722379604
chr19	CARM1	10908549	10908668	2687	120	241107	4435	238420	4315	22.391666666666666	55.25376593279258
chr19	CARM1	10908549	10908633	2442	85	241107	4435	238665	4350	28.729411764705883	54.86551724137931
chr19	SMARCA4	11010380	11010531	0	152	1007126	15628	1007126	15476	0.0	65.07663478935126
chr19	SMARCA4	11039457	11039553	543	97	1007126	15628	1006583	15531	5.597938144329897	64.81121627712318
chr19	SMARCA4	11058787	11058889	51	103	1007126	15628	1007075	15525	0.49514563106796117	64.86795491143317
chr19	SMARCA4	11033766	11033865	21416	100	1007126	15628	985710	15528	214.16	63.47952086553323
chr19	SMARCA4	10980776	10980852	0	77	1007126	15628	1007126	15551	0.0	64.76278052858338
chr19	SMARCA4	10977652	10977815	98	164	1007126	15628	1007028	15464	0.5975609756097561	65.12079668908433
chr19	SMARCA4	10983479	10983711	0	233	1007126	15628	1007126	15395	0.0	65.41903215329653
chr19	SMARCA4	10965306	10965309	0	4	1007126	15628	1007126	15624	0.0	64.46018945212494
chr19	SMARCA4	11056216	11056382	0	167	1007126	15628	1007126	15461	0.0	65.13977103680227
chr19	SMARCA4	11007901	11008023	0	123	1007126	15628	1007126	15505	0.0	64.95491776846178
chr19	SMARCA4	11033771	11033865	20218	95	1007126	15628	986908	15533	212.82105263157894	63.53621322345973
chr19	SMARCA4	11047594	11047795	0	202	1007126	15628	1007126	15426	0.0	65.28756644625956
chr19	LDLR	11102663	11102786	0	124	99028	6361	99028	6237	0.0	15.877505210838544
chr19	LDLR	11105219	11105600	45737	382	99028	6361	53291	5979	119.7303664921466	8.91302893460445
chr19	LDLR	11110651	11110771	0	121	99028	6361	99028	6240	0.0	15.869871794871795
chr19	LDLR	11116858	11116998	0	141	99028	6361	99028	6220	0.0	15.920900321543408
chr19	LDLR	11120369	11120522	49	154	99028	6361	98979	6207	0.3181818181818182	15.946350894151765
chr19	LDLR	11106564	11106687	0	124	99028	6361	99028	6237	0.0	15.877505210838544
chr19	ANGPTL8	11240134	11240296	41552	163	45431	1229	3879	1066	254.920245398773	3.6388367729831144
chr19	TSPAN16	11298871	11298946	635	76	13300	1568	12665	1492	8.355263157894736	8.488605898123325
chr19	TSPAN16	11307861	11308061	621	201	13300	1568	12679	1367	3.08955223880597	9.275054864667155
chr19	CCDC159	11348965	11349083	1766	119	24270	3263	22504	3144	14.840336134453782	7.157760814249364
chr19	CCDC159	11352056	11352133	86	78	24270	3263	24184	3185	1.1025641025641026	7.59309262166405
chr19	CNN1	11539294	11539560	40	267	258392	2816	258352	2549	0.149812734082397	101.35425657120439
chr19	CNN1	11549322	11549469	23	148	258392	2816	258369	2668	0.1554054054054054	96.83995502248875
chr19	CNN1	11539294	11539569	112	276	258392	2816	258280	2540	0.4057971014492754	101.68503937007874
chr19	ZNF627	11604209	11604364	613	156	731274	3821	730661	3665	3.9294871794871793	199.3618008185539
chr19	ZNF833P	11684113	11684165	0	53	120	1596	120	1543	0.0	0.07777057679844458
chr19	ZNF441	11778115	11778179	555	65	874781	4753	874226	4688	8.538461538461538	186.4816552901024
chr19	ZNF491	11804541	11804667	459	127	7829	3455	7370	3328	3.6141732283464565	2.214543269230769
chr19	ZNF440	11830282	11830409	0	128	57876	6459	57876	6331	0.0	9.141683778234086
chr19	ZNF440	11830273	11830409	0	137	57876	6459	57876	6322	0.0	9.15469788041759
chr19	ZNF763	11977370	11977431	2447	62	66931	3085	64484	3023	39.46774193548387	21.331128018524645
chr19	AC008770.2	11961660	11961758	0	99	31170	2226	31170	2127	0.0	14.654442877291961
chr19	ZNF763	11977037	11977164	1800	128	66931	3085	65131	2957	14.0625	22.026039905309435
chr19	ZNF844	12074360	12074421	0	62	41080	6592	41080	6530	0.0	6.2909647779479325
chr19	ZNF433-AS1	12001773	12001822	117	50	38405	5851	38288	5801	2.34	6.600241337700396
chr19	ZNF433-AS1	11990168	11990381	0	214	38405	5851	38405	5637	0.0	6.81302111051978
chr19	ZNF844	12074030	12074157	1530	128	41080	6592	39550	6464	11.953125	6.118502475247524
chr19	ZNF788P	12094065	12094184	0	120	25859	5701	25859	5581	0.0	4.633399032431464
chr19	ZNF788P	12093835	12093895	6	61	25859	5701	25853	5640	0.09836065573770492	4.58386524822695
chr19	ZNF788P	12110633	12110694	110	62	25859	5701	25749	5639	1.7741935483870968	4.5662351480759
chr19	ZNF136	12169281	12169391	0	111	160107	5383	160107	5272	0.0	30.369309559939303
chr19	ZNF136	12164465	12164874	0	410	160107	5383	160107	4973	0.0	32.19525437361754
chr19	ZNF136	12185784	12185911	40	128	160107	5383	160067	5255	0.3125	30.459942911512844
chr19	AC012618.3	12234712	12234824	62	113	19767	3146	19705	3033	0.5486725663716814	6.496867787668974
chr19	AC012618.3	12202319	12202551	0	233	19767	3146	19767	2913	0.0	6.785787847579814
chr19	ZNF791	12612225	12612365	459	141	11941	6647	11482	6506	3.25531914893617	1.7648324623424532
chr19	ZNF791	12624649	12624710	631	62	11941	6647	11310	6585	10.17741935483871	1.7175398633257404
chr19	ZNF791	12612225	12612316	459	92	11941	6647	11482	6555	4.989130434782608	1.7516399694889397
chr19	ZNF791	12623699	12623826	0	128	11941	6647	11941	6519	0.0	1.83172265684921
chr19	WDR83	12672462	12672549	51	88	19016	1664	18965	1576	0.5795454545454546	12.033629441624365
chr19	RNASEH2A	12807205	12807329	3312	125	145163	1973	141851	1848	26.496	76.75919913419914
chr19	MAST1	12843528	12843607	4	80	377052	6561	377048	6481	0.05	58.17744175281592
chr19	GCDH	12891486	12891522	0	37	4111	4015	4111	3978	0.0	1.033433886375063
chr19	GCDH	12892115	12892178	312	64	4111	4015	3799	3951	4.875	0.9615287269045811
chr19	GCDH	12891486	12891660	0	175	4111	4015	4111	3840	0.0	1.0705729166666667
chr19	GCDH	12892316	12892434	0	119	4111	4015	4111	3896	0.0	1.0551848049281314
chr19	GCDH	12892386	12892434	0	49	4111	4015	4111	3966	0.0	1.0365607665153806
chr19	CALR	12939427	12939631	1486	205	3048	2690	1562	2485	7.248780487804878	0.6285714285714286
chr19	RAD23A	12949080	12949159	344	80	6750	2229	6406	2149	4.3	2.9809213587715218
chr19	RAD23A	12952688	12952853	612	166	6750	2229	6138	2063	3.6867469879518073	2.9752787203102278
chr19	RAD23A	12948496	12948552	70	57	6750	2229	6680	2172	1.2280701754385965	3.0755064456721914
chr19	RAD23A	12951491	12951589	0	99	6750	2229	6750	2130	0.0	3.1690140845070425
chr19	RAD23A	12948513	12948552	0	40	6750	2229	6750	2189	0.0	3.083599817268159
chr19	RAD23A	12952688	12952820	612	133	6750	2229	6138	2096	4.601503759398496	2.928435114503817
chr19	DAND5	12970450	12970535	357	86	33401	2001	33044	1915	4.151162790697675	17.255352480417756
chr19	NFIX	13078612	13078735	0	124	4126	3883	4126	3759	0.0	1.097632349028997
chr19	NFIX	13087988	13088136	0	149	4126	3883	4126	3734	0.0	1.1049812533476164
chr19	CCDC130	13751607	13751811	0	205	51	3082	51	2877	0.0	0.017726798748696558
chr19	MRI1	13765953	13766065	0	113	102	3471	102	3358	0.0	0.030375223347230494
chr19	MRI1	13765953	13766129	0	177	102	3471	102	3294	0.0	0.030965391621129327
chr19	C19ORF53	13774651	13774707	0	57	51	1201	51	1144	0.0	0.044580419580419584
chr19	C19ORF53	13775470	13775613	0	144	51	1201	51	1057	0.0	0.048249763481551564
chr19	C19ORF53	13775476	13775613	0	138	51	1201	51	1063	0.0	0.04797742238946378
chr19	ZSWIM4	13814514	13814865	879	352	3338	4727	2459	4375	2.497159090909091	0.5620571428571428
chr19	CC2D1A	13919817	13919951	5617	135	39549	4964	33932	4829	41.60740740740741	7.026713605301304
chr19	DCAF15	13953029	13953308	231	280	3616	2900	3385	2620	0.825	1.2919847328244274
chr19	RLN3	14030244	14030356	16585	113	70543	1204	53958	1091	146.76991150442478	49.45737855178735
chr19	ADGRE5	14388449	14388500	0	52	845	5308	845	5256	0.0	0.16076864535768645
chr19	ADGRE5	14397888	14397935	0	48	845	5308	845	5260	0.0	0.16064638783269963
chr19	ADGRE5	14396341	14396473	0	133	845	5308	845	5175	0.0	0.16328502415458937
chr19	ADGRE5	14397076	14397223	0	148	845	5308	845	5160	0.0	0.16375968992248063
chr19	PKN1	14434589	14434654	0	66	6403	4395	6403	4329	0.0	1.479094479094479
chr19	PKN1	14471101	14471426	508	326	6403	4395	5895	4069	1.5582822085889572	1.4487589088228066
chr19	TECR	14564948	14564992	0	45	63548	5686	63548	5641	0.0	11.265378478993087
chr19	TECR	14565617	14565663	0	47	63548	5686	63548	5639	0.0	11.26937400248271
chr19	TECR	14545113	14545180	0	68	63548	5686	63548	5618	0.0	11.311498754004983
chr19	CLEC17A	14600030	14600182	8628	153	36097	3130	27469	2977	56.3921568627451	9.22707423580786
chr19	CLEC17A	14606992	14607102	0	111	36097	3130	36097	3019	0.0	11.956608148393508
chr19	ZNF333	14701583	14701897	0	315	5424665	10691	5424665	10376	0.0	522.8088858905165
chr19	SYDE1	15111631	15111792	0	162	153	3522	153	3360	0.0	0.045535714285714284
chr19	CYP4F8	15622218	15622340	0	123	271	4309	271	4186	0.0	0.06473960821786909
chr19	CYP4F8	15628760	15628843	0	84	271	4309	271	4225	0.0	0.06414201183431953
chr19	CYP4F8	15628530	15628595	0	66	271	4309	271	4243	0.0	0.0638699033702569
chr19	CYP4F3	15643906	15644051	0	146	315	5101	315	4955	0.0	0.06357214934409687
chr19	CYP4F3	15645718	15645863	0	146	315	5101	315	4955	0.0	0.06357214934409687
chr19	CYP4F12	15678260	15678405	0	146	123	4073	123	3927	0.0	0.03132161955691368
chr19	CYP4F12	15678260	15678329	0	70	123	4073	123	4003	0.0	0.030726954783912065
chr19	UCA1	15831254	15831356	0	103	561	2973	561	2870	0.0	0.1954703832752613
chr19	UCA1	15834501	15835114	561	614	561	2973	0	2359	0.9136807817589576	0.0
chr19	UCA1	15834973	15835114	0	142	561	2973	561	2831	0.0	0.19816319321794418
chr19	UCA1	15831197	15831356	0	160	561	2973	561	2813	0.0	0.1994312122289371
chr19	UCA1	15831254	15831337	0	84	561	2973	561	2889	0.0	0.19418483904465214
chr19	UCA1	15831207	15831356	0	150	561	2973	561	2823	0.0	0.19872476089266738
chr19	UCA1	15835217	15835280	0	64	561	2973	561	2909	0.0	0.19284977655551735
chr19	UCA1	15834635	15835114	0	480	561	2973	561	2493	0.0	0.2250300842358604
chr19	UCA1	15834575	15835114	44	540	561	2973	517	2433	0.08148148148148149	0.21249486230990547
chr19	UCA1	15832512	15832588	0	77	561	2973	561	2896	0.0	0.19371546961325967
chr19	UCA1	15834501	15835280	561	780	561	2973	0	2193	0.7192307692307692	0.0
chr19	UCA1	15833570	15833632	0	63	561	2973	561	2910	0.0	0.19278350515463918
chr19	LINC00905	16034479	16034637	0	159	5	3588	5	3429	0.0	0.0014581510644502771
chr19	TPM4	16081912	16082046	0	135	51	9477	51	9342	0.0	0.005459216441875401
chr19	TPM4	16095263	16095357	0	95	51	9477	51	9382	0.0	0.005435941163930932
chr19	TPM4	16093039	16093132	0	94	51	9477	51	9383	0.0	0.005435361824576362
chr19	TPM4	16095263	16095893	0	631	51	9477	51	8846	0.0	0.005765317657698395
chr19	TPM4	16077956	16078149	0	194	51	9477	51	9283	0.0	0.0054939136055154585
chr19	TPM4	16081019	16081075	0	57	51	9477	51	9420	0.0	0.005414012738853503
chr19	HSH2D	16148723	16148875	0	153	102	3407	102	3254	0.0	0.0313460356484327
chr19	HSH2D	16151446	16151578	0	133	102	3407	102	3274	0.0	0.031154551007941355
chr19	HSH2D	16155641	16155763	0	123	102	3407	102	3284	0.0	0.031059683313032885
chr19	FAM32A	16190519	16190573	9533	55	471732	1896	462199	1841	173.3272727272727	251.05866376969038
chr19	FAM32A	16189387	16189511	85703	125	471732	1896	386029	1771	685.624	217.97233201581028
chr19	AP1M1	16228769	16228928	0	160	729512	13929	729512	13769	0.0	52.98220640569395
chr19	AP1M1	16210359	16210395	863	37	729512	13929	728649	13892	23.324324324324323	52.45097898070832
chr19	AP1M1	16202988	16203101	39	114	729512	13929	729473	13815	0.34210526315789475	52.80296778863554
chr19	AP1M1	16202946	16203101	39	156	729512	13929	729473	13773	0.25	52.96398751179844
chr19	KLF2	16325215	16326032	1275	818	5735	2823	4460	2005	1.558679706601467	2.224438902743142
chr19	C19ORF44	16503064	16503380	23860	317	40515	4349	16655	4032	75.26813880126183	4.130704365079365
chr19	C19ORF44	16513013	16513109	5111	97	40515	4349	35404	4252	52.69072164948454	8.326434619002821
chr19	C19ORF44	16514496	16514663	11187	168	40515	4349	29328	4181	66.58928571428571	7.014589811049988
chr19	C19ORF44	16514549	16514663	10394	115	40515	4349	30121	4234	90.38260869565218	7.114076523382145
chr19	C19ORF44	16499473	16499620	102	148	40515	4349	40413	4201	0.6891891891891891	9.619852416091407
chr19	NWD1	16724365	16724463	0	99	224304	9155	224304	9056	0.0	24.768551236749115
chr19	NWD1	16794462	16794553	37	92	224304	9155	224267	9063	0.40217391304347827	24.74533818823789
chr19	NWD1	16721397	16721617	0	221	224304	9155	224304	8934	0.0	25.106783075889858
chr19	NWD1	16721394	16721617	0	224	224304	9155	224304	8931	0.0	25.11521666106819
chr19	NWD1	16812744	16812850	0	107	224304	9155	224304	9048	0.0	24.79045092838196
chr19	NWD1	16738225	16738269	301	45	224304	9155	224003	9110	6.688888888888889	24.58869374313941
chr19	NWD1	16738225	16738292	301	68	224304	9155	224003	9087	4.426470588235294	24.650929899856937
chr19	SIN3B	16862883	16862979	0	97	2009	8288	2009	8191	0.0	0.2452691979001343
chr19	MYO9B	17180926	17181040	290	115	248138	9359	247848	9244	2.5217391304347827	26.811769796624837
chr19	MYO9B	17210332	17210380	0	49	248138	9359	248138	9310	0.0	26.65284640171858
chr19	MYO9B	17177796	17177886	0	91	248138	9359	248138	9268	0.0	26.77362969356927
chr19	USE1	17215801	17215851	3963	51	20143	1745	16180	1694	77.70588235294117	9.551357733175916
chr19	USE1	17219212	17219387	497	176	20143	1745	19646	1569	2.8238636363636362	12.521351179094966
chr19	OCEL1	17227839	17228005	561	167	3283	1754	2722	1587	3.3592814371257487	1.7151858853182105
chr19	OCEL1	17228802	17228915	51	114	3283	1754	3232	1640	0.4473684210526316	1.9707317073170731
chr19	BABAM1	17271596	17271655	139	60	12248	1792	12109	1732	2.316666666666667	6.991339491916859
chr19	BABAM1	17273903	17274024	7307	122	12248	1792	4941	1670	59.89344262295082	2.958682634730539
chr19	BABAM1	17277383	17277479	0	97	12248	1792	12248	1695	0.0	7.225958702064896
chr19	ANKLE1	17285680	17285819	0	140	118153	3243	118153	3103	0.0	38.077022236545275
chr19	ANKLE1	17284088	17284266	0	179	118153	3243	118153	3064	0.0	38.56168407310705
chr19	MRPL34	17298311	17298377	368	67	69170	1418	68802	1351	5.492537313432836	50.926720947446334
chr19	GTPBP3	17338953	17339026	1270	74	85313	3908	84043	3834	17.16216216216216	21.920448617631717
chr19	BISPR	17413096	17413305	451	210	9874	3025	9423	2815	2.1476190476190475	3.347424511545293
chr19	MVB12A	17422331	17422458	2035	128	55436	3168	53401	3040	15.8984375	17.566118421052632
chr19	MVB12A	17424620	17424677	180	58	55436	3168	55256	3110	3.103448275862069	17.767202572347266
chr19	SLC27A1	17486562	17487335	0	774	0	6378	0	5604	0.0	0.0
chr19	SLC27A1	17483881	17484121	0	241	0	6378	0	6137	0.0	0.0
chr19	SLC27A1	17488847	17488939	0	93	0	6378	0	6285	0.0	0.0
chr19	SLC27A1	17501272	17501419	0	148	0	6378	0	6230	0.0	0.0
chr19	SLC27A1	17500711	17500876	0	166	0	6378	0	6212	0.0	0.0
chr19	PGLS	17516370	17516474	2117	105	35105	1863	32988	1758	20.16190476190476	18.764505119453926
chr19	PGLS	17517709	17517850	128	142	35105	1863	34977	1721	0.9014084507042254	20.323649041255084
chr19	PGLS	17512944	17512968	0	25	35105	1863	35105	1838	0.0	19.099564744287267
chr19	NIBAN3	17530754	17530885	492	132	4305	6554	3813	6422	3.727272727272727	0.5937402678293366
chr19	NIBAN3	17543523	17543631	40	109	4305	6554	4265	6445	0.3669724770642202	0.6617532971295578
chr19	NIBAN3	17549443	17549527	0	85	4305	6554	4305	6469	0.0	0.6654815272839697
chr19	NIBAN3	17549454	17549527	0	74	4305	6554	4305	6480	0.0	0.6643518518518519
chr19	NIBAN3	17530754	17530816	0	63	4305	6554	4305	6491	0.0	0.6632260052380219
chr19	COLGALT1	17572482	17572602	0	121	10608	4112	10608	3991	0.0	2.6579804560260585
chr19	MAP1S	17721250	17721463	0	214	2332	3788	2332	3574	0.0	0.6524902070509233
chr19	MAP1S	17720985	17721037	0	53	2332	3788	2332	3735	0.0	0.6243641231593039
chr19	MAP1S	17720935	17721037	0	103	2332	3788	2332	3685	0.0	0.6328358208955224
chr19	FCHO1	17781230	17781343	0	114	8258	5470	8258	5356	0.0	1.5418222554144885
chr19	FCHO1	17755075	17755191	0	117	8258	5470	8258	5353	0.0	1.5426863441061087
chr19	FCHO1	17755117	17755191	0	75	8258	5470	8258	5395	0.0	1.5306765523632992
chr19	FCHO1	17754591	17754758	0	168	8258	5470	8258	5302	0.0	1.5575254620897774
chr19	FCHO1	17754591	17754621	0	31	8258	5470	8258	5439	0.0	1.5182938040080898
chr19	FCHO1	17758684	17758791	0	108	8258	5470	8258	5362	0.0	1.5400969787392764
chr19	FCHO1	17753691	17753809	3388	119	8258	5470	4870	5351	28.470588235294116	0.91011025976453
chr19	FCHO1	17752283	17752401	1259	119	8258	5470	6999	5351	10.579831932773109	1.3079798168566623
chr19	PIK3R2	18161278	18161495	0	218	102	4944	102	4726	0.0	0.02158273381294964
chr19	PIK3R2	18161053	18161185	0	133	102	4944	102	4811	0.0	0.02120141342756184
chr19	MPV17L2	18194776	18194853	0	78	0	2103	0	2025	0.0	0.0
chr19	PGPEP1	18342858	18342911	0	54	351	2114	351	2060	0.0	0.1703883495145631
chr19	PGPEP1	18357382	18357615	0	234	351	2114	351	1880	0.0	0.18670212765957447
chr19	PGPEP1	18348947	18349068	0	122	351	2114	351	1992	0.0	0.17620481927710843
chr19	PGPEP1	18358005	18358070	0	66	351	2114	351	2048	0.0	0.17138671875
chr19	SSBP4	18427751	18427813	0	63	51542	2816	51542	2753	0.0	18.72212132219397
chr19	SSBP4	18431792	18431862	0	71	51542	2816	51542	2745	0.0	18.776684881602915
chr19	SSBP4	18431352	18431418	0	67	51542	2816	51542	2749	0.0	18.7493634048745
chr19	SSBP4	18425908	18426083	0	176	51542	2816	51542	2640	0.0	19.52348484848485
chr19	KXD1	18567131	18567178	2385	48	28450	3162	26065	3114	49.6875	8.370263326910726
chr19	KXD1	18560419	18560550	0	132	28450	3162	28450	3030	0.0	9.389438943894389
chr19	KXD1	18565133	18565190	0	58	28450	3162	28450	3104	0.0	9.165592783505154
chr19	KXD1	18560099	18560550	0	452	28450	3162	28450	2710	0.0	10.498154981549815
chr19	UBA52	18572350	18572607	31653	258	38683	2211	7030	1953	122.68604651162791	3.599590373783922
chr19	REX1BD	18589478	18589683	0	206	33	1799	33	1593	0.0	0.02071563088512241
chr19	REX1BD	18589412	18589683	0	272	33	1799	33	1527	0.0	0.021611001964636542
chr19	KLHL26	18659686	18659784	0	99	248962	3465	248962	3366	0.0	73.96375519904932
chr19	CRTC1	18744107	18744155	0	49	175640	6980	175640	6931	0.0	25.341220603087578
chr19	DDX49	18920833	18920909	0	77	102	2821	102	2744	0.0	0.03717201166180758
chr19	DDX49	18920844	18920909	0	66	102	2821	102	2755	0.0	0.037023593466424684
chr19	DDX49	18921662	18921748	0	87	102	2821	102	2734	0.0	0.03730797366495977
chr19	ARMC6	19043991	19044074	903	84	66168	4030	65265	3946	10.75	16.53953370501774
chr19	ARMC6	19055790	19055928	0	139	66168	4030	66168	3891	0.0	17.005397070161912
chr19	ARMC6	19037551	19037707	2257	157	66168	4030	63911	3873	14.375796178343949	16.501678285566744
chr19	ARMC6	19039321	19039414	9962	94	66168	4030	56206	3936	105.97872340425532	14.279979674796747
chr19	ARMC6	19034130	19034238	153	109	66168	4030	66015	3921	1.4036697247706422	16.8362662586075
chr19	ARMC6	19042710	19042877	35219	168	66168	4030	30949	3862	209.63690476190476	8.013723459347489
chr19	ARMC6	19040689	19040792	0	104	66168	4030	66168	3926	0.0	16.853795211411107
chr19	ARMC6	19055790	19055977	0	188	66168	4030	66168	3842	0.0	17.222280062467465
chr19	SLC25A42	19101780	19101886	37739	107	297993	4650	260254	4543	352.70093457943926	57.286814880035216
chr19	RFXANK	19197185	19197251	448	67	3315	2341	2867	2274	6.686567164179104	1.2607739665787159
chr19	RFXANK	19198959	19199003	0	45	3315	2341	3315	2296	0.0	1.443815331010453
chr19	RFXANK	19200818	19200893	128	76	3315	2341	3187	2265	1.6842105263157894	1.4070640176600442
chr19	NCAN	19248699	19248882	0	184	7104	6935	7104	6751	0.0	1.0522885498444674
chr19	MAU2	19338844	19338939	0	96	408	10018	408	9922	0.0	0.041120741785930254
chr19	GATAD2A	19436130	19436219	0	90	22182	7305	22182	7215	0.0	3.0744282744282745
chr19	GATAD2A	19492305	19492438	0	134	22182	7305	22182	7171	0.0	3.093292427834333
chr19	GATAD2A	19494293	19494383	0	91	22182	7305	22182	7214	0.0	3.0748544496811756
chr19	GATAD2A	19501968	19502043	56	76	22182	7305	22126	7229	0.7368421052631579	3.0607276248443767
chr19	YJEFN3	19529363	19529513	0	151	258	2966	258	2815	0.0	0.09165186500888099
chr19	ZNF101	19677863	19677990	734	128	39322	4964	38588	4836	5.734375	7.979321753515302
chr19	ZNF101	19677863	19677986	730	124	39322	4964	38592	4840	5.887096774193548	7.973553719008264
chr19	ZNF101	19672209	19672358	0	150	39322	4964	39322	4814	0.0	8.16825924387204
chr19	ZNF253	19878480	19878607	684	128	17837	3129	17153	3001	5.34375	5.7157614128623795
chr19	ZNF253	19880050	19880146	0	97	17837	3129	17837	3032	0.0	5.882915567282322
chr19	ZNF93	19915279	19915406	1952	128	20868	5442	18916	5314	15.25	3.5596537448249905
chr19	ZNF93	19926100	19926221	1453	122	20868	5442	19415	5320	11.90983606557377	3.649436090225564
chr19	ZNF90	20104238	20104365	0	128	69040	6096	69040	5968	0.0	11.568364611260053
chr19	ZNF90	20121221	20121346	233	126	69040	6096	68807	5970	1.8492063492063493	11.525460636515913
chr19	ZNF90	20106947	20107085	0	139	69040	6096	69040	5957	0.0	11.589726372335068
chr19	ZNF85	20934965	20935047	0	83	0	4677	0	4594	0.0	0.0
chr19	ZNF85	20934023	20934150	0	128	0	4677	0	4549	0.0	0.0
chr19	ZNF85	20934948	20935047	0	100	0	4677	0	4577	0.0	0.0
chr19	ZNF85	20934969	20935047	0	79	0	4677	0	4598	0.0	0.0
chr19	ZNF85	20946299	20946389	0	91	0	4677	0	4586	0.0	0.0
chr19	ZNF714	21083977	21084069	0	93	43987	9849	43987	9756	0.0	4.5087125871258715
chr19	ZNF714	21098184	21098311	0	128	43987	9849	43987	9721	0.0	4.524945993210575
chr19	ZNF714	21109622	21109644	180	23	43987	9849	43807	9826	7.826086956521739	4.458273967026257
chr19	ZNF714	21116806	21118885	26260	2080	43987	9849	17727	7769	12.625	2.2817608443815165
chr19	ZNF714	21098811	21098910	0	100	43987	9849	43987	9749	0.0	4.511949943583957
chr19	ZNF431	21175452	21175474	0	23	23622	8821	23622	8798	0.0	2.6849283928165493
chr19	ZNF431	21169802	21169882	26	81	23622	8821	23596	8740	0.32098765432098764	2.699771167048055
chr19	ZNF431	21151078	21151198	0	121	23622	8821	23622	8700	0.0	2.7151724137931033
chr19	ZNF738	21360474	21360596	51	123	47597	3288	47546	3165	0.4146341463414634	15.022432859399684
chr19	ZNF493	21413465	21413508	0	44	4080	9218	4080	9174	0.0	0.4447351209941138
chr19	LINC00664	21488310	21488456	396	147	13278	5905	12882	5758	2.693877551020408	2.2372351510941297
chr19	ZNF429	21553916	21553954	39	39	31989	6761	31950	6722	1.0	4.753049687592978
chr19	ZNF257	22081553	22081670	0	118	357	5178	357	5060	0.0	0.07055335968379446
chr19	ZNF257	22060507	22060628	0	122	357	5178	357	5056	0.0	0.07060917721518987
chr19	ZNF257	22087530	22087595	0	66	357	5178	357	5112	0.0	0.0698356807511737
chr19	GOLGA2P9	22599705	22599793	0	89	352	2661	352	2572	0.0	0.1368584758942457
chr19	GOLGA2P9	22599232	22599321	23	90	352	2661	329	2571	0.25555555555555554	0.1279657720731233
chr19	GOLGA2P9	22602977	22603130	0	154	352	2661	352	2507	0.0	0.1404068607897886
chr19	AC092279.1	24049661	24049839	0	179	8378	11997	8378	11818	0.0	0.708918598747673
chr19	AC092279.1	24047707	24047850	0	144	8378	11997	8378	11853	0.0	0.7068252763013583
chr19	AC092279.1	24048936	24049014	0	79	8378	11997	8378	11918	0.0	0.7029702970297029
chr19	AC092279.1	24057930	24058106	0	177	8378	11997	8378	11820	0.0	0.7087986463620981
chr19	AC092279.1	24063815	24063941	0	127	8378	11997	8378	11870	0.0	0.7058129738837405
chr19	AC092279.1	24036252	24036382	0	131	8378	11997	8378	11866	0.0	0.7060509017360526
chr19	AC092279.1	24042442	24042722	0	281	8378	11997	8378	11716	0.0	0.7150904745646979
chr19	AC092279.1	24047050	24047146	0	97	8378	11997	8378	11900	0.0	0.7040336134453782
chr19	AC092279.1	24065462	24065648	0	187	8378	11997	8378	11810	0.0	0.7093988145639288
chr19	AC092279.1	24064546	24064669	0	124	8378	11997	8378	11873	0.0	0.7056346332013813
chr19	AC092279.1	24049404	24049548	0	145	8378	11997	8378	11852	0.0	0.7068849139385758
chr19	AC092279.1	24050184	24050302	0	119	8378	11997	8378	11878	0.0	0.7053375989223775
chr19	AC092279.1	24057930	24058300	0	371	8378	11997	8378	11626	0.0	0.7206261826939618
chr19	AC092279.1	24034522	24034712	0	191	8378	11997	8378	11806	0.0	0.7096391665254955
chr19	AC092279.1	24063818	24063941	0	124	8378	11997	8378	11873	0.0	0.7056346332013813
chr19	AC092279.1	24057930	24058230	0	301	8378	11997	8378	11696	0.0	0.716313269493844
chr19	AC092279.1	24049409	24049548	0	140	8378	11997	8378	11857	0.0	0.7065868263473054
chr19	ZNF254	24106547	24106643	3418	97	62269	4811	58851	4714	35.23711340206186	12.484302078913874
chr19	ZNF254	24091900	24092015	0	116	62269	4811	62269	4695	0.0	13.262832800851971
chr19	ZNF254	24105939	24106066	1383	128	62269	4811	60886	4683	10.8046875	13.001494768310911
chr19	ZNF254	24103746	24103867	2579	122	62269	4811	59690	4689	21.139344262295083	12.72979313286415
chr19	AC006504.5	27797753	27798176	0	424	0	13629	0	13205	0.0	0.0
chr19	AC006504.5	27794681	27794869	0	189	0	13629	0	13440	0.0	0.0
chr19	LINC00906	28916501	28916695	0	195	79	6203	79	6008	0.0	0.0131491344873502
chr19	LINC00906	28970200	28970267	0	68	79	6203	79	6135	0.0	0.012876935615321923
chr19	LINC00906	28968946	28969042	0	97	79	6203	79	6106	0.0	0.012938093678349165
chr19	LINC00906	28965929	28966627	0	699	79	6203	79	5504	0.0	0.014353197674418604
chr19	LINC00906	28965929	28966663	0	735	79	6203	79	5468	0.0	0.014447695683979517
chr19	LINC00906	28965929	28966472	0	544	79	6203	79	5659	0.0	0.013960063615479766
chr19	LINC00906	28967804	28969042	51	1239	79	6203	28	4964	0.04116222760290557	0.0056406124093473006
chr19	LINC01532	29004173	29004252	0	80	0	4140	0	4060	0.0	0.0
chr19	LINC01532	29010730	29010946	0	217	0	4140	0	3923	0.0	0.0
chr19	LINC01532	29003601	29003740	0	140	0	4140	0	4000	0.0	0.0
chr19	AC007786.1	29213713	29213821	0	109	0	1609	0	1500	0.0	0.0
chr19	POP4	29610408	29610632	0	225	51	4182	51	3957	0.0	0.01288855193328279
chr19	CCNE1	29821995	29822130	0	136	51	2472	51	2336	0.0	0.02183219178082192
chr19	URI1	29980158	29980364	0	207	0	4959	0	4752	0.0	0.0
chr19	URI1	29957976	29958072	0	97	0	4959	0	4862	0.0	0.0
chr19	URI1	29971192	29971227	0	36	0	4959	0	4923	0.0	0.0
chr19	URI1	29980158	29980250	0	93	0	4959	0	4866	0.0	0.0
chr19	URI1	30014180	30014222	0	43	0	4959	0	4916	0.0	0.0
chr19	ZNF536	30284071	30284141	0	71	9756	8670	9756	8599	0.0	1.1345505291312943
chr19	LINC01791	31195589	31195703	0	115	0	3441	0	3326	0.0	0.0
chr19	LINC01791	31204745	31204920	0	176	0	3441	0	3265	0.0	0.0
chr19	LINC01791	31168344	31168656	0	313	0	3441	0	3128	0.0	0.0
chr19	LINC01791	31195586	31195703	0	118	0	3441	0	3323	0.0	0.0
chr19	LINC01791	31170179	31170265	0	87	0	3441	0	3354	0.0	0.0
chr19	LINC01791	31178723	31178816	0	94	0	3441	0	3347	0.0	0.0
chr19	LINC01791	31167684	31167833	0	150	0	3441	0	3291	0.0	0.0
chr19	AC011525.2	31588817	31588948	0	132	0	3123	0	2991	0.0	0.0
chr19	AC011525.2	31591219	31591310	0	92	0	3123	0	3031	0.0	0.0
chr19	AC011525.2	31588627	31588680	0	54	0	3123	0	3069	0.0	0.0
chr19	AC011525.2	31588761	31588948	0	188	0	3123	0	2935	0.0	0.0
chr19	AC011525.2	31591212	31591310	0	99	0	3123	0	3024	0.0	0.0
chr19	AC011525.2	31590355	31590478	0	124	0	3123	0	2999	0.0	0.0
chr19	AC011525.2	31590039	31590116	0	78	0	3123	0	3045	0.0	0.0
chr19	AC011525.2	31589862	31590116	0	255	0	3123	0	2868	0.0	0.0
chr19	AC011525.2	31589981	31590116	0	136	0	3123	0	2987	0.0	0.0
chr19	AC011525.2	31588786	31588948	0	163	0	3123	0	2960	0.0	0.0
chr19	AC011525.2	31591073	31591310	0	238	0	3123	0	2885	0.0	0.0
chr19	AC011525.2	31589857	31590116	0	260	0	3123	0	2863	0.0	0.0
chr19	AC011525.2	31590355	31590452	0	98	0	3123	0	3025	0.0	0.0
chr19	AC011525.2	31588600	31588680	0	81	0	3123	0	3042	0.0	0.0
chr19	LINC01533	32039492	32039619	0	128	0	3749	0	3621	0.0	0.0
chr19	LINC01533	32040365	32040570	0	206	0	3749	0	3543	0.0	0.0
chr19	LINC01533	32042903	32043071	0	169	0	3749	0	3580	0.0	0.0
chr19	LINC01533	32042899	32043071	0	173	0	3749	0	3576	0.0	0.0
chr19	LINC01533	32036989	32037095	0	107	0	3749	0	3642	0.0	0.0
chr19	ZNF507	32347244	32347338	0	95	0	11247	0	11152	0.0	0.0
chr19	ZNF507	32380608	32380620	0	13	0	11247	0	11234	0.0	0.0
chr19	DPY19L3	32468730	32468813	0	84	0	10805	0	10721	0.0	0.0
chr19	DPY19L3	32480704	32480756	0	53	0	10805	0	10752	0.0	0.0
chr19	DPY19L3	32467473	32467626	0	154	0	10805	0	10651	0.0	0.0
chr19	DPY19L3	32481040	32481940	0	901	0	10805	0	9904	0.0	0.0
chr19	PDCD5	32585815	32585907	0	93	51	1079	51	986	0.0	0.05172413793103448
chr19	TDRD12	32826682	32826749	0	68	95	7059	95	6991	0.0	0.013588900014304106
chr19	FAAP24	32973425	32973562	8066	138	36704	2193	28638	2055	58.44927536231884	13.935766423357665
chr19	FAAP24	32973183	32973302	3754	120	36704	2193	32950	2073	31.283333333333335	15.894838398456343
chr19	GPATCH1	33100172	33100274	475	103	78511	4490	78036	4387	4.611650485436893	17.788010029633007
chr19	WDR88	33174181	33174296	0	116	1003	1858	1003	1742	0.0	0.5757749712973593
chr19	CHST8	33667766	33667843	1630	78	2684	3061	1054	2983	20.897435897435898	0.35333556821991285
chr19	KCTD15	33799593	33799718	0	126	3561	5017	3561	4891	0.0	0.7280719689225107
chr19	KCTD15	33798263	33798390	1030	128	3561	5017	2531	4889	8.046875	0.5176927797095521
chr19	LSM14A	34195218	34195320	0	103	51	4760	51	4657	0.0	0.010951256173502255
chr19	LSM14A	34226407	34226464	0	58	51	4760	51	4702	0.0	0.010846448319863887
chr19	LSM14A	34208928	34209051	0	124	51	4760	51	4636	0.0	0.01100086281276963
chr19	LSM14A	34215123	34215300	0	178	51	4760	51	4582	0.0	0.011130510694020079
chr19	GPI	34368582	34368702	0	121	102	7809	102	7688	0.0	0.013267429760665974
chr19	GPI	34377502	34377586	0	85	102	7809	102	7724	0.0	0.01320559295701709
chr19	GPI	34396580	34396657	0	78	102	7809	102	7731	0.0	0.013193636010865347
chr19	GPI	34377734	34377881	0	148	102	7809	102	7661	0.0	0.013314188748205195
chr19	UBA2	34430092	34430186	0	95	23	4835	23	4740	0.0	0.004852320675105486
chr19	UBA2	34458768	34458924	0	157	23	4835	23	4678	0.0	0.004916631038905515
chr19	UBA2	34430575	34430659	0	85	23	4835	23	4750	0.0	0.004842105263157895
chr19	ZNF302	34679827	34679959	1020	133	95694	4981	94674	4848	7.669172932330827	19.528465346534652
chr19	ZNF181	34736074	34736206	0	133	153	6016	153	5883	0.0	0.026007139214686385
chr19	AC008555.2	34839598	34839818	3726	221	147140	8366	143414	8145	16.85972850678733	17.607612031921423
chr19	AC008555.2	34839598	34839786	2580	189	147140	8366	144560	8177	13.65079365079365	17.67885532591415
chr19	ZNF30	34942593	34942673	668	81	12821	2751	12153	2670	8.246913580246913	4.551685393258427
chr19	GRAMD1A	35009422	35009443	0	22	10972	5699	10972	5677	0.0	1.932710938876167
chr19	GRAMD1A	35013255	35013368	0	114	10972	5699	10972	5585	0.0	1.9645478961504028
chr19	GRAMD1A	35022899	35022911	0	13	10972	5699	10972	5686	0.0	1.9296517762926486
chr19	SCN1B	35035887	35036013	0	127	413	4311	413	4184	0.0	0.0987093690248566
chr19	SCN1B	35037162	35037354	2	193	413	4311	411	4118	0.010362694300518135	0.09980573093734822
chr19	FXYD3	35119167	35119251	0	85	2622	3345	2622	3260	0.0	0.8042944785276074
chr19	FXYD3	35117256	35117378	0	123	2622	3345	2622	3222	0.0	0.813780260707635
chr19	FXYD5	35156843	35156974	0	132	20223	2929	20223	2797	0.0	7.230246692885234
chr19	LSR	35261924	35261981	304	58	2685	2695	2381	2637	5.241379310344827	0.9029199848312476
chr19	LSR	35262545	35262692	0	148	2685	2695	2685	2547	0.0	1.0541813898704357
chr19	LSR	35266678	35266738	0	61	2685	2695	2685	2634	0.0	1.0193621867881548
chr19	LSR	35258944	35259064	742	121	2685	2695	1943	2574	6.132231404958677	0.7548562548562548
chr19	USF2	35269802	35270003	0	202	0	2816	0	2614	0.0	0.0
chr19	USF2	35275782	35275900	0	119	0	2816	0	2697	0.0	0.0
chr19	MAG	35295385	35295454	0	70	13	2972	13	2902	0.0	0.004479669193659545
chr19	MAG	35312280	35312325	0	46	13	2972	13	2926	0.0	0.004442925495557075
chr19	MAG	35295454	35295510	0	57	13	2972	13	2915	0.0	0.0044596912521440825
chr19	CD22	35332018	35332074	0	57	0	5309	0	5252	0.0	0.0
chr19	CD22	35336035	35336341	0	307	0	5309	0	5002	0.0	0.0
chr19	CD22	35345601	35345720	0	120	0	5309	0	5189	0.0	0.0
chr19	CD22	35331926	35332074	0	149	0	5309	0	5160	0.0	0.0
chr19	CD22	35331905	35332074	0	170	0	5309	0	5139	0.0	0.0
chr19	CD22	35332593	35332924	0	332	0	5309	0	4977	0.0	0.0
chr19	CD22	35330572	35330660	0	89	0	5309	0	5220	0.0	0.0
chr19	CD22	35338167	35338431	0	265	0	5309	0	5044	0.0	0.0
chr19	CD22	35337754	35338021	0	268	0	5309	0	5041	0.0	0.0
chr19	LINC01531	35409285	35409472	231	188	16710	3495	16479	3307	1.2287234042553192	4.983066223162988
chr19	LINC01531	35401058	35401117	0	60	16710	3495	16710	3435	0.0	4.864628820960698
chr19	GAPDHS	35536812	35536990	0	179	21	1490	21	1311	0.0	0.016018306636155607
chr19	LINC01766	35597322	35597430	0	109	836	971	836	862	0.0	0.9698375870069605
chr19	LINC01766	35597875	35597957	0	83	836	971	836	888	0.0	0.9414414414414415
chr19	HAUS5	35618401	35618465	0	65	13082	5031	13082	4966	0.0	2.6343133306484092
chr19	RBM42	35637157	35637352	534	196	23815	2216	23281	2020	2.7244897959183674	11.525247524752475
chr19	RBM42	35632935	35633001	1886	67	23815	2216	21929	2149	28.149253731343283	10.204281060958586
chr19	RBM42	35631330	35631405	259	76	23815	2216	23556	2140	3.4078947368421053	11.007476635514019
chr19	ETV2	35642433	35642530	551	98	29563	2008	29012	1910	5.622448979591836	15.189528795811519
chr19	COX6B1	35654570	35654671	1241	102	373384	1374	372143	1272	12.166666666666666	292.56525157232704
chr19	UPK1A	35676235	35676333	0	99	51	1375	51	1276	0.0	0.039968652037617555
chr19	ZBTB32	35715756	35715830	0	75	10	2349	10	2274	0.0	0.0043975373790677225
chr19	ZBTB32	35715938	35716007	0	70	10	2349	10	2279	0.0	0.004387889425186486
chr19	KMT2B	35728363	35728455	992	93	1352	7477	360	7384	10.666666666666666	0.04875406283856988
chr19	PROSER3	35759788	35759991	188	204	205201	4865	205013	4661	0.9215686274509803	43.98476721733534
chr19	ARHGAP33	35785188	35785334	0	147	63	4441	63	4294	0.0	0.014671634839310665
chr19	ARHGAP33	35777644	35777742	0	99	63	4441	63	4342	0.0	0.014509442653155229
chr19	KIRREL2	35857344	35857494	0	151	51	3075	51	2924	0.0	0.01744186046511628
chr19	KIRREL2	35862492	35862597	0	106	51	3075	51	2969	0.0	0.017177500842034354
chr19	APLP1	35874503	35874662	25	160	178	3559	153	3399	0.15625	0.04501323918799647
chr19	APLP1	35878084	35878108	0	25	178	3559	178	3534	0.0	0.05036785512167515
chr19	APLP1	35878081	35878108	0	28	178	3559	178	3531	0.0	0.05041064854148966
chr19	WDR62	36081793	36081935	0	143	23375	9265	23375	9122	0.0	2.562486296864723
chr19	WDR62	36058976	36059060	0	85	23375	9265	23375	9180	0.0	2.5462962962962963
chr19	WDR62	36075953	36075990	0	38	23375	9265	23375	9227	0.0	2.5333261081608325
chr19	TBCB	36124249	36124363	0	115	109829	3141	109829	3026	0.0	36.295109054857896
chr19	TBCB	36117790	36117928	1113	139	109829	3141	108716	3002	8.007194244604317	36.2145236508994
chr19	TBCB	36118527	36118664	0	138	109829	3141	109829	3003	0.0	36.57309357309357
chr19	CAPNS1	36142651	36142741	0	91	93325	2477	93325	2386	0.0	39.11357921207041
chr19	CAPNS1	36140357	36140511	459	155	93325	2477	92866	2322	2.9612903225806453	39.99397071490095
chr19	ZNF146	36218121	36218195	2243	75	629339	3653	627096	3578	29.906666666666666	175.2643935159307
chr19	AC092296.2	36310994	36311388	0	395	50	2027	50	1632	0.0	0.030637254901960783
chr19	AC092296.2	36312521	36312635	0	115	50	2027	50	1912	0.0	0.02615062761506276
chr19	ZNF529-AS1	36594155	36594299	15703	145	150445	3624	134742	3479	108.29655172413793	38.730094854843344
chr19	ZNF382	36609901	36610053	4771	153	893065	7939	888294	7786	31.18300653594771	114.08862060107886
chr19	ZNF382	36609926	36610053	4195	128	893065	7939	888870	7811	32.7734375	113.79720906414032
chr19	ZNF567	36694801	36694876	36	76	72099	4734	72063	4658	0.47368421052631576	15.47080291970803
chr19	ZNF567	36718947	36720561	28478	1615	72099	4734	43621	3119	17.63343653250774	13.985572298813722
chr19	ZNF790-AS1	36801202	36801240	326	39	106753	7129	106427	7090	8.35897435897436	15.01086036671368
chr19	ZNF790-AS1	36812909	36813032	3145	124	106753	7129	103608	7005	25.362903225806452	14.790578158458244
chr19	ZNF790-AS1	36823730	36823821	0	92	106753	7129	106753	7037	0.0	15.170243001278955
chr19	ZNF790-AS1	36812509	36812606	357	98	106753	7129	106396	7031	3.642857142857143	15.13241359692789
chr19	ZNF345	36854449	36854594	0	146	33103	4030	33103	3884	0.0	8.522914521112256
chr19	ZNF345	36872550	36872748	0	199	33103	4030	33103	3831	0.0	8.64082484990864
chr19	ZNF345	36876784	36876876	2146	93	33103	4030	30957	3937	23.0752688172043	7.8630937261874525
chr19	ZNF345	36862916	36863011	0	96	33103	4030	33103	3934	0.0	8.41459074733096
chr19	ZNF568	36922585	36922846	1351	262	21898	9232	20547	8970	5.156488549618321	2.290635451505017
chr19	ZNF568	36931552	36931645	0	94	21898	9232	21898	9138	0.0	2.3963668198730574
chr19	ZNF568	36991175	36991299	216	125	21898	9232	21682	9107	1.728	2.380805973427034
chr19	ZNF568	36925199	36925258	51	60	21898	9232	21847	9172	0.85	2.3819232446576537
chr19	ZNF568	36976326	36976367	0	42	21898	9232	21898	9190	0.0	2.3828073993471164
chr19	ZNF420	37080344	37080388	503	45	41755	2747	41252	2702	11.177777777777777	15.26720947446336
chr19	ZNF420	37111599	37111711	0	113	41755	2747	41755	2634	0.0	15.852315869400153
chr19	ZNF420	37096030	37096115	1232	86	41755	2747	40523	2661	14.325581395348838	15.228485531754979
chr19	ZNF383	37219598	37219749	0	152	11201	8163	11201	8011	0.0	1.398202471601548
chr19	ZNF383	37224817	37224939	0	123	11201	8163	11201	8040	0.0	1.3931592039800995
chr19	LINC01535	37256398	37256519	0	122	5142	2437	5142	2315	0.0	2.2211663066954643
chr19	LINC01535	37258947	37259069	0	123	5142	2437	5142	2314	0.0	2.2221261884183234
chr19	LINC01535	37256187	37256519	663	333	5142	2437	4479	2104	1.990990990990991	2.1288022813688214
chr19	LINC01535	37264695	37264755	392	61	5142	2437	4750	2376	6.426229508196721	1.9991582491582491
chr19	ZNF875	37324795	37324936	1852	142	23037	6750	21185	6608	13.04225352112676	3.2059624697336564
chr19	ZNF875	37357961	37358039	0	79	23037	6750	23037	6671	0.0	3.453305351521511
chr19	ZNF875	37322184	37322232	27	49	23037	6750	23010	6701	0.5510204081632653	3.4338158483808385
chr19	ZNF875	37325153	37325274	131	122	23037	6750	22906	6628	1.0737704918032787	3.455944477972239
chr19	ZNF875	37358546	37358661	0	116	23037	6750	23037	6634	0.0	3.472565571299367
chr19	ZNF875	37359425	37359546	0	122	23037	6750	23037	6628	0.0	3.4757091128545565
chr19	ZNF875	37347189	37347316	0	128	23037	6750	23037	6622	0.0	3.4788583509513744
chr19	ZNF875	37335168	37335257	81	90	23037	6750	22956	6660	0.9	3.4468468468468467
chr19	ZNF875	37346422	37346492	0	71	23037	6750	23037	6679	0.0	3.44916903728103
chr19	ZNF875	37347231	37347316	0	86	23037	6750	23037	6664	0.0	3.456932773109244
chr19	ZNF875	37346887	37347052	0	166	23037	6750	23037	6584	0.0	3.498936816524909
chr19	ZNF875	37335199	37335257	81	59	23037	6750	22956	6691	1.3728813559322033	3.430877297862801
chr19	ZNF875	37344609	37344774	0	166	23037	6750	23037	6584	0.0	3.498936816524909
chr19	ZNF875	37358540	37358661	0	122	23037	6750	23037	6628	0.0	3.4757091128545565
chr19	ZNF527	37380276	37380372	4250	97	65488	2491	61238	2394	43.81443298969072	25.579782790309107
chr19	ZNF527	37380047	37380372	6655	326	65488	2491	58833	2165	20.414110429447852	27.17459584295612
chr19	ZNF570	37470303	37470387	7423	85	92939	6067	85516	5982	87.32941176470588	14.295553326646607
chr19	ZNF793	37520183	37520312	0	130	16523	9645	16523	9515	0.0	1.736521282186022
chr19	ZNF793	37522531	37522647	0	117	16523	9645	16523	9528	0.0	1.734151973131822
chr19	ZNF571-AS1	37566030	37566089	230	60	11133	6494	10903	6434	3.8333333333333335	1.6945912340690084
chr19	ZNF571-AS1	37583482	37583834	0	353	11133	6494	11133	6141	0.0	1.8128969223253542
chr19	ZNF571-AS1	37550861	37550991	0	131	11133	6494	11133	6363	0.0	1.7496463932107496
chr19	ZNF571-AS1	37567617	37567750	51	134	11133	6494	11082	6360	0.3805970149253731	1.7424528301886792
chr19	ZNF571-AS1	37569849	37569996	570	148	11133	6494	10563	6346	3.8513513513513513	1.664513079104948
chr19	ZNF540	37599625	37599752	1407	128	2999	3869	1592	3741	10.9921875	0.425554664528201
chr19	ZNF540	37601009	37601105	306	97	2999	3869	2693	3772	3.154639175257732	0.7139448568398727
chr19	ZNF571-AS1	37566439	37566484	19	46	11133	6494	11114	6448	0.41304347826086957	1.72363523573201
chr19	ZNF571-AS1	37585083	37585161	114	79	11133	6494	11019	6415	1.4430379746835442	1.717692907248636
chr19	ZNF540	37601006	37601105	306	100	2999	3869	2693	3769	3.06	0.7145131334571504
chr19	ZNF540	37597447	37597570	0	124	2999	3869	2999	3745	0.0	0.8008010680907878
chr19	AC016582.3	37819496	37819617	5964	122	162882	6940	156918	6818	48.885245901639344	23.015253740099737
chr19	AC016582.3	37823810	37823906	1887	97	162882	6940	160995	6843	19.45360824742268	23.526961858833843
chr19	SPINT2	38283626	38283797	1479	172	7549	3644	6070	3472	8.598837209302326	1.7482718894009217
chr19	SPINT2	38287875	38287935	0	61	7549	3644	7549	3583	0.0	2.106893664526933
chr19	CATSPERG	38343992	38344119	0	128	396	6878	396	6750	0.0	0.058666666666666666
chr19	CATSPERG	38352260	38352432	0	173	396	6878	396	6705	0.0	0.05906040268456376
chr19	CATSPERG	38356483	38356543	0	61	396	6878	396	6817	0.0	0.058090068945283846
chr19	CATSPERG	38352393	38352432	0	40	396	6878	396	6838	0.0	0.05791167007897046
chr19	CATSPERG	38356741	38356861	41	121	396	6878	355	6757	0.33884297520661155	0.052538108628089386
chr19	CATSPERG	38337739	38337861	0	123	396	6878	396	6755	0.0	0.058623242042931165
chr19	CATSPERG	38369445	38369624	0	180	396	6878	396	6698	0.0	0.05912212600776351
chr19	PSMD8	38381148	38381312	0	165	765	3064	765	2899	0.0	0.26388409796481543
chr19	SPRED3	38394360	38394476	37	117	9254	5774	9217	5657	0.3162393162393162	1.6293088209298214
chr19	FAM98C	38405343	38405421	306	79	6527	2931	6221	2852	3.8734177215189876	2.1812762973352036
chr19	FAM98C	38406909	38407077	0	169	6527	2931	6527	2762	0.0	2.3631426502534394
chr19	RYR1	38511560	38511610	0	51	16413	16081	16413	16030	0.0	1.0238927011852776
chr19	RYR1	38512071	38512132	0	62	16413	16081	16413	16019	0.0	1.0245957924964104
chr19	RYR1	38523914	38523929	0	16	16413	16081	16413	16065	0.0	1.0216619981325863
chr19	RYR1	38536749	38536767	0	19	16413	16081	16413	16062	0.0	1.0218528203212551
chr19	RYR1	38570606	38570693	0	88	16413	16081	16413	15993	0.0	1.026261489401613
chr19	RYR1	38535996	38536070	0	75	16413	16081	16413	16006	0.0	1.0254279645133075
chr19	EIF3K	38632600	38632678	0	79	5640	2691	5640	2612	0.0	2.1592649310872893
chr19	EIF3K	38620336	38620435	0	100	5640	2691	5640	2591	0.0	2.1767657275183327
chr19	ACP7	39106946	39107084	0	139	275093	3057	275093	2918	0.0	94.27450308430431
chr19	ACP7	39100226	39100350	152	125	275093	3057	274941	2932	1.216	93.7725102319236
chr19	ACP7	39101465	39101537	153	73	275093	3057	274940	2984	2.095890410958904	92.13806970509384
chr19	PAK4	39168229	39168312	0	84	20331	7124	20331	7040	0.0	2.887926136363636
chr19	PAK4	39172917	39173106	960	190	20331	7124	19371	6934	5.052631578947368	2.7936256129218346
chr19	PAK4	39167991	39168085	0	95	20331	7124	20331	7029	0.0	2.8924455825864275
chr19	PAK4	39172917	39173376	1275	460	20331	7124	19056	6664	2.7717391304347827	2.859543817527011
chr19	PAK4	39168624	39168840	1173	217	20331	7124	19158	6907	5.405529953917051	2.7737078326335602
chr19	PAK4	39168229	39168302	0	74	20331	7124	20331	7050	0.0	2.8838297872340424
chr19	SAMD4B	39354005	39354066	0	62	211621	5835	211621	5773	0.0	36.657024077602635
chr19	SAMD4B	39375649	39375889	2312	241	211621	5835	209309	5594	9.593360995850622	37.416696460493384
chr19	MED29	39392463	39392522	421	60	116054	3844	115633	3784	7.016666666666667	30.55840380549683
chr19	MED29	39392651	39392802	215	152	116054	3844	115839	3692	1.4144736842105263	31.375677139761645
chr19	PLEKHG2	39421074	39421113	124	40	424427	7761	424303	7721	3.1	54.95441005051159
chr19	PLEKHG2	39420948	39420996	0	49	424427	7761	424427	7712	0.0	55.034621369294605
chr19	SUPT5H	39458293	39458305	0	13	9493	8603	9493	8590	0.0	1.1051222351571595
chr19	SUPT5H	39464797	39465049	42	253	9493	8603	9451	8350	0.16600790513833993	1.1318562874251497
chr19	TIMM50	39481882	39482033	0	152	0	5589	0	5437	0.0	0.0
chr19	TIMM50	39485543	39485602	0	60	0	5589	0	5529	0.0	0.0
chr19	TIMM50	39483134	39483156	0	23	0	5589	0	5566	0.0	0.0
chr19	TIMM50	39485151	39485263	0	113	0	5589	0	5476	0.0	0.0
chr19	SELENOV	39518607	39518632	0	26	112179	1738	112179	1712	0.0	65.52511682242991
chr19	SELENOV	39518902	39518977	0	76	112179	1738	112179	1662	0.0	67.49638989169675
chr19	AC005176.1	39640820	39640906	534	87	1197	1839	663	1752	6.137931034482759	0.3784246575342466
chr19	LGALS17A	39681432	39681509	0	78	462	1750	462	1672	0.0	0.27631578947368424
chr19	LGALS17A	39681997	39682208	0	212	462	1750	462	1538	0.0	0.30039011703511054
chr19	LGALS14	39705704	39706009	0	306	0	909	0	603	0.0	0.0
chr19	LGALS14	39706596	39706673	0	78	0	909	0	831	0.0	0.0
chr19	ZNF546	39999600	39999854	46	255	63778	9041	63732	8786	0.1803921568627451	7.25381288413385
chr19	ZNF546	39998247	39998410	6883	164	63778	9041	56895	8877	41.96951219512195	6.409259885096317
chr19	ZNF546	39998247	39998332	5926	86	63778	9041	57852	8955	68.90697674418605	6.460301507537689
chr19	MAP3K10	40204484	40204633	0	150	306	4074	306	3924	0.0	0.0779816513761468
chr19	MAP3K10	40205910	40206157	0	248	306	4074	306	3826	0.0	0.0799790904338735
chr19	PLD3	40365717	40365930	0	214	937	4360	937	4146	0.0	0.22600096478533527
chr19	PLD3	40365552	40365585	0	34	937	4360	937	4326	0.0	0.2165973185390661
chr19	PLD3	40365552	40365930	0	379	937	4360	937	3981	0.0	0.23536799799045466
chr19	PLD3	40365661	40365930	0	270	937	4360	937	4090	0.0	0.22909535452322738
chr19	SPTBN4	40524543	40524629	571	87	70491	11711	69920	11624	6.563218390804598	6.015141087405368
chr19	SHKBP1	40578153	40578212	38	60	13951	3701	13913	3641	0.6333333333333333	3.8212029662180718
chr19	SHKBP1	40586773	40586944	382	172	13951	3701	13569	3529	2.2209302325581395	3.8449985831680364
chr19	SHKBP1	40590243	40590422	0	180	13951	3701	13951	3521	0.0	3.9622266401590456
chr19	SHKBP1	40578122	40578212	51	91	13951	3701	13900	3610	0.5604395604395604	3.850415512465374
chr19	SHKBP1	40588623	40588779	0	157	13951	3701	13951	3544	0.0	3.936512415349887
chr19	SHKBP1	40578096	40578212	51	117	13951	3701	13900	3584	0.4358974358974359	3.8783482142857144
chr19	SHKBP1	40589081	40589178	2407	98	13951	3701	11544	3603	24.56122448979592	3.2039966694421316
chr19	LTBP4	40611151	40611394	33	244	957	7848	924	7604	0.13524590163934427	0.1215149921094161
chr19	LTBP4	40616888	40617020	0	133	957	7848	957	7715	0.0	0.12404406999351912
chr19	LTBP4	40617099	40617225	0	127	957	7848	957	7721	0.0	0.1239476751716099
chr19	LTBP4	40622949	40623021	0	73	957	7848	957	7775	0.0	0.12308681672025723
chr19	ITPKC	40733159	40733364	204	206	115750	3383	115546	3177	0.9902912621359223	36.36953100409191
chr19	SNRPA	40758783	40758869	450	87	44452	2064	44002	1977	5.172413793103448	22.25695498229641
chr19	MIA	40775751	40775885	189	135	32857	1167	32668	1032	1.4	31.655038759689923
chr19	RAB4B	40783777	40783840	3154	64	144558	2971	141404	2907	49.28125	48.642586859305126
chr19	RAB4B	40783920	40784075	5397	156	144558	2971	139161	2815	34.59615384615385	49.435523978685616
chr19	MIA	40775751	40775833	189	83	32857	1167	32668	1084	2.2771084337349397	30.136531365313655
chr19	EGLN2	40806554	40806674	1171	121	18931	5469	17760	5348	9.677685950413224	3.3208676140613314
chr19	CYP2B6	41012673	41012815	360	143	499	3744	139	3601	2.5174825174825175	0.038600388780894196
chr19	CYP2B6	41007478	41007600	0	123	499	3744	499	3621	0.0	0.13780723557028446
chr19	CYP2B6	41012972	41013030	0	59	499	3744	499	3685	0.0	0.13541383989145184
chr19	CYP2F1	41116177	41116359	2271	183	155940	2330	153669	2147	12.40983606557377	71.57382394038193
chr19	CYP2F1	41125738	41125788	2396	51	155940	2330	153544	2279	46.98039215686274	67.37340939008337
chr19	CYP2S1	41203449	41203637	44	189	80541	2723	80497	2534	0.2328042328042328	31.76677190213102
chr19	CYP2S1	41194543	41194709	4836	167	80541	2723	75705	2556	28.95808383233533	29.618544600938968
chr19	CYP2S1	41197778	41197928	18141	151	80541	2723	62400	2572	120.13907284768212	24.261275272161743
chr19	AXL	41239693	41239720	0	28	31603	5156	31603	5128	0.0	6.162831513260531
chr19	HNRNPUL1	41268222	41268345	8	124	332756	6669	332748	6545	0.06451612903225806	50.840030557677615
chr19	HNRNPUL1	41281162	41281275	122	114	332756	6669	332634	6555	1.0701754385964912	50.74508009153318
chr19	HNRNPUL1	41305645	41305867	2041	223	332756	6669	330715	6446	9.152466367713005	51.30546075085324
chr19	HNRNPUL1	41305675	41305867	2041	193	332756	6669	330715	6476	10.575129533678757	51.067788758492895
chr19	HNRNPUL1	41305831	41305867	124	37	332756	6669	332632	6632	3.3513513513513513	50.15560916767189
chr19	HNRNPUL1	41279076	41279176	0	101	332756	6669	332756	6568	0.0	50.66321559074299
chr19	TMEM91	41382771	41382921	0	151	707	1776	707	1625	0.0	0.4350769230769231
chr19	BCKDHA	41410922	41411009	0	88	57	2171	57	2083	0.0	0.027364378300528083
chr19	TMEM91	41383560	41383632	350	73	707	1776	357	1703	4.794520547945205	0.20963006459189665
chr19	BCKDHA	41418724	41418817	0	94	57	2171	57	2077	0.0	0.0274434280211844
chr19	CEACAM21	41586153	41586195	0	43	0	1988	0	1945	0.0	0.0
chr19	CEACAM5	41715649	41715904	0	256	24273	3969	24273	3713	0.0	6.537301373552384
chr19	CEACAM5	41714970	41715249	102	280	24273	3969	24171	3689	0.36428571428571427	6.552182163187855
chr19	CEACAM3	41809964	41810017	66110	54	624089	2545	557979	2491	1224.2592592592594	223.99799277398634
chr19	CEACAM3	41807110	41807244	591	135	624089	2545	623498	2410	4.377777777777778	258.7128630705394
chr19	RPS19	41861479	41861560	0	82	20791	3216	20791	3134	0.0	6.63401403956605
chr19	ARHGEF1	41894625	41894661	259	37	306572	8522	306313	8485	7.0	36.10053034767236
chr19	ARHGEF1	41904948	41905036	0	89	306572	8522	306572	8433	0.0	36.35384797818096
chr19	ARHGEF1	41905174	41905261	0	88	306572	8522	306572	8434	0.0	36.349537585961585
chr19	ARHGEF1	41906456	41906620	357	165	306572	8522	306215	8357	2.1636363636363636	36.6417374655977
chr19	ARHGEF1	41892024	41892123	0	100	306572	8522	306572	8422	0.0	36.40132985039183
chr19	ARHGEF1	41897945	41898113	357	169	306572	8522	306215	8353	2.1124260355029585	36.65928408954866
chr19	ARHGEF1	41897314	41897326	13	13	306572	8522	306559	8509	1.0	36.02761781642966
chr19	MEGF8	42371349	42371482	0	134	163853	10518	163853	10384	0.0	15.779372110939908
chr19	MEGF8	42348271	42348472	0	202	163853	10518	163853	10316	0.0	15.883385032958511
chr19	ZNF283	43833504	43833626	0	123	3385	7162	3385	7039	0.0	0.4808921721835488
chr19	ZNF283	43837052	43837179	0	128	3385	7162	3385	7034	0.0	0.48123400625533125
chr19	ZNF283	43827775	43827940	659	166	3385	7162	2726	6996	3.9698795180722892	0.3896512292738708
chr19	ZNF283	43831317	43831381	0	65	3385	7162	3385	7097	0.0	0.4769620966605608
chr19	ZNF221	43960186	43960356	0	171	11290	2719	11290	2548	0.0	4.430926216640502
chr19	ZNF221	43961823	43961971	0	149	11290	2719	11290	2570	0.0	4.392996108949417
chr19	ZNF155	43990023	43990112	0	90	18312	3441	18312	3351	0.0	5.4646374216651745
chr19	ZNF222	44026025	44026086	88	62	1893	2008	1805	1946	1.4193548387096775	0.9275436793422405
chr19	ZNF223	44060454	44060581	0	128	12803	3317	12803	3189	0.0	4.014738162433365
chr19	ZNF222	44027397	44027490	0	94	1893	2008	1893	1914	0.0	0.9890282131661442
chr19	ZNF223	44063264	44063566	115	303	12803	3317	12688	3014	0.3795379537953795	4.209688122096881
chr19	ZNF225	44114048	44114213	1122	166	161200	6611	160078	6445	6.759036144578313	24.837548487199378
chr19	ZNF225	44129041	44129098	42	58	161200	6611	161158	6553	0.7241379310344828	24.593010834732183
chr19	ZNF234	44144556	44144647	0	92	974353	5221	974353	5129	0.0	189.9693897445896
chr19	ZNF234	44149770	44149976	51	207	974353	5221	974302	5014	0.2463768115942029	194.31631431990428
chr19	ZNF226	44165587	44165613	513	27	136153	5116	135640	5089	19.0	26.653566516014934
chr19	ZNF226	44166704	44166882	786	179	136153	5116	135367	4937	4.391061452513966	27.41887786104922
chr19	ZNF226	44167818	44167860	0	43	136153	5116	136153	5073	0.0	26.838754188842895
chr19	ZNF226	44169564	44169628	126046	65	136153	5116	10107	5051	1939.1692307692308	2.000989902989507
chr19	ZNF227	44229732	44229816	168	85	182032	4812	181864	4727	1.9764705882352942	38.473450391368736
chr19	ZNF227	44217790	44217852	0	63	182032	4812	182032	4749	0.0	38.33059591492946
chr19	IGSF23	44618075	44618192	51	118	32283	1421	32232	1303	0.4322033898305085	24.7367613200307
chr19	PVR	44657761	44657910	308	150	142715	6106	142407	5956	2.0533333333333332	23.909838817998658
chr19	PVR	44658741	44658765	0	25	142715	6106	142715	6081	0.0	23.469001808913006
chr19	PVR	44658741	44658900	0	160	142715	6106	142715	5946	0.0	24.00184998318197
chr19	CEACAM19	44666957	44667321	0	365	79209	4281	79209	3916	0.0	20.227017364657815
chr19	CEACAM19	44671303	44671436	714	134	79209	4281	78495	4147	5.3283582089552235	18.928140824692548
chr19	CBLC	44784263	44784401	100	139	6096	1624	5996	1485	0.7194244604316546	4.037710437710437
chr19	CBLC	44784263	44784417	102	155	6096	1624	5994	1469	0.6580645161290323	4.080326752893124
chr19	BCAM	44814151	44814288	0	138	6611	4838	6611	4700	0.0	1.406595744680851
chr19	APOC1	44914671	44914733	0	63	0	1238	0	1175	0.0	0.0
chr19	APOC1	44916189	44916325	0	137	0	1238	0	1101	0.0	0.0
chr19	APOC1	44916189	44916470	0	282	0	1238	0	956	0.0	0.0
chr19	APOC1	44918840	44918961	0	122	0	1238	0	1116	0.0	0.0
chr19	APOC1	44916189	44916359	0	171	0	1238	0	1067	0.0	0.0
chr19	APOC1	44915097	44915217	0	121	0	1238	0	1117	0.0	0.0
chr19	APOC1P1	44927794	44927930	0	137	16434	925	16434	788	0.0	20.85532994923858
chr19	APOC1P1	44927609	44927930	315	322	16434	925	16119	603	0.9782608695652174	26.73134328358209
chr19	APOC4-APOC2	44945139	44946075	408	937	543	1835	135	898	0.43543223052294555	0.15033407572383073
chr19	CLPTM1	44974438	44974597	737	160	4553	4812	3816	4652	4.60625	0.820292347377472
chr19	CLPTM1	44991237	44991373	247	137	4553	4812	4306	4675	1.802919708029197	0.9210695187165775
chr19	RELB	45008457	45008721	0	265	230	3028	230	2763	0.0	0.08324285197249366
chr19	RELB	45009813	45009822	0	10	230	3028	230	3018	0.0	0.07620941020543406
chr19	CLASRP	45068419	45068480	0	62	836	4944	836	4882	0.0	0.17124129455141335
chr19	GEMIN7	45079906	45080029	38	124	197	1913	159	1789	0.3064516129032258	0.0888764673001677
chr19	BLOC1S3	45198888	45199013	0	126	566	1768	566	1642	0.0	0.3447015834348356
chr19	BLOC1S3	45180267	45180413	0	147	566	1768	566	1621	0.0	0.3491671807526218
chr19	MARK4	45298142	45298222	0	81	27097	6665	27097	6584	0.0	4.115583232077764
chr19	POLR1G	45407093	45407235	0	143	148454	3199	148454	3056	0.0	48.577879581151834
chr19	FOSB	45471193	45471301	0	109	571	4899	571	4790	0.0	0.11920668058455115
chr19	FOSB	45470628	45470949	10	322	571	4899	561	4577	0.031055900621118012	0.12256936858204064
chr19	FOSB	45470745	45470949	10	205	571	4899	561	4694	0.04878048780487805	0.11951427354069025
chr19	PPM1N	45500649	45500710	0	62	38	2380	38	2318	0.0	0.01639344262295082
chr19	PPM1N	45500680	45500710	0	31	38	2380	38	2349	0.0	0.016177096636866752
chr19	PPM1N	45500689	45500710	0	22	38	2380	38	2358	0.0	0.016115351993214587
chr19	VASP	45521321	45521406	0	86	21470	3335	21470	3249	0.0	6.608187134502924
chr19	VASP	45524877	45525077	874	201	21470	3335	20596	3134	4.348258706467662	6.571793235481812
chr19	EML2-AS1	45641878	45642072	0	195	3621	1237	3621	1042	0.0	3.4750479846449136
chr19	GIPR	45671579	45671757	459	179	89233	4844	88774	4665	2.564245810055866	19.029796355841373
chr19	GIPR	45671284	45671392	17	109	89233	4844	89216	4735	0.1559633027522936	18.841816261879618
chr19	QPCTL	45695400	45695718	612	319	3772	2550	3160	2231	1.9184952978056427	1.4164051994621245
chr19	QPCTL	45698800	45698900	0	101	3772	2550	3772	2449	0.0	1.5402204981625154
chr19	QPCTL	45695436	45695718	612	283	3772	2550	3160	2267	2.1625441696113072	1.3939126599029554
chr19	QPCTL	45695632	45695718	48	87	3772	2550	3724	2463	0.5517241379310345	1.511977263499797
chr19	CCDC61	46003418	46003501	100	84	26610	2352	26510	2268	1.1904761904761905	11.688712522045856
chr19	CCDC61	45996244	45996401	0	158	26610	2352	26610	2194	0.0	12.128532360984503
chr19	AC006262.1	46203559	46203656	2210	98	648310	4973	646100	4875	22.551020408163264	132.53333333333333
chr19	AC006262.1	46211608	46211678	38	71	648310	4973	648272	4902	0.5352112676056338	132.24643002855976
chr19	AC006262.1	46213328	46213483	51	156	648310	4973	648259	4817	0.3269230769230769	134.57733028856134
chr19	HIF3A	46305244	46305390	0	147	143781	8157	143781	8010	0.0	17.950187265917602
chr19	HIF3A	46305098	46305135	0	38	143781	8157	143781	8119	0.0	17.709200640472964
chr19	HIF3A	46310541	46310691	75	151	143781	8157	143706	8006	0.4966887417218543	17.94978765925556
chr19	PPP5C	46383410	46383476	0	67	145344	6407	145344	6340	0.0	22.924921135646688
chr19	CALM3	46605826	46605857	0	32	2508	3098	2508	3066	0.0	0.8180039138943248
chr19	CALM3	46605993	46606185	0	193	2508	3098	2508	2905	0.0	0.8633390705679862
chr19	FKRP	46748514	46748717	0	204	51	5171	51	4967	0.0	0.010267767263942018
chr19	FKRP	46748774	46748884	0	111	51	5171	51	5060	0.0	0.01007905138339921
chr19	FKRP	46747233	46747305	0	73	51	5171	51	5098	0.0	0.010003923107100824
chr19	FKRP	46748514	46748884	0	371	51	5171	51	4800	0.0	0.010625
chr19	FKRP	46754248	46754315	0	68	51	5171	51	5103	0.0	0.009994121105232217
chr19	FKRP	46748514	46748665	0	152	51	5171	51	5019	0.0	0.010161386730424387
chr19	FKRP	46747233	46747294	0	62	51	5171	51	5109	0.0	0.009982384028185555
chr19	FKRP	46747578	46747732	0	155	51	5171	51	5016	0.0	0.010167464114832535
chr19	FKRP	46748514	46748621	0	108	51	5171	51	5063	0.0	0.010073079202054119
chr19	FKRP	46754101	46754181	0	81	51	5171	51	5090	0.0	0.010019646365422397
chr19	FKRP	46747578	46747681	0	104	51	5171	51	5067	0.0	0.010065127294256957
chr19	SAE1	47143493	47143605	0	113	343089	3760	343089	3647	0.0	94.07430765012339
chr19	SAE1	47142510	47142611	0	102	343089	3760	343089	3658	0.0	93.79141607435757
chr19	SAE1	47197232	47197377	7268	146	343089	3760	335821	3614	49.78082191780822	92.92224681793027
chr19	SAE1	47180145	47180303	90	159	343089	3760	342999	3601	0.5660377358490566	95.25104137739517
chr19	SAE1	47156986	47157181	0	196	343089	3760	343089	3564	0.0	96.26515151515152
chr19	SAE1	47156568	47156661	0	94	343089	3760	343089	3666	0.0	93.58674304418986
chr19	SAE1	47203670	47203740	0	71	343089	3760	343089	3689	0.0	93.00325291406885
chr19	SAE1	47151995	47152053	0	59	343089	3760	343089	3701	0.0	92.70170224263713
chr19	DHX34	47362475	47362693	0	219	48760	4787	48760	4568	0.0	10.674255691768826
chr19	DHX34	47376914	47376989	0	76	48760	4787	48760	4711	0.0	10.350244109530886
chr19	EHD2	47716557	47717016	153	460	57434	3852	57281	3392	0.33260869565217394	16.887087264150942
chr19	NOP53	47755755	47755822	0	68	1817	3435	1817	3367	0.0	0.5396495396495397
chr19	SELENOW	47780724	47780749	66	26	70412	2027	70346	2001	2.5384615384615383	35.155422288855576
chr19	CRX	47834408	47834543	0	136	1020	3965	1020	3829	0.0	0.26638809088534865
chr19	CRX	47836242	47836394	0	153	1020	3965	1020	3812	0.0	0.2675760755508919
chr19	ELSPBP1	48014170	48014308	51	139	3429	1130	3378	991	0.3669064748201439	3.408678102926337
chr19	AC011466.3	48122208	48122365	270	158	750	1013	480	855	1.7088607594936709	0.5614035087719298
chr19	ZNF114	48271726	48271828	0	103	54479	2813	54479	2710	0.0	20.102952029520296
chr19	ZNF114	48271748	48271828	0	81	54479	2813	54479	2732	0.0	19.941068814055637
chr19	ZNF114	48281551	48281689	0	139	54479	2813	54479	2674	0.0	20.3735976065819
chr19	EMP3	48327520	48327623	0	104	0	1570	0	1466	0.0	0.0
chr19	EMP3	48326829	48326922	0	94	0	1570	0	1476	0.0	0.0
chr19	EMP3	48325990	48326053	0	64	0	1570	0	1506	0.0	0.0
chr19	SYNGR4	48375612	48375752	0	141	51	1200	51	1059	0.0	0.04815864022662889
chr19	CYTH2	48470602	48470669	0	68	0	6155	0	6087	0.0	0.0
chr19	CYTH2	48477716	48477719	0	4	0	6155	0	6151	0.0	0.0
chr19	SPHK2	48625949	48626362	17040	414	215551	5205	198511	4791	41.15942028985507	41.43414735963265
chr19	SPHK2	48626067	48626362	17040	296	215551	5205	198511	4909	57.567567567567565	40.43817478101446
chr19	SPHK2	48625890	48626362	17079	473	215551	5205	198472	4732	36.10782241014799	41.942519019442095
chr19	SPHK2	48628680	48629726	7157	1047	215551	5205	208394	4158	6.835721107927411	50.11880711880712
chr19	DHDH	48936031	48936195	0	165	484	1071	484	906	0.0	0.5342163355408388
chr19	DHDH	48942439	48942564	0	126	484	1071	484	945	0.0	0.5121693121693122
chr19	DHDH	48944356	48944507	0	152	484	1071	484	919	0.0	0.5266594124047879
chr19	BAX	48955686	48955833	0	148	116995	1767	116995	1619	0.0	72.26374305126622
chr19	BAX	48955547	48955599	0	53	116995	1767	116995	1714	0.0	68.25845974329054
chr19	BAX	48960238	48960336	5436	99	116995	1767	111559	1668	54.90909090909091	66.88189448441247
chr19	RUVBL2	48999318	48999373	1955	56	1899	3172	-56	3116	34.910714285714285	-0.01797175866495507
chr19	RUVBL2	49015020	49015150	0	131	1899	3172	1899	3041	0.0	0.6244656363038474
chr19	RUVBL2	49001348	49001590	0	243	1899	3172	1899	2929	0.0	0.6483441447593035
chr19	SNRNP70	49086404	49086561	0	158	204	4668	204	4510	0.0	0.04523281596452328
chr19	SNRNP70	49102113	49102173	0	61	204	4668	204	4607	0.0	0.04428044280442804
chr19	SNRNP70	49102113	49103587	153	1475	204	4668	51	3193	0.10372881355932204	0.015972439711869714
chr19	SNRNP70	49102113	49102185	0	73	204	4668	204	4595	0.0	0.04439608269858542
chr19	SNRNP70	49087633	49087777	0	145	204	4668	204	4523	0.0	0.04510280787088216
chr19	LIN7B	49116262	49116472	204	211	459	1760	255	1549	0.966824644549763	0.1646223369916075
chr19	LIN7B	49115824	49116024	204	201	459	1760	255	1559	1.0149253731343284	0.163566388710712
chr19	PPFIA3	49129992	49130067	0	76	83930	5974	83930	5898	0.0	14.230247541539505
chr19	PPFIA3	49138204	49138427	929	224	83930	5974	83001	5750	4.147321428571429	14.43495652173913
chr19	PPFIA3	49146165	49146192	173	28	83930	5974	83757	5946	6.178571428571429	14.08627648839556
chr19	TRPM4	49166040	49166215	255	176	6890	6483	6635	6307	1.4488636363636365	1.0520057079435547
chr19	TRPM4	49190207	49190320	0	114	6890	6483	6890	6369	0.0	1.0818024807662114
chr19	TRPM4	49196439	49196874	0	436	6890	6483	6890	6047	0.0	1.1394079708946585
chr19	TRPM4	49211014	49211087	0	74	6890	6483	6890	6409	0.0	1.075050709939148
chr19	TRPM4	49167916	49168097	51	182	6890	6483	6839	6301	0.2802197802197802	1.0853832724964292
chr19	TRPM4	49181348	49181461	0	114	6890	6483	6890	6369	0.0	1.0818024807662114
chr19	TRPM4	49168259	49168423	51	165	6890	6483	6839	6318	0.3090909090909091	1.0824628046850269
chr19	TRPM4	49172008	49172108	0	101	6890	6483	6890	6382	0.0	1.0795988718270135
chr19	CD37	49335885	49336029	0	145	20848	3440	20848	3295	0.0	6.327162367223066
chr19	DKKL1	49365792	49365885	0	94	3349	1332	3349	1238	0.0	2.7051696284329565
chr19	DKKL1	49365508	49365649	0	142	3349	1332	3349	1190	0.0	2.8142857142857145
chr19	KASH5	49390788	49390926	0	139	399270	5515	399270	5376	0.0	74.26897321428571
chr19	KASH5	49393345	49393419	145	75	399270	5515	399125	5440	1.9333333333333333	73.3685661764706
chr19	KASH5	49391685	49391781	0	97	399270	5515	399270	5418	0.0	73.69324473975637
chr19	KASH5	49391680	49391781	0	102	399270	5515	399270	5413	0.0	73.76131535193053
chr19	KASH5	49393345	49393400	130	56	399270	5515	399140	5459	2.3214285714285716	73.11595530316907
chr19	ALDH16A1	49461883	49462036	51	154	381212	3286	381161	3132	0.33116883116883117	121.69891443167305
chr19	ALDH16A1	49464126	49464263	95582	138	381212	3286	285630	3148	692.6231884057971	90.73379923761118
chr19	ALDH16A1	49458959	49459086	84701	128	381212	3286	296511	3158	661.7265625	93.89202026599114
chr19	ALDH16A1	49459669	49459848	3896	180	381212	3286	377316	3106	21.644444444444446	121.47971667739859
chr19	ALDH16A1	49458485	49458588	714	104	381212	3286	380498	3182	6.865384615384615	119.57825267127593
chr19	FLT3LG	49478962	49479047	2	86	146194	2805	146192	2719	0.023255813953488372	53.766826038984924
chr19	FLT3LG	49480297	49480476	0	180	146194	2805	146194	2625	0.0	55.692952380952384
chr19	FLT3LG	49478908	49479047	51	140	146194	2805	146143	2665	0.36428571428571427	54.837898686679175
chr19	RPL13A	49490231	49490297	2	67	71861	3165	71859	3098	0.029850746268656716	23.195287282117494
chr19	FCGRT	49513386	49513473	3336	88	274657	3363	271321	3275	37.90909090909091	82.84610687022901
chr19	FCGRT	49514210	49514486	180880	277	274657	3363	93777	3086	652.9963898916967	30.38788075178224
chr19	FCGRT	49515176	49515269	0	94	274657	3363	274657	3269	0.0	84.01866014071581
chr19	FCGRT	49513881	49514133	153	253	274657	3363	274504	3110	0.6047430830039525	88.26495176848874
chr19	FCGRT	49521694	49521813	112	120	274657	3363	274545	3243	0.9333333333333333	84.6577243293247
chr19	FCGRT	49520668	49521201	2548	534	274657	3363	272109	2829	4.771535580524344	96.18557794273595
chr19	RCN3	49534192	49534395	204	204	364	1663	160	1459	1.0	0.10966415352981494
chr19	RCN3	49534192	49534301	36	110	364	1663	328	1553	0.32727272727272727	0.2112041210560206
chr19	BCL2L12	49667018	49667161	516	144	41102	2223	40586	2079	3.5833333333333335	19.521885521885523
chr19	BCL2L12	49670215	49670488	36137	274	41102	2223	4965	1949	131.88686131386862	2.547460236018471
chr19	BCL2L12	49669023	49669164	1020	142	41102	2223	40082	2081	7.183098591549296	19.260932244113405
chr19	BCL2L12	49667021	49667161	488	141	41102	2223	40614	2082	3.4609929078014185	19.507204610951007
chr19	BCL2L12	49669023	49669115	1020	93	41102	2223	40082	2130	10.96774193548387	18.817840375586854
chr19	BCL2L12	49668850	49668937	1000	88	41102	2223	40102	2135	11.363636363636363	18.783138173302106
chr19	PRMT1	49676345	49676439	2107	95	78864	4621	76757	4526	22.178947368421053	16.959125055236413
chr19	PRMT1	49679871	49679925	0	55	78864	4621	78864	4566	0.0	17.272010512483575
chr19	CPT1C	49696481	49696602	1010	122	87612	5093	86602	4971	8.278688524590164	17.421444377388855
chr19	CPT1C	49700683	49700855	0	173	87612	5093	87612	4920	0.0	17.807317073170733
chr19	CPT1C	49701316	49701418	578	103	87612	5093	87034	4990	5.611650485436893	17.441683366733468
chr19	CPT1C	49691660	49691770	0	111	87612	5093	87612	4982	0.0	17.58570855078282
chr19	CPT1C	49691820	49691889	0	70	87612	5093	87612	5023	0.0	17.442166036233328
chr19	CPT1C	49691820	49691953	2033	134	87612	5093	85579	4959	15.171641791044776	17.257309941520468
chr19	AP2A1	49802533	49802599	314	67	21862	6084	21548	6017	4.686567164179104	3.5811866378593984
chr19	PTOV1	49854969	49855077	281	109	134864	4048	134583	3939	2.5779816513761467	34.16679360243717
chr19	TBC1D17	49878142	49878241	0	100	18	4759	18	4659	0.0	0.0038634900193174502
chr19	TBC1D17	49879322	49879504	0	183	18	4759	18	4576	0.0	0.003933566433566434
chr19	ATF5	49929700	49929865	0	166	12446	2898	12446	2732	0.0	4.5556368960468525
chr19	ZNF473	50031013	50031091	187	79	330339	6268	330152	6189	2.367088607594937	53.344966876716754
chr19	ZNF473	50030891	50031091	561	201	330339	6268	329778	6067	2.791044776119403	54.356024394264054
chr19	ZNF473	50040533	50040629	0	97	330339	6268	330339	6171	0.0	53.530870199319395
chr19	MYH14	50224153	50224177	0	25	495588	7572	495588	7547	0.0	65.66688750496886
chr19	MYH14	50255219	50255318	0	100	495588	7572	495588	7472	0.0	66.32601713062098
chr19	MYH14	50230824	50230999	0	176	495588	7572	495588	7396	0.0	67.00757166035694
chr19	NR1H2	50376234	50376576	50408	343	264399	5355	213991	5012	146.96209912536443	42.695730247406225
chr19	NR1H2	50378148	50378312	6686	165	264399	5355	257713	5190	40.52121212121212	49.65568400770713
chr19	NR1H2	50378148	50378439	12578	292	264399	5355	251821	5063	43.07534246575342	49.73750740667588
chr19	POLD1	50417044	50417097	4737	54	119377	4790	114640	4736	87.72222222222223	24.20608108108108
chr19	POLD1	50415723	50415826	0	104	119377	4790	119377	4686	0.0	25.47524541186513
chr19	POLD1	50395024	50395150	72	127	119377	4790	119305	4663	0.5669291338582677	25.585460004289086
chr19	POLD1	50410982	50411058	44703	77	119377	4790	74674	4713	580.5584415584416	15.844260555909187
chr19	SPIB	50422822	50423037	9987	216	219834	4287	209847	4071	46.236111111111114	51.546794399410466
chr19	EMC10	50481860	50481947	242	88	155017	9750	154775	9662	2.75	16.018940178016972
chr19	KLK3	50858028	50858086	0	59	44	2916	44	2857	0.0	0.015400770038501925
chr19	KLK2	50874720	50874880	0	161	9608	5806	9608	5645	0.0	1.7020372010628875
chr19	KLK2	50874720	50874966	0	247	9608	5806	9608	5559	0.0	1.7283684115848175
chr19	KLK2	50877703	50877756	0	54	9608	5806	9608	5752	0.0	1.670375521557719
chr19	SIGLEC7	51144405	51144684	0	280	51	2050	51	1770	0.0	0.0288135593220339
chr19	SIGLEC7	51147220	51147317	0	98	51	2050	51	1952	0.0	0.02612704918032787
chr19	SIGLEC17P	51168602	51168650	0	49	0	1572	0	1523	0.0	0.0
chr19	CD33	51226308	51226356	0	49	231	3144	231	3095	0.0	0.07463651050080776
chr19	CD33	51225217	51225598	0	382	231	3144	231	2762	0.0	0.08363504706734251
chr19	SIGLECL1	51265367	51265649	255	283	255	2360	0	2077	0.901060070671378	0.0
chr19	LINC01872	51279197	51279300	0	104	714	1114	714	1010	0.0	0.7069306930693069
chr19	AC008750.2	51343687	51343811	0	125	0	443	0	318	0.0	0.0
chr19	FPR2	51762416	51762535	0	120	0	3632	0	3512	0.0	0.0
chr19	FPR2	51763361	51763517	0	157	0	3632	0	3475	0.0	0.0
chr19	ZNF613	51929731	51929824	0	94	0	3225	0	3131	0.0	0.0
chr19	ZNF613	51927894	51927994	0	101	0	3225	0	3124	0.0	0.0
chr19	ZNF613	51929731	51929896	0	166	0	3225	0	3059	0.0	0.0
chr19	ZNF613	51936027	51936235	0	209	0	3225	0	3016	0.0	0.0
chr19	PPP2R1A	52200273	52200398	510	126	10684	7147	10174	7021	4.0476190476190474	1.4490813274462326
chr19	ZNF766	52282110	52282237	0	128	0	6941	0	6813	0.0	0.0
chr19	ZNF766	52277153	52277541	0	389	0	6941	0	6552	0.0	0.0
chr19	ZNF766	52288041	52288115	0	75	0	6941	0	6866	0.0	0.0
chr19	ZNF766	52275577	52275607	0	31	0	6941	0	6910	0.0	0.0
chr19	ZNF480	52314152	52314279	0	128	306	3049	306	2921	0.0	0.1047586442998973
chr19	ZNF480	52315833	52315962	0	130	306	3049	306	2919	0.0	0.10483042137718397
chr19	ZNF480	52317415	52317513	0	99	306	3049	306	2950	0.0	0.10372881355932204
chr19	ZNF610	52354250	52354379	0	130	3673	3557	3673	3427	0.0	1.0717829004960606
chr19	ZNF880	52379420	52379540	0	121	23727	3725	23727	3604	0.0	6.583518312985571
chr19	ZNF528	52401684	52401753	0	70	2660	7868	2660	7798	0.0	0.34111310592459604
chr19	ZNF528	52402428	52402545	695	118	2660	7868	1965	7750	5.889830508474576	0.2535483870967742
chr19	ZNF528	52414203	52414368	0	166	2660	7868	2660	7702	0.0	0.34536484030122044
chr19	ZNF528	52414938	52415039	51	102	2660	7868	2609	7766	0.5	0.33595158382693796
chr19	ZNF534	52435080	52435209	0	130	6524	3285	6524	3155	0.0	2.067828843106181
chr19	ZNF808	52547511	52547638	0	128	31410	5015	31410	4887	0.0	6.427255985267035
chr19	ZNF808	52532907	52533009	0	103	31410	5015	31410	4912	0.0	6.394543973941368
chr19	ZNF701	52572236	52572368	0	133	30435	7085	30435	6952	0.0	4.377876869965478
chr19	AC092070.2	53202551	53202702	649	152	3265	4057	2616	3905	4.269736842105263	0.669910371318822
chr19	ZNF845	53340823	53340925	0	103	11979	6455	11979	6352	0.0	1.8858627204030227
chr19	ZNF765	53402064	53402191	0	128	143927	9293	143927	9165	0.0	15.703982542280414
chr19	ZNF813	53486631	53486758	270	128	5729	6251	5459	6123	2.109375	0.8915564265882737
chr19	ZNF813	53488207	53488300	0	94	5729	6251	5729	6157	0.0	0.9304856261166152
chr19	ZNF331	53522616	53522684	87	69	38078	8057	37991	7988	1.2608695652173914	4.756009013520281
chr19	ZNF331	53539215	53539282	0	68	38078	8057	38078	7989	0.0	4.766303667542871
chr19	ZNF331	53555844	53555908	0	65	38078	8057	38078	7992	0.0	4.764514514514515
chr19	ZNF331	53523263	53523496	0	234	38078	8057	38078	7823	0.0	4.8674421577399976
chr19	ZNF331	53563762	53563792	0	31	38078	8057	38078	8026	0.0	4.74433092449539
chr19	MYADM	53869689	53869838	996	150	4998	4306	4002	4156	6.64	0.9629451395572666
chr19	MYADM	53869753	53869838	312	86	4998	4306	4686	4220	3.627906976744186	1.1104265402843603
chr19	MYADM	53872711	53872787	0	77	4998	4306	4998	4229	0.0	1.181839678410972
chr19	CACNG6	53999633	53999771	0	139	249	1857	249	1718	0.0	0.14493597206053552
chr19	CACNG6	53998238	53998313	198	76	249	1857	51	1781	2.6052631578947367	0.028635597978663673
chr19	NDUFA3	54105596	54105703	0	108	153	2142	153	2034	0.0	0.0752212389380531
chr19	NDUFA3	54106352	54106446	0	95	153	2142	153	2047	0.0	0.07474352711284807
chr19	NDUFA3	54106810	54106978	0	169	153	2142	153	1973	0.0	0.07754688291941206
chr19	CNOT3	54152427	54152626	0	200	45	5828	45	5628	0.0	0.007995735607675906
chr19	CNOT3	54153180	54153393	0	214	45	5828	45	5614	0.0	0.008015675097969362
chr19	RPS9	54206275	54206462	0	188	0	3672	0	3484	0.0	0.0
chr19	RPS9	54206552	54206724	0	173	0	3672	0	3499	0.0	0.0
chr19	RPS9	54206275	54206724	0	450	0	3672	0	3222	0.0	0.0
chr19	TTYH1	54421276	54421388	0	113	1323	6918	1323	6805	0.0	0.19441587068332108
chr19	TTYH1	54435827	54435873	0	47	1323	6918	1323	6871	0.0	0.19254839179158784
chr19	LENG8	54451289	54451382	0	94	250	5922	250	5828	0.0	0.04289636238846946
chr19	LENG8	54453545	54453656	0	112	250	5922	250	5810	0.0	0.043029259896729774
chr19	LAIR2	54503699	54503735	0	37	0	1050	0	1013	0.0	0.0
chr19	LAIR2	54509034	54509085	0	52	0	1050	0	998	0.0	0.0
chr19	KIR3DX1	54542523	54542646	0	124	18870	4481	18870	4357	0.0	4.330961670874455
chr19	KIR3DX1	54535585	54535647	0	63	18870	4481	18870	4418	0.0	4.271163422363061
chr19	LILRA2	54573697	54573912	0	216	102	5359	102	5143	0.0	0.01983278242271048
chr19	LILRA2	54574075	54574111	0	37	102	5359	102	5322	0.0	0.019165727170236752
chr19	LILRA2	54573830	54573912	0	83	102	5359	102	5276	0.0	0.019332827899924184
chr19	LILRA2	54587009	54587060	0	52	102	5359	102	5307	0.0	0.01921989824759751
chr19	LILRA2	54577464	54577723	0	260	102	5359	102	5099	0.0	0.020003922337713278
chr19	LILRA1	54594196	54594278	0	83	14585	3887	14585	3804	0.0	3.8341219768664563
chr19	LILRB1	54635103	54635179	21552	77	338180	4895	316628	4818	279.8961038961039	65.71772519717724
chr19	LILRB1	54633637	54633688	4	52	338180	4895	338176	4843	0.07692307692307693	69.8277926904811
chr19	LILRB1	54634363	54634402	261	40	338180	4895	337919	4855	6.525	69.6022657054583
chr19	LILRB4	54667634	54667793	582	160	100059	6341	99477	6181	3.6375	16.09399773499434
chr19	LILRB4	54667637	54667793	582	157	100059	6341	99477	6184	3.7070063694267517	16.08619016817594
chr19	KIR2DL1	54780088	54780166	0	79	54	1701	54	1622	0.0	0.03329223181257707
chr19	KIR2DL4	54804792	54805077	0	286	0	1732	0	1446	0.0	0.0
chr19	KIR2DL4	54808832	54808883	0	52	0	1732	0	1680	0.0	0.0
chr19	KIR2DL4	54813124	54813228	0	105	0	1732	0	1627	0.0	0.0
chr19	KIR2DL4	54813124	54813295	0	172	0	1732	0	1560	0.0	0.0
chr19	KIR3DL1	54818314	54818599	51	286	51	1880	0	1594	0.17832167832167833	0.0
chr19	KIR3DL1	54825027	54825078	0	52	51	1880	51	1828	0.0	0.027899343544857767
chr19	KIR2DS4	54842867	54842918	0	52	91	1616	91	1564	0.0	0.058184143222506396
chr19	KIR3DL2	54859078	54859129	0	52	0	1886	0	1834	0.0	0.0
chr19	FCAR	54875329	54875365	0	37	50	3333	50	3296	0.0	0.01516990291262136
chr19	FCAR	54888006	54888294	0	289	50	3333	50	3044	0.0	0.0164257555847569
chr19	FCAR	54885234	54885525	0	292	50	3333	50	3041	0.0	0.01644195988161789
chr19	FCAR	54888006	54888228	0	223	50	3333	50	3110	0.0	0.01607717041800643
chr19	FCAR	54888006	54888220	0	215	50	3333	50	3118	0.0	0.01603592046183451
chr19	NCR1	54906298	54906334	0	37	0	1901	0	1864	0.0	0.0
chr19	NCR1	54906522	54906807	0	286	0	1901	0	1615	0.0	0.0
chr19	NCR1	54912167	54912218	0	52	0	1901	0	1849	0.0	0.0
chr19	NCR1	54912170	54912218	0	49	0	1901	0	1852	0.0	0.0
chr19	NLRP2	54977751	54977823	943	73	203387	6333	202444	6260	12.917808219178083	32.33929712460064
chr19	NLRP2	54981616	54981682	0	67	203387	6333	203387	6266	0.0	32.458825406958184
chr19	NLRP2	54976859	54976958	0	100	203387	6333	203387	6233	0.0	32.630675437189154
chr19	NLRP2	54981625	54981682	0	58	203387	6333	203387	6275	0.0	32.41227091633466
chr19	NLRP2	54989556	54989752	2	197	203387	6333	203385	6136	0.01015228426395939	33.146186440677965
chr19	EPS8L1	55078998	55079057	0	60	0	4935	0	4875	0.0	0.0
chr19	EPS8L1	55078087	55078128	0	42	0	4935	0	4893	0.0	0.0
chr19	EPS8L1	55083766	55084642	0	877	0	4935	0	4058	0.0	0.0
chr19	BRSK1	55304049	55304110	0	62	665	3974	665	3912	0.0	0.16998977505112475
chr19	KMT5C	55342214	55342380	0	167	0	4651	0	4484	0.0	0.0
chr19	ZNF628	55479833	55479917	45	85	249	3565	204	3480	0.5294117647058824	0.05862068965517241
chr19	SSC5D	55497879	55498197	0	319	255	7009	255	6690	0.0	0.03811659192825112
chr19	CCDC106	55649204	55649309	0	106	114095	2490	114095	2384	0.0	47.858640939597315
chr19	U2AF2	55658861	55658981	0	121	2777	4130	2777	4009	0.0	0.6926914442504365
chr19	EPN1	55689296	55689371	1570	76	206534	16106	204964	16030	20.657894736842106	12.786275733000624
chr19	NLRP4	55867708	55867876	0	169	28570	3723	28570	3554	0.0	8.038829487900957
chr19	ZNF444	56142275	56142386	0	112	128616	4183	128616	4071	0.0	31.593220338983052
chr19	GALP	56180585	56180634	230	50	167320	956	167090	906	4.6	184.42604856512142
chr19	EDDM13	56302841	56302983	0	143	0	2340	0	2197	0.0	0.0
chr19	ZNF542P	56369278	56369337	0	60	0	4675	0	4615	0.0	0.0
chr19	ZNF542P	56374685	56374757	0	73	0	4675	0	4602	0.0	0.0
chr19	ZNF542P	56374685	56374825	0	141	0	4675	0	4534	0.0	0.0
chr19	ZNF582-AS1	56394216	56394441	0	226	0	1662	0	1436	0.0	0.0
chr19	ZNF667-AS1	56491576	56491766	0	191	153	6804	153	6613	0.0	0.02313624678663239
chr19	ZFP28	56548377	56548478	0	102	102	6918	102	6816	0.0	0.014964788732394365
chr19	ZNF470	56574393	56574520	0	128	387	8087	387	7959	0.0	0.04862419901997738
chr19	ZNF71	56613811	56613938	803	128	19115	6139	18312	6011	6.2734375	3.0464149060056562
chr19	SMIM17	56647557	56647634	0	78	31058	2547	31058	2469	0.0	12.579181855002025
chr19	AC006115.2	56791054	56791307	0	254	51131	16166	51131	15912	0.0	3.213360985419809
chr19	AC006115.2	56793103	56793232	0	130	51131	16166	51131	16036	0.0	3.188513344973809
chr19	AC006115.2	56789927	56791307	969	1381	51131	16166	50162	14785	0.7016654598117307	3.3927629354075077
chr19	AC006115.2	56821727	56821812	0	86	51131	16166	51131	16080	0.0	3.1797885572139304
chr19	AC006115.2	56789927	56790078	243	152	51131	16166	50888	16014	1.5986842105263157	3.177719495441489
chr19	ZNF264	57205396	57205492	0	97	918	12290	918	12193	0.0	0.0752891003034528
chr19	AURKC	57233459	57233608	0	150	51	1747	51	1597	0.0	0.031934877896055106
chr19	ZNF805	57243922	57244049	0	128	153	10173	153	10045	0.0	0.01523145843703335
chr19	ZNF304	57355270	57355411	0	142	0	4614	0	4472	0.0	0.0
chr19	ZNF304	57352654	57352735	0	82	0	4614	0	4532	0.0	0.0
chr19	ZNF547	57370972	57371094	0	123	51	3420	51	3297	0.0	0.015468607825295723
chr19	ZNF548	57394187	57394223	0	37	187	6008	187	5971	0.0	0.03131803717970189
chr19	ZNF548	57394042	57394223	0	182	187	6008	187	5826	0.0	0.03209749399244765
chr19	ZNF548	57392800	57392948	21	149	187	6008	166	5859	0.14093959731543623	0.028332479945383172
chr19	ZNF548	57390721	57390845	0	125	187	6008	187	5883	0.0	0.031786503484616695
chr19	ZNF548	57392787	57392948	34	162	187	6008	153	5846	0.20987654320987653	0.026171741361614778
chr19	ZNF17	57413595	57413636	0	42	51	3186	51	3144	0.0	0.016221374045801526
chr19	ZNF17	57417911	57418038	0	128	51	3186	51	3058	0.0	0.016677567037279267
chr19	ZNF749	57441884	57442011	0	128	0	4546	0	4418	0.0	0.0
chr19	ZNF419	57492112	57492211	0	100	0	5698	0	5598	0.0	0.0
chr19	ZNF419	57490146	57490185	0	40	0	5698	0	5658	0.0	0.0
chr19	ZNF419	57490130	57490185	0	56	0	5698	0	5642	0.0	0.0
chr19	ZNF773	57508519	57508564	0	46	255	5246	255	5200	0.0	0.04903846153846154
chr19	ZNF549	57531069	57531108	0	40	0	9284	0	9244	0.0	0.0
chr19	ZIK1	57588538	57588665	0	128	51	5376	51	5248	0.0	0.009717987804878049
chr19	ZIK1	57584951	57584990	0	40	51	5376	51	5336	0.0	0.009557721139430285
chr19	ZIK1	57588580	57588665	0	86	51	5376	51	5290	0.0	0.009640831758034027
chr19	ZNF530	57600727	57600779	0	53	69	3993	69	3940	0.0	0.01751269035532995
chr19	ZNF530	57605685	57607827	51	2143	69	3993	18	1850	0.02379841343910406	0.00972972972972973
chr19	ZNF134	57619411	57619508	0	98	51	5143	51	5045	0.0	0.010109018830525273
chr19	ZNF134	57618791	57618877	0	87	51	5143	51	5056	0.0	0.010087025316455696
chr19	ZNF211	57639911	57640067	0	157	102	4549	102	4392	0.0	0.023224043715846996
chr19	ZNF211	57634022	57634061	0	40	102	4549	102	4509	0.0	0.02262142381902861
chr19	ZNF211	57633785	57633905	23	121	102	4549	79	4428	0.19008264462809918	0.017841011743450767
chr19	ZNF211	57633712	57633905	23	194	102	4549	79	4355	0.11855670103092783	0.018140068886337544
chr19	ZNF551	57685261	57685385	102	125	51688	4707	51586	4582	0.816	11.258402444347446
chr19	ZNF586	57774765	57774815	0	51	61401	5489	61401	5438	0.0	11.291099668995955
chr19	ZNF586	57776542	57776669	0	128	61401	5489	61401	5361	0.0	11.453273642977056
chr19	AC010522.1	57820493	57820549	0	57	21137	1165	21137	1108	0.0	19.076714801444044
chr19	AC010522.1	57856106	57856233	0	128	21137	1165	21137	1037	0.0	20.382835101253615
chr19	AC010522.1	57856103	57856233	0	131	21137	1165	21137	1034	0.0	20.441972920696326
chr19	AC008969.1	58004382	58004700	13877	319	60516	5845	46639	5526	43.50156739811912	8.439920376402462
chr19	AC008969.1	58005906	58005995	4482	90	60516	5845	56034	5755	49.8	9.736576889661164
chr19	ZSCAN1	58035439	58035502	274	64	117936	2403	117662	2339	4.28125	50.30440359127832
chr19	ZNF135	58059973	58060035	0	63	60582	6389	60582	6326	0.0	9.576667720518495
chr19	ZNF135	58059968	58060398	0	431	60582	6389	60582	5958	0.0	10.168177240684793
chr19	ZNF135	58059968	58060035	0	68	60582	6389	60582	6321	0.0	9.584242999525392
chr19	ZNF274	58185711	58185838	0	128	51065	6244	51065	6116	0.0	8.34941137998692
chr19	ZNF274	58186946	58187042	0	97	51065	6244	51065	6147	0.0	8.307304376118433
chr19	ZNF274	58185696	58185838	0	143	51065	6244	51065	6101	0.0	8.369939354204229
chr19	ZNF544	58230393	58230462	9	70	16719	6745	16710	6675	0.12857142857142856	2.5033707865168537
chr19	ZNF544	58246745	58246794	0	50	16719	6745	16719	6695	0.0	2.4972367438386858
chr19	ZNF544	58237248	58237334	1872	87	16719	6745	14847	6658	21.517241379310345	2.2299489336136977
chr19	ZNF544	58246710	58246794	14	85	16719	6745	16705	6660	0.16470588235294117	2.5082582582582584
chr19	ZNF544	58230393	58230497	44	105	16719	6745	16675	6640	0.41904761904761906	2.5112951807228914
chr19	ZNF544	58276322	58276429	0	108	16719	6745	16719	6637	0.0	2.51905981618201
chr19	ERVK3-1	58312020	58312061	90	42	15568	2116	15478	2074	2.142857142857143	7.462873674059788
chr19	ERVK3-1	58311198	58311380	2388	183	15568	2116	13180	1933	13.049180327868852	6.818416968442835
chr19	A1BG-AS1	58353320	58353474	8004	155	125640	3102	117636	2947	51.63870967741936	39.91720393620631
chr19	A1BG-AS1	58353320	58353461	6725	142	125640	3102	118915	2960	47.359154929577464	40.173986486486484
chr19	A1BG-AS1	58353378	58353474	4091	97	125640	3102	121549	3005	42.175257731958766	40.44891846921797
chr19	RPS5	58387031	58387339	3111	309	16407	2650	13296	2341	10.067961165048544	5.679624092268261
chr19	RPS5	58392975	58393185	1068	211	16407	2650	15339	2439	5.061611374407583	6.289052890528906
chr19	RPS5	58388417	58388480	0	64	16407	2650	16407	2586	0.0	6.344547563805104
chr19	ZNF584	58415792	58415940	2893	149	56591	2662	53698	2513	19.416107382550337	21.36808595304417
chr19	ZNF584	58409940	58410091	0	152	56591	2662	56591	2510	0.0	22.546215139442232
chr19	ZNF584	58410005	58410091	0	87	56591	2662	56591	2575	0.0	21.97708737864078
chr19	ZNF584	58409964	58410091	0	128	56591	2662	56591	2534	0.0	22.332675611681136
chr19	ZNF584	58415818	58415940	1919	123	56591	2662	54672	2539	15.601626016260163	21.532886963371407
chr19	ZNF324B	58453186	58453266	3604	81	45501	4041	41897	3960	44.49382716049383	10.580050505050504
chr19	ZNF324B	58452127	58452782	19493	656	45501	4041	26008	3385	29.714939024390244	7.683308714918759
chr19	ZNF446	58479642	58479727	0	86	17271	4698	17271	4612	0.0	3.74479618386817
chr19	ZNF446	58476439	58476504	0	66	17271	4698	17271	4632	0.0	3.7286269430051813
chr19	MZF1-AS1	58571857	58571955	818	99	9481	3845	8663	3746	8.262626262626263	2.312600106780566
chr19	AC016629.3	58591497	58591624	258	128	127991	3405	127733	3277	2.015625	38.97863899908453
chr20	NRSN2	349637	349832	357	196	887	2380	530	2184	1.8214285714285714	0.24267399267399267
chr20	NRSN2	347433	347506	0	74	887	2380	887	2306	0.0	0.3846487424111015
chr20	NRSN2	347433	347512	0	80	887	2380	887	2300	0.0	0.38565217391304346
chr20	NRSN2	355325	355349	7	25	887	2380	880	2355	0.28	0.37367303609341823
chr20	TRIB3	382432	382626	468	195	87672	3039	87204	2844	2.4	30.662447257383967
chr20	RBCK1	409880	410025	306	146	205085	4749	204779	4603	2.095890410958904	44.48815989572018
chr20	RBCK1	420870	421006	33377	137	205085	4749	171708	4612	243.62773722627736	37.230702515177796
chr20	RBCK1	409883	410025	301	143	205085	4749	204784	4606	2.104895104895105	44.4602692140686
chr20	RBCK1	420870	421031	36444	162	205085	4749	168641	4587	224.96296296296296	36.76498800959233
chr20	RBCK1	417219	417342	26663	124	205085	4749	178422	4625	215.0241935483871	38.57772972972973
chr20	FAM110A	839454	839563	0	110	839	2312	839	2202	0.0	0.3810172570390554
chr20	PSMF1	1118752	1118902	0	151	2176	9208	2176	9057	0.0	0.24025615545986528
chr20	PSMF1	1127425	1127508	1288	84	2176	9208	888	9124	15.333333333333334	0.09732573432704954
chr20	PSMF1	1163129	1163183	0	55	2176	9208	2176	9153	0.0	0.23773626133508138
chr20	RAD21L1	1246209	1246305	0	97	1071	2747	1071	2650	0.0	0.4041509433962264
chr20	SDCBP2-AS1	1350338	1350481	715951	144	734309	5316	18358	5172	4971.881944444444	3.5494972931167825
chr20	SDCBP2-AS1	1374483	1374698	0	216	734309	5316	734309	5100	0.0	143.9821568627451
chr20	SDCBP2-AS1	1373077	1373178	0	102	734309	5316	734309	5214	0.0	140.83410049865745
chr20	TGM6	2430893	2431027	0	135	0	2312	0	2177	0.0	0.0
chr20	NOP56	2657638	2657692	0	55	0	4253	0	4198	0.0	0.0
chr20	NOP56	2657372	2657488	0	117	0	4253	0	4136	0.0	0.0
chr20	EBF4	2709573	2709642	0	70	21	3015	21	2945	0.0	0.007130730050933786
chr20	PTPRA	2975214	2975241	0	28	321294	4499	321294	4471	0.0	71.86177588906286
chr20	PTPRA	2923206	2923285	0	80	321294	4499	321294	4419	0.0	72.70739986422268
chr20	PTPRA	2947981	2948024	40	44	321294	4499	321254	4455	0.9090909090909091	72.11088664421997
chr20	PTPRA	2955608	2955698	0	91	321294	4499	321294	4408	0.0	72.8888384754991
chr20	ITPA	3213318	3213383	0	66	101937	1951	101937	1885	0.0	54.07798408488064
chr20	ITPA	3213168	3213226	0	59	101937	1951	101937	1892	0.0	53.877906976744185
chr20	HSPA12B	3740814	3740912	4423	99	23952	3146	19529	3047	44.676767676767675	6.409255004922875
chr20	CDC25B	3800742	3800865	0	124	183122	4331	183122	4207	0.0	43.5279296410744
chr20	CDC25B	3801721	3801802	153	82	183122	4331	182969	4249	1.8658536585365855	43.06166156742763
chr20	MAVS	3857634	3857809	3714	176	371980	11778	368266	11602	21.102272727272727	31.74159627650405
chr20	PANK2	3901547	3901617	7982	71	300313	5369	292331	5298	112.4225352112676	55.177614194035485
chr20	PANK2	3901551	3901617	7439	67	300313	5369	292874	5302	111.02985074626865	55.238400603545834
chr20	SMOX	4182088	4182848	0	761	3213	2958	3213	2197	0.0	1.4624487938097406
chr20	SMOX	4186742	4186832	51	91	3213	2958	3162	2867	0.5604395604395604	1.1028950122078829
chr20	CDS2	5173522	5173659	1579	138	149704	11814	148125	11676	11.442028985507246	12.686279547790338
chr20	AL121757.1	5471853	5471931	35	79	6488	3014	6453	2935	0.4430379746835443	2.1986371379897784
chr20	AL121757.2	5488957	5489429	1122	473	1122	3073	0	2600	2.372093023255814	0.0
chr20	SHLD1	5765093	5765184	0	92	1530	2191	1530	2099	0.0	0.728918532634588
chr20	SHLD1	5756711	5756848	102	138	1530	2191	1428	2053	0.7391304347826086	0.6955674622503654
chr20	CHGB	5914617	5914713	0	97	62496	4453	62496	4356	0.0	14.347107438016529
chr20	MCM8	5973055	5973196	0	142	187962	7711	187962	7569	0.0	24.833135156559653
chr20	CRLS1	6031284	6031370	0	87	13965	5374	13965	5287	0.0	2.6413845280877624
chr20	LINC01706	7357779	7357988	0	210	0	1390	0	1180	0.0	0.0
chr20	LINC01706	7353807	7353918	0	112	0	1390	0	1278	0.0	0.0
chr20	AL021396.1	8022380	8022449	0	70	0	4232	0	4162	0.0	0.0
chr20	PLCB1	8657183	8657284	0	102	3834	16902	3834	16800	0.0	0.2282142857142857
chr20	PLCB1	8802055	8802173	51	119	3834	16902	3783	16783	0.42857142857142855	0.22540666150271108
chr20	PLCB1	8141870	8141948	0	79	3834	16902	3834	16823	0.0	0.22790227664506926
chr20	PLCB4	9096286	9096342	12	57	8989	6909	8977	6852	0.21052631578947367	1.310128429655575
chr20	PLCB4	9373046	9373104	0	59	8989	6909	8989	6850	0.0	1.3122627737226278
chr20	PLCB4	9405312	9405348	0	37	8989	6909	8989	6872	0.0	1.3080616996507568
chr20	PLCB4	9459634	9459810	3843	177	8989	6909	5146	6732	21.71186440677966	0.7644087938205585
chr20	PLCB4	9476716	9476753	0	38	8989	6909	8989	6871	0.0	1.3082520739339252
chr20	LAMP5	9515999	9516131	0	133	0	2048	0	1915	0.0	0.0
chr20	ANKEF1	10035578	10035642	0	65	9180	5882	9180	5817	0.0	1.5781330582774626
chr20	BTBD3	11919085	11919176	0	92	1852	5915	1852	5823	0.0	0.3180491155761635
chr20	BTBD3	11917777	11918011	0	235	1852	5915	1852	5680	0.0	0.326056338028169
chr20	LINC01723	12951450	12951567	0	118	0	2909	0	2791	0.0	0.0
chr20	LINC01723	12994909	12994996	0	88	0	2909	0	2821	0.0	0.0
chr20	NDUFAF5	13794837	13794941	0	105	324	6832	324	6727	0.0	0.04816411476140925
chr20	NDUFAF5	13801485	13801683	51	199	324	6832	273	6633	0.2562814070351759	0.04115784712799638
chr20	NDUFAF5	13814417	13814515	0	99	324	6832	324	6733	0.0	0.04812119411852072
chr20	NDUFAF5	13816462	13816546	0	85	324	6832	324	6747	0.0	0.04802134281903068
chr20	NDUFAF5	13801507	13801683	51	177	324	6832	273	6655	0.288135593220339	0.04102178812922615
chr20	MACROD2	15892926	15893010	0	85	51	11457	51	11372	0.0	0.004484699261343651
chr20	MACROD2	16044570	16044639	0	70	51	11457	51	11387	0.0	0.004478791604461228
chr20	PCSK2	17260239	17260344	90	106	4170	7043	4080	6937	0.8490566037735849	0.5881504973331412
chr20	DSTN	17591931	17592063	0	133	274873	3645	274873	3512	0.0	78.26679954441913
chr20	DSTN	17605109	17605211	288	103	274873	3645	274585	3542	2.796116504854369	77.52258610954263
chr20	BANF2	17712160	17712540	0	381	0	1365	0	984	0.0	0.0
chr20	BANF2	17722715	17722878	0	164	0	1365	0	1201	0.0	0.0
chr20	MGME1	17975683	17975903	0	221	2377	2236	2377	2015	0.0	1.179652605459057
chr20	MGME1	17988165	17988298	0	134	2377	2236	2377	2102	0.0	1.1308277830637488
chr20	KAT14	18159083	18159265	0	183	111073	4878	111073	4695	0.0	23.65772097976571
chr20	KAT14	18183534	18183581	0	48	111073	4878	111073	4830	0.0	22.99648033126294
chr20	ZNF133	18297984	18298062	0	79	5281	5437	5281	5358	0.0	0.9856289660321015
chr20	ZNF133	18305007	18305178	0	172	5281	5437	5281	5265	0.0	1.0030389363722696
chr20	ZNF133	18305667	18305807	0	141	5281	5437	5281	5296	0.0	0.9971676737160121
chr20	ZNF133	18310168	18310306	0	139	5281	5437	5281	5298	0.0	0.996791241978105
chr20	ZNF133	18306297	18306393	0	97	5281	5437	5281	5340	0.0	0.9889513108614232
chr20	ZNF133	18289898	18290074	2017	177	5281	5437	3264	5260	11.3954802259887	0.620532319391635
chr20	ZNF133	18298288	18298464	0	177	5281	5437	5281	5260	0.0	1.0039923954372623
chr20	ZNF133	18306705	18306747	0	43	5281	5437	5281	5394	0.0	0.9790507971820541
chr20	POLR3F	18481618	18481810	0	193	92527	2678	92527	2485	0.0	37.23420523138833
chr20	POLR3F	18468943	18469061	20558	119	92527	2678	71969	2559	172.7563025210084	28.123876514263383
chr20	SEC23B	18551088	18551175	0	88	76019	4075	76019	3987	0.0	19.066716829696514
chr20	SEC23B	18508090	18508297	72739	208	76019	4075	3280	3867	349.7067307692308	0.8482027411430049
chr20	SEC23B	18509615	18509943	561	329	76019	4075	75458	3746	1.7051671732522797	20.143619861185265
chr20	DTD1	18620066	18620113	0	48	194764	6424	194764	6376	0.0	30.54642409033877
chr20	RIN2	19870843	19870915	217	73	54312	8294	54095	8221	2.9726027397260273	6.580099744556623
chr20	RIN2	19964951	19965024	0	74	54312	8294	54312	8220	0.0	6.607299270072993
chr20	NAA20	20032507	20032653	0	147	29466	2189	29466	2042	0.0	14.429970617042116
chr20	NAA20	20022455	20022480	0	26	29466	2189	29466	2163	0.0	13.622746185852982
chr20	CFAP61	20056645	20056796	0	152	51	7956	51	7804	0.0	0.0065351101998974885
chr20	CFAP61	20056617	20056796	0	180	51	7956	51	7776	0.0	0.006558641975308642
chr20	CFAP61	20191341	20191419	0	79	51	7956	51	7877	0.0	0.006474546147010283
chr20	CFAP61	20199767	20199902	0	136	51	7956	51	7820	0.0	0.006521739130434782
chr20	CFAP61	20246116	20246215	0	100	51	7956	51	7856	0.0	0.006491853360488798
chr20	CFAP61	20277165	20277458	0	294	51	7956	51	7662	0.0	0.006656225528582615
chr20	CFAP61	20288608	20288936	0	329	51	7956	51	7627	0.0	0.006686770683099515
chr20	CFAP61	20069744	20069901	0	158	51	7956	51	7798	0.0	0.006540138497050526
chr20	CFAP61	20107645	20107771	0	127	51	7956	51	7829	0.0	0.006514241921062715
chr20	CFAP61	20232320	20232503	0	184	51	7956	51	7772	0.0	0.00656201749871333
chr20	KIZ	21215582	21215648	234	67	2332	3152	2098	3085	3.4925373134328357	0.680064829821718
chr20	KIZ	21232733	21232830	0	98	2332	3152	2332	3054	0.0	0.7635887360838245
chr20	KIZ	21132096	21132159	0	64	2332	3152	2332	3088	0.0	0.7551813471502591
chr20	KIZ	21145564	21145654	0	91	2332	3152	2332	3061	0.0	0.761842535119242
chr20	KIZ	21131863	21131957	0	95	2332	3152	2332	3057	0.0	0.7628393850179915
chr20	KIZ	21136389	21136552	0	164	2332	3152	2332	2988	0.0	0.7804551539491299
chr20	LINC01727	21612547	21612683	0	137	102	7415	102	7278	0.0	0.014014839241549877
chr20	LINC01727	21615612	21615888	0	277	102	7415	102	7138	0.0	0.014289717007565145
chr20	LINC01727	21615661	21615888	0	228	102	7415	102	7187	0.0	0.014192291637679143
chr20	LINC01727	21651673	21651813	0	141	102	7415	102	7274	0.0	0.014022546054440473
chr20	AL118508.1	23186399	23186550	0	152	0	3797	0	3645	0.0	0.0
chr20	AL118508.1	23187212	23187640	0	429	0	3797	0	3368	0.0	0.0
chr20	AL118508.1	23186222	23186313	0	92	0	3797	0	3705	0.0	0.0
chr20	AL118508.1	23185869	23185950	0	82	0	3797	0	3715	0.0	0.0
chr20	AL118508.1	23186402	23186550	0	149	0	3797	0	3648	0.0	0.0
chr20	AL118508.1	23180603	23180793	0	191	0	3797	0	3606	0.0	0.0
chr20	AL118508.1	23180931	23181216	0	286	0	3797	0	3511	0.0	0.0
chr20	AL118508.1	23187314	23187640	0	327	0	3797	0	3470	0.0	0.0
chr20	AL118508.1	23187574	23187640	0	67	0	3797	0	3730	0.0	0.0
chr20	AL118508.1	23186453	23186550	0	98	0	3797	0	3699	0.0	0.0
chr20	GZF1	23367002	23367097	3646	96	36072	5470	32426	5374	37.979166666666664	6.033866765909937
chr20	GZF1	23369583	23369741	1348	159	36072	5470	34724	5311	8.477987421383649	6.5381284127283
chr20	AL121894.3	23672593	23672720	0	128	0	3234	0	3106	0.0	0.0
chr20	AL591074.1	23803714	23803836	0	123	252	1556	252	1433	0.0	0.17585484996510817
chr20	AL591074.1	23803738	23803836	0	99	252	1556	252	1457	0.0	0.17295813315030886
chr20	LINC01721	24201465	24202251	0	787	0	8968	0	8181	0.0	0.0
chr20	ENTPD6	25207075	25207397	127521	323	152424	6012	24903	5689	394.8018575851393	4.377394972754439
chr20	ENTPD6	25213262	25213406	304	145	152424	6012	152120	5867	2.0965517241379312	25.9280722686211
chr20	ENTPD6	25221231	25221333	0	103	152424	6012	152424	5909	0.0	25.795227618886443
chr20	ENTPD6	25206521	25206590	7997	70	152424	6012	144427	5942	114.24285714285715	24.306125883540897
chr20	ENTPD6	25207078	25207397	124851	320	152424	6012	27573	5692	390.159375	4.844167252283907
chr20	ZNF337-AS1	25674896	25675078	13647	183	59579	3182	45932	2999	74.57377049180327	15.315771923974658
chr20	ZNF337-AS1	25634728	25634827	0	100	59579	3182	59579	3082	0.0	19.33127839065542
chr20	ZNF337-AS1	25645530	25645648	962	119	59579	3182	58617	3063	8.084033613445378	19.137120470127325
chr20	FAM182A	26073769	26073869	0	101	10804	10300	10804	10199	0.0	1.0593195411314835
chr20	FAM182A	26076333	26076505	0	173	10804	10300	10804	10127	0.0	1.0668509923965637
chr20	HM13	31538178	31538261	0	84	1479	7787	1479	7703	0.0	0.1920031156692198
chr20	HM13	31549206	31549332	0	127	1479	7787	1479	7660	0.0	0.19308093994778067
chr20	HM13	31554745	31554829	0	85	1479	7787	1479	7702	0.0	0.1920280446637237
chr20	HM13	31568077	31568280	0	204	1479	7787	1479	7583	0.0	0.19504154028748516
chr20	HM13	31566209	31566295	0	87	1479	7787	1479	7700	0.0	0.19207792207792207
chr20	HM13	31527921	31528050	0	130	1479	7787	1479	7657	0.0	0.19315658874232727
chr20	HM13	31568077	31568224	0	148	1479	7787	1479	7639	0.0	0.1936117292839377
chr20	HM13	31538178	31538554	0	377	1479	7787	1479	7410	0.0	0.19959514170040485
chr20	HM13	31554759	31554829	0	71	1479	7787	1479	7716	0.0	0.1916796267496112
chr20	HM13	31538178	31538359	0	182	1479	7787	1479	7605	0.0	0.19447731755424064
chr20	HM13	31549028	31549114	0	87	1479	7787	1479	7700	0.0	0.19207792207792207
chr20	HM13	31567639	31567740	0	102	1479	7787	1479	7685	0.0	0.19245283018867926
chr20	COX4I2	31643403	31643535	0	133	0	674	0	541	0.0	0.0
chr20	TPX2	31780938	31781046	0	109	0	3624	0	3515	0.0	0.0
chr20	TTLL9	31919863	31919932	0	70	2953	5733	2953	5663	0.0	0.5214550591559244
chr20	TTLL9	31926048	31926091	0	44	2953	5733	2953	5689	0.0	0.5190718931270873
chr20	TTLL9	31934691	31934888	0	198	2953	5733	2953	5535	0.0	0.5335140018066847
chr20	TTLL9	31939141	31939266	0	126	2953	5733	2953	5607	0.0	0.5266630996968076
chr20	TTLL9	31884020	31884102	0	83	2953	5733	2953	5650	0.0	0.5226548672566371
chr20	TTLL9	31938158	31938263	0	106	2953	5733	2953	5627	0.0	0.5247911853563177
chr20	TTLL9	31925872	31925960	0	89	2953	5733	2953	5644	0.0	0.5232104890148831
chr20	TTLL9	31938181	31938263	0	83	2953	5733	2953	5650	0.0	0.5226548672566371
chr20	TTLL9	31920645	31920719	0	75	2953	5733	2953	5658	0.0	0.5219158713326264
chr20	CCM2L	32025855	32025919	0	65	20757	2609	20757	2544	0.0	8.159198113207546
chr20	HCK	32069687	32069751	0	65	2874	3098	2874	3033	0.0	0.9475766567754699
chr20	HCK	32054215	32054281	0	67	2874	3098	2874	3031	0.0	0.9482019135598813
chr20	TM9SF4	32136876	32136997	0	122	853	5182	853	5060	0.0	0.16857707509881423
chr20	POFUT1	32210070	32210192	0	123	291174	4772	291174	4649	0.0	62.63153366315337
chr20	ASXL1	32367726	32367729	0	4	641407	10047	641407	10043	0.0	63.86607587374291
chr20	ASXL1	32429900	32430053	255	154	641407	10047	641152	9893	1.655844155844156	64.80865258263418
chr20	ASXL1	32371777	32371874	0	98	641407	10047	641407	9949	0.0	64.46949442154991
chr20	ASXL1	32360709	32360806	663	98	641407	10047	640744	9949	6.76530612244898	64.40285455824706
chr20	DNMT3B	32786501	32786627	0	127	24805	4654	24805	4527	0.0	5.479346145350122
chr20	DNMT3B	32793535	32793595	0	61	24805	4654	24805	4593	0.0	5.400609623339865
chr20	DNMT3B	32784757	32784859	0	103	24805	4654	24805	4551	0.0	5.45045045045045
chr20	BPIFB6	33033302	33033613	0	312	2713	1692	2713	1380	0.0	1.9659420289855072
chr20	BPIFA3	33224354	33224462	0	109	29796	2536	29796	2427	0.0	12.276885043263288
chr20	CBFA2T2	33573973	33574261	0	289	71368	9475	71368	9186	0.0	7.769214021336817
chr20	CBFA2T2	33601829	33601905	0	77	71368	9475	71368	9398	0.0	7.593956160885295
chr20	CBFA2T2	33623772	33623854	127	83	71368	9475	71241	9392	1.5301204819277108	7.5852853492333905
chr20	ZNF341	33745102	33745299	0	198	2859	5472	2859	5274	0.0	0.5420932878270762
chr20	ZNF341	33781290	33781387	0	98	2859	5472	2859	5374	0.0	0.5320059545962039
chr20	RALY	34065043	34065160	690	118	230306	7527	229616	7409	5.8474576271186445	30.99149682818194
chr20	RALY	34073818	34073866	156	49	230306	7527	230150	7478	3.183673469387755	30.776945707408398
chr20	RALY	34033163	34033239	0	77	230306	7527	230306	7450	0.0	30.913557046979864
chr20	ITCH	34393769	34393881	0	113	34947	10673	34947	10560	0.0	3.309375
chr20	ITCH	34408650	34408792	366	143	34947	10673	34581	10530	2.5594405594405596	3.284045584045584
chr20	ITCH	34393790	34393881	0	92	34947	10673	34947	10581	0.0	3.302806918060675
chr20	ITCH	34442207	34442303	105	97	34947	10673	34842	10576	1.0824742268041236	3.2944402420574885
chr20	ITCH	34397207	34397321	0	115	34947	10673	34947	10558	0.0	3.3100018942981624
chr20	ITCH	34365459	34365576	0	118	34947	10673	34947	10555	0.0	3.310942681193747
chr20	ITCH	34392736	34392914	210	179	34947	10673	34737	10494	1.1731843575418994	3.310177244139508
chr20	ITCH	34417116	34417239	0	124	34947	10673	34947	10549	0.0	3.312825860271116
chr20	DYNLRB1	34529851	34530234	648	384	2116	2460	1468	2076	1.6875	0.7071290944123314
chr20	MAP1LC3A	34559207	34559263	0	57	0	1158	0	1101	0.0	0.0
chr20	TP53INP2	34705357	34705474	0	118	204	4174	204	4056	0.0	0.05029585798816568
chr20	ACSS2	34926104	34926281	0	178	0	5112	0	4934	0.0	0.0
chr20	ACSS2	34893568	34893622	0	55	0	5112	0	5057	0.0	0.0
chr20	ACSS2	34908904	34908943	0	40	0	5112	0	5072	0.0	0.0
chr20	ACSS2	34915217	34915256	0	40	0	5112	0	5072	0.0	0.0
chr20	PROCR	35177086	35177215	357	130	20389	1313	20032	1183	2.746153846153846	16.933220625528318
chr20	CEP250	35458303	35458374	0	72	154498	10901	154498	10829	0.0	14.267060670422016
chr20	CEP250	35475501	35475646	3338	146	154498	10901	151160	10755	22.863013698630137	14.05485820548582
chr20	CEP250	35500048	35500169	0	122	154498	10901	154498	10779	0.0	14.333240560348827
chr20	CEP250	35474793	35474852	1131	60	154498	10901	153367	10841	18.85	14.14694216400701
chr20	ERGIC3	35554371	35554386	0	16	18412	4803	18412	4787	0.0	3.846250261123877
chr20	ERGIC3	35556032	35556129	0	98	18412	4803	18412	4705	0.0	3.9132837407013814
chr20	ERGIC3	35543660	35543804	0	145	18412	4803	18412	4658	0.0	3.952769428939459
chr20	ERGIC3	35549162	35549207	0	46	18412	4803	18412	4757	0.0	3.870506621820475
chr20	SPAG4	35618086	35618130	0	45	1972	2311	1972	2266	0.0	0.8702559576345984
chr20	SPAG4	35618611	35618720	0	110	1972	2311	1972	2201	0.0	0.8959563834620627
chr20	PHF20	35858301	35858381	54675	81	81245	8400	26570	8319	675.0	3.193893496814521
chr20	PHF20	35863012	35863400	0	389	81245	8400	81245	8011	0.0	10.141680189739109
chr20	PHF20	35870954	35871134	0	181	81245	8400	81245	8219	0.0	9.885022508821024
chr20	PHF20	35782327	35782609	459	283	81245	8400	80786	8117	1.6219081272084805	9.95269188123691
chr20	PHF20	35845384	35845508	0	125	81245	8400	81245	8275	0.0	9.818126888217522
chr20	PHF20	35800093	35800173	51	81	81245	8400	81194	8319	0.6296296296296297	9.760067315783147
chr20	CNBD2	35983981	35984138	0	158	21771	5019	21771	4861	0.0	4.478708084756223
chr20	CNBD2	35987394	35987533	0	140	21771	5019	21771	4879	0.0	4.46218487394958
chr20	CNBD2	36023601	36023771	123	171	21771	5019	21648	4848	0.7192982456140351	4.465346534653466
chr20	CNBD2	36023613	36023771	123	159	21771	5019	21648	4860	0.7735849056603774	4.454320987654321
chr20	AL035420.1	36071897	36071988	0	92	0	2043	0	1951	0.0	0.0
chr20	AL035420.1	36081877	36081970	0	94	0	2043	0	1949	0.0	0.0
chr20	AL035420.1	36072677	36072810	0	134	0	2043	0	1909	0.0	0.0
chr20	AL035420.1	36070485	36070808	0	324	0	2043	0	1719	0.0	0.0
chr20	EPB41L1	36177951	36178056	0	106	1553	9712	1553	9606	0.0	0.16166978971476162
chr20	EPB41L1	36209487	36209898	0	412	1553	9712	1553	9300	0.0	0.16698924731182796
chr20	EPB41L1	36173763	36173954	0	192	1553	9712	1553	9520	0.0	0.16313025210084034
chr20	EPB41L1	36121659	36121816	0	158	1553	9712	1553	9554	0.0	0.16254971739585514
chr20	EPB41L1	36214356	36214440	0	85	1553	9712	1553	9627	0.0	0.1613171289082788
chr20	EPB41L1	36218875	36218962	0	88	1553	9712	1553	9624	0.0	0.16136741479634248
chr20	EPB41L1	36113692	36113799	0	108	1553	9712	1553	9604	0.0	0.16170345689296126
chr20	EPB41L1	36195328	36195364	0	37	1553	9712	1553	9675	0.0	0.16051679586563308
chr20	EPB41L1	36214359	36214440	0	82	1553	9712	1553	9630	0.0	0.1612668743509865
chr20	EPB41L1	36112425	36112480	0	56	1553	9712	1553	9656	0.0	0.16083264291632146
chr20	EPB41L1	36125422	36125527	0	106	1553	9712	1553	9606	0.0	0.16166978971476162
chr20	EPB41L1	36208300	36208408	0	109	1553	9712	1553	9603	0.0	0.1617202957409143
chr20	DLGAP4	36499241	36499321	245	81	47725	7378	47480	7297	3.0246913580246915	6.506783609702618
chr20	DLGAP4	36499587	36499676	1122	90	47725	7378	46603	7288	12.466666666666667	6.394484083424808
chr20	DLGAP4	36465264	36465367	0	104	47725	7378	47725	7274	0.0	6.561039318119329
chr20	DLGAP4	36493057	36493185	204	129	47725	7378	47521	7249	1.5813953488372092	6.555524899986205
chr20	MYL9	36548031	36548193	0	163	0	2812	0	2649	0.0	0.0
chr20	TGIF2	36576214	36576403	0	190	1455	3979	1455	3789	0.0	0.384006334125099
chr20	RAB5IF	36609600	36609730	0	131	16567	1286	16567	1155	0.0	14.343722943722943
chr20	TGIF2	36590909	36591009	0	101	1455	3979	1455	3878	0.0	0.3751933986591026
chr20	RAB5IF	36607889	36608000	0	112	16567	1286	16567	1174	0.0	14.111584327086883
chr20	RAB5IF	36609600	36609758	0	159	16567	1286	16567	1127	0.0	14.700088731144632
chr20	TLDC2	36889250	36889403	0	154	0	2560	0	2406	0.0	0.0
chr20	RPN2	37199049	37199225	0	177	19265	2720	19265	2543	0.0	7.575697994494691
chr20	RPN2	37232295	37232391	0	97	19265	2720	19265	2623	0.0	7.344643537933663
chr20	RPN2	37238401	37238449	0	49	19265	2720	19265	2671	0.0	7.212654436540621
chr20	RPN2	37198396	37198492	230	97	19265	2720	19035	2623	2.3711340206185567	7.256957682043462
chr20	RPN2	37200446	37200494	135	49	19265	2720	19130	2671	2.7551020408163267	7.162111568700861
chr20	RPN2	37236579	37236709	0	131	19265	2720	19265	2589	0.0	7.4410969486288145
chr20	MANBAL	37302279	37302323	0	45	51	2051	51	2006	0.0	0.025423728813559324
chr20	SRC	37386459	37386477	0	19	62801	6499	62801	6480	0.0	9.691512345679012
chr20	NNAT	37522357	37522384	0	28	0	1332	0	1304	0.0	0.0
chr20	NNAT	37522357	37522438	0	82	0	1332	0	1250	0.0	0.0
chr20	NNAT	37522357	37522433	0	77	0	1332	0	1255	0.0	0.0
chr20	CTNNBL1	37727301	37727402	0	102	0	4173	0	4071	0.0	0.0
chr20	CTNNBL1	37694926	37695033	0	108	0	4173	0	4065	0.0	0.0
chr20	VSTM2L	37933538	37933589	0	52	0	1956	0	1904	0.0	0.0
chr20	VSTM2L	37931634	37931804	0	171	0	1956	0	1785	0.0	0.0
chr20	RPRD1B	38040434	38040564	0	131	0	5344	0	5213	0.0	0.0
chr20	RPRD1B	38048347	38048481	0	135	0	5344	0	5209	0.0	0.0
chr20	SNHG11	38447929	38448093	0	165	0	4261	0	4096	0.0	0.0
chr20	RALGAPB	38534384	38534393	0	10	104	11777	104	11767	0.0	0.008838276536075466
chr20	PPP1R16B	38905968	38906094	0	127	39	6421	39	6294	0.0	0.006196377502383222
chr20	DHX35	38972558	38972651	0	94	17	5021	17	4927	0.0	0.003450375482037751
chr20	DHX35	39023689	39023767	0	79	17	5021	17	4942	0.0	0.0034399028733306356
chr20	DHX35	39030703	39030775	0	73	17	5021	17	4948	0.0	0.0034357316087308
chr20	DHX35	39010511	39010579	17	69	17	5021	0	4952	0.2463768115942029	0.0
chr20	LINC01370	40006934	40007046	0	113	153	4191	153	4078	0.0	0.037518391368317805
chr20	LINC01370	40008340	40008459	0	120	153	4191	153	4071	0.0	0.03758290346352248
chr20	PLCG1	41172192	41172289	0	98	0	9334	0	9236	0.0	0.0
chr20	PLCG1	41174123	41174311	0	189	0	9334	0	9145	0.0	0.0
chr20	PLCG1	41180503	41180664	0	162	0	9334	0	9172	0.0	0.0
chr20	PLCG1	41174466	41174539	0	74	0	9334	0	9260	0.0	0.0
chr20	PLCG1	41185573	41185775	0	203	0	9334	0	9131	0.0	0.0
chr20	LPIN3	41354644	41354737	0	94	0	4686	0	4592	0.0	0.0
chr20	AL021395.1	43194976	43195054	144	79	3459	2448	3315	2369	1.8227848101265822	1.3993246095398904
chr20	AL021395.1	43198848	43198957	0	110	3459	2448	3459	2338	0.0	1.4794696321642429
chr20	SRSF6	43460702	43460852	0	151	0	2895	0	2744	0.0	0.0
chr20	SRSF6	43459152	43459420	0	269	0	2895	0	2626	0.0	0.0
chr20	L3MBTL1	43515291	43515415	0	125	1799354	12176	1799354	12051	0.0	149.31159239897104
chr20	L3MBTL1	43530797	43530889	2273	93	1799354	12176	1797081	12083	24.440860215053764	148.72804767028055
chr20	L3MBTL1	43532772	43532924	357	153	1799354	12176	1798997	12023	2.3333333333333335	149.6296265491142
chr20	L3MBTL1	43513475	43513639	12	165	1799354	12176	1799342	12011	0.07272727272727272	149.8078428107568
chr20	L3MBTL1	43518606	43518703	0	98	1799354	12176	1799354	12078	0.0	148.97781089584367
chr20	L3MBTL1	43513558	43513639	12	82	1799354	12176	1799342	12094	0.14634146341463414	148.77972548371093
chr20	L3MBTL1	43540752	43540815	408	64	1799354	12176	1798946	12112	6.375	148.52592470277412
chr20	SGK2	43565041	43565286	6471	246	488748	4836	482277	4590	26.304878048780488	105.07124183006536
chr20	SGK2	43583182	43583374	0	193	488748	4836	488748	4643	0.0	105.2655610596597
chr20	IFT52	43642478	43642624	816	147	12178	2501	11362	2354	5.551020408163265	4.826677994902294
chr20	MYBL2	43681783	43681855	190	73	67094	2790	66904	2717	2.6027397260273974	24.62421788737578
chr20	TOX2	44064776	44064857	0	82	906169	3248	906169	3166	0.0	286.21888818698676
chr20	TOX2	43955147	43955272	128160	126	906169	3248	778009	3122	1017.1428571428571	249.20211402946828
chr20	TOX2	44065711	44066107	77	397	906169	3248	906092	2851	0.19395465994962216	317.81550333216416
chr20	OSER1-DT	44217366	44217682	0	317	48	9245	48	8928	0.0	0.005376344086021506
chr20	OSER1-DT	44214887	44215003	0	117	48	9245	48	9128	0.0	0.0052585451358457495
chr20	OSER1-DT	44223718	44223872	0	155	48	9245	48	9090	0.0	0.005280528052805281
chr20	GDAP1L1	44258433	44258607	0	175	102	2968	102	2793	0.0	0.036519871106337275
chr20	GDAP1L1	44258376	44258607	0	232	102	2968	102	2736	0.0	0.03728070175438596
chr20	HNF4A	44390457	44390679	0	223	799777	7355	799777	7132	0.0	112.13923163208077
chr20	HNF4A	44402553	44402644	0	92	799777	7355	799777	7263	0.0	110.11661847721328
chr20	TTPAL	44478623	44478647	0	25	69152	7062	69152	7037	0.0	9.82691487849936
chr20	PKIG	44585099	44585204	169	106	4078	2475	3909	2369	1.5943396226415094	1.6500633178556352
chr20	PKIG	44582584	44582731	1651	148	4078	2475	2427	2327	11.155405405405405	1.0429737859905457
chr20	PKIG	44598615	44598890	498	276	4078	2475	3580	2199	1.8043478260869565	1.628012733060482
chr20	CCN5	44724737	44724992	0	256	494806	4985	494806	4729	0.0	104.63226897864241
chr20	YWHAB	44903035	44903121	0	87	0	5857	0	5770	0.0	0.0
chr20	YWHAB	44887647	44887742	0	96	0	5857	0	5761	0.0	0.0
chr20	YWHAB	44887544	44887742	0	199	0	5857	0	5658	0.0	0.0
chr20	YWHAB	44886878	44886978	0	101	0	5857	0	5756	0.0	0.0
chr20	YWHAB	44902897	44903121	0	225	0	5857	0	5632	0.0	0.0
chr20	PABPC1L	44916755	44916871	0	117	0	3854	0	3737	0.0	0.0
chr20	PABPC1L	44932341	44932432	0	92	0	3854	0	3762	0.0	0.0
chr20	PABPC1L	44938673	44938748	0	76	0	3854	0	3778	0.0	0.0
chr20	PABPC1L	44933071	44933185	0	115	0	3854	0	3739	0.0	0.0
chr20	PABPC1L	44934500	44934563	0	64	0	3854	0	3790	0.0	0.0
chr20	PABPC1L	44933056	44933185	0	130	0	3854	0	3724	0.0	0.0
chr20	PABPC1L	44931832	44932026	0	195	0	3854	0	3659	0.0	0.0
chr20	PABPC1L	44936893	44936976	0	84	0	3854	0	3770	0.0	0.0
chr20	PABPC1L	44938060	44938191	0	132	0	3854	0	3722	0.0	0.0
chr20	STK4	44987131	44987296	71719	166	184090	9018	112371	8852	432.0421686746988	12.694419340262087
chr20	STK4	45053085	45053180	0	96	184090	9018	184090	8922	0.0	20.633266083837704
chr20	SYS1	45363528	45363693	6997	166	16135	6006	9138	5840	42.15060240963855	1.5647260273972603
chr20	SYS1	45363543	45363693	6641	151	16135	6006	9494	5855	43.980132450331126	1.6215200683176771
chr20	SYS1-DBNDD2	45399689	45399751	0	63	11102	1409	11102	1346	0.0	8.248142644873699
chr20	PIGT	45419294	45419395	0	102	204	11655	204	11553	0.0	0.01765775123344586
chr20	PIGT	45421382	45421583	0	202	204	11655	204	11453	0.0	0.017811927006024623
chr20	PIGT	45424495	45424579	0	85	204	11655	204	11570	0.0	0.01763180639585134
chr20	PIGT	45416516	45416694	0	179	204	11655	204	11476	0.0	0.017776228651097944
chr20	PIGT	45416516	45416654	0	139	204	11655	204	11516	0.0	0.017714484195901353
chr20	PIGT	45418851	45418979	0	129	204	11655	204	11526	0.0	0.017699115044247787
chr20	PIGT	45421382	45421533	0	152	204	11655	204	11503	0.0	0.017734504042423715
chr20	PIGT	45418771	45418979	0	209	204	11655	204	11446	0.0	0.017822820199196225
chr20	PIGT	45447634	45447816	0	183	204	11655	204	11472	0.0	0.01778242677824268
chr20	PIGT	45416516	45416664	0	149	204	11655	204	11506	0.0	0.01772988006257605
chr20	PIGT	45419277	45419395	0	119	204	11655	204	11536	0.0	0.01768377253814147
chr20	PIGT	45419142	45419395	0	254	204	11655	204	11401	0.0	0.017893167266029297
chr20	PIGT	45418771	45419395	0	625	204	11655	204	11030	0.0	0.018495013599274704
chr20	PIGT	45421382	45421664	0	283	204	11655	204	11372	0.0	0.017938797045374603
chr20	PIGT	45424460	45424579	0	120	204	11655	204	11535	0.0	0.017685305591677504
chr20	WFDC2	45470388	45470532	0	145	0	1137	0	992	0.0	0.0
chr20	WFDC2	45471152	45471281	0	130	0	1137	0	1007	0.0	0.0
chr20	DNTTIP1	45795344	45795443	0	100	0	1880	0	1780	0.0	0.0
chr20	DNTTIP1	45809113	45809185	0	73	0	1880	0	1807	0.0	0.0
chr20	UBE2C	45814383	45814470	0	88	6	1293	6	1205	0.0	0.004979253112033195
chr20	UBE2C	45815389	45815540	0	152	6	1293	6	1141	0.0	0.0052585451358457495
chr20	UBE2C	45815540	45815745	6	206	6	1293	0	1087	0.02912621359223301	0.0
chr20	UBE2C	45815442	45815745	6	304	6	1293	0	989	0.019736842105263157	0.0
chr20	SNX21	45840447	45840458	873	12	147635	3701	146762	3689	72.75	39.78368121442125
chr20	CTSA	45892272	45892323	0	52	24659	7771	24659	7719	0.0	3.194584790776007
chr20	CTSA	45894649	45894741	0	93	24659	7771	24659	7678	0.0	3.2116436572023965
chr20	CTSA	45897716	45897806	0	91	24659	7771	24659	7680	0.0	3.210807291666667
chr20	CTSA	45893219	45893311	0	93	24659	7771	24659	7678	0.0	3.2116436572023965
chr20	CTSA	45891915	45892027	0	113	24659	7771	24659	7658	0.0	3.220031339775398
chr20	CTSA	45892978	45893145	0	168	24659	7771	24659	7603	0.0	3.2433250032881755
chr20	CTSA	45893039	45893145	0	107	24659	7771	24659	7664	0.0	3.217510438413361
chr20	CTSA	45897725	45897806	0	82	24659	7771	24659	7689	0.0	3.2070490310833657
chr20	CTSA	45896964	45897040	0	77	24659	7771	24659	7694	0.0	3.2049649077203015
chr20	SLC12A5	46037254	46037385	0	132	420	8372	420	8240	0.0	0.050970873786407765
chr20	SLC12A5	46022842	46023071	0	230	420	8372	420	8142	0.0	0.051584377302873984
chr20	SLC12A5	46022929	46023071	0	143	420	8372	420	8229	0.0	0.05103900838497995
chr20	SLC12A5	46038223	46038330	0	108	420	8372	420	8264	0.0	0.050822846079380445
chr20	CD40	46123125	46123219	0	95	6419	2531	6419	2436	0.0	2.6350574712643677
chr20	CD40	46126639	46126701	0	63	6419	2531	6419	2468	0.0	2.6008914100486225
chr20	EYA2	47143058	47143148	0	91	264	3638	264	3547	0.0	0.0744290950098675
chr20	LINC00494	48360605	48360975	129	371	333	5148	204	4777	0.3477088948787062	0.042704626334519574
chr20	LINC00494	48360605	48360883	129	279	333	5148	204	4869	0.46236559139784944	0.041897720271102896
chr20	LINC00494	48365872	48366007	102	136	333	5148	231	5012	0.75	0.046089385474860335
chr20	LINC00494	48366735	48367059	0	325	333	5148	333	4823	0.0	0.06904416338378602
chr20	CSE1L	49072285	49072453	0	169	332	3652	332	3483	0.0	0.09532012632787827
chr20	DDX27	49231022	49231115	0	94	79	4140	79	4046	0.0	0.019525457241720216
chr20	ZFAS1	49280484	49280570	0	87	2295	7898	2295	7811	0.0	0.29381641275124826
chr20	ZFAS1	49281751	49281818	0	68	2295	7898	2295	7830	0.0	0.29310344827586204
chr20	ZFAS1	49280902	49280964	0	63	2295	7898	2295	7835	0.0	0.2929164007657945
chr20	AL035685.1	49331379	49331455	0	77	816	3966	816	3889	0.0	0.20982257649781436
chr20	RNF114	49949247	49949355	0	109	3573	4344	3573	4235	0.0	0.8436835891381346
chr20	RNF114	49941582	49941711	0	130	3573	4344	3573	4214	0.0	0.8478879924062648
chr20	RNF114	49941560	49941711	0	152	3573	4344	3573	4192	0.0	0.8523377862595419
chr20	RNF114	49941106	49941220	0	115	3573	4344	3573	4229	0.0	0.8448805864270513
chr20	LINC01273	50173201	50173318	0	118	102	1682	102	1564	0.0	0.06521739130434782
chr20	PELATON	50276056	50276390	0	335	356	7207	356	6872	0.0	0.05180442374854482
chr20	PELATON	50275645	50275735	0	91	356	7207	356	7116	0.0	0.05002810567734682
chr20	PELATON	50275650	50275735	0	86	356	7207	356	7121	0.0	0.04999297851425362
chr20	LINC01270	50298155	50298413	0	259	5256	5084	5256	4825	0.0	1.0893264248704664
chr20	LINC01270	50311613	50311706	0	94	5256	5084	5256	4990	0.0	1.0533066132264528
chr20	LINC01270	50313068	50313299	0	232	5256	5084	5256	4852	0.0	1.0832646331409728
chr20	LINC01270	50293242	50293728	0	487	5256	5084	5256	4597	0.0	1.143354361540135
chr20	PTPN1	50561362	50561453	0	92	1383	4051	1383	3959	0.0	0.34933063905026523
chr20	BCAS4	50875996	50876093	0	98	0	7591	0	7493	0.0	0.0
chr20	BCAS4	50841765	50841900	0	136	0	7591	0	7455	0.0	0.0
chr20	BCAS4	50840536	50840930	0	395	0	7591	0	7196	0.0	0.0
chr20	ADNP-AS1	50933723	50933827	0	105	0	1053	0	948	0.0	0.0
chr20	ADNP-AS1	50933719	50933827	0	109	0	1053	0	944	0.0	0.0
chr20	LINC01524	52234768	52234932	0	165	79339	14925	79339	14760	0.0	5.3752710027100274
chr20	LINC01524	52304954	52304991	0	38	79339	14925	79339	14887	0.0	5.329414925774166
chr20	LINC01524	52325461	52325632	0	172	79339	14925	79339	14753	0.0	5.377821460042026
chr20	LINC01524	52281833	52281964	0	132	79339	14925	79339	14793	0.0	5.363279929696478
chr20	LINC01524	52416125	52416218	0	94	79339	14925	79339	14831	0.0	5.3495381295934195
chr20	LINC01524	52340489	52340652	0	164	79339	14925	79339	14761	0.0	5.374906849129463
chr20	LINC01524	52442499	52442638	0	140	79339	14925	79339	14785	0.0	5.366181941156578
chr20	LINC01524	52438858	52438993	0	136	79339	14925	79339	14789	0.0	5.364730542971127
chr20	LINC01524	52215466	52215558	0	93	79339	14925	79339	14832	0.0	5.349177454153183
chr20	LINC01524	52355321	52355359	192	39	79339	14925	79147	14886	4.923076923076923	5.316874916028483
chr20	LINC01524	52538751	52539061	0	311	79339	14925	79339	14614	0.0	5.428972218420692
chr20	LINC01524	52666718	52666777	0	60	79339	14925	79339	14865	0.0	5.337302388160108
chr20	LINC01524	52285096	52285170	92	75	79339	14925	79247	14850	1.2266666666666666	5.336498316498316
chr20	LINC01524	52324714	52324759	0	46	79339	14925	79339	14879	0.0	5.332280395187849
chr20	LINC01524	52646489	52646806	0	318	79339	14925	79339	14607	0.0	5.431573902923256
chr20	LINC01524	52646979	52647720	0	742	79339	14925	79339	14183	0.0	5.593950504124656
chr20	AL031674.1	52675209	52675310	0	102	187	3306	187	3204	0.0	0.058364544319600496
chr20	AL031674.1	52677019	52677108	187	90	187	3306	0	3216	2.077777777777778	0.0
chr20	AL031674.1	52681404	52681550	0	147	187	3306	187	3159	0.0	0.059195948084836976
chr20	AL031674.1	52685074	52685213	0	140	187	3306	187	3166	0.0	0.059065066329753634
chr20	AL031674.1	52687948	52688165	0	218	187	3306	187	3088	0.0	0.06055699481865285
chr20	AL031674.1	52690521	52690614	0	94	187	3306	187	3212	0.0	0.05821917808219178
chr20	AL031674.1	52687951	52688165	0	215	187	3306	187	3091	0.0	0.060498220640569395
chr20	LINC01440	55411929	55411983	0	55	0	5095	0	5040	0.0	0.0
chr20	LINC01440	55438128	55438303	0	176	0	5095	0	4919	0.0	0.0
chr20	LINC01440	55448864	55448969	0	106	0	5095	0	4989	0.0	0.0
chr20	AL109828.1	55779379	55779515	0	137	306	1444	306	1307	0.0	0.234123947972456
chr20	CASS4	56451818	56453129	0	1312	0	5076	0	3764	0.0	0.0
chr20	RTF2	56472325	56472415	0	91	0	4074	0	3983	0.0	0.0
chr20	RTF2	56516934	56516989	0	56	0	4074	0	4018	0.0	0.0
chr20	SPO11	57331832	57331946	0	115	0	1837	0	1722	0.0	0.0
chr20	SPO11	57337738	57337771	0	34	0	1837	0	1803	0.0	0.0
chr20	RAE1	57373474	57373581	0	108	0	3313	0	3205	0.0	0.0
chr20	RAE1	57351890	57351998	0	109	0	3313	0	3204	0.0	0.0
chr20	RBM38	57393278	57393333	0	56	0	2646	0	2590	0.0	0.0
chr20	RBM38	57399927	57399968	0	42	0	2646	0	2604	0.0	0.0
chr20	VAPB	58434601	58434705	0	105	36553	10486	36553	10381	0.0	3.5211443984201907
chr20	VAPB	58440906	58441083	331	178	36553	10486	36222	10308	1.8595505617977528	3.5139697322467986
chr20	VAPB	58438944	58439025	1425	82	36553	10486	35128	10404	17.378048780487806	3.376393694732795
chr20	APCDD1L-DT	58521389	58521551	8256	163	24977	5587	16721	5424	50.65030674846626	3.0827802359882006
chr20	APCDD1L-DT	58519503	58519625	2711	123	24977	5587	22266	5464	22.040650406504064	4.075036603221084
chr20	APCDD1L-DT	58519503	58519599	2117	97	24977	5587	22860	5490	21.824742268041238	4.163934426229508
chr20	APCDD1L-DT	58547811	58547928	0	118	24977	5587	24977	5469	0.0	4.5670140793563725
chr20	STX16	58669290	58669453	0	164	0	5049	0	4885	0.0	0.0
chr20	STX16	58671153	58671297	0	145	0	5049	0	4904	0.0	0.0
chr20	STX16	58659622	58659634	0	13	0	5049	0	5036	0.0	0.0
chr20	STX16	58667200	58667318	0	119	0	5049	0	4930	0.0	0.0
chr20	NPEPL1	58705497	58705569	0	73	0	5961	0	5888	0.0	0.0
chr20	STX16	58671163	58671297	0	135	0	5049	0	4914	0.0	0.0
chr20	STX16	58669301	58669453	0	153	0	5049	0	4896	0.0	0.0
chr20	GNAS	58898940	58898985	0	46	51	12313	51	12267	0.0	0.004157495720224994
chr20	GNAS	58840849	58840886	0	38	51	12313	51	12275	0.0	0.004154786150712831
chr20	GNAS	58899948	58900030	0	83	51	12313	51	12230	0.0	0.004170073589533933
chr20	GNAS	58891581	58891865	0	285	51	12313	51	12028	0.0	0.004240106418357166
chr20	GNAS	58889525	58889549	0	25	51	12313	51	12288	0.0	0.004150390625
chr20	EDN3	59322371	59322452	0	82	0	3293	0	3211	0.0	0.0
chr20	EDN3	59322371	59322417	0	47	0	3293	0	3246	0.0	0.0
chr20	EDN3	59323665	59323723	0	59	0	3293	0	3234	0.0	0.0
chr20	EDN3	59322371	59322482	0	112	0	3293	0	3181	0.0	0.0
chr20	PHACTR3	59767185	59767395	0	211	0	6122	0	5911	0.0	0.0
chr20	CDH26	60001342	60001411	0	70	0	5774	0	5704	0.0	0.0
chr20	CDH26	60002812	60002866	0	55	0	5774	0	5719	0.0	0.0
chr20	C20ORF197	60058906	60058986	0	81	1543	3400	1543	3319	0.0	0.46489906598373004
chr20	MIR646HG	60284476	60284593	0	118	2778	22150	2778	22032	0.0	0.12608932461873637
chr20	MIR646HG	60088596	60088721	0	126	2778	22150	2778	22024	0.0	0.12613512531783508
chr20	MIR646HG	60138493	60138644	0	152	2778	22150	2778	21998	0.0	0.1262842076552414
chr20	MIR646HG	60272066	60272240	0	175	2778	22150	2778	21975	0.0	0.12641638225255972
chr20	MIR646HG	60098928	60098963	0	36	2778	22150	2778	22114	0.0	0.12562177805914806
chr20	MIR646HG	60098928	60099032	0	105	2778	22150	2778	22045	0.0	0.12601496938081197
chr20	MIR646HG	60117743	60117807	0	65	2778	22150	2778	22085	0.0	0.12578673307674892
chr20	MIR646HG	60123779	60123860	0	82	2778	22150	2778	22068	0.0	0.1258836324089179
chr20	MIR646HG	60091977	60092062	0	86	2778	22150	2778	22064	0.0	0.12590645395213923
chr20	MIR646HG	60101690	60101798	0	109	2778	22150	2778	22041	0.0	0.12603783857356743
chr20	MIR646HG	60123491	60123606	0	116	2778	22150	2778	22034	0.0	0.1260778796405555
chr20	MIR646HG	60253358	60253498	0	141	2778	22150	2778	22009	0.0	0.12622109137171159
chr20	MIR646HG	60098928	60099069	0	142	2778	22150	2778	22008	0.0	0.126226826608506
chr20	MIR646HG	60096534	60097521	0	988	2778	22150	2778	21162	0.0	0.13127303657499292
chr20	MIR646HG	60100170	60100219	0	50	2778	22150	2778	22100	0.0	0.12570135746606334
chr20	MIR646HG	60280982	60281124	0	143	2778	22150	2778	22007	0.0	0.12623256236651975
chr20	MIR646HG	60117357	60117507	0	151	2778	22150	2778	21999	0.0	0.1262784672030547
chr20	MIR646HG	60096534	60097664	0	1131	2778	22150	2778	21019	0.0	0.1321661354013036
chr20	MIR646HG	60117361	60117507	0	147	2778	22150	2778	22003	0.0	0.12625551061218926
chr20	MIR646HG	60121027	60121121	0	95	2778	22150	2778	22055	0.0	0.12595783269099978
chr20	MIR646HG	60098665	60098726	0	62	2778	22150	2778	22088	0.0	0.1257696486780152
chr20	MIR646HG	60138271	60138644	0	374	2778	22150	2778	21776	0.0	0.12757163850110212
chr20	MIR646HG	60527386	60527458	0	73	2778	22150	2778	22077	0.0	0.12583231417312135
chr20	MIR646HG	60320632	60320858	0	227	2778	22150	2778	21923	0.0	0.12671623409204943
chr20	MIR646HG	60246792	60246927	0	136	2778	22150	2778	22014	0.0	0.1261924230035432
chr20	MIR646HG	60318920	60319007	0	88	2778	22150	2778	22062	0.0	0.1259178678270329
chr20	MIR646HG	60246037	60246129	0	93	2778	22150	2778	22057	0.0	0.12594641157002312
chr20	MIR646HG	60313309	60313387	0	79	2778	22150	2778	22071	0.0	0.12586652168003262
chr20	MIR646HG	60247554	60247689	0	136	2778	22150	2778	22014	0.0	0.1261924230035432
chr20	LSM14B	62130218	62130296	0	79	36058	3388	36058	3309	0.0	10.896947718343911
chr20	LSM14B	62127584	62127701	0	118	36058	3388	36058	3270	0.0	11.026911314984709
chr20	SS18L1	62154280	62154465	941	186	5387	4351	4446	4165	5.059139784946237	1.067466986794718
chr20	MTG2	62197851	62197967	0	117	220477	5139	220477	5022	0.0	43.90223018717642
chr20	MTG2	62198633	62198852	27430	220	220477	5139	193047	4919	124.68181818181819	39.2451717828827
chr20	MTG2	62188789	62188805	32	17	220477	5139	220445	5122	1.8823529411764706	43.038852010933226
chr20	OSBPL2	62259980	62260125	7883	146	175526	10826	167643	10680	53.99315068493151	15.69691011235955
chr20	OSBPL2	62256056	62256221	13	166	175526	10826	175513	10660	0.0783132530120482	16.464634146341464
chr20	OSBPL2	62286336	62286488	1315	153	175526	10826	174211	10673	8.594771241830065	16.322589712358287
chr20	OSBPL2	62289206	62289330	501	125	175526	10826	175025	10701	4.008	16.355948042239042
chr20	OSBPL2	62242320	62242661	714	342	175526	10826	174812	10484	2.087719298245614	16.674170164059518
chr20	OSBPL2	62260016	62260125	4110	110	175526	10826	171416	10716	37.36363636363637	15.996267263904443
chr20	OSBPL2	62264628	62264718	0	91	175526	10826	175526	10735	0.0	16.350815090824405
chr20	OSBPL2	62280008	62280122	675	115	175526	10826	174851	10711	5.869565217391305	16.324432826066662
chr20	OSBPL2	62285535	62286217	39192	683	175526	10826	136334	10143	57.38213762811127	13.44119096914128
chr20	OSBPL2	62271633	62271731	12803	99	175526	10826	162723	10727	129.32323232323233	15.1694788850564
chr20	OSBPL2	62242320	62242434	714	115	175526	10826	174812	10711	6.208695652173913	16.320791709457566
chr20	OSBPL2	62291244	62291344	1070	101	175526	10826	174456	10725	10.594059405940595	16.266293706293705
chr20	ADRM1	62304460	62304577	0	118	13504	2153	13504	2035	0.0	6.6358722358722355
chr20	LAMA5-AS1	62355267	62355480	0	214	1654	846	1654	632	0.0	2.617088607594937
chr20	MIR1-1HG	62564988	62565100	30505	113	37431	1224	6926	1111	269.95575221238937	6.234023402340234
chr20	SLCO4A1	62668011	62668184	357	174	15976	3905	15619	3731	2.0517241379310347	4.18627713749665
chr20	SLCO4A1	62668157	62668184	18	28	15976	3905	15958	3877	0.6428571428571429	4.116069125612587
chr20	SLCO4A1	62668154	62668184	36	31	15976	3905	15940	3874	1.1612903225806452	4.1146102219927725
chr20	COL9A3	62836477	62836532	0	56	46	4195	46	4139	0.0	0.01111379560280261
chr20	SLC17A9	62953210	62953272	0	63	510	5474	510	5411	0.0	0.09425244871557938
chr20	ARFGAP1	63276090	63276200	0	111	0	6173	0	6062	0.0	0.0
chr20	ARFGAP1	63277204	63277305	0	102	0	6173	0	6071	0.0	0.0
chr20	ARFGAP1	63283850	63283880	0	31	0	6173	0	6142	0.0	0.0
chr20	ARFGAP1	63273999	63274210	0	212	0	6173	0	5961	0.0	0.0
chr20	ARFGAP1	63285979	63286218	0	240	0	6173	0	5933	0.0	0.0
chr20	ARFGAP1	63279219	63279306	0	88	0	6173	0	6085	0.0	0.0
chr20	COL20A1	63322057	63322111	0	55	0	9868	0	9813	0.0	0.0
chr20	COL20A1	63325268	63325364	0	97	0	9868	0	9771	0.0	0.0
chr20	PPDPF	63521283	63521363	0	81	0	1055	0	974	0.0	0.0
chr20	RTEL1	63689501	63689648	0	148	0	5965	0	5817	0.0	0.0
chr20	RTEL1	63690086	63690210	0	125	0	5965	0	5840	0.0	0.0
chr20	RTEL1	63660675	63660796	0	122	0	5965	0	5843	0.0	0.0
chr20	RTEL1	63659232	63659504	0	273	0	5965	0	5692	0.0	0.0
chr20	LIME1	63738597	63738931	0	335	0	2442	0	2107	0.0	0.0
chr20	SLC2A4RG	63741868	63742056	0	189	0	2703	0	2514	0.0	0.0
chr20	TPD52L2	63875815	63875875	0	61	0	4020	0	3959	0.0	0.0
chr20	TPD52L2	63882718	63882820	0	103	0	4020	0	3917	0.0	0.0
chr20	TPD52L2	63889189	63889238	0	50	0	4020	0	3970	0.0	0.0
chr20	TPD52L2	63887563	63887605	0	43	0	4020	0	3977	0.0	0.0
chr20	TPD52L2	63886015	63886042	0	28	0	4020	0	3992	0.0	0.0
chr20	DNAJC5	63931108	63931182	0	75	0	5349	0	5274	0.0	0.0
chr20	C20ORF204	64038295	64038448	0	154	0	5445	0	5291	0.0	0.0
chr20	TCEA2	64063891	64063949	0	59	0	3909	0	3850	0.0	0.0
chr20	OPRL1	64091965	64092116	0	152	0	3647	0	3495	0.0	0.0
chr20	MYT1	64151696	64151910	0	215	0	6891	0	6676	0.0	0.0
chr20	MYT1	64207593	64208487	0	895	0	6891	0	5996	0.0	0.0
chr20	MYT1	64223290	64223359	0	70	0	6891	0	6821	0.0	0.0
chr20	MYT1	64171103	64171281	0	179	0	6891	0	6712	0.0	0.0
chr20	MYT1	64195912	64196054	0	143	0	6891	0	6748	0.0	0.0
chr20	PCMTD2	64258766	64258882	0	117	0	5895	0	5778	0.0	0.0
chr20	LINC00266-1	64303150	64303358	0	209	0	1443	0	1234	0.0	0.0
chr20	C20ORF96	289558	289676	0	119	78461	1737	78461	1618	0.0	48.492583436341164
chr20	CSNK2A1	492253	492364	51	112	94575	19650	94524	19538	0.45535714285714285	4.8379568021291846
chr20	CSNK2A1	495718	495802	0	85	94575	19650	94575	19565	0.0	4.833887043189368
chr20	CSNK2A1	499254	499305	0	52	94575	19650	94575	19598	0.0	4.825747525257679
chr20	CSNK2A1	499832	499934	0	103	94575	19650	94575	19547	0.0	4.838338363943316
chr20	CSNK2A1	508450	508660	5644	211	94575	19650	88931	19439	26.748815165876778	4.574875250784506
chr20	CSNK2A1	527932	528049	0	118	94575	19650	94575	19532	0.0	4.842054065123899
chr20	CSNK2A1	483927	484076	1042	150	94575	19650	93533	19500	6.946666666666666	4.796564102564102
chr20	CSNK2A1	499524	499630	0	107	94575	19650	94575	19543	0.0	4.839328659878217
chr20	CSNK2A1	500030	500115	0	86	94575	19650	94575	19564	0.0	4.834134123901043
chr20	CSNK2A1	526695	526942	0	248	94575	19650	94575	19402	0.0	4.874497474487166
chr20	CSNK2A1	497720	497780	25	61	94575	19650	94550	19589	0.4098360655737705	4.8266884475981415
chr20	CSNK2A1	499524	499573	0	50	94575	19650	94575	19600	0.0	4.825255102040816
chr20	CSNK2A1	508450	508605	1917	156	94575	19650	92658	19494	12.288461538461538	4.753154816866728
chr20	CSNK2A1	540889	541099	0	211	94575	19650	94575	19439	0.0	4.865219404290344
chr20	CSNK2A1	540827	541099	0	273	94575	19650	94575	19377	0.0	4.880786499458121
chr20	CSNK2A1	508450	508621	3123	172	94575	19650	91452	19478	18.156976744186046	4.695143238525516
chr20	CSNK2A1	510167	510338	51	172	94575	19650	94524	19478	0.29651162790697677	4.852859636512989
chr20	SLC52A3	763497	764003	0	507	255	5203	255	4696	0.0	0.0543015332197615
chr20	SLC52A3	768296	768482	0	187	255	5203	255	5016	0.0	0.05083732057416268
chr20	RSPO4	963934	964120	0	187	0	2762	0	2575	0.0	0.0
chr20	FKBP1A	1375490	1375603	0	114	82406	4404	82406	4290	0.0	19.208857808857807
chr20	FKBP1A	1392833	1392881	6573	49	82406	4404	75833	4355	134.14285714285714	17.412858783008037
chr20	FKBP1A	1377429	1377511	0	83	82406	4404	82406	4321	0.0	19.07104836843323
chr20	FKBP1A	1371119	1371147	0	29	82406	4404	82406	4375	0.0	18.835657142857144
chr20	FKBP1A	1371021	1371147	1581	127	82406	4404	80825	4277	12.448818897637794	18.897591769932195
chr20	NSFL1C	1454212	1454305	0	94	21610	6545	21610	6451	0.0	3.349868237482561
chr20	NSFL1C	1464328	1464426	0	99	21610	6545	21610	6446	0.0	3.3524666459820045
chr20	NSFL1C	1455713	1455719	1	7	21610	6545	21609	6538	0.14285714285714285	3.305139186295503
chr20	NSFL1C	1463334	1463441	0	108	21610	6545	21610	6437	0.0	3.3571539537051422
chr20	NSFL1C	1455713	1455870	85	158	21610	6545	21525	6387	0.5379746835443038	3.370126820103335
chr20	SIRPB2	1479699	1479794	0	96	0	4491	0	4395	0.0	0.0
chr20	SIRPB1	1603094	1603207	0	114	1976	8242	1976	8128	0.0	0.24311023622047245
chr20	SIRPG	1635266	1635599	738	334	2592	2251	1854	1917	2.2095808383233533	0.9671361502347418
chr20	SIRPG	1636187	1636505	0	319	2592	2251	2592	1932	0.0	1.3416149068322982
chr20	AL109809.4	1800530	1800663	0	134	9720	8563	9720	8429	0.0	1.1531617036421877
chr20	AL109809.4	1811114	1811224	0	111	9720	8563	9720	8452	0.0	1.150023663038334
chr20	PDYN	1992583	1992643	0	61	204	3531	204	3470	0.0	0.058789625360230545
chr20	SNRPB	2467191	2467315	597	125	46903	1286	46306	1161	4.776	39.88458225667528
chr20	ZNF343	2486640	2486763	39	124	574	4645	535	4521	0.31451612903225806	0.11833665118336652
chr20	ZNF343	2495414	2495524	382	111	574	4645	192	4534	3.4414414414414414	0.0423467137185708
chr20	IDH3B	2658637	2658837	0	201	235	2575	235	2374	0.0	0.09898904802021904
chr20	IDH3B	2658758	2658837	0	80	235	2575	235	2495	0.0	0.09418837675350701
chr20	PCED1A	2836038	2836314	1377	277	51727	2329	50350	2052	4.971119133574007	24.537037037037038
chr20	UBOX5	3115304	3115466	0	163	9036	4744	9036	4581	0.0	1.9724950884086443
chr20	UBOX5	3156683	3156790	0	108	9036	4744	9036	4636	0.0	1.9490940465918896
chr20	DDRGK1	3191189	3191238	532	50	28212	1840	27680	1790	10.64	15.46368715083799
chr20	SLC4A11	3230731	3230845	8567	115	92029	4340	83462	4225	74.49565217391304	19.75431952662722
chr20	ADAM33	3671418	3671496	0	79	0	5402	0	5323	0.0	0.0
chr20	C20ORF27	3754396	3754519	0	124	3191	1361	3191	1237	0.0	2.5796281325788195
chr20	RNF24	3974331	3974400	0	70	4722	7652	4722	7582	0.0	0.62279082036402
chr20	AL139350.1	4429577	4429684	0	108	0	1456	0	1348	0.0	0.0
chr20	TMEM230	5111056	5111174	111	119	596130	3050	596019	2931	0.9327731092436975	203.35005117707266
chr20	TMEM230	5111763	5111808	0	46	596130	3050	596130	3004	0.0	198.44540612516644
chr20	TMEM230	5111499	5111605	38	107	596130	3050	596092	2943	0.35514018691588783	202.5457016649677
chr20	LINC00658	5433788	5434092	0	305	51	2892	51	2587	0.0	0.019713954387321223
chr20	LINC00658	5437099	5437273	51	175	51	2892	0	2717	0.2914285714285714	0.0
chr20	LINC00658	5433788	5434405	0	618	51	2892	51	2274	0.0	0.022427440633245383
chr20	LINC00658	5433788	5433962	0	175	51	2892	51	2717	0.0	0.018770702981229296
chr20	LINC00658	5433788	5434065	0	278	51	2892	51	2614	0.0	0.019510328997704666
chr20	LINC00658	5433788	5434070	0	283	51	2892	51	2609	0.0	0.019547719432732848
chr20	LINC00658	5438209	5438315	0	107	51	2892	51	2785	0.0	0.018312387791741474
chr20	LINC00658	5434114	5434401	0	288	51	2892	51	2604	0.0	0.019585253456221197
chr20	LINC00658	5434114	5434405	0	292	51	2892	51	2600	0.0	0.019615384615384614
chr20	LINC00658	5433962	5434092	0	131	51	2892	51	2761	0.0	0.018471568272365086
chr20	LINC00658	5433962	5434070	0	109	51	2892	51	2783	0.0	0.018325547969816745
chr20	LINC00658	5437099	5437266	51	168	51	2892	0	2724	0.30357142857142855	0.0
chr20	LINC00654	5508260	5508328	0	69	23237	8091	23237	8022	0.0	2.8966591872351035
chr20	LINC00654	5502902	5503083	0	182	23237	8091	23237	7909	0.0	2.9380452648881024
chr20	GPCPD1	5586193	5586269	0	77	28545	7494	28545	7417	0.0	3.848591074558447
chr20	GPCPD1	5567796	5567842	0	47	28545	7494	28545	7447	0.0	3.8330871491875924
chr20	TRMT6	5944804	5944914	0	111	31893	3690	31893	3579	0.0	8.911148365465214
chr20	FERMT1	6110297	6110511	0	215	2682	4862	2682	4647	0.0	0.5771465461588121
chr20	AL080248.1	7256974	7257094	0	121	0	2270	0	2149	0.0	0.0
chr20	TMX4	8018792	8019039	0	248	40592	6567	40592	6319	0.0	6.423801234372528
chr20	PAK5	9784357	9784506	0	150	0	4995	0	4845	0.0	0.0
chr20	PAK5	9818679	9818785	0	107	0	4995	0	4888	0.0	0.0
chr20	SNAP25-AS1	10125181	10125291	0	111	23011	11293	23011	11182	0.0	2.0578608477910927
chr20	SNAP25-AS1	10198752	10198875	0	124	23011	11293	23011	11169	0.0	2.060256065896678
chr20	SNAP25-AS1	10190056	10190152	0	97	23011	11293	23011	11196	0.0	2.0552876027152553
chr20	SNAP25-AS1	10196817	10196937	0	121	23011	11293	23011	11172	0.0	2.059702828499821
chr20	SNAP25-AS1	10231483	10231619	0	137	23011	11293	23011	11156	0.0	2.0626568662603084
chr20	MKKS	10428729	10428816	0	88	103423	7048	103423	6960	0.0	14.859626436781609
chr20	AL050403.1	10884485	10884690	0	206	0	2937	0	2731	0.0	0.0
chr20	AL050403.1	10893964	10894020	0	57	0	2937	0	2880	0.0	0.0
chr20	AL050403.1	10907578	10907641	0	64	0	2937	0	2873	0.0	0.0
chr20	LINC00687	11849506	11849658	0	153	0	1995	0	1842	0.0	0.0
chr20	LINC00687	11871985	11872193	0	209	0	1995	0	1786	0.0	0.0
chr20	TASP1	13623445	13623514	0	70	501	2914	501	2844	0.0	0.17616033755274263
chr20	SEL1L2	13859261	13859434	0	174	1562	3912	1562	3738	0.0	0.4178705189941145
chr20	SEL1L2	13865348	13865514	0	167	1562	3912	1562	3745	0.0	0.4170894526034713
chr20	SEL1L2	13885346	13885403	0	58	1562	3912	1562	3854	0.0	0.4052932018681889
chr20	SEL1L2	13915120	13915241	0	122	1562	3912	1562	3790	0.0	0.41213720316622693
chr20	SEL1L2	13866701	13866850	0	150	1562	3912	1562	3762	0.0	0.4152046783625731
chr20	FLRT3	14329133	14329327	0	195	0	5194	0	4999	0.0	0.0
chr20	MACROD2-AS1	14909648	14909737	0	90	0	1891	0	1801	0.0	0.0
chr20	MACROD2-AS1	14888095	14888304	0	210	0	1891	0	1681	0.0	0.0
chr20	AL161941.1	16256935	16257362	0	428	0	3469	0	3041	0.0	0.0
chr20	AL161941.1	16181888	16182018	0	131	0	3469	0	3338	0.0	0.0
chr20	KIF16B	16374256	16374409	0	154	1224	7763	1224	7609	0.0	0.1608621369430937
chr20	KIF16B	16382097	16382130	0	34	1224	7763	1224	7729	0.0	0.15836460085392676
chr20	BFSP1	17541064	17541199	378	136	3442	3386	3064	3250	2.7794117647058822	0.9427692307692308
chr20	RRBP1	17679998	17680075	0	78	170410	5199	170410	5121	0.0	33.27670376879516
chr20	RRBP1	17658595	17660528	3978	1934	170410	5199	166432	3265	2.0568769389865564	50.97457886676876
chr20	SNX5	17952586	17952710	12030	125	322598	6160	310568	6035	96.24	51.461143330571666
chr20	SNX5	17955364	17955475	17905	112	322598	6160	304693	6048	159.86607142857142	50.379133597883595
chr20	SNX5	17956932	17957037	0	106	322598	6160	322598	6054	0.0	53.286752560290715
chr20	SNX5	17968374	17968457	2097	84	322598	6160	320501	6076	24.964285714285715	52.74868334430546
chr20	AL049646.1	18345489	18345546	0	58	5718	3242	5718	3184	0.0	1.795854271356784
chr20	DZANK1	18415326	18415449	0	124	51349	6644	51349	6520	0.0	7.875613496932515
chr20	DZANK1	18452614	18452682	0	69	51349	6644	51349	6575	0.0	7.809733840304182
chr20	DZANK1	18451853	18451962	2586	110	51349	6644	48763	6534	23.509090909090908	7.462962962962963
chr20	DZANK1	18394674	18394858	0	185	51349	6644	51349	6459	0.0	7.949992258863602
chr20	RBBP9	18490394	18490480	28	87	28516	3848	28488	3761	0.3218390804597701	7.574581228396703
chr20	RBBP9	18495837	18495880	0	44	28516	3848	28516	3804	0.0	7.496319663512092
chr20	LINC00652	18791741	18792133	0	393	51	4119	51	3726	0.0	0.013687600644122383
chr20	RALGAPA2	20396694	20396734	0	41	16036	11690	16036	11649	0.0	1.3765988496866683
chr20	RALGAPA2	20598678	20598819	0	142	16036	11690	16036	11548	0.0	1.3886387253204018
chr20	KIZ-AS1	21213535	21213592	144	58	12126	2796	11982	2738	2.4827586206896552	4.376186997808619
chr20	KIZ-AS1	21198728	21198804	0	77	12126	2796	12126	2719	0.0	4.459727841118058
chr20	LINC01427	22276420	22280540	51	4121	51	6326	0	2205	0.012375636981315215	0.0
chr20	LINC01427	22280338	22280540	0	203	51	6326	51	6123	0.0	0.008329250367466928
chr20	AL133464.1	22406628	22406712	0	85	51	5302	51	5217	0.0	0.0097757331799885
chr20	AL133464.1	22406628	22406715	0	88	51	5302	51	5214	0.0	0.009781357882623706
chr20	LINC00656	23128628	23128729	0	102	5272	1914	5272	1812	0.0	2.9094922737306845
chr20	NAPB	23397071	23397188	0	118	22699	4598	22699	4480	0.0	5.066741071428571
chr20	NAPB	23395138	23395185	0	48	22699	4598	22699	4550	0.0	4.988791208791209
chr20	NAPB	23397071	23397200	0	130	22699	4598	22699	4468	0.0	5.08034914950761
chr20	CST11	23451815	23451920	0	106	0	588	0	482	0.0	0.0
chr20	APMAP	24964374	24964398	0	25	4062	2236	4062	2211	0.0	1.837177747625509
chr20	VSX1	25077684	25077865	0	182	0	3605	0	3423	0.0	0.0
chr20	VSX1	25072535	25072643	0	109	0	3605	0	3496	0.0	0.0
chr20	ABHD12	25300698	25300884	34775	187	49808	4504	15033	4317	185.9625668449198	3.48227936066713
chr20	ABHD12	25302218	25302346	0	129	49808	4504	49808	4375	0.0	11.384685714285714
chr20	ABHD12	25303549	25303628	0	80	49808	4504	49808	4424	0.0	11.258589511754069
chr20	ABHD12	25306832	25306915	0	84	49808	4504	49808	4420	0.0	11.268778280542987
chr20	ABHD12	25309445	25309575	0	131	49808	4504	49808	4373	0.0	11.389892522295908
chr20	ABHD12	25314924	25314970	0	47	49808	4504	49808	4457	0.0	11.175229975319722
chr20	ABHD12	25301718	25302034	1386	317	49808	4504	48422	4187	4.37223974763407	11.564843563410557
chr20	ABHD12	25302218	25302276	0	59	49808	4504	49808	4445	0.0	11.205399325084365
chr20	ABHD12	25301718	25301833	567	116	49808	4504	49241	4388	4.887931034482759	11.221741112123974
chr20	ABHD12	25301248	25301294	0	47	49808	4504	49808	4457	0.0	11.175229975319722
chr20	ABHD12	25301331	25301378	0	48	49808	4504	49808	4456	0.0	11.17773788150808
chr20	ABHD12	25341945	25342096	0	152	49808	4504	49808	4352	0.0	11.444852941176471
chr20	ABHD12	25338884	25339004	0	121	49808	4504	49808	4383	0.0	11.363906000456309
chr20	NINL	25476042	25477089	2662	1048	60540	6054	57878	5006	2.5400763358778624	11.561725928885338
chr20	NINL	25491350	25491525	4157	176	60540	6054	56383	5878	23.619318181818183	9.59220823409323
chr20	MIR663AHG	26192132	26192232	0	101	36	6568	36	6467	0.0	0.005566723364775011
chr20	MIR663AHG	26194297	26194444	0	148	36	6568	36	6420	0.0	0.005607476635514018
chr20	MIR663AHG	26191792	26191896	0	105	36	6568	36	6463	0.0	0.00557016865232864
chr20	MIR663AHG	26199448	26199523	0	76	36	6568	36	6492	0.0	0.005545286506469501
chr20	MIR663AHG	26200195	26200316	0	122	36	6568	36	6446	0.0	0.005584858827179647
chr20	MIR663AHG	26194385	26194444	0	60	36	6568	36	6508	0.0	0.005531653349723417
chr20	MIR663AHG	26192128	26192232	0	105	36	6568	36	6463	0.0	0.00557016865232864
chr20	MIR663AHG	26200195	26200312	0	118	36	6568	36	6450	0.0	0.005581395348837209
chr20	MIR663AHG	26189962	26190119	36	158	36	6568	0	6410	0.22784810126582278	0.0
chr20	FRG1CP	28601602	28601756	0	155	0	2742	0	2587	0.0	0.0
chr20	FRG1CP	28583869	28583946	0	78	0	2742	0	2664	0.0	0.0
chr20	FRG1CP	28601656	28601756	0	101	0	2742	0	2641	0.0	0.0
chr20	ANKRD20A21P	30720215	30720330	0	116	33676	3750	33676	3634	0.0	9.26692350027518
chr20	DEFB119	31378351	31378391	225	41	20755	789	20530	748	5.487804878048781	27.446524064171122
chr20	BCL2L1	31666990	31667147	0	158	0	3964	0	3806	0.0	0.0
chr20	BCL2L1	31684366	31684588	0	223	0	3964	0	3741	0.0	0.0
chr20	DUSP15	31869563	31869597	0	35	51	3591	51	3556	0.0	0.014341957255343082
chr20	NOL4L	32454014	32454084	0	71	424	5380	424	5309	0.0	0.07986438123940479
chr20	FO393400.1	32640565	32640687	0	123	3910	4720	3910	4597	0.0	0.850554709593213
chr20	FO393400.1	32651732	32651981	969	250	3910	4720	2941	4470	3.876	0.6579418344519016
chr20	SUN5	33001211	33001278	0	68	1856	1488	1856	1420	0.0	1.3070422535211268
chr20	SUN5	33002586	33002661	997	76	1856	1488	859	1412	13.118421052631579	0.6083569405099151
chr20	CDK5RAP1	33379460	33379691	0	232	6764	4575	6764	4343	0.0	1.5574487681326272
chr20	CDK5RAP1	33387322	33387533	0	212	6764	4575	6764	4363	0.0	1.5503094201237682
chr20	CDK5RAP1	33396760	33396936	114	177	6764	4575	6650	4398	0.6440677966101694	1.5120509322419282
chr20	CDK5RAP1	33396760	33397084	546	325	6764	4575	6218	4250	1.68	1.4630588235294117
chr20	CDK5RAP1	33383479	33383521	0	43	6764	4575	6764	4532	0.0	1.4924977934686672
chr20	CDK5RAP1	33395012	33395116	0	105	6764	4575	6764	4470	0.0	1.513199105145414
chr20	CDK5RAP1	33394031	33394066	288	36	6764	4575	6476	4539	8.0	1.4267459792905925
chr20	NECAB3	33659496	33659550	816	55	79506	4125	78690	4070	14.836363636363636	19.334152334152336
chr20	PXMP4	33710554	33710753	2523	200	533217	5723	530694	5523	12.615	96.08799565453558
chr20	PXMP4	33710554	33710773	2552	220	533217	5723	530665	5503	11.6	96.43194621115755
chr20	RALY-AS1	33993059	33993150	1588	92	83037	8725	81449	8633	17.26086956521739	9.434611374956562
chr20	PIGU	34585436	34585580	0	145	369656	2721	369656	2576	0.0	143.5
chr20	PIGU	34616041	34616139	51	99	369656	2721	369605	2622	0.5151515151515151	140.96300533943554
chr20	PIGU	34645274	34645334	0	61	369656	2721	369656	2660	0.0	138.96842105263158
chr20	NCOA6	34740362	34743341	2505	2980	57107	11155	54602	8175	0.8406040268456376	6.67914373088685
chr20	GGT7	34850781	34850917	0	137	54999	2979	54999	2842	0.0	19.352216748768473
chr20	GGT7	34863679	34863730	0	52	54999	2979	54999	2927	0.0	18.790228903313974
chr20	GSS	34929400	34929590	0	191	0	5144	0	4953	0.0	0.0
chr20	GSS	34935575	34935642	0	68	0	5144	0	5076	0.0	0.0
chr20	GSS	34942487	34942627	0	141	0	5144	0	5003	0.0	0.0
chr20	GSS	34942930	34943006	0	77	0	5144	0	5067	0.0	0.0
chr20	GSS	34945952	34946098	0	147	0	5144	0	4997	0.0	0.0
chr20	GSS	34936762	34936840	0	79	0	5144	0	5065	0.0	0.0
chr20	GSS	34941712	34941829	0	118	0	5144	0	5026	0.0	0.0
chr20	GSS	34942487	34942585	0	99	0	5144	0	5045	0.0	0.0
chr20	GSS	34945952	34946051	0	100	0	5144	0	5044	0.0	0.0
chr20	GSS	34954268	34954547	0	280	0	5144	0	4864	0.0	0.0
chr20	EDEM2	35146824	35146935	0	112	11096	1895	11096	1783	0.0	6.223219293325855
chr20	MMP24OS	35236080	35236191	82676	112	98583	5505	15907	5393	738.1785714285714	2.9495642499536436
chr20	MMP24OS	35276155	35276314	50	160	98583	5505	98533	5345	0.3125	18.43461178671656
chr20	EIF6	35280653	35280829	43558	177	86150	1643	42592	1466	246.090395480226	29.053206002728512
chr20	EIF6	35284175	35284261	1338	87	86150	1643	84812	1556	15.379310344827585	54.50642673521851
chr20	UQCC1	35314687	35314765	145	79	146229	4188	146084	4109	1.8354430379746836	35.5522024823558
chr20	UQCC1	35384037	35384133	44768	97	146229	4188	101461	4091	461.5257731958763	24.80102664385236
chr20	UQCC1	35374183	35374256	0	74	146229	4188	146229	4114	0.0	35.544239183276616
chr20	UQCC1	35409344	35409467	59627	124	146229	4188	86602	4064	480.86290322580646	21.30954724409449
chr20	UQCC1	35381917	35382025	0	109	146229	4188	146229	4079	0.0	35.849227751899974
chr20	UQCC1	35392235	35392277	0	43	146229	4188	146229	4145	0.0	35.278407720144756
chr20	UQCC1	35346700	35346747	0	48	146229	4188	146229	4140	0.0	35.321014492753626
chr20	UQCC1	35386276	35386389	204	114	146229	4188	146025	4074	1.7894736842105263	35.84315169366716
chr20	UQCC1	35384558	35384644	0	87	146229	4188	146229	4101	0.0	35.656912948061446
chr20	CEP250-AS1	35481132	35481251	2976	120	13825	843	10849	723	24.8	15.005532503457815
chr20	CEP250-AS1	35477825	35477945	285	121	13825	843	13540	722	2.355371900826446	18.753462603878116
chr20	FER1L4	35567600	35567654	0	55	18832	9174	18832	9119	0.0	2.0651387213510253
chr20	FER1L4	35578835	35578967	0	133	18832	9174	18832	9041	0.0	2.0829554252848137
chr20	FER1L4	35562808	35562969	0	162	18832	9174	18832	9012	0.0	2.0896582334664893
chr20	FER1L4	35582838	35583012	0	175	18832	9174	18832	8999	0.0	2.092676964107123
chr20	FER1L4	35583685	35583810	0	126	18832	9174	18832	9048	0.0	2.081343943412909
chr20	FER1L4	35585123	35585276	0	154	18832	9174	18832	9020	0.0	2.0878048780487806
chr20	FER1L4	35602106	35602266	27	161	18832	9174	18805	9013	0.16770186335403728	2.0864307111949407
chr20	CPNE1	35632162	35632234	5783	73	59737	2948	53954	2875	79.21917808219177	18.766608695652174
chr20	CPNE1	35632794	35632923	0	130	59737	2948	59737	2818	0.0	21.198367636621718
chr20	CPNE1	35655201	35655344	0	144	59737	2948	59737	2804	0.0	21.304208273894435
chr20	CPNE1	35658929	35658982	0	54	59737	2948	59737	2894	0.0	20.64167242570836
chr20	CPNE1	35632162	35632248	6154	87	59737	2948	53583	2861	70.73563218390805	18.728766165676337
chr20	CPNE1	35658929	35659014	0	86	59737	2948	59737	2862	0.0	20.87246680642907
chr20	NFS1	35675044	35675202	0	159	43987	5562	43987	5403	0.0	8.141217841939664
chr20	NFS1	35690412	35690565	3341	154	43987	5562	40646	5408	21.694805194805195	7.515902366863905
chr20	NFS1	35692248	35692370	0	123	43987	5562	43987	5439	0.0	8.087332230189373
chr20	NFS1	35692248	35692296	0	49	43987	5562	43987	5513	0.0	7.978777435153274
chr20	RBM39	35716739	35716805	0	67	11658	11032	11658	10965	0.0	1.0632010943912449
chr20	RBM39	35729461	35729527	0	67	11658	11032	11658	10965	0.0	1.0632010943912449
chr20	RBM39	35740524	35740597	0	74	11658	11032	11658	10958	0.0	1.0638802701222851
chr20	RBM39	35707939	35707992	0	54	11658	11032	11658	10978	0.0	1.061942065950082
chr20	RBM39	35734185	35734257	0	73	11658	11032	11658	10959	0.0	1.0637831918970708
chr20	RBM39	35710282	35710420	0	139	11658	11032	11658	10893	0.0	1.07022858716607
chr20	RBM39	35713701	35713857	0	157	11658	11032	11658	10875	0.0	1.072
chr20	RBM39	35736512	35736567	198	56	11658	11032	11460	10976	3.5357142857142856	1.0440962099125364
chr20	RBM39	35739392	35739547	0	156	11658	11032	11658	10876	0.0	1.0719014343508644
chr20	NDRG3	36654800	36654839	6	40	9366	3278	9360	3238	0.15	2.890673255095738
chr20	NDRG3	36706971	36707007	828	37	9366	3278	8538	3241	22.37837837837838	2.634372107374267
chr20	DSN1	36770872	36771193	246	322	79798	2481	79552	2159	0.7639751552795031	36.846688281611854
chr20	DSN1	36770872	36770977	195	106	79798	2481	79603	2375	1.8396226415094339	33.51705263157895
chr20	DSN1	36771424	36771473	0	50	79798	2481	79798	2431	0.0	32.82517482517483
chr20	SAMHD1	36898439	36898544	0	106	33	8463	33	8357	0.0	0.00394878544932392
chr20	SAMHD1	36935028	36935189	0	162	33	8463	33	8301	0.0	0.003975424647632815
chr20	SAMHD1	36917151	36917215	0	65	33	8463	33	8398	0.0	0.003929507025482257
chr20	SAMHD1	36935340	36935403	0	64	33	8463	33	8399	0.0	0.00392903917132992
chr20	SAMHD1	36935080	36935189	0	110	33	8463	33	8353	0.0	0.003950676403687298
chr20	RBL1	37081887	37082029	0	143	23673	5979	23673	5836	0.0	4.056374228923921
chr20	MROH8	37173994	37174116	0	123	9857	3902	9857	3779	0.0	2.6083620005292407
chr20	BLCAP	37521318	37521451	0	134	79	5359	79	5225	0.0	0.015119617224880384
chr20	BLCAP	37521318	37521409	0	92	79	5359	79	5267	0.0	0.014999050692994115
chr20	TTI1	38019004	38019144	0	141	0	4062	0	3921	0.0	0.0
chr20	KIAA1755	38225664	38225781	0	118	51	8084	51	7966	0.0	0.006402209389907106
chr20	SNHG17	38422086	38422241	0	156	378	11084	378	10928	0.0	0.0345900439238653
chr20	SNHG17	38425934	38426048	0	115	378	11084	378	10969	0.0	0.03446075303126994
chr20	SNHG17	38422290	38422368	0	79	378	11084	378	11005	0.0	0.03434802362562472
chr20	SNHG17	38434503	38434626	0	124	378	11084	378	10960	0.0	0.03448905109489051
chr20	SNHG17	38422091	38422241	0	151	378	11084	378	10933	0.0	0.03457422482392756
chr20	SNHG17	38427679	38427766	0	88	378	11084	378	10996	0.0	0.03437613677700982
chr20	SNHG17	38425934	38426052	0	119	378	11084	378	10965	0.0	0.03447332421340629
chr20	SNHG17	38422095	38422241	0	147	378	11084	378	10937	0.0	0.03456157995794094
chr20	SNHG17	38429868	38429959	0	92	378	11084	378	10992	0.0	0.034388646288209604
chr20	SNHG17	38427679	38427847	0	169	378	11084	378	10915	0.0	0.03463124141090243
chr20	ZHX3	41201285	41201384	0	100	51	4825	51	4725	0.0	0.010793650793650795
chr20	ZHX3	41254587	41254635	0	49	51	4825	51	4776	0.0	0.010678391959798994
chr20	ZHX3	41238687	41238796	0	110	51	4825	51	4715	0.0	0.010816542948038176
chr20	ZHX3	41213733	41213899	0	167	51	4825	51	4658	0.0	0.010948905109489052
chr20	ZHX3	41267462	41267612	0	151	51	4825	51	4674	0.0	0.010911424903722721
chr20	ZHX3	41269410	41269485	0	76	51	4825	51	4749	0.0	0.010739102969046115
chr20	CHD6	41551304	41551360	0	57	51	14072	51	14015	0.0	0.0036389582590082054
chr20	CHD6	41564010	41564151	0	142	51	14072	51	13930	0.0	0.0036611629576453696
chr20	PTPRT	42270396	42270453	0	58	17020	12975	17020	12917	0.0	1.3176434156537895
chr20	PTPRT	42116038	42116098	0	61	17020	12975	17020	12914	0.0	1.3179495121573486
chr20	PTPRT	42236228	42236258	0	31	17020	12975	17020	12944	0.0	1.314894932014833
chr20	ADA	44622587	44622652	0	66	16853	2687	16853	2621	0.0	6.429988553987028
chr20	ADA	44623006	44623078	0	73	16853	2687	16853	2614	0.0	6.447207345065034
chr20	KCNK15-AS1	44716624	44716793	108	170	512	1509	404	1339	0.6352941176470588	0.3017176997759522
chr20	KCNK15-AS1	44737510	44737570	0	61	512	1509	512	1448	0.0	0.35359116022099446
chr20	KCNS1	45100159	45100361	0	203	0	5654	0	5451	0.0	0.0
chr20	MATN4	45303388	45303511	0	124	90	2479	90	2355	0.0	0.03821656050955414
chr20	MATN4	45301320	45301443	0	124	90	2479	90	2355	0.0	0.03821656050955414
chr20	MATN4	45301101	45301224	0	124	90	2479	90	2355	0.0	0.03821656050955414
chr20	WFDC10B	45685901	45686056	0	156	0	634	0	478	0.0	0.0
chr20	WFDC3	45787835	45787982	0	148	0	2416	0	2268	0.0	0.0
chr20	WFDC3	45777074	45777209	0	136	0	2416	0	2280	0.0	0.0
chr20	WFDC3	45788930	45789059	0	130	0	2416	0	2286	0.0	0.0
chr20	WFDC3	45789893	45789982	0	90	0	2416	0	2326	0.0	0.0
chr20	WFDC3	45777074	45777206	0	133	0	2416	0	2283	0.0	0.0
chr20	ACOT8	45843526	45843721	2059	196	49437	3508	47378	3312	10.505102040816327	14.304951690821255
chr20	ACOT8	45855158	45855292	547	135	49437	3508	48890	3373	4.051851851851852	14.494515268307145
chr20	ACOT8	45843526	45843772	3251	247	49437	3508	46186	3261	13.161943319838057	14.163140141061024
chr20	ACOT8	45848449	45848675	2718	227	49437	3508	46719	3281	11.973568281938325	14.239256324291375
chr20	ACOT8	45853922	45853984	28	63	49437	3508	49409	3445	0.4444444444444444	14.3422351233672
chr20	ACOT8	45853922	45853979	28	58	49437	3508	49409	3450	0.4827586206896552	14.321449275362319
chr20	PLTP	45909941	45910070	1391	130	27935	2558	26544	2428	10.7	10.932454695222406
chr20	PLTP	45909515	45909671	0	157	27935	2558	27935	2401	0.0	11.634735526863807
chr20	NCOA5	46079386	46079453	0	68	612	3232	612	3164	0.0	0.1934260429835651
chr20	SLC35C2	46355801	46355874	0	74	51	7719	51	7645	0.0	0.006671026814911707
chr20	ELMO2	46387337	46387437	0	101	326	4584	326	4483	0.0	0.0727191612759313
chr20	ELMO2	46398696	46398771	0	76	326	4584	326	4508	0.0	0.07231588287488909
chr20	ELMO2	46393528	46393601	0	74	326	4584	326	4510	0.0	0.07228381374722838
chr20	ELMO2	46387337	46387431	0	95	326	4584	326	4489	0.0	0.07262196480285142
chr20	AL031686.1	46459218	46459622	0	405	0	4281	0	3876	0.0	0.0
chr20	ZNF334	46506306	46506458	0	153	51	6001	51	5848	0.0	0.00872093023255814
chr20	ZNF334	46509604	46509751	0	148	51	6001	51	5853	0.0	0.008713480266529985
chr20	SLC13A3	46588058	46588163	0	106	0	6075	0	5969	0.0	0.0
chr20	SLC13A3	46599970	46600037	0	68	0	6075	0	6007	0.0	0.0
chr20	ZMYND8	47229725	47229806	0	82	1277	7654	1277	7572	0.0	0.16864764923402006
chr20	ZMYND8	47238757	47239138	0	382	1277	7654	1277	7272	0.0	0.1756050605060506
chr20	ZMYND8	47262287	47262428	680	142	1277	7654	597	7512	4.788732394366197	0.07947284345047924
chr20	ZMYND8	47294665	47294779	0	115	1277	7654	1277	7539	0.0	0.16938586019365964
chr20	ZMYND8	47212641	47212725	0	85	1277	7654	1277	7569	0.0	0.1687144933280486
chr20	ZMYND8	47238895	47239138	0	244	1277	7654	1277	7410	0.0	0.17233468286099865
chr20	ZMYND8	47355449	47355520	0	72	1277	7654	1277	7582	0.0	0.16842521762068055
chr20	ZMYND8	47349860	47349988	0	129	1277	7654	1277	7525	0.0	0.16970099667774086
chr20	SULF2	47659398	47659452	0	55	34610	6098	34610	6043	0.0	5.727287770974682
chr20	SULF2	47690125	47690295	0	171	34610	6098	34610	5927	0.0	5.839379112535853
chr20	SULF2	47736702	47736942	2841	241	34610	6098	31769	5857	11.78838174273859	5.424107905070856
chr20	CSE1L-AS1	49043149	49043372	51	224	51	682	0	458	0.22767857142857142	0.0
chr20	STAU1	49165996	49166285	0	290	2081	4110	2081	3820	0.0	0.5447643979057591
chr20	STAU1	49174194	49174269	0	76	2081	4110	2081	4034	0.0	0.515865146256817
chr20	STAU1	49179121	49179244	0	124	2081	4110	2081	3986	0.0	0.5220772704465629
chr20	PTGIS	49547840	49548019	1365	180	361217	5580	359852	5400	7.583333333333333	66.63925925925926
chr20	UBE2V1	50084128	50084254	0	127	306	4832	306	4705	0.0	0.06503719447396387
chr20	UBE2V1	50096671	50096820	0	150	306	4832	306	4682	0.0	0.06535668517727466
chr20	UBE2V1	50098881	50098981	0	101	306	4832	306	4731	0.0	0.06467977171845275
chr20	UBE2V1	50111288	50111562	0	275	306	4832	306	4557	0.0	0.06714944042132982
chr20	UBE2V1	50108972	50109111	0	140	306	4832	306	4692	0.0	0.06521739130434782
chr20	PEDS1	50130855	50130947	0	93	51	7939	51	7846	0.0	0.00650012745347948
chr20	UBE2V1	50096482	50096534	0	53	306	4832	306	4779	0.0	0.064030131826742
chr20	UBE2V1	50098881	50098964	0	84	306	4832	306	4748	0.0	0.06444818871103622
chr20	PEDS1	50130864	50130947	0	84	51	7939	51	7855	0.0	0.006492679821769574
chr20	PEDS1	50151211	50151315	0	105	51	7939	51	7834	0.0	0.0065100842481490935
chr20	LINC01275	50163638	50164033	0	396	0	1006	0	610	0.0	0.0
chr20	ADNP	50904765	50904849	0	85	51	7594	51	7509	0.0	0.0067918497802636835
chr20	ADNP	50918738	50918781	0	44	51	7594	51	7550	0.0	0.006754966887417219
chr20	ADNP	50903888	50904001	0	114	51	7594	51	7480	0.0	0.006818181818181818
chr20	ADNP	50928650	50928825	0	176	51	7594	51	7418	0.0	0.006875168509032084
chr20	DPM1	50941128	50941209	0	82	153	1217	153	1135	0.0	0.13480176211453745
chr20	DPM1	50942030	50942126	0	97	153	1217	153	1120	0.0	0.13660714285714284
chr20	DPM1	50941104	50941209	0	106	153	1217	153	1111	0.0	0.13771377137713772
chr20	KCNG1	51012358	51012416	0	59	0	5421	0	5362	0.0	0.0
chr20	KCNG1	51013728	51013844	0	117	0	5421	0	5304	0.0	0.0
chr20	NFATC2	51398642	51398730	0	89	73	8298	73	8209	0.0	0.008892678767206725
chr20	SALL4	51790021	51792352	48	2332	48	5780	0	3448	0.02058319039451115	0.0
chr20	SALL4	51791332	51792352	0	1021	48	5780	48	4759	0.0	0.010086152553057365
chr20	ZFP64	52165863	52166025	357	163	16780	5849	16423	5686	2.1901840490797544	2.8883221948645796
chr20	ZNF217	53571720	53571853	0	134	0	6191	0	6057	0.0	0.0
chr20	BCAS1	53992511	53992646	0	136	48	8200	48	8064	0.0	0.005952380952380952
chr20	BCAS1	53957431	53957497	0	67	48	8200	48	8133	0.0	0.005901881224640354
chr20	BCAS1	53966905	53967073	0	169	48	8200	48	8031	0.0	0.005976839745984311
chr20	BCAS1	53975388	53975430	0	43	48	8200	48	8157	0.0	0.005884516366311144
chr20	CYP24A1	54157387	54157585	0	199	0	4000	0	3801	0.0	0.0
chr20	AURKA	56390555	56390665	0	111	0	2904	0	2793	0.0	0.0
chr20	AURKA	56388686	56388784	0	99	0	2904	0	2805	0.0	0.0
chr20	AURKA	56388311	56388506	0	196	0	2904	0	2708	0.0	0.0
chr20	BMP7	57183721	57183919	0	199	17511	5438	17511	5239	0.0	3.3424317617866004
chr20	BMP7	57225854	57225962	420	109	17511	5438	17091	5329	3.853211009174312	3.207168324263464
chr20	CTCFL	57514591	57514741	0	151	7077	8679	7077	8528	0.0	0.8298545966228893
chr20	CTCFL	57523662	57524216	2907	555	7077	8679	4170	8124	5.237837837837838	0.5132939438700148
chr20	CTCFL	57525027	57525127	0	101	7077	8679	7077	8578	0.0	0.8250174865936115
chr20	CTCFL	57513235	57513872	0	638	7077	8679	7077	8041	0.0	0.8801144136301455
chr20	CTCFL	57523067	57523278	4119	212	7077	8679	2958	8467	19.42924528301887	0.3493563245541514
chr20	ZBP1	57616243	57616468	4610	226	608908	5371	604298	5145	20.398230088495577	117.45344995140914
chr20	PMEPA1	57700015	57700186	0	172	0	5734	0	5562	0.0	0.0
chr20	PPP4R1L	58238210	58238311	0	102	0	9090	0	8988	0.0	0.0
chr20	PPP4R1L	58271362	58271505	0	144	0	9090	0	8946	0.0	0.0
chr20	PPP4R1L	58263371	58263517	0	147	0	9090	0	8943	0.0	0.0
chr20	APCDD1L	58513816	58513987	2530	172	14649	4216	12119	4044	14.709302325581396	2.9967853610286843
chr20	AL121917.1	58884846	58885015	0	170	0	2065	0	1895	0.0	0.0
chr20	PRELID3B	59037190	59037280	0	91	0	2883	0	2792	0.0	0.0
chr20	PRELID3B	59037190	59037299	0	110	0	2883	0	2773	0.0	0.0
chr20	SYCP2	59868412	59868568	0	157	0	6512	0	6355	0.0	0.0
chr20	SYCP2	59932061	59932154	0	94	0	6512	0	6418	0.0	0.0
chr20	AL160412.1	61435702	61435794	0	93	25171	3576	25171	3483	0.0	7.226815963250072
chr20	AL160412.1	61436479	61436633	0	155	25171	3576	25171	3421	0.0	7.357790119847998
chr20	AL160412.1	61434955	61435151	918	197	25171	3576	24253	3379	4.659898477157361	7.17756732761172
chr20	AL160412.1	61436185	61436633	52416	449	25171	3576	-27245	3127	116.73942093541203	-8.712823792772625
chr20	AL162457.2	61740470	61740887	0	418	0	1357	0	939	0.0	0.0
chr20	LAMA5	62310418	62310572	1125	155	889399	14260	888274	14105	7.258064516129032	62.97582417582417
chr20	LAMA5	62312887	62313010	1720	124	889399	14260	887679	14136	13.870967741935484	62.79562818336163
chr20	LAMA5	62336903	62336986	2468	84	889399	14260	886931	14176	29.38095238095238	62.565674379232505
chr20	LAMA5	62350987	62351257	896	271	889399	14260	888503	13989	3.3062730627306274	63.5144041747087
chr20	CABLES2	62394156	62394265	158	110	7355	3795	7197	3685	1.4363636363636363	1.9530529172320217
chr20	MIR1-1HG-AS1	62547547	62547702	193	156	34091	2949	33898	2793	1.2371794871794872	12.136770497672753
chr20	MIR1-1HG-AS1	62548311	62548461	929	151	34091	2949	33162	2798	6.152317880794702	11.852037169406719
chr20	LINC00029	63035564	63035721	0	158	0	1794	0	1636	0.0	0.0
chr20	YTHDF1	63202286	63203807	0	1522	0	3211	0	1689	0.0	0.0
chr20	NKAIN4	63242538	63242623	0	86	0	2605	0	2519	0.0	0.0
chr20	NKAIN4	63244469	63244543	0	75	0	2605	0	2530	0.0	0.0
chr20	CHRNA4	63355495	63355595	0	101	0	11311	0	11210	0.0	0.0
chr20	KCNQ2	63419618	63419672	0	55	0	11982	0	11927	0.0	0.0
chr20	KCNQ2	63431339	63431369	0	31	0	11982	0	11951	0.0	0.0
chr20	KCNQ2	63411774	63411882	0	109	0	11982	0	11873	0.0	0.0
chr20	KCNQ2	63409960	63410009	0	50	0	11982	0	11932	0.0	0.0
chr20	PTK6	63534937	63535059	0	123	0	2961	0	2838	0.0	0.0
chr20	ARFRP1	63701829	63701900	0	72	0	2709	0	2637	0.0	0.0
chr20	ARFRP1	63706998	63707092	0	95	0	2709	0	2614	0.0	0.0
chr20	ARFRP1	63706998	63707097	0	100	0	2709	0	2609	0.0	0.0
chr20	ARFRP1	63701829	63701898	0	70	0	2709	0	2639	0.0	0.0
chr20	UCKL1	63943652	63943669	0	18	0	3201	0	3183	0.0	0.0
chr20	SAMD10	63978244	63978361	0	118	0	2457	0	2339	0.0	0.0
chr20	RGS19	64076856	64076954	0	99	0	2035	0	1936	0.0	0.0
chr21	FP565260.3	5026279	5026630	0	352	0	3365	0	3013	0.0	0.0
chr21	FP565260.3	5026431	5026630	0	200	0	3365	0	3165	0.0	0.0
chr21	CU633967.1	5585822	5585987	0	166	0	5133	0	4967	0.0	0.0
chr21	CU633967.1	5586444	5586499	0	56	0	5133	0	5077	0.0	0.0
chr21	CU633967.1	5566124	5566183	0	60	0	5133	0	5073	0.0	0.0
chr21	CU633967.1	5579669	5579808	0	140	0	5133	0	4993	0.0	0.0
chr21	CU633967.1	5584809	5584975	0	167	0	5133	0	4966	0.0	0.0
chr21	CU633967.1	5584809	5585063	0	255	0	5133	0	4878	0.0	0.0
chr21	LINC01669	6075739	6075807	0	69	0	1690	0	1621	0.0	0.0
chr21	CU633906.2	6329547	6329607	0	61	0	3412	0	3351	0.0	0.0
chr21	CU634019.1	7061346	7061405	0	60	0	3064	0	3004	0.0	0.0
chr21	CU634019.1	7080035	7080289	0	255	0	3064	0	2809	0.0	0.0
chr21	CU633904.1	7463448	7463503	0	56	0	3394	0	3338	0.0	0.0
chr21	CU633904.1	7443124	7443183	0	60	0	3394	0	3334	0.0	0.0
chr21	CU633904.1	7461813	7462067	0	255	0	3394	0	3139	0.0	0.0
chr21	SMIM11B	7754951	7755118	0	168	0	4297	0	4129	0.0	0.0
chr21	CR381653.1	9325630	9325823	0	194	0	1910	0	1716	0.0	0.0
chr21	CR381653.1	9325604	9325823	0	220	0	1910	0	1690	0.0	0.0
chr21	CR381653.1	9325873	9325961	0	89	0	1910	0	1821	0.0	0.0
chr21	AC018692.1	9914092	9914182	0	91	51	923	51	832	0.0	0.06129807692307692
chr21	TPTE	10552656	10552716	0	61	135	2620	135	2559	0.0	0.05275498241500586
chr21	TPTE	10595981	10596087	0	107	135	2620	135	2513	0.0	0.05372065260644648
chr21	TPTE	10542394	10542448	0	55	135	2620	135	2565	0.0	0.05263157894736842
chr21	TPTE	10543328	10543382	0	55	135	2620	135	2565	0.0	0.05263157894736842
chr21	ANKRD30BP2	13046235	13046373	0	139	0	4155	0	4016	0.0	0.0
chr21	LINC01674	13556392	13556511	0	120	0	1252	0	1132	0.0	0.0
chr21	LINC01674	13565664	13565781	0	118	0	1252	0	1134	0.0	0.0
chr21	RBM11	14219562	14219725	0	164	0	2365	0	2201	0.0	0.0
chr21	ABCC13	14336079	14336257	0	179	0	8015	0	7836	0.0	0.0
chr21	ABCC13	14308971	14309098	0	128	0	8015	0	7887	0.0	0.0
chr21	USP25	15826203	15826365	0	163	32	7850	32	7687	0.0	0.004162872381943541
chr21	USP25	15849776	15849872	0	97	32	7850	32	7753	0.0	0.004127434541467819
chr21	USP25	15847662	15847776	0	115	32	7850	32	7735	0.0	0.004137039431157078
chr21	MIR99AHG	16231055	16231115	0	61	255	42307	255	42246	0.0	0.006036074421246982
chr21	MIR99AHG	16391613	16391685	0	73	255	42307	255	42234	0.0	0.006037789458729933
chr21	MIR99AHG	15972310	15972515	0	206	255	42307	255	42101	0.0	0.006056863257404812
chr21	MIR99AHG	16537378	16537439	0	62	255	42307	255	42245	0.0	0.006036217303822937
chr21	MIR99AHG	15965331	15965407	0	77	255	42307	255	42230	0.0	0.006038361354487331
chr21	MIR99AHG	16257392	16257454	0	63	255	42307	255	42244	0.0	0.006036360193163526
chr21	MIR99AHG	16589352	16589557	0	206	255	42307	255	42101	0.0	0.006056863257404812
chr21	MIR99AHG	16535033	16535709	0	677	255	42307	255	41630	0.0	0.006125390343502282
chr21	MIR99AHG	16594339	16594454	0	116	255	42307	255	42191	0.0	0.006043943021023441
chr21	MIR99AHG	16477844	16478039	0	196	255	42307	255	42111	0.0	0.006055424948350787
chr21	MIR99AHG	16383159	16383304	0	146	255	42307	255	42161	0.0	0.006048243637484879
chr21	MIR99AHG	16589352	16589467	0	116	255	42307	255	42191	0.0	0.006043943021023441
chr21	MIR99AHG	16589352	16589540	0	189	255	42307	255	42118	0.0	0.006054418538392136
chr21	MIR99AHG	16214256	16214378	0	123	255	42307	255	42184	0.0	0.006044945951071496
chr21	MIR99AHG	16564773	16564809	0	37	255	42307	255	42270	0.0	0.00603264726756565
chr21	MIR99AHG	16352128	16352273	0	146	255	42307	255	42161	0.0	0.006048243637484879
chr21	MIR99AHG	16223523	16223574	0	52	255	42307	255	42255	0.0	0.006034788782392616
chr21	MIR99AHG	16596384	16596402	0	19	255	42307	255	42288	0.0	0.0060300794551645855
chr21	MIR99AHG	16606225	16606273	0	49	255	42307	255	42258	0.0	0.006034360357802073
chr21	MIR99AHG	16521718	16521816	0	99	255	42307	255	42208	0.0	0.006041508718726308
chr21	MIR99AHG	16560446	16560498	0	53	255	42307	255	42254	0.0	0.006034931604108487
chr21	MIR99AHG	16485711	16485816	0	106	255	42307	255	42201	0.0	0.006042510840975332
chr21	MIR99AHG	16589352	16589413	0	62	255	42307	255	42245	0.0	0.006036217303822937
chr21	MIR99AHG	16631440	16631489	0	50	255	42307	255	42257	0.0	0.00603450315923989
chr21	CXADR	17558975	17559131	0	157	255	6029	255	5872	0.0	0.043426430517711175
chr21	CXADR	17551748	17551953	0	206	255	6029	255	5823	0.0	0.04379185986604843
chr21	CHODL	18262790	18262893	0	104	0	3103	0	2999	0.0	0.0
chr21	CHODL	18027871	18027971	0	101	0	3103	0	3002	0.0	0.0
chr21	LINC01425	21748394	21748684	0	291	22	777	22	486	0.0	0.04526748971193416
chr21	LINC01684	24441168	24441353	0	186	0	9534	0	9348	0.0	0.0
chr21	LINC01684	24522888	24522999	0	112	0	9534	0	9422	0.0	0.0
chr21	LINC01684	24443963	24444128	0	166	0	9534	0	9368	0.0	0.0
chr21	LINC01684	24488112	24488309	0	198	0	9534	0	9336	0.0	0.0
chr21	LINC01684	24443557	24443743	0	187	0	9534	0	9347	0.0	0.0
chr21	LINC01684	24485622	24485685	0	64	0	9534	0	9470	0.0	0.0
chr21	JAM2	25689865	25689973	0	109	0	5938	0	5829	0.0	0.0
chr21	JAM2	25711366	25711568	0	203	0	5938	0	5735	0.0	0.0
chr21	GABPA	25741572	25741675	0	104	0	5752	0	5648	0.0	0.0
chr21	AP001442.1	25937789	25937912	0	124	0	2606	0	2482	0.0	0.0
chr21	AP001442.1	25934909	25935048	0	140	0	2606	0	2466	0.0	0.0
chr21	AP000229.1	26180536	26180601	0	66	0	4249	0	4183	0.0	0.0
chr21	AP001604.1	27391389	27391551	496	163	496	1219	0	1056	3.042944785276074	0.0
chr21	LINC01673	27669351	27669530	0	180	0	2081	0	1901	0.0	0.0
chr21	LINC01673	27645458	27645640	0	183	0	2081	0	1898	0.0	0.0
chr21	LINC01673	27653118	27653222	0	105	0	2081	0	1976	0.0	0.0
chr21	LINC01697	28101265	28101319	0	55	51	4071	51	4016	0.0	0.012699203187250997
chr21	LINC01697	28095880	28096114	0	235	51	4071	51	3836	0.0	0.013295099061522419
chr21	USP16	29025708	29025771	0	64	94	5713	94	5649	0.0	0.016640113294388387
chr21	USP16	29026566	29026661	0	96	94	5713	94	5617	0.0	0.016734911874666192
chr21	MAP3K7CL	29080551	29080708	0	158	0	4362	0	4204	0.0	0.0
chr21	MAP3K7CL	29133305	29133414	0	110	0	4362	0	4252	0.0	0.0
chr21	MAP3K7CL	29130794	29130923	0	130	0	4362	0	4232	0.0	0.0
chr21	MAP3K7CL	29085071	29085143	0	73	0	4362	0	4289	0.0	0.0
chr21	MAP3K7CL	29109039	29109183	0	145	0	4362	0	4217	0.0	0.0
chr21	BACH1	29218860	29218926	0	67	102	7684	102	7617	0.0	0.01339109885781804
chr21	BACH1	29270356	29270456	0	101	102	7684	102	7583	0.0	0.013451140709481736
chr21	BACH1	29582311	29582351	0	41	102	7684	102	7643	0.0	0.013345544943085177
chr21	GRIK1-AS1	29760019	29760065	0	47	0	3102	0	3055	0.0	0.0
chr21	GRIK1-AS1	29758830	29759010	0	181	0	3102	0	2921	0.0	0.0
chr21	GRIK1-AS1	29761256	29761419	0	164	0	3102	0	2938	0.0	0.0
chr21	HUNK	31958842	31958970	0	129	51	8601	51	8472	0.0	0.0060198300283286115
chr21	MRAP	32298961	32299077	0	117	0	1347	0	1230	0.0	0.0
chr21	EVA1C	32453311	32453508	0	198	14066	4328	14066	4130	0.0	3.4058111380145277
chr21	EVA1C	32457596	32457720	0	125	14066	4328	14066	4203	0.0	3.3466571496550084
chr21	EVA1C	32495026	32495170	357	145	14066	4328	13709	4183	2.462068965517241	3.277312933301458
chr21	EVA1C	32501414	32501495	0	82	14066	4328	14066	4246	0.0	3.312764955252002
chr21	EVA1C	32501414	32501538	0	125	14066	4328	14066	4203	0.0	3.3466571496550084
chr21	EVA1C	32501414	32501486	0	73	14066	4328	14066	4255	0.0	3.305757931844888
chr21	PAXBP1-AS1	32732518	32732825	0	308	1122	9689	1122	9381	0.0	0.11960345378957467
chr21	PAXBP1-AS1	32733588	32733657	0	70	1122	9689	1122	9619	0.0	0.11664414180268219
chr21	PAXBP1-AS1	32738271	32738341	0	71	1122	9689	1122	9618	0.0	0.11665626949469744
chr21	C21ORF62-AS1	32784796	32784919	19	124	3538	9197	3519	9073	0.1532258064516129	0.3878540725228701
chr21	C21ORF62-AS1	32788611	32788701	0	91	3538	9197	3538	9106	0.0	0.3885350318471338
chr21	IFNAR2	33244950	33245074	0	125	51	4591	51	4466	0.0	0.01141961486789073
chr21	IFNAR2	33260596	33260727	0	132	51	4591	51	4459	0.0	0.011437542049786947
chr21	IL10RB	33276595	33276753	0	159	0	4535	0	4376	0.0	0.0
chr21	IFNAR2	33252137	33252248	0	112	51	4591	51	4479	0.0	0.011386470194239785
chr21	IL10RB	33268393	33268517	0	125	0	4535	0	4410	0.0	0.0
chr21	IL10RB	33294011	33294127	0	117	0	4535	0	4418	0.0	0.0
chr21	IFNAR1	33343267	33343422	0	156	1817	6892	1817	6736	0.0	0.26974465558194777
chr21	IFNAR1	33343534	33343676	0	143	1817	6892	1817	6749	0.0	0.2692250703807972
chr21	IFNAR1	33345245	33345360	0	116	1817	6892	1817	6776	0.0	0.26815230224321135
chr21	IFNGR2	33414887	33415020	0	134	0	2453	0	2319	0.0	0.0
chr21	IFNGR2	33411444	33411575	0	132	0	2453	0	2321	0.0	0.0
chr21	IFNGR2	33410835	33410892	0	58	0	2453	0	2395	0.0	0.0
chr21	IFNGR2	33410840	33410892	0	53	0	2453	0	2400	0.0	0.0
chr21	SON	33549475	33555391	0	5917	51	12719	51	6802	0.0	0.007497794766245222
chr21	SON	33572550	33572630	0	81	51	12719	51	12638	0.0	0.004035448646937807
chr21	ITSN1	33750253	33750322	0	70	94504	21317	94504	21247	0.0	4.447874994116816
chr21	ITSN1	33818266	33818472	0	207	94504	21317	94504	21110	0.0	4.476740881099005
chr21	ITSN1	33823486	33823653	84	168	94504	21317	94420	21149	0.5	4.464513688590477
chr21	ITSN1	33716430	33716555	0	126	94504	21317	94504	21191	0.0	4.459629087820301
chr21	ITSN1	33750142	33750322	0	181	94504	21317	94504	21136	0.0	4.471233913701741
chr21	ITSN1	33802429	33802444	607	16	94504	21317	93897	21301	37.9375	4.408102905966856
chr21	ITSN1	33875353	33875521	372	169	94504	21317	94132	21148	2.201183431952663	4.4511064876111215
chr21	ITSN1	33882242	33882455	0	214	94504	21317	94504	21103	0.0	4.478225844666635
chr21	ITSN1	33829623	33829745	0	123	94504	21317	94504	21194	0.0	4.4589978295744075
chr21	ITSN1	33689321	33689383	10536	63	94504	21317	83968	21254	167.23809523809524	3.950691634515856
chr21	ITSN1	33802436	33802444	348	9	94504	21317	94156	21308	38.666666666666664	4.418809836681059
chr21	ITSN1	33828967	33829050	28	84	94504	21317	94476	21233	0.3333333333333333	4.44948900296708
chr21	ITSN1	33826817	33826863	0	47	94504	21317	94504	21270	0.0	4.44306535025858
chr21	ITSN1	33883549	33883671	0	123	94504	21317	94504	21194	0.0	4.4589978295744075
chr21	LINC00649	33923896	33924311	0	416	89925	8737	89925	8321	0.0	10.806994351640428
chr21	LINC00310	34182707	34183192	51	486	977	3286	926	2800	0.10493827160493827	0.33071428571428574
chr21	LINC00310	34182707	34183118	51	412	977	3286	926	2874	0.12378640776699029	0.3221990257480863
chr21	LINC00310	34188216	34188662	0	447	977	3286	977	2839	0.0	0.3441352588939767
chr21	SMIM11A	34385477	34385644	0	168	0	7871	0	7703	0.0	0.0
chr21	CLIC6	34706026	34706080	0	55	125670	4262	125670	4207	0.0	29.87164250059425
chr21	MORC3	36333645	36333718	0	74	5286	6433	5286	6359	0.0	0.8312627771662211
chr21	MORC3	36384186	36384210	0	25	5286	6433	5286	6408	0.0	0.8249063670411985
chr21	RIPPLY3	37013550	37013618	0	69	51	2188	51	2119	0.0	0.02406795658329401
chr21	TTC3	37121816	37121979	0	164	132	15936	132	15772	0.0	0.008369261983261477
chr21	TTC3	37087832	37087875	0	44	132	15936	132	15892	0.0	0.008306065945129625
chr21	TTC3	37090232	37090286	0	55	132	15936	132	15881	0.0	0.008311819154965053
chr21	TTC3	37094004	37094090	0	87	132	15936	132	15849	0.0	0.00832860117357562
chr21	TTC3	37148545	37148647	0	103	132	15936	132	15833	0.0	0.00833701762142361
chr21	TTC3	37192111	37192213	0	103	132	15936	132	15833	0.0	0.00833701762142361
chr21	TTC3	37157160	37157214	0	55	132	15936	132	15881	0.0	0.008311819154965053
chr21	DSCR9	37210004	37210114	0	111	102	1584	102	1473	0.0	0.06924643584521385
chr21	DSCR9	37214095	37214153	0	59	102	1584	102	1525	0.0	0.06688524590163934
chr21	DSCR9	37216404	37216493	0	90	102	1584	102	1494	0.0	0.06827309236947791
chr21	DYRK1A	37506098	37506223	0	126	204518	22440	204518	22314	0.0	9.165456663977771
chr21	DYRK1A	37420298	37420384	0	87	204518	22440	204518	22353	0.0	9.149465396143695
chr21	DYRK1A	37410569	37410670	2421	102	204518	22440	202097	22338	23.735294117647058	9.047228937236996
chr21	DYRK1A	37506098	37506354	0	257	204518	22440	204518	22183	0.0	9.21958256322409
chr21	DYRK1A	37415489	37415565	831	77	204518	22440	203687	22363	10.792207792207792	9.108214461387112
chr21	DYRK1A	37430268	37430400	391	133	204518	22440	204127	22307	2.9398496240601504	9.150804680145246
chr21	DYRK1A	37421773	37421866	0	94	204518	22440	204518	22346	0.0	9.152331513469973
chr21	DYRK1A	37456129	37456308	0	180	204518	22440	204518	22260	0.0	9.187690925426775
chr21	DSCR8	38154414	38154529	0	116	62873	835	62873	719	0.0	87.44506258692628
chr21	DSCR8	38154432	38154529	0	98	62873	835	62873	737	0.0	85.30936227951153
chr21	KCNJ15	38169168	38169268	0	101	30542	10358	30542	10257	0.0	2.977673783757434
chr21	KCNJ15	38257045	38257185	62	141	30542	10358	30480	10217	0.4397163120567376	2.9832631888029755
chr21	KCNJ15	38291605	38291747	0	143	30542	10358	30542	10215	0.0	2.989916789035732
chr21	KCNJ15	38256742	38256787	0	46	30542	10358	30542	10312	0.0	2.9617920868890613
chr21	KCNJ15	38298143	38298282	0	140	30542	10358	30542	10218	0.0	2.989038950871012
chr21	KCNJ15	38285586	38285689	0	104	30542	10358	30542	10254	0.0	2.9785449580651453
chr21	ETS2	38806450	38806808	0	359	1661	4917	1661	4558	0.0	0.36441421676173763
chr21	ETS2	38806690	38806808	0	119	1661	4917	1661	4798	0.0	0.34618591079616506
chr21	GET1	39393165	39393280	0	116	0	8656	0	8540	0.0	0.0
chr21	GET1	39390697	39390863	0	167	0	8656	0	8489	0.0	0.0
chr21	SH3BGR	39475134	39475215	0	82	0	1493	0	1411	0.0	0.0
chr21	SH3BGR	39499822	39499915	0	94	0	1493	0	1399	0.0	0.0
chr21	GET1	39405913	39406058	0	146	0	8656	0	8510	0.0	0.0
chr21	GET1	39407792	39407917	0	126	0	8656	0	8530	0.0	0.0
chr21	GET1	39405913	39406298	0	386	0	8656	0	8270	0.0	0.0
chr21	GET1	39425759	39426034	0	276	0	8656	0	8380	0.0	0.0
chr21	GET1	39391226	39391476	0	251	0	8656	0	8405	0.0	0.0
chr21	GET1	39408605	39408677	0	73	0	8656	0	8583	0.0	0.0
chr21	GET1	39413809	39414591	0	783	0	8656	0	7873	0.0	0.0
chr21	B3GALT5	39659752	39659912	0	161	19890	14328	19890	14167	0.0	1.403966965483165
chr21	PCP4	39926046	39926191	0	146	0	991	0	845	0.0	0.0
chr21	DSCAM-AS1	40383651	40384138	0	488	1255	1772	1255	1284	0.0	0.9774143302180686
chr21	BACE2	41250751	41250901	0	151	102	9570	102	9419	0.0	0.01082917507166366
chr21	BACE2	41257157	41257326	0	170	102	9570	102	9400	0.0	0.010851063829787235
chr21	FAM3B	41322922	41323066	0	145	0	3839	0	3694	0.0	0.0
chr21	FAM3B	41322587	41322704	0	118	0	3839	0	3721	0.0	0.0
chr21	MX2	41372933	41372999	0	67	55	11393	55	11326	0.0	0.004856083348048737
chr21	MX2	41363268	41363389	0	122	55	11393	55	11271	0.0	0.004879779966285157
chr21	MX2	41399195	41399337	0	143	55	11393	55	11250	0.0	0.004888888888888889
chr21	MX2	41373897	41374127	0	231	55	11393	55	11162	0.0	0.004927432359792152
chr21	MX1	41430532	41430608	0	77	51	6893	51	6816	0.0	0.007482394366197183
chr21	MX1	41427205	41427304	0	100	51	6893	51	6793	0.0	0.007507728544089504
chr21	ZNF295-AS1	42041516	42041982	0	467	0	3806	0	3339	0.0	0.0
chr21	UMODL1	42088293	42088480	0	188	51	7308	51	7120	0.0	0.007162921348314606
chr21	UMODL1	42090297	42090438	0	142	51	7308	51	7166	0.0	0.0071169411108010045
chr21	UMODL1	42122830	42123150	0	321	51	7308	51	6987	0.0	0.0072992700729927005
chr21	UMODL1	42101707	42101817	0	111	51	7308	51	7197	0.0	0.0070862859524802
chr21	UMODL1	42093870	42094024	0	155	51	7308	51	7153	0.0	0.0071298755766811125
chr21	UMODL1	42086529	42086626	0	98	51	7308	51	7210	0.0	0.007073509015256588
chr21	UMODL1	42093403	42093522	0	120	51	7308	51	7188	0.0	0.0070951585976627716
chr21	UMODL1	42088293	42088473	0	181	51	7308	51	7127	0.0	0.007155886067068893
chr21	ABCG1	42276894	42276945	0	52	51	6143	51	6091	0.0	0.008373009358069283
chr21	UBASH3A	42413409	42413523	0	115	0	3935	0	3820	0.0	0.0
chr21	SLC37A1	42514869	42514935	0	67	255	6841	255	6774	0.0	0.037643932683790966
chr21	PDE9A	42686191	42686262	0	72	26094	5304	26094	5232	0.0	4.987385321100917
chr21	PDE9A	42687916	42687994	0	79	26094	5304	26094	5225	0.0	4.994066985645933
chr21	PDE9A	42731769	42731949	0	181	26094	5304	26094	5123	0.0	5.093499902400937
chr21	PDE9A	42732069	42732124	0	56	26094	5304	26094	5248	0.0	4.972179878048781
chr21	PDE9A	42743775	42743860	0	86	26094	5304	26094	5218	0.0	5.000766577232656
chr21	PDE9A	42697414	42697490	0	77	26094	5304	26094	5227	0.0	4.992156112492825
chr21	PDE9A	42698967	42699011	0	45	26094	5304	26094	5259	0.0	4.961779806046777
chr21	NDUFV3	42903181	42904276	0	1096	51	6349	51	5253	0.0	0.009708737864077669
chr21	NDUFV3	42896926	42897047	0	122	51	6349	51	6227	0.0	0.008190139714148064
chr21	PKNOX1	43010052	43010224	0	173	4762	7547	4762	7374	0.0	0.6457824789802007
chr21	PDXK	43743723	43743807	0	85	0	11305	0	11220	0.0	0.0
chr21	PDXK	43732138	43732647	0	510	0	11305	0	10795	0.0	0.0
chr21	PDXK	43732138	43732442	0	305	0	11305	0	11000	0.0	0.0
chr21	RRP1	43791015	43791056	0	42	0	4003	0	3961	0.0	0.0
chr21	AGPAT3	43954549	43955242	2207	694	3444	9318	1237	8624	3.180115273775216	0.14343692022263452
chr21	AGPAT3	43948153	43948329	0	177	3444	9318	3444	9141	0.0	0.3767640301936331
chr21	TRAPPC10	44063052	44063168	0	117	1219	8744	1219	8627	0.0	0.14130056798423554
chr21	PWP2	44114178	44114278	0	101	756	6249	756	6148	0.0	0.12296681847755368
chr21	GATD3A	44134101	44134154	0	54	153	7961	153	7907	0.0	0.019349943088402682
chr21	GATD3A	44140249	44140342	0	94	153	7961	153	7867	0.0	0.019448328460658446
chr21	PFKL	44305799	44305935	0	137	90314	8712	90314	8575	0.0	10.532244897959183
chr21	PFKL	44304274	44304455	1400	182	90314	8712	88914	8530	7.6923076923076925	10.423681125439625
chr21	TRPM2	44427009	44427111	0	103	23395	6626	23395	6523	0.0	3.586539935612448
chr21	TRPM2	44422269	44422419	204	151	23395	6626	23191	6475	1.3509933774834437	3.5816216216216215
chr21	TSPEAR-AS2	44518258	44518332	1411	75	247795	3030	246384	2955	18.813333333333333	83.37868020304569
chr21	ITGB2-AS1	44927624	44927667	0	44	6563	2443	6563	2399	0.0	2.7357232180075033
chr21	ITGB2-AS1	44922912	44922983	159	72	6563	2443	6404	2371	2.2083333333333335	2.700970054829186
chr21	ADARB1	45184473	45184593	1033	121	1089577	8105	1088544	7984	8.537190082644628	136.34068136272546
chr21	LINC00334	45243531	45243626	0	96	1508	2102	1508	2006	0.0	0.7517447657028913
chr21	COL18A1	45507560	45507593	1610	34	101809	8507	100199	8473	47.35294117647059	11.82568157677328
chr21	LINC01694	45595572	45595661	0	90	44	3518	44	3428	0.0	0.012835472578763127
chr21	PCBP3	45913950	45914025	0	76	55208	6336	55208	6260	0.0	8.819169329073482
chr21	PCBP3	45930785	45930845	0	61	55208	6336	55208	6275	0.0	8.79808764940239
chr21	PCBP3	45929916	45929995	0	80	55208	6336	55208	6256	0.0	8.824808184143222
chr21	PCBP3	45913950	45914094	0	145	55208	6336	55208	6191	0.0	8.917460830237442
chr21	MCM3AP-AS1	46236223	46236326	51	104	17082	9232	17031	9128	0.49038461538461536	1.86579754601227
chr21	MCM3AP-AS1	46230326	46230527	31	202	17082	9232	17051	9030	0.15346534653465346	1.8882613510520487
chr21	YBEY	46291333	46291462	6403	130	69252	1807	62849	1677	49.253846153846155	37.477042337507456
chr21	PCNT	46351428	46351540	2921	113	68271	11691	65350	11578	25.849557522123895	5.6443254448091205
chr21	DIP2A	46504360	46504489	0	130	11281	12486	11281	12356	0.0	0.9129977338944643
chr21	DIP2A	46559833	46559863	0	31	11281	12486	11281	12455	0.0	0.9057406663990365
chr21	PRMT2	46658744	46658920	0	177	10517	5492	10517	5315	0.0	1.9787394167450612
chr21	PRMT2	46663382	46663554	0	173	10517	5492	10517	5319	0.0	1.9772513630381652
chr21	PRMT2	46636438	46636547	0	110	10517	5492	10517	5382	0.0	1.9541062801932367
chr21	PRMT2	46661799	46661936	0	138	10517	5492	10517	5354	0.0	1.964325737766156
chr21	GATD3B	5121710	5121803	0	94	0	2837	0	2743	0.0	0.0
chr21	GATD3B	5127897	5127950	0	54	0	2837	0	2783	0.0	0.0
chr21	FP565260.1	5134360	5134479	0	120	0	7451	0	7331	0.0	0.0
chr21	CU633906.1	6254790	6254849	0	60	0	2884	0	2824	0.0	0.0
chr21	CU633906.1	6234982	6235147	0	166	0	2884	0	2718	0.0	0.0
chr21	CU633906.1	6235988	6236160	0	173	0	2884	0	2711	0.0	0.0
chr21	CBSL	6447735	6447777	0	43	0	3896	0	3853	0.0	0.0
chr21	U2AF1L5	6492130	6492197	0	68	0	7422	0	7354	0.0	0.0
chr21	U2AF1L5	6493043	6493110	0	68	0	7422	0	7354	0.0	0.0
chr21	CU638689.4	6659518	6659578	0	61	0	6658	0	6597	0.0	0.0
chr21	ANKRD20A11P	13927334	13927447	0	114	0	4871	0	4757	0.0	0.0
chr21	LIPI	14166361	14166451	0	91	0	1755	0	1664	0.0	0.0
chr21	SAMSN1	14523270	14523394	0	125	51	5206	51	5081	0.0	0.010037394213737453
chr21	AF127936.1	14750862	14750909	0	48	51	4958	51	4910	0.0	0.010386965376782077
chr21	AF127936.1	14753323	14753394	0	72	51	4958	51	4886	0.0	0.010437986082685223
chr21	NRIP1	15014343	15014466	0	124	51	8505	51	8381	0.0	0.006085192697768763
chr21	NRIP1	15043494	15043574	0	81	51	8505	51	8424	0.0	0.006054131054131054
chr21	AJ009632.2	15394472	15394506	0	35	18153	18447	18153	18412	0.0	0.9859330871170976
chr21	AJ009632.2	15513864	15513934	0	71	18153	18447	18153	18376	0.0	0.9878646060078363
chr21	AJ009632.2	15393970	15394049	0	80	18153	18447	18153	18367	0.0	0.9883486688081886
chr21	AJ009632.2	15397888	15397984	0	97	18153	18447	18153	18350	0.0	0.9892643051771117
chr21	AJ009632.2	15385621	15385689	0	69	18153	18447	18153	18378	0.0	0.9877571008814887
chr21	AJ009632.2	15383028	15383173	0	146	18153	18447	18153	18301	0.0	0.9919130102180209
chr21	AJ009632.2	15441777	15441847	42	71	18153	18447	18111	18376	0.5915492957746479	0.9855790161079669
chr21	AJ009632.2	15571191	15571356	0	166	18153	18447	18153	18281	0.0	0.992998194847109
chr21	AJ009632.2	15573972	15574034	0	63	18153	18447	18153	18384	0.0	0.987434725848564
chr21	BTG3	17604144	17604276	0	133	0	2311	0	2178	0.0	0.0
chr21	BTG3	17611656	17611774	0	119	0	2311	0	2192	0.0	0.0
chr21	C21ORF91-OT1	17785547	17785612	0	66	0	1005	0	939	0.0	0.0
chr21	C21ORF91	17795207	17795270	0	64	0	2406	0	2342	0.0	0.0
chr21	TMPRSS15	18379282	18379318	0	37	969	4390	969	4353	0.0	0.22260509993108202
chr21	TMPRSS15	18380539	18380584	0	46	969	4390	969	4344	0.0	0.22306629834254144
chr21	MIR548XHG	18563314	18563372	0	59	0	2746	0	2687	0.0	0.0
chr21	MIR548XHG	18752747	18753116	0	370	0	2746	0	2376	0.0	0.0
chr21	LINC00320	20782306	20782446	0	141	215	16661	215	16520	0.0	0.01301452784503632
chr21	LINC00320	20743615	20743833	0	219	215	16661	215	16442	0.0	0.01307626809390585
chr21	LINC00320	20757310	20757417	0	108	215	16661	215	16553	0.0	0.01298858213012747
chr21	LINC00320	20786035	20786088	0	54	215	16661	215	16607	0.0	0.012946347925573554
chr21	LINC00320	20782249	20782446	0	198	215	16661	215	16463	0.0	0.013059588167405697
chr21	LINC00320	20778642	20778762	0	121	215	16661	215	16540	0.0	0.012998790810157194
chr21	LINC00320	20778642	20778796	0	155	215	16661	215	16506	0.0	0.013025566460680964
chr21	LINC00320	20780810	20780907	0	98	215	16661	215	16563	0.0	0.012980740204069311
chr21	LINC00320	20786035	20786111	0	77	215	16661	215	16584	0.0	0.012964302942595273
chr21	LINC00320	20778183	20778344	0	162	215	16661	215	16499	0.0	0.013031092793502636
chr21	LINC00320	20757218	20757417	0	200	215	16661	215	16461	0.0	0.013061174898244335
chr21	LINC00320	20783271	20783409	0	139	215	16661	215	16522	0.0	0.01301295242706694
chr21	LINC01687	22032384	22032505	0	122	0	3693	0	3571	0.0	0.0
chr21	LINC01687	22042944	22043087	0	144	0	3693	0	3549	0.0	0.0
chr21	AP000470.1	24182692	24182777	0	86	0	1137	0	1051	0.0	0.0
chr21	LINC00158	25388913	25389082	0	170	0	4142	0	3972	0.0	0.0
chr21	LINC00158	25424553	25424649	0	97	0	4142	0	4045	0.0	0.0
chr21	LINC00158	25396448	25396684	0	237	0	4142	0	3905	0.0	0.0
chr21	LINC00158	25420707	25420800	0	94	0	4142	0	4048	0.0	0.0
chr21	LINC00158	25421508	25421775	0	268	0	4142	0	3874	0.0	0.0
chr21	LINC00158	25428890	25428959	0	70	0	4142	0	4072	0.0	0.0
chr21	LINC00158	25428890	25429030	0	141	0	4142	0	4001	0.0	0.0
chr21	MRPL39	25587700	25587789	0	90	0	1210	0	1120	0.0	0.0
chr21	ATP5PF	25734332	25734375	0	44	0	1583	0	1539	0.0	0.0
chr21	APP	25905023	25905077	0	55	0	5908	0	5853	0.0	0.0
chr21	APP	26111978	26112146	0	169	0	5908	0	5739	0.0	0.0
chr21	APP	25997359	25997416	0	58	0	5908	0	5850	0.0	0.0
chr21	APP	26000014	26000182	0	169	0	5908	0	5739	0.0	0.0
chr21	ADAMTS1	26840997	26841165	0	169	0	7313	0	7144	0.0	0.0
chr21	ADAMTS5	26939811	26939955	0	145	25809	9774	25809	9629	0.0	2.6803406376570775
chr21	LINC01695	28167225	28167319	0	95	212877	5328	212877	5233	0.0	40.67972482323715
chr21	LINC01695	28217177	28217347	5926	171	212877	5328	206951	5157	34.654970760233915	40.13011440760132
chr21	N6AMT1	28879869	28879953	0	85	102	4871	102	4786	0.0	0.02131216046803176
chr21	LTN1	28967601	28967973	0	373	900	8909	900	8536	0.0	0.10543580131208997
chr21	RWDD2B	29008239	29008307	0	69	0	3266	0	3197	0.0	0.0
chr21	CCT8	29064967	29065105	0	139	0	3204	0	3065	0.0	0.0
chr21	CCT8	29069422	29069502	0	81	0	3204	0	3123	0.0	0.0
chr21	GRIK1	29537797	29537884	0	88	3111	4262	3111	4174	0.0	0.7453282223287014
chr21	GRIK1	29596525	29596570	0	46	3111	4262	3111	4216	0.0	0.7379032258064516
chr21	TIAM1	31202907	31203012	0	106	0	9246	0	9140	0.0	0.0
chr21	TIAM1	31213397	31213472	0	76	0	9246	0	9170	0.0	0.0
chr21	SCAF4	31705422	31705467	0	46	0	4942	0	4896	0.0	0.0
chr21	LINC00159	32083473	32083617	0	145	0	1514	0	1369	0.0	0.0
chr21	CFAP298-TCP10L	32505636	32505734	0	99	14288	19230	14288	19131	0.0	0.7468506612304636
chr21	CFAP298-TCP10L	32582199	32582415	229	217	14288	19230	14059	19013	1.055299539170507	0.7394414348077631
chr21	CFAP298-TCP10L	32603160	32603292	0	133	14288	19230	14288	19097	0.0	0.7481803424621668
chr21	CFAP298-TCP10L	32587312	32587477	0	166	14288	19230	14288	19064	0.0	0.7494754511120436
chr21	CFAP298-TCP10L	32607648	32607716	0	69	14288	19230	14288	19161	0.0	0.7456813318720318
chr21	CFAP298-TCP10L	32572507	32572595	0	89	14288	19230	14288	19141	0.0	0.7464604775090121
chr21	CFAP298-TCP10L	32574095	32574124	0	30	14288	19230	14288	19200	0.0	0.7441666666666666
chr21	CFAP298-TCP10L	32567940	32568079	0	140	14288	19230	14288	19090	0.0	0.7484546883184914
chr21	CFAP298-TCP10L	32573283	32574676	0	1394	14288	19230	14288	17836	0.0	0.8010764745458623
chr21	CFAP298-TCP10L	32572491	32572595	0	105	14288	19230	14288	19125	0.0	0.7470849673202614
chr21	CFAP298-TCP10L	32584160	32584305	0	146	14288	19230	14288	19084	0.0	0.7486900020959967
chr21	CFAP298-TCP10L	32575376	32576923	1989	1548	14288	19230	12299	17682	1.2848837209302326	0.6955661124307205
chr21	CFAP298-TCP10L	32602271	32602367	0	97	14288	19230	14288	19133	0.0	0.746772591857001
chr21	SYNJ1	32634860	32634884	0	25	2508	8097	2508	8072	0.0	0.3107036669970268
chr21	SYNJ1	32676331	32676355	0	25	2508	8097	2508	8072	0.0	0.3107036669970268
chr21	SYNJ1	32643409	32643457	0	49	2508	8097	2508	8048	0.0	0.3116302186878728
chr21	SYNJ1	32634860	32634881	0	22	2508	8097	2508	8075	0.0	0.31058823529411766
chr21	PAXBP1	32750916	32751032	0	117	1143	6180	1143	6063	0.0	0.1885205343889164
chr21	C21ORF62	32807641	32807716	0	76	18	1113	18	1037	0.0	0.017357762777242044
chr21	C21ORF62	32810573	32810654	18	82	18	1113	0	1031	0.21951219512195122	0.0
chr21	TMEM50B	33456003	33456097	0	95	51	4429	51	4334	0.0	0.011767420396862021
chr21	GART	33529566	33529768	0	203	102	6725	102	6522	0.0	0.015639374425023
chr21	DONSON	33579349	33579562	0	214	0	2762	0	2548	0.0	0.0
chr21	DONSON	33583487	33583666	0	180	0	2762	0	2582	0.0	0.0
chr21	DONSON	33584589	33584726	0	138	0	2762	0	2624	0.0	0.0
chr21	DONSON	33587521	33587602	0	82	0	2762	0	2680	0.0	0.0
chr21	DONSON	33579349	33579417	0	69	0	2762	0	2693	0.0	0.0
chr21	DONSON	33584589	33584768	0	180	0	2762	0	2582	0.0	0.0
chr21	DONSON	33582164	33582246	0	83	0	2762	0	2679	0.0	0.0
chr21	ATP5PO	33909081	33909211	0	131	1708	1528	1708	1397	0.0	1.2226198997852542
chr21	CRYZL1	33597279	33597401	0	123	60526	5121	60526	4998	0.0	12.110044017607043
chr21	CRYZL1	33616705	33616750	0	46	60526	5121	60526	5075	0.0	11.926305418719211
chr21	CRYZL1	33631485	33631557	0	73	60526	5121	60526	5048	0.0	11.990095087163233
chr21	CRYZL1	33613537	33613606	0	70	60526	5121	60526	5051	0.0	11.98297366858048
chr21	CRYZL1	33641178	33641305	28811	128	60526	5121	31715	4993	225.0859375	6.351892649709593
chr21	CRYZL1	33631485	33631527	0	43	60526	5121	60526	5078	0.0	11.919259551004332
chr21	ATP5PO	33906448	33906500	0	53	1708	1528	1708	1475	0.0	1.1579661016949152
chr21	ATP5PO	33906727	33906794	0	68	1708	1528	1708	1460	0.0	1.16986301369863
chr21	ATP5PO	33906725	33906821	0	97	1708	1528	1708	1431	0.0	1.193570929419986
chr21	KCNE1	34458653	34458764	0	112	0	4010	0	3898	0.0	0.0
chr21	KCNE1	34458653	34458736	0	84	0	4010	0	3926	0.0	0.0
chr21	RCAN1	34525087	34525608	51	522	1442	6537	1391	6015	0.09770114942528736	0.2312551953449709
chr21	RUNX1	34834409	34834601	1327	193	229296	15480	227969	15287	6.875647668393782	14.912605481781906
chr21	RUNX1	34892924	34892963	0	40	229296	15480	229296	15440	0.0	14.850777202072539
chr21	RUNX1	34886842	34887096	1509	255	229296	15480	227787	15225	5.91764705882353	14.961379310344828
chr21	SETD4	36048307	36048396	0	90	0	6423	0	6333	0.0	0.0
chr21	SETD4	36057383	36057477	0	95	0	6423	0	6328	0.0	0.0
chr21	CBR3-AS1	36146255	36146355	0	101	1039	8894	1039	8793	0.0	0.1181621744569544
chr21	CBR3-AS1	36133686	36133761	0	76	1039	8894	1039	8818	0.0	0.11782717169426174
chr21	CBR3-AS1	36137093	36137176	0	84	1039	8894	1039	8810	0.0	0.11793416572077185
chr21	CBR3-AS1	36137093	36137308	0	216	1039	8894	1039	8678	0.0	0.11972804793731275
chr21	CBR3-AS1	36137093	36137229	0	137	1039	8894	1039	8757	0.0	0.11864793879182368
chr21	CBR3-AS1	36144978	36145076	0	99	1039	8894	1039	8795	0.0	0.11813530415008527
chr21	CLDN14	36477373	36477563	0	191	0	2389	0	2198	0.0	0.0
chr21	HLCS	36946008	36946154	0	147	0	10535	0	10388	0.0	0.0
chr21	HLCS	36947332	36948287	0	956	0	10535	0	9579	0.0	0.0
chr21	HLCS	36948165	36948287	0	123	0	10535	0	10412	0.0	0.0
chr21	PIGP	37069551	37069624	0	74	0	4217	0	4143	0.0	0.0
chr21	PIGP	37072144	37072310	0	167	0	4217	0	4050	0.0	0.0
chr21	VPS26C	37240495	37240639	0	145	51	8542	51	8397	0.0	0.006073597713469096
chr21	VPS26C	37233361	37233442	0	82	51	8542	51	8460	0.0	0.006028368794326241
chr21	ERG	38445403	38445621	297	219	10940	7601	10643	7382	1.356164383561644	1.4417502031969656
chr21	ERG	38392375	38392444	0	70	10940	7601	10940	7531	0.0	1.452662329039968
chr21	ERG	38400573	38400645	0	73	10940	7601	10940	7528	0.0	1.453241232731137
chr21	AP001042.1	38893960	38894285	0	326	63652	10133	63652	9807	0.0	6.490465993677985
chr21	AP001042.1	38880591	38880708	0	118	63652	10133	63652	10015	0.0	6.355666500249626
chr21	AP001042.1	38904229	38904483	0	255	63652	10133	63652	9878	0.0	6.44381453735574
chr21	AP001042.1	38920741	38920839	0	99	63652	10133	63652	10034	0.0	6.343631652381902
chr21	AF064858.1	38990826	38991024	0	199	51	6658	51	6459	0.0	0.007895959126799815
chr21	AF064858.1	39008101	39008231	0	131	51	6658	51	6527	0.0	0.007813696951126091
chr21	PSMG1	39179923	39179986	0	64	0	2159	0	2095	0.0	0.0
chr21	PSMG1	39181771	39181878	0	108	0	2159	0	2051	0.0	0.0
chr21	BRWD1	39210785	39210929	0	145	51	16239	51	16094	0.0	0.003168882813470859
chr21	BRWD1	39247700	39247832	0	133	51	16239	51	16106	0.0	0.003166521793120576
chr21	BRWD1	39255644	39255828	0	185	51	16239	51	16054	0.0	0.0031767783729911548
chr21	BRWD1	39210865	39210929	0	65	51	16239	51	16174	0.0	0.0031532088537158404
chr21	BRWD1	39255664	39255828	0	165	51	16239	51	16074	0.0	0.0031728256812243376
chr21	HMGN1	39345829	39345958	0	130	0	4327	0	4197	0.0	0.0
chr21	HMGN1	39348421	39348451	0	31	0	4327	0	4296	0.0	0.0
chr21	HMGN1	39347378	39347478	0	101	0	4327	0	4226	0.0	0.0
chr21	HMGN1	39347378	39347483	0	106	0	4327	0	4221	0.0	0.0
chr21	HMGN1	39347113	39347292	0	180	0	4327	0	4147	0.0	0.0
chr21	HMGN1	39347915	39347952	0	38	0	4327	0	4289	0.0	0.0
chr21	HMGN1	39347246	39347292	0	47	0	4327	0	4280	0.0	0.0
chr21	LCA5L	39428171	39428503	0	333	0	4442	0	4109	0.0	0.0
chr21	LCA5L	39435419	39435573	0	155	0	4442	0	4287	0.0	0.0
chr21	LCA5L	39444134	39444201	0	68	0	4442	0	4374	0.0	0.0
chr21	LCA5L	39436096	39436167	0	72	0	4442	0	4370	0.0	0.0
chr21	LCA5L	39444643	39444745	0	103	0	4442	0	4339	0.0	0.0
chr21	LCA5L	39435419	39435542	0	124	0	4442	0	4318	0.0	0.0
chr21	LCA5L	39438683	39438718	0	36	0	4442	0	4406	0.0	0.0
chr21	LCA5L	39439633	39439773	0	141	0	4442	0	4301	0.0	0.0
chr21	B3GALT5-AS1	39601418	39601543	0	126	0	6066	0	5940	0.0	0.0
chr21	B3GALT5-AS1	39599340	39600279	0	940	0	6066	0	5126	0.0	0.0
chr21	LINC00323	41147348	41147499	0	152	0	2574	0	2422	0.0	0.0
chr21	LINC00323	41145076	41145335	0	260	0	2574	0	2314	0.0	0.0
chr21	PLAC4	41180471	41180573	0	103	0	4468	0	4365	0.0	0.0
chr21	PLAC4	41182149	41182245	0	97	0	4468	0	4371	0.0	0.0
chr21	TMPRSS2	41488393	41488513	0	121	0	6341	0	6220	0.0	0.0
chr21	TMPRSS2	41494355	41494578	0	224	0	6341	0	6117	0.0	0.0
chr21	TMPRSS2	41477346	41477462	0	117	0	6341	0	6224	0.0	0.0
chr21	TMPRSS2	41494479	41494578	0	100	0	6341	0	6241	0.0	0.0
chr21	TMPRSS2	41489506	41489593	0	88	0	6341	0	6253	0.0	0.0
chr21	TMPRSS2	41498118	41498189	0	72	0	6341	0	6269	0.0	0.0
chr21	LINC00479	41713855	41713936	0	82	0	1003	0	921	0.0	0.0
chr21	PRDM15	41823317	41823449	0	133	51	11221	51	11088	0.0	0.0045995670995671
chr21	PRDM15	41834504	41834564	0	61	51	11221	51	11160	0.0	0.00456989247311828
chr21	PRDM15	41859030	41859228	0	199	51	11221	51	11022	0.0	0.004627109417528579
chr21	ZBTB21	41992492	41994108	0	1617	51	8068	51	6451	0.0	0.007905751046349403
chr21	ZBTB21	42002896	42002961	0	66	51	8068	51	8002	0.0	0.006373406648337915
chr21	ZBTB21	42002349	42002503	0	155	51	8068	51	7913	0.0	0.0064450903576393275
chr21	ZBTB21	42009466	42009597	0	132	51	8068	51	7936	0.0	0.006426411290322581
chr21	ZBTB21	42002349	42002563	0	215	51	8068	51	7853	0.0	0.006494333375779956
chr21	RSPH1	42492965	42493079	0	115	0	1896	0	1781	0.0	0.0
chr21	CBS	43056057	43056099	0	43	1122	6280	1122	6237	0.0	0.17989417989417988
chr21	U2AF1	43100452	43100519	0	68	918	7408	918	7340	0.0	0.12506811989100816
chr21	U2AF1	43101365	43101432	0	68	918	7408	918	7340	0.0	0.12506811989100816
chr21	LINC00313	43463339	43463489	0	151	333	3377	333	3226	0.0	0.10322380657160571
chr21	LINC00313	43462457	43462525	0	69	333	3377	333	3308	0.0	0.10066505441354293
chr21	LINC00313	43476539	43476751	65	213	333	3377	268	3164	0.3051643192488263	0.08470290771175727
chr21	CSTB	43774657	43774759	0	103	0	2378	0	2275	0.0	0.0
chr21	AATBC	43806963	43807239	0	277	0	4099	0	3822	0.0	0.0
chr21	ICOSLG	44236866	44237217	0	352	51	9348	51	8996	0.0	0.005669186305024455
chr21	DNMT3L	44260794	44260839	5932	46	22789	1872	16857	1826	128.95652173913044	9.231653888280395
chr21	TSPEAR	44690544	44690606	0	63	21489	4477	21489	4414	0.0	4.868373357498867
chr21	UBE2G2	44779143	44779216	0	74	0	6326	0	6252	0.0	0.0
chr21	UBE2G2	44801283	44801398	0	116	0	6326	0	6210	0.0	0.0
chr21	UBE2G2	44774566	44774741	0	176	0	6326	0	6150	0.0	0.0
chr21	PTTG1IP	44861162	44861271	853	110	5245	3546	4392	3436	7.754545454545455	1.2782305005820722
chr21	ITGB2	44903364	44903535	2772	172	22384	6221	19612	6049	16.11627906976744	3.242188791535791
chr21	ITGB2	44920820	44921050	782	231	22384	6221	21602	5990	3.3852813852813854	3.6063439065108516
chr21	ITGB2	44898541	44898613	38	73	22384	6221	22346	6148	0.5205479452054794	3.6346779440468446
chr21	ITGB2	44920820	44920962	520	143	22384	6221	21864	6078	3.6363636363636362	3.5972359328726555
chr21	ITGB2	44908073	44908182	0	110	22384	6221	22384	6111	0.0	3.662902961872034
chr21	LINC01547	44937538	44937682	0	145	4743	3203	4743	3058	0.0	1.5510137344669719
chr21	POFUT2	45266021	45266227	0	207	1781	5242	1781	5035	0.0	0.3537239324726912
chr21	POFUT2	45283382	45283527	1581	146	1781	5242	200	5096	10.82876712328767	0.03924646781789639
chr21	POFUT2	45285268	45285328	0	61	1781	5242	1781	5181	0.0	0.34375603165412083
chr21	POFUT2	45282803	45282938	0	136	1781	5242	1781	5106	0.0	0.34880532706619666
chr21	POFUT2	45282348	45282459	0	112	1781	5242	1781	5130	0.0	0.3471734892787524
chr21	SLC19A1	45543776	45543859	88	84	194872	8967	194784	8883	1.0476190476190477	21.92772711921648
chr21	FTCD	46138879	46138923	0	45	0	3340	0	3295	0.0	0.0
chr21	SPATC1L	46182623	46183774	70	1152	121	2338	51	1186	0.06076388888888889	0.04300168634064081
chr21	LSS	46191065	46191235	131730	171	1517213	7259	1385483	7088	770.3508771929825	195.46882054176072
chr21	LSS	46191075	46191235	126883	161	1517213	7259	1390330	7098	788.0931677018633	195.8763031839955
chr21	C21ORF58	46301996	46302154	0	159	2090	4107	2090	3948	0.0	0.5293819655521783
chr21	C21ORF58	46318784	46318961	0	178	2090	4107	2090	3929	0.0	0.5319419699669127
chr21	S100B	46600281	46600375	3894	95	16193	1810	12299	1715	40.98947368421052	7.171428571428572
chr22	ANKRD62P1-PARP4P3	16673599	16673752	0	154	0	1190	0	1036	0.0	0.0
chr22	GAB4	16969942	16970193	0	252	15	3152	15	2900	0.0	0.005172413793103448
chr22	GAB4	16987959	16988167	0	209	15	3152	15	2943	0.0	0.0050968399592252805
chr22	GAB4	16987959	16988116	0	158	15	3152	15	2994	0.0	0.00501002004008016
chr22	GAB4	16969612	16970193	0	582	15	3152	15	2570	0.0	0.005836575875486381
chr22	HDHD5	17138549	17138738	0	190	195	3533	195	3343	0.0	0.05833084056236913
chr22	HDHD5	17149541	17149745	0	205	195	3533	195	3328	0.0	0.05859375
chr22	ADA2	17189941	17190032	0	92	0	8720	0	8628	0.0	0.0
chr22	ADA2	17209355	17209723	0	369	0	8720	0	8351	0.0	0.0
chr22	ADA2	17209355	17209598	0	244	0	8720	0	8476	0.0	0.0
chr22	ADA2	17203853	17203889	0	37	0	8720	0	8683	0.0	0.0
chr22	ADA2	17209355	17209690	0	336	0	8720	0	8384	0.0	0.0
chr22	ATP6V1E1	17601091	17601181	0	91	54863	3153	54863	3062	0.0	17.917374265186155
chr22	ATP6V1E1	17619460	17619526	7338	67	54863	3153	47525	3086	109.5223880597015	15.400194426441995
chr22	ATP6V1E1	17619033	17619127	18411	95	54863	3153	36452	3058	193.8	11.920209287115762
chr22	BID	17743802	17744013	0	212	459	4429	459	4217	0.0	0.10884515058098174
chr22	BID	17750104	17750174	0	71	459	4429	459	4358	0.0	0.10532354290959156
chr22	BID	17740081	17740176	0	96	459	4429	459	4333	0.0	0.10593122547888299
chr22	MICAL3	17827643	17827781	0	139	439	22491	439	22352	0.0	0.019640300644237652
chr22	MICAL3	17899447	17899548	0	102	439	22491	439	22389	0.0	0.0196078431372549
chr22	MICAL3	17830066	17830154	0	89	439	22491	439	22402	0.0	0.019596464601374878
chr22	MICAL3	17803810	17803861	0	52	439	22491	439	22439	0.0	0.019564151700164893
chr22	MICAL3	17812506	17812557	0	52	439	22491	439	22439	0.0	0.019564151700164893
chr22	MICAL3	17793728	17793794	0	67	439	22491	439	22424	0.0	0.01957723867285052
chr22	MICAL3	17826453	17826516	0	64	439	22491	439	22427	0.0	0.019574619877825834
chr22	MICAL3	17884274	17884358	26	85	439	22491	413	22406	0.3058823529411765	0.018432562706417924
chr22	FAM230J	18368390	18370713	92953	2324	95919	4160	2966	1836	39.99698795180723	1.6154684095860568
chr22	PRODH	18923114	18923179	0	66	232	7184	232	7118	0.0	0.03259342511941556
chr22	PRODH	18930989	18931198	80	210	232	7184	152	6974	0.38095238095238093	0.021795239460854602
chr22	PRODH	18936014	18936327	0	314	232	7184	232	6870	0.0	0.033770014556040756
chr22	DGCR2	19089367	19089490	714	124	2547	5617	1833	5493	5.758064516129032	0.3336974330966685
chr22	DGCR2	19060565	19060955	0	391	2547	5617	2547	5226	0.0	0.4873708381171068
chr22	CLTCL1	19187980	19188091	0	112	20799	6720	20799	6608	0.0	3.147548426150121
chr22	CLTCL1	19208153	19208311	0	159	20799	6720	20799	6561	0.0	3.1700960219478738
chr22	CLTCL1	19225452	19225633	0	182	20799	6720	20799	6538	0.0	3.1812480881003364
chr22	CLTCL1	19187557	19187728	51	172	20799	6720	20748	6548	0.29651162790697677	3.1686010995723883
chr22	CLTCL1	19184395	19184536	0	142	20799	6720	20799	6578	0.0	3.161903314077227
chr22	CLTCL1	19257804	19257867	0	64	20799	6720	20799	6656	0.0	3.1248497596153846
chr22	HIRA	19355759	19355865	0	107	45793	4326	45793	4219	0.0	10.853993837402228
chr22	UFD1	19475067	19475100	0	34	125232	7600	125232	7566	0.0	16.551942902458368
chr22	UFD1	19475469	19475602	255	134	125232	7600	124977	7466	1.9029850746268657	16.739485668363248
chr22	UFD1	19471686	19471808	0	123	125232	7600	125232	7477	0.0	16.748963488029958
chr22	GNB1L	19820597	19820723	0	127	6073	1660	6073	1533	0.0	3.9615133724722766
chr22	GNB1L	19821227	19821375	0	149	6073	1660	6073	1511	0.0	4.019192587690271
chr22	TXNRD2	19880621	19880717	336	97	10718	6767	10382	6670	3.463917525773196	1.5565217391304347
chr22	TXNRD2	19919542	19919599	0	58	10718	6767	10718	6709	0.0	1.5975555224325533
chr22	TXNRD2	19931029	19931095	214	67	10718	6767	10504	6700	3.1940298507462686	1.5677611940298508
chr22	TXNRD2	19931029	19931098	235	70	10718	6767	10483	6697	3.357142857142857	1.5653277586979244
chr22	TXNRD2	19880855	19880945	131	91	10718	6767	10587	6676	1.4395604395604396	1.5858298382264828
chr22	ARVCF	19971215	19971335	65	121	7518	5658	7453	5537	0.5371900826446281	1.346035759436518
chr22	ARVCF	19976705	19976723	0	19	7518	5658	7518	5639	0.0	1.3332151090618904
chr22	AC006547.1	20067013	20067249	0	237	28583	2243	28583	2006	0.0	14.248753738783648
chr22	AC006547.1	20069042	20069164	2822	123	28583	2243	25761	2120	22.943089430894307	12.151415094339622
chr22	DGCR6L	20316118	20316219	332	102	2374	1197	2042	1095	3.2549019607843137	1.8648401826484018
chr22	KLHL22	20488984	20489244	0	261	1596	4144	1596	3883	0.0	0.411022405356683
chr22	KLHL22	20488984	20489212	0	229	1596	4144	1596	3915	0.0	0.4076628352490421
chr22	KLHL22	20493147	20493217	0	71	1596	4144	1596	4073	0.0	0.39184876012767
chr22	KLHL22	20471349	20471515	0	167	1596	4144	1596	3977	0.0	0.40130751822982147
chr22	SMPD4P1	20621262	20621417	0	156	0	3882	0	3726	0.0	0.0
chr22	SMPD4P1	20624098	20624185	0	88	0	3882	0	3794	0.0	0.0
chr22	TUBA3FP	21013041	21013184	0	144	0	2126	0	1982	0.0	0.0
chr22	TUBA3FP	21012526	21012658	0	133	0	2126	0	1993	0.0	0.0
chr22	FAM230H	21307558	21309524	162023	1967	267694	5886	105671	3919	82.37061514997458	26.963766266904823
chr22	FAM230H	21321591	21321719	0	129	267694	5886	267694	5757	0.0	46.49887093972555
chr22	PI4KAP2	21476643	21476764	0	122	3632	6796	3632	6674	0.0	0.544201378483668
chr22	YDJC	21629009	21629187	0	179	0	1668	0	1489	0.0	0.0
chr22	MAPK1	21788256	21788388	0	133	414	6188	414	6055	0.0	0.06837324525185796
chr22	TOP3B	21970979	21971061	654	83	354925	6344	354271	6261	7.879518072289157	56.58377256029388
chr22	TOP3B	21975904	21975953	8930	50	354925	6344	345995	6294	178.6	54.972195741976485
chr22	TOP3B	21982413	21982449	12498	37	354925	6344	342427	6307	337.7837837837838	54.29316632313303
chr22	TOP3B	21975980	21976187	108091	208	354925	6344	246834	6136	519.6682692307693	40.22718383311604
chr22	TOP3B	21975904	21976187	134679	284	354925	6344	220246	6060	474.2218309859155	36.344224422442245
chr22	PRAME	22556811	22556909	0	99	612	3814	612	3715	0.0	0.16473755047106325
chr22	PRAME	22556811	22556930	0	120	612	3814	612	3694	0.0	0.165674066053059
chr22	PRAME	22556811	22556977	0	167	612	3814	612	3647	0.0	0.16780915821222922
chr22	PRAME	22556811	22557086	0	276	612	3814	612	3538	0.0	0.17297908422837763
chr22	PRAME	22552808	22552951	0	144	612	3814	612	3670	0.0	0.1667574931880109
chr22	CES5AP1	23368779	23368884	0	106	0	1570	0	1464	0.0	0.0
chr22	ZDHHC8P1	23402036	23402155	0	120	71	3277	71	3157	0.0	0.022489705416534684
chr22	ZDHHC8P1	23401840	23401953	20	114	71	3277	51	3163	0.17543859649122806	0.01612393297502371
chr22	IGLL1	23574966	23575082	0	117	0	901	0	784	0.0	0.0
chr22	IGLL1	23574966	23575085	0	120	0	901	0	781	0.0	0.0
chr22	GUSBP11	23683724	23683867	0	144	8836	7702	8836	7558	0.0	1.1690923524741996
chr22	GUSBP11	23686830	23686995	0	166	8836	7702	8836	7536	0.0	1.1725053078556262
chr22	GUSBP11	23640307	23640423	0	117	8836	7702	8836	7585	0.0	1.1649307844429795
chr22	GUSBP11	23700725	23700845	0	121	8836	7702	8836	7581	0.0	1.1655454425537528
chr22	GUSBP11	23686837	23686995	0	159	8836	7702	8836	7543	0.0	1.171417208007424
chr22	CHCHD10	23767373	23767593	0	221	0	893	0	672	0.0	0.0
chr22	CHCHD10	23767373	23767540	0	168	0	893	0	725	0.0	0.0
chr22	GSTT4	24001174	24001325	993	152	7284	1112	6291	960	6.532894736842105	6.553125
chr22	GSTT4	24004180	24004322	165	143	7284	1112	7119	969	1.1538461538461537	7.3467492260061915
chr22	GGT5	24233873	24234004	235	132	37885	2603	37650	2471	1.7803030303030303	15.236746256576286
chr22	GGT5	24220491	24220584	487	94	37885	2603	37398	2509	5.180851063829787	14.905540055799124
chr22	GGT5	24233497	24233593	1631	97	37885	2603	36254	2506	16.814432989690722	14.466879489225859
chr22	ADORA2A-AS1	24460452	24460771	20582	320	38630	4042	18048	3722	64.31875	4.849005910800645
chr22	ADORA2A-AS1	24471767	24471895	0	129	38630	4042	38630	3913	0.0	9.872220802453361
chr22	ADORA2A-AS1	24439293	24439567	13064	275	38630	4042	25566	3767	47.50545454545455	6.786833023626228
chr22	ADORA2A-AS1	24452210	24452328	0	119	38630	4042	38630	3923	0.0	9.847055824624013
chr22	GUCD1	24543841	24544083	0	243	2858	4101	2858	3858	0.0	0.7407983411093831
chr22	GUCD1	24554948	24555136	0	189	2858	4101	2858	3912	0.0	0.7305725971370143
chr22	LRRC75B	24588678	24589265	255	588	306	2629	51	2041	0.4336734693877551	0.024987751102400785
chr22	LRRC75B	24592216	24592423	0	208	306	2629	306	2421	0.0	0.12639405204460966
chr22	PIWIL3	24761878	24761961	0	84	528	3826	528	3742	0.0	0.14110101549973275
chr22	PIWIL3	24769670	24769789	0	120	528	3826	528	3706	0.0	0.14247166756610902
chr22	LRP5L	25361208	25361319	125	112	2058	3674	1933	3562	1.1160714285714286	0.5426726558113419
chr22	MYO18B-AS1	25895110	25895268	0	159	3091	5997	3091	5838	0.0	0.5294621445700582
chr22	MYO18B-AS1	25898383	25898441	0	59	3091	5997	3091	5938	0.0	0.5205456382620411
chr22	MYO18B-AS1	25900269	25900329	0	61	3091	5997	3091	5936	0.0	0.5207210242587601
chr22	MYO18B-AS1	25895337	25895498	0	162	3091	5997	3091	5835	0.0	0.5297343616109683
chr22	MYO18B-AS1	25895110	25895370	0	261	3091	5997	3091	5736	0.0	0.5388772663877266
chr22	MYO18B-AS1	25899715	25899884	0	170	3091	5997	3091	5827	0.0	0.5304616440707053
chr22	HPS4	26479264	26479355	0	92	0	7752	0	7660	0.0	0.0
chr22	HPS4	26466050	26466104	0	55	0	7752	0	7697	0.0	0.0
chr22	HPS4	26471212	26471388	0	177	0	7752	0	7575	0.0	0.0
chr22	HPS4	26471212	26471288	0	77	0	7752	0	7675	0.0	0.0
chr22	TFIP11	26510616	26510702	0	87	0	5452	0	5365	0.0	0.0
chr22	TFIP11	26511118	26511195	0	78	0	5452	0	5374	0.0	0.0
chr22	TFIP11	26511118	26511153	0	36	0	5452	0	5416	0.0	0.0
chr22	TFIP11	26510616	26510692	0	77	0	5452	0	5375	0.0	0.0
chr22	TFIP11	26511118	26511317	0	200	0	5452	0	5252	0.0	0.0
chr22	TPST2	26544603	26544675	0	73	0	6926	0	6853	0.0	0.0
chr22	TPST2	26543107	26543277	0	171	0	6926	0	6755	0.0	0.0
chr22	TPST2	26547499	26547618	0	120	0	6926	0	6806	0.0	0.0
chr22	PITPNB	27854853	27854939	0	87	0	5142	0	5055	0.0	0.0
chr22	TTC28	27990788	27990812	0	25	1663	12670	1663	12645	0.0	0.13151443258204823
chr22	CHEK2	28696900	28696987	0	88	1581	4425	1581	4337	0.0	0.3645376988701868
chr22	CHEK2	28703504	28703566	0	63	1581	4425	1581	4362	0.0	0.3624484181568088
chr22	CHEK2	28719394	28719485	0	92	1581	4425	1581	4333	0.0	0.3648742210939303
chr22	CHEK2	28734402	28734727	0	326	1581	4425	1581	4099	0.0	0.3857038302024884
chr22	CHEK2	28721517	28721631	0	115	1581	4425	1581	4310	0.0	0.3668213457076566
chr22	CHEK2	28737884	28738038	0	155	1581	4425	1581	4270	0.0	0.3702576112412178
chr22	CHEK2	28730419	28730548	0	130	1581	4425	1581	4295	0.0	0.3681024447031432
chr22	CHEK2	28738081	28738197	0	117	1581	4425	1581	4308	0.0	0.366991643454039
chr22	CHEK2	28730455	28730548	0	94	1581	4425	1581	4331	0.0	0.3650427153082429
chr22	AP1B1	29329711	29329720	0	10	5159	5928	5159	5918	0.0	0.8717472118959108
chr22	AP1B1	29339753	29339774	0	22	5159	5928	5159	5906	0.0	0.8735184558076532
chr22	RFPL1S	29472305	29472446	0	142	7188	3117	7188	2975	0.0	2.416134453781513
chr22	RFPL1S	29472305	29472449	0	145	7188	3117	7188	2972	0.0	2.4185733512786003
chr22	THOC5	29531830	29531963	0	134	5726	7903	5726	7769	0.0	0.7370317930235551
chr22	THOC5	29550727	29550843	0	117	5726	7903	5726	7786	0.0	0.7354225533007963
chr22	THOC5	29528273	29528359	0	87	5726	7903	5726	7816	0.0	0.7325997952917093
chr22	THOC5	29531077	29531110	0	34	5726	7903	5726	7869	0.0	0.7276655229381116
chr22	NIPSNAP1	29580098	29580155	0	58	200	2996	200	2938	0.0	0.06807351940095303
chr22	NIPSNAP1	29564237	29564371	200	135	200	2996	0	2861	1.4814814814814814	0.0
chr22	ASCC2	29832244	29832342	0	99	9396	5178	9396	5079	0.0	1.849970466627289
chr22	ASCC2	29825621	29825780	0	160	9396	5178	9396	5018	0.0	1.872459147070546
chr22	ASCC2	29827476	29827600	0	125	9396	5178	9396	5053	0.0	1.8594894122303582
chr22	ASCC2	29834488	29834550	0	63	9396	5178	9396	5115	0.0	1.836950146627566
chr22	ASCC2	29833540	29833614	0	75	9396	5178	9396	5103	0.0	1.8412698412698412
chr22	ASCC2	29836437	29836500	0	64	9396	5178	9396	5114	0.0	1.8373093468908877
chr22	HORMAD2-AS1	30040176	30040278	22	103	3613	1445	3591	1342	0.21359223300970873	2.6758569299552906
chr22	LIF	30244754	30244933	0	180	0	3874	0	3694	0.0	0.0
chr22	OSM	30265001	30265144	0	144	0	2129	0	1985	0.0	0.0
chr22	CASTOR1	30286262	30286376	0	115	508	2662	508	2547	0.0	0.1994503337259521
chr22	CASTOR1	30288705	30288776	0	72	508	2662	508	2590	0.0	0.19613899613899613
chr22	TBC1D10A	30292772	30292851	0	80	1145	4998	1145	4918	0.0	0.23281821878812525
chr22	CASTOR1	30287789	30287862	0	74	508	2662	508	2588	0.0	0.19629057187017002
chr22	TBC1D10A	30304530	30304630	0	101	1145	4998	1145	4897	0.0	0.23381662242189094
chr22	TBC1D10A	30304530	30304651	0	122	1145	4998	1145	4876	0.0	0.2348236259228876
chr22	TBC1D10A	30293158	30293319	51	162	1145	4998	1094	4836	0.3148148148148148	0.22622001654259719
chr22	RNF215	30379481	30379622	0	142	36315	5055	36315	4913	0.0	7.391614085080399
chr22	RNF215	30379547	30379622	0	76	36315	5055	36315	4979	0.0	7.293633259690701
chr22	SEC14L3	30470211	30470255	0	45	0	3646	0	3601	0.0	0.0
chr22	SEC14L3	30471159	30471207	0	49	0	3646	0	3597	0.0	0.0
chr22	SEC14L3	30468788	30468958	0	171	0	3646	0	3475	0.0	0.0
chr22	SEC14L3	30471159	30471277	0	119	0	3646	0	3527	0.0	0.0
chr22	SEC14L4	30495741	30495790	0	50	0	2154	0	2104	0.0	0.0
chr22	SEC14L6	30525349	30525519	0	171	204	3404	204	3233	0.0	0.06309928858645221
chr22	GAL3ST1	30558278	30558388	0	111	14	3105	14	2994	0.0	0.004676018704074816
chr22	GAL3ST1	30558259	30558388	0	130	14	3105	14	2975	0.0	0.004705882352941176
chr22	GAL3ST1	30563229	30563278	0	50	14	3105	14	3055	0.0	0.004582651391162029
chr22	GAL3ST1	30560276	30560418	0	143	14	3105	14	2962	0.0	0.004726536124240378
chr22	GAL3ST1	30565076	30565201	0	126	14	3105	14	2979	0.0	0.004699563611950319
chr22	DUSP18	30663012	30663260	0	249	495	2739	495	2490	0.0	0.19879518072289157
chr22	DUSP18	30663403	30664080	0	678	495	2739	495	2061	0.0	0.24017467248908297
chr22	DUSP18	30664954	30665121	0	168	495	2739	495	2571	0.0	0.19253208868144692
chr22	MORC2	30927529	30927803	0	275	10186	8653	10186	8378	0.0	1.2158032943423251
chr22	MORC2	30933693	30933777	0	85	10186	8653	10186	8568	0.0	1.188842203548086
chr22	PIK3IP1	31289314	31289393	0	80	6980	3646	6980	3566	0.0	1.957375210319686
chr22	PATZ1	31328786	31328924	10248	139	52139	5813	41891	5674	73.72661870503597	7.382974973563623
chr22	PATZ1	31328786	31328859	0	74	52139	5813	52139	5739	0.0	9.085032235581112
chr22	EIF4ENIF1	31450288	31450360	0	73	862	5677	862	5604	0.0	0.15381870092790864
chr22	EIF4ENIF1	31446937	31447008	0	72	862	5677	862	5605	0.0	0.15379125780553077
chr22	PISD	31620552	31620713	0	162	8238	4943	8238	4781	0.0	1.7230704873457436
chr22	PISD	31650698	31650778	0	81	8238	4943	8238	4862	0.0	1.6943644590703415
chr22	PISD	31628002	31628210	0	209	8238	4943	8238	4734	0.0	1.7401774397972116
chr22	PISD	31625762	31626016	201	255	8238	4943	8037	4688	0.788235294117647	1.714377133105802
chr22	PISD	31620552	31620599	0	48	8238	4943	8238	4895	0.0	1.6829417773237998
chr22	PISD	31632182	31632291	0	110	8238	4943	8238	4833	0.0	1.7045313469894476
chr22	PRR14L	31701655	31701762	46	108	28159	11816	28113	11708	0.42592592592592593	2.4011786812435942
chr22	PRR14L	31738386	31738911	13166	526	28159	11816	14993	11290	25.03041825095057	1.3279893711248894
chr22	C22ORF24	31927093	31927291	1042	199	2613	5555	1571	5356	5.236180904522613	0.2933159073935773
chr22	C22ORF24	31927098	31927310	727	213	2613	5555	1886	5342	3.4131455399061035	0.353051291651067
chr22	C22ORF24	31927093	31927310	1042	218	2613	5555	1571	5337	4.779816513761468	0.29436012741240397
chr22	RFPL2	32194344	32194490	0	147	1887	2941	1887	2794	0.0	0.6753758052970651
chr22	RFPL2	32194344	32194398	0	55	1887	2941	1887	2886	0.0	0.6538461538461539
chr22	RFPL3S	32362971	32363058	3	88	255	6910	252	6822	0.03409090909090909	0.036939313984168866
chr22	RFPL3S	32370898	32370941	0	44	255	6910	255	6866	0.0	0.0371395281095252
chr22	BPIFC	32432372	32432543	0	172	779796	2245	779796	2073	0.0	376.16787264833573
chr22	BPIFC	32461573	32461661	0	89	779796	2245	779796	2156	0.0	361.6864564007421
chr22	SYN3	32527917	32528005	0	89	23	10207	23	10118	0.0	0.0022731765170982405
chr22	LARGE1	33304228	33304507	0	280	0	14082	0	13802	0.0	0.0
chr22	LARGE1	33316084	33316248	0	165	0	14082	0	13917	0.0	0.0
chr22	LARGE1	33337645	33337801	0	157	0	14082	0	13925	0.0	0.0
chr22	LARGE1	33381918	33382044	0	127	0	14082	0	13955	0.0	0.0
chr22	LARGE1	33283201	33283348	0	148	0	14082	0	13934	0.0	0.0
chr22	LARGE1	33305531	33305625	0	95	0	14082	0	13987	0.0	0.0
chr22	LARGE1	33761370	33761558	0	189	0	14082	0	13893	0.0	0.0
chr22	LARGE1	33856739	33856802	0	64	0	14082	0	14018	0.0	0.0
chr22	LARGE1	33291968	33293173	0	1206	0	14082	0	12876	0.0	0.0
chr22	MB	35621965	35622096	0	132	0	2060	0	1928	0.0	0.0
chr22	RBFOX2	35778024	35778078	1417	55	320528	10064	319111	10009	25.763636363636362	31.882405834748727
chr22	RBFOX2	35756104	35756144	0	41	320528	10064	320528	10023	0.0	31.979247730220493
chr22	RBFOX2	35750425	35750457	0	33	320528	10064	320528	10031	0.0	31.95374339547403
chr22	RBFOX2	35752612	35752655	0	44	320528	10064	320528	10020	0.0	31.98882235528942
chr22	RBFOX2	35836319	35836439	0	121	320528	10064	320528	9943	0.0	32.2365483254551
chr22	APOL3	36149045	36149142	0	98	118729	5914	118729	5816	0.0	20.414202200825308
chr22	APOL3	36149258	36149371	1275	114	118729	5914	117454	5800	11.18421052631579	20.250689655172415
chr22	APOL3	36149045	36149371	3519	327	118729	5914	115210	5587	10.761467889908257	20.62108466081976
chr22	APOL3	36161483	36161546	19630	64	118729	5914	99099	5850	306.71875	16.94
chr22	APOL3	36156843	36157006	255	164	118729	5914	118474	5750	1.5548780487804879	20.60417391304348
chr22	APOL3	36149045	36149185	1672	141	118729	5914	117057	5773	11.858156028368795	20.276632600034645
chr22	APOL3	36146139	36146408	2471	270	118729	5914	116258	5644	9.151851851851852	20.598511693834162
chr22	APOL3	36153284	36153423	267	140	118729	5914	118462	5774	1.9071428571428573	20.516453065465882
chr22	APOL3	36149770	36149964	15	195	118729	5914	118714	5719	0.07692307692307693	20.7578247945445
chr22	APOL4	36201992	36202055	110	64	1173	4268	1063	4204	1.71875	0.2528544243577545
chr22	APOL4	36201699	36201888	561	190	1173	4268	612	4078	2.9526315789473685	0.15007356547327122
chr22	APOL4	36201699	36202055	1122	357	1173	4268	51	3911	3.142857142857143	0.013040143185885963
chr22	APOL4	36201699	36201796	561	98	1173	4268	612	4170	5.724489795918367	0.14676258992805755
chr22	APOL4	36201699	36201841	561	143	1173	4268	612	4125	3.923076923076923	0.14836363636363636
chr22	APOL4	36199555	36199608	0	54	1173	4268	1173	4214	0.0	0.2783578547698149
chr22	APOL2	36237060	36237185	0	126	154478	3251	154478	3125	0.0	49.43296
chr22	APOL2	36234235	36234335	152234	101	154478	3251	2244	3150	1507.2673267326732	0.7123809523809523
chr22	MYH9	36364778	36364833	0	56	12156	8953	12156	8897	0.0	1.3663032482859392
chr22	TXN2	36468601	36468717	0	117	0	1656	0	1539	0.0	0.0
chr22	EIF3D	36526819	36526905	0	87	5611	3779	5611	3692	0.0	1.5197724810400868
chr22	IFT27	36760843	36760919	1591	77	8216	3881	6625	3804	20.662337662337663	1.7415878023133544
chr22	IFT27	36767982	36768099	663	118	8216	3881	7553	3763	5.61864406779661	2.0071751262290727
chr22	PVALB	36811474	36811524	1033	51	408912	1058	407879	1007	20.254901960784313	405.0436941410129
chr22	TMPRSS6	37068615	37068681	0	67	0	4253	0	4186	0.0	0.0
chr22	IL2RB	37161792	37161983	953	192	1646	4633	693	4441	4.963541666666667	0.15604593560009006
chr22	C1QTNF6	37184336	37184437	0	102	51	3780	51	3678	0.0	0.013866231647634585
chr22	RAC2	37244113	37244202	0	90	0	2531	0	2441	0.0	0.0
chr22	MFNG	37472442	37472528	0	87	0	3033	0	2946	0.0	0.0
chr22	MFNG	37480720	37480769	0	50	0	3033	0	2983	0.0	0.0
chr22	ANKRD54	37832957	37833082	0	126	0	4400	0	4274	0.0	0.0
chr22	ANKRD54	37838499	37838598	0	100	0	4400	0	4300	0.0	0.0
chr22	ANKRD54	37840186	37840234	0	49	0	4400	0	4351	0.0	0.0
chr22	ANKRD54	37838499	37838593	0	95	0	4400	0	4305	0.0	0.0
chr22	C22ORF23	37951459	37951522	0	64	306	2290	306	2226	0.0	0.13746630727762804
chr22	SOX10	37983356	37983868	51	513	1071	3734	1020	3221	0.09941520467836257	0.3166718410431543
chr22	BAIAP2L2	38085685	38085732	0	48	14612	2163	14612	2115	0.0	6.908747044917257
chr22	PLA2G6	38128268	38128430	687	163	28177	8089	27490	7926	4.214723926380368	3.4683320716628816
chr22	PLA2G6	38139981	38140169	0	189	28177	8089	28177	7900	0.0	3.5667088607594937
chr22	PLA2G6	38143104	38143288	724	185	28177	8089	27453	7904	3.9135135135135135	3.4733046558704452
chr22	PLA2G6	38145437	38145653	196	217	28177	8089	27981	7872	0.9032258064516129	3.5544969512195124
chr22	PLA2G6	38114433	38114570	0	138	28177	8089	28177	7951	0.0	3.5438309646585333
chr22	PLA2G6	38125638	38125691	278	54	28177	8089	27899	8035	5.148148148148148	3.472184194150591
chr22	PLA2G6	38148492	38148623	51	132	28177	8089	28126	7957	0.38636363636363635	3.5347492773658415
chr22	PLA2G6	38147349	38147475	0	127	28177	8089	28177	7962	0.0	3.5389349409696056
chr22	PLA2G6	38114433	38114637	0	205	28177	8089	28177	7884	0.0	3.573947234906139
chr22	PLA2G6	38116319	38116410	0	92	28177	8089	28177	7997	0.0	3.523446292359635
chr22	PLA2G6	38127406	38127458	0	53	28177	8089	28177	8036	0.0	3.5063464410154306
chr22	TMEM184B	38230668	38230744	0	77	74129	6174	74129	6097	0.0	12.158274561259637
chr22	TMEM184B	38246784	38246885	0	102	74129	6174	74129	6072	0.0	12.208333333333334
chr22	TMEM184B	38222641	38222662	0	22	74129	6174	74129	6152	0.0	12.049577373211964
chr22	TMEM184B	38246805	38246885	0	81	74129	6174	74129	6093	0.0	12.166256359757098
chr22	CSNK1E	38295386	38295447	0	62	10872	6057	10872	5995	0.0	1.813511259382819
chr22	TPTEP2	38347488	38347585	2244	98	34952	3870	32708	3772	22.897959183673468	8.671261930010605
chr22	TPTEP2	38369985	38370045	0	61	34952	3870	34952	3809	0.0	9.176161722236808
chr22	TPTEP2	38363053	38363104	0	52	34952	3870	34952	3818	0.0	9.154531168150864
chr22	DDX17	38489227	38489458	0	232	51999	8894	51999	8662	0.0	6.003117063033941
chr22	FAM227A	38639654	38639724	162	71	3162	3270	3000	3199	2.2816901408450705	0.9377930603313536
chr22	JOSD1	38689295	38689424	14696	130	395937	4226	381241	4096	113.04615384615384	93.076416015625
chr22	SUN2	38750897	38751035	0	139	17333	6389	17333	6250	0.0	2.77328
chr22	SUN2	38754641	38754706	261	66	17333	6389	17072	6323	3.9545454545454546	2.699984184722442
chr22	CBX7	39141370	39141436	59	67	271219	4555	271160	4488	0.8805970149253731	60.41889483065954
chr22	RPS19BP1	39530463	39530554	2931	92	76538	2963	73607	2871	31.858695652173914	25.63810518982933
chr22	MRTFA	40423535	40423685	0	151	0	7572	0	7421	0.0	0.0
chr22	MRTFA	40594673	40594735	0	63	0	7572	0	7509	0.0	0.0
chr22	MRTFA	40519463	40519612	0	150	0	7572	0	7422	0.0	0.0
chr22	SLC25A17	40794513	40794580	48	68	4692	3372	4644	3304	0.7058823529411765	1.4055690072639224
chr22	SLC25A17	40779757	40779894	0	138	4692	3372	4692	3234	0.0	1.450834879406308
chr22	SLC25A17	40792524	40792676	0	153	4692	3372	4692	3219	0.0	1.4575955265610439
chr22	SLC25A17	40776189	40776308	1530	120	4692	3372	3162	3252	12.75	0.9723247232472325
chr22	SLC25A17	40799022	40799040	133	19	4692	3372	4559	3353	7.0	1.3596779003877124
chr22	SLC25A17	40797283	40797336	518	54	4692	3372	4174	3318	9.592592592592593	1.2579867389993973
chr22	SLC25A17	40799022	40799083	238	62	4692	3372	4454	3310	3.838709677419355	1.345619335347432
chr22	SLC25A17	40784512	40784604	0	93	4692	3372	4692	3279	0.0	1.4309240622140897
chr22	SLC25A17	40797253	40797336	714	84	4692	3372	3978	3288	8.5	1.2098540145985401
chr22	SLC25A17	40799560	40799671	643	112	4692	3372	4049	3260	5.741071428571429	1.2420245398773007
chr22	ST13	40832568	40832671	0	104	36649	3646	36649	3542	0.0	10.346979107848673
chr22	ST13	40832086	40832216	7	131	36649	3646	36642	3515	0.05343511450381679	10.424466571834992
chr22	L3MBTL2-AS1	41213629	41214703	2263	1075	13133	4463	10870	3388	2.1051162790697675	3.208382526564345
chr22	L3MBTL2-AS1	41213795	41214703	2091	909	13133	4463	11042	3554	2.3003300330033003	3.1069217782779965
chr22	RANGAP1	41261445	41261580	102	136	24986	5891	24884	5755	0.75	4.323892267593397
chr22	POLR3H	41532658	41532745	0	88	36457	6368	36457	6280	0.0	5.805254777070064
chr22	POLR3H	41540698	41540795	55	98	36457	6368	36402	6270	0.5612244897959183	5.8057416267942585
chr22	POLR3H	41532603	41532745	0	143	36457	6368	36457	6225	0.0	5.8565461847389555
chr22	POLR3H	41533521	41533687	3850	167	36457	6368	32607	6201	23.05389221556886	5.2583454281567485
chr22	PMM1	41589051	41589163	0	113	6586	4510	6586	4397	0.0	1.4978394359790765
chr22	SNU13	41682355	41682587	1521	233	35940	2935	34419	2702	6.527896995708154	12.738341968911918
chr22	SNU13	41688078	41688327	51	250	35940	2935	35889	2685	0.204	13.366480446927374
chr22	SNU13	41688151	41688327	51	177	35940	2935	35889	2758	0.288135593220339	13.01269035532995
chr22	SNU13	41687721	41688327	153	607	35940	2935	35787	2328	0.25205930807248766	15.37242268041237
chr22	SNU13	41688793	41688981	0	189	35940	2935	35940	2746	0.0	13.088128186453023
chr22	CENPM	41943609	41943701	0	93	19374	1757	19374	1664	0.0	11.643028846153847
chr22	CYP2D6	42129032	42129185	0	154	102	1726	102	1572	0.0	0.0648854961832061
chr22	CYP2D7	42142727	42142880	0	154	176	3408	176	3254	0.0	0.054087277197295634
chr22	TCF20	42168608	42168736	0	129	15841	8217	15841	8088	0.0	1.9585806132542039
chr22	TCF20	42168608	42168703	0	96	15841	8217	15841	8121	0.0	1.9506218446004187
chr22	RRP7A	42518612	42518728	0	117	3555	5708	3555	5591	0.0	0.6358433196208192
chr22	POLDIP3	42601969	42602056	0	88	2202	3658	2202	3570	0.0	0.6168067226890757
chr22	POLDIP3	42601969	42602107	0	139	2202	3658	2202	3519	0.0	0.6257459505541347
chr22	CYB5R3	42646640	42646701	76	62	4528	5573	4452	5511	1.2258064516129032	0.8078388677191073
chr22	ARFGAP3	42810812	42810944	0	133	1195	3290	1195	3157	0.0	0.37852391510928096
chr22	ARFGAP3	42835361	42835493	0	133	1195	3290	1195	3157	0.0	0.37852391510928096
chr22	ARFGAP3	42834241	42834325	940	85	1195	3290	255	3205	11.058823529411764	0.07956318252730109
chr22	PACSIN2	42876887	42877010	0	124	62413	4388	62413	4264	0.0	14.637195121951219
chr22	PACSIN2	42880616	42880622	0	7	62413	4388	62413	4381	0.0	14.246290801186944
chr22	PACSIN2	42993619	42993780	1146	162	62413	4388	61267	4226	7.074074074074074	14.497633696166588
chr22	TTLL1	43051800	43051887	0	88	5677	1880	5677	1792	0.0	3.16796875
chr22	TTLL1	43070170	43070242	0	73	5677	1880	5677	1807	0.0	3.141671278361926
chr22	MCAT	43137080	43137298	0	219	0	2393	0	2174	0.0	0.0
chr22	SCUBE1	43255487	43255577	0	91	42504	5437	42504	5346	0.0	7.950617283950617
chr22	EFCAB6	43615825	43615922	0	98	44141	8593	44141	8495	0.0	5.1961153619776335
chr22	EFCAB6	43772891	43773103	0	213	44141	8593	44141	8380	0.0	5.267422434367542
chr22	EFCAB6	43782179	43782325	0	147	44141	8593	44141	8446	0.0	5.226260951929907
chr22	SULT4A1	43841801	43841932	0	132	0	2867	0	2735	0.0	0.0
chr22	SULT4A1	43827513	43827640	0	128	0	2867	0	2739	0.0	0.0
chr22	PHF21B	44933472	44933518	0	47	25359	5722	25359	5675	0.0	4.468546255506608
chr22	KIAA0930	45207572	45207772	0	201	51	8069	51	7868	0.0	0.006481952211489578
chr22	KIAA0930	45226151	45226383	0	233	51	8069	51	7836	0.0	0.006508422664624809
chr22	BX324167.1	45877213	45877360	0	148	0	991	0	843	0.0	0.0
chr22	CDPF1	46248171	46248284	288	114	492	1642	204	1528	2.526315789473684	0.13350785340314136
chr22	CDPF1	46246672	46246795	0	124	492	1642	492	1518	0.0	0.3241106719367589
chr22	CDPF1	46247109	46247221	0	113	492	1642	492	1529	0.0	0.32177894048397643
chr22	CERK	46711085	46711149	0	65	92356	4945	92356	4880	0.0	18.925409836065572
chr22	LINC00898	47627161	47627242	0	82	756	4992	756	4910	0.0	0.1539714867617108
chr22	Z84468.2	48476309	48476411	0	103	51	2513	51	2410	0.0	0.02116182572614108
chr22	AL078622.1	49049394	49049463	0	70	0	3815	0	3745	0.0	0.0
chr22	AL078622.1	49049394	49049546	0	153	0	3815	0	3662	0.0	0.0
chr22	AL078622.1	49049394	49049460	0	67	0	3815	0	3748	0.0	0.0
chr22	C22ORF34	49416601	49416735	0	135	0	6782	0	6647	0.0	0.0
chr22	MLC1	50083083	50083173	0	91	2040	3835	2040	3744	0.0	0.5448717948717948
chr22	HDAC10	50247691	50247776	0	86	5812	4150	5812	4064	0.0	1.4301181102362204
chr22	HDAC10	50248830	50248890	416	61	5812	4150	5396	4089	6.819672131147541	1.3196380533137686
chr22	HDAC10	50248365	50248472	51	108	5812	4150	5761	4042	0.4722222222222222	1.425284512617516
chr22	HDAC10	50250426	50250523	0	98	5812	4150	5812	4052	0.0	1.4343534057255676
chr22	HDAC10	50248830	50248859	0	30	5812	4150	5812	4120	0.0	1.4106796116504854
chr22	MAPK12	50256934	50256964	17	31	12822	9010	12805	8979	0.5483870967741935	1.4261053569439803
chr22	HDAC10	50248661	50248751	768	91	5812	4150	5044	4059	8.43956043956044	1.2426706085242671
chr22	MAPK12	50257081	50257193	0	113	12822	9010	12822	8897	0.0	1.4411599415533325
chr22	MAPK11	50267568	50267627	0	60	3151	2698	3151	2638	0.0	1.1944655041698256
chr22	PLXNB2	50282183	50282313	1255	131	348220	7083	346965	6952	9.580152671755725	49.908659378596084
chr22	PLXNB2	50284844	50284913	942	70	348220	7083	347278	7013	13.457142857142857	49.51917866818765
chr22	DENND6B	50316565	50316626	0	62	74838	5745	74838	5683	0.0	13.168748900228753
chr22	DENND6B	50316565	50316712	0	148	74838	5745	74838	5597	0.0	13.371091656244417
chr22	SBF1	50457033	50457111	0	79	603	9490	603	9411	0.0	0.06407395600892572
chr22	TYMP	50526000	50526141	0	142	102	1961	102	1819	0.0	0.056074766355140186
chr22	TYMP	50527164	50527283	96	120	102	1961	6	1841	0.8	0.0032590983161325366
chr22	TYMP	50528511	50528610	0	100	102	1961	102	1861	0.0	0.054809242342826435
chr22	TYMP	50526000	50526156	0	157	102	1961	102	1804	0.0	0.0565410199556541
chr22	TYMP	50527164	50527328	102	165	102	1961	0	1796	0.6181818181818182	0.0
chr22	TYMP	50528511	50528573	0	63	102	1961	102	1898	0.0	0.05374077976817703
chr22	ODF3B	50531569	50531702	0	134	0	2010	0	1876	0.0	0.0
chr22	ODF3B	50531569	50531773	0	205	0	2010	0	1805	0.0	0.0
chr22	CPT1B	50576535	50576637	0	103	79	4122	79	4019	0.0	0.019656631002737
chr22	CPT1B	50576535	50576593	0	59	79	4122	79	4063	0.0	0.01944376076790549
chr22	CHKB-CPT1B	50578548	50578659	0	112	69	5050	69	4938	0.0	0.013973268529769137
chr22	CPT1B	50573807	50573921	0	115	79	4122	79	4007	0.0	0.019715497878712254
chr22	ARSA	50627555	50627792	327	238	12405	3989	12078	3751	1.3739495798319328	3.219941348973607
chr22	RABL2B	50769904	50770016	0	113	10031	5879	10031	5766	0.0	1.7396808879639265
chr22	RABL2B	50775771	50775851	399	81	10031	5879	9632	5798	4.925925925925926	1.6612625043118316
chr22	RABL2B	50783038	50783286	195	249	10031	5879	9836	5630	0.7831325301204819	1.7470692717584368
chr22	RABL2B	50782890	50783045	92	156	10031	5879	9939	5723	0.5897435897435898	1.736676568233444
chr22	RABL2B	50780612	50780718	0	107	10031	5879	10031	5772	0.0	1.7378724878724878
chr22	POTEH	15697373	15697629	0	257	0	2253	0	1996	0.0	0.0
chr22	TPTEP1	16647604	16647785	0	182	0	5184	0	5002	0.0	0.0
chr22	CECR7	17046345	17046444	0	100	2040	4460	2040	4360	0.0	0.46788990825688076
chr22	IL17RA	17097061	17097086	0	26	765	9049	765	9023	0.0	0.08478333148620193
chr22	IL17RA	17105852	17105954	0	103	765	9049	765	8946	0.0	0.08551307847082495
chr22	LINC01664	17122568	17122738	0	171	0	1936	0	1765	0.0	0.0
chr22	CECR2	17550242	17550409	4948	168	118669	10783	113721	10615	29.452380952380953	10.713235986811116
chr22	SLC25A18	17569923	17569986	3	64	94371	4735	94368	4671	0.046875	20.20295439948619
chr22	BCL2L13	17688985	17689142	0	158	16710	7270	16710	7112	0.0	2.3495500562429696
chr22	BCL2L13	17696140	17696210	0	71	16710	7270	16710	7199	0.0	2.3211557160716767
chr22	BCL2L13	17655661	17655832	153	172	16710	7270	16557	7098	0.8895348837209303	2.3326289095519863
chr22	BCL2L13	17683213	17683321	0	109	16710	7270	16710	7161	0.0	2.333472978634269
chr22	BCL2L13	17702242	17702386	0	145	16710	7270	16710	7125	0.0	2.345263157894737
chr22	PEX26	18085111	18085258	102	148	145014	20054	144912	19906	0.6891891891891891	7.279815131116246
chr22	AC008132.1	18852218	18852594	0	377	1530	7577	1530	7200	0.0	0.2125
chr22	DGCR6	18909979	18910098	0	120	0	5168	0	5048	0.0	0.0
chr22	DGCR5	18985835	18986019	0	185	448	8044	448	7859	0.0	0.057004707978114265
chr22	DGCR5	18989739	18989964	40	226	448	8044	408	7818	0.17699115044247787	0.052187260168841135
chr22	DGCR5	18988090	18988195	0	106	448	8044	448	7938	0.0	0.0564373897707231
chr22	DGCR5	18987756	18987900	0	145	448	8044	448	7899	0.0	0.05671604000506393
chr22	CDC45	19482689	19482827	171	139	10465	2603	10294	2464	1.2302158273381294	4.177759740259741
chr22	CDC45	19479825	19480019	2122	195	10465	2603	8343	2408	10.882051282051282	3.464700996677741
chr22	CDC45	19494506	19494602	0	97	10465	2603	10465	2506	0.0	4.175977653631285
chr22	CDC45	19480685	19480779	0	95	10465	2603	10465	2508	0.0	4.172647527910685
chr22	CDC45	19494473	19494602	5	130	10465	2603	10460	2473	0.038461538461538464	4.229680549939345
chr22	SEPTIN5	19721639	19721736	0	98	1020	4211	1020	4113	0.0	0.24799416484318015
chr22	COMT	19961696	19961874	3878	179	75391	6477	71513	6298	21.664804469273744	11.354874563353446
chr22	COMT	19947306	19947490	330	185	75391	6477	75061	6292	1.7837837837837838	11.929593134138589
chr22	COMT	19966625	19966718	968	94	75391	6477	74423	6383	10.297872340425531	11.65956446811844
chr22	COMT	19967163	19967621	9945	459	75391	6477	65446	6018	21.666666666666668	10.875041542040545
chr22	TANGO2	20061529	20061683	0	155	26583	4941	26583	4786	0.0	5.554325114918512
chr22	TANGO2	20019180	20019299	225	120	26583	4941	26358	4821	1.875	5.4673304293715
chr22	TANGO2	20055942	20056013	0	72	26583	4941	26583	4869	0.0	5.459642637091806
chr22	TANGO2	20053436	20053551	622	116	26583	4941	25961	4825	5.362068965517241	5.380518134715026
chr22	TANGO2	20053359	20053551	6248	193	26583	4941	20335	4748	32.373056994818654	4.282855939342881
chr22	TANGO2	20063337	20063442	0	106	26583	4941	26583	4835	0.0	5.498035160289556
chr22	TANGO2	20061529	20061681	0	153	26583	4941	26583	4788	0.0	5.552005012531328
chr22	DGCR8	20092808	20092907	185	100	155746	7302	155561	7202	1.85	21.599694529297416
chr22	RANBP1	20122579	20122697	0	119	73207	4188	73207	4069	0.0	17.99139837797985
chr22	ZNF74	20394562	20394662	5519	101	25296	5230	19777	5129	54.64356435643565	3.855917332813414
chr22	ZNF74	20395332	20395418	240	87	25296	5230	25056	5143	2.7586206896551726	4.871864670425822
chr22	ZNF74	20401276	20401372	0	97	25296	5230	25296	5133	0.0	4.928112215078901
chr22	ZNF74	20399594	20399690	430	97	25296	5230	24866	5133	4.43298969072165	4.84434054159361
chr22	MED15	20518877	20518995	0	119	408	8263	408	8144	0.0	0.05009823182711198
chr22	MED15	20554935	20555148	0	214	408	8263	408	8049	0.0	0.0506895266492732
chr22	MED15	20582610	20582747	0	138	408	8263	408	8125	0.0	0.05021538461538461
chr22	MED15	20584854	20585015	0	162	408	8263	408	8101	0.0	0.05036415257375633
chr22	MED15	20575112	20575232	0	121	408	8263	408	8142	0.0	0.050110537951363304
chr22	MED15	20552538	20552709	0	172	408	8263	408	8091	0.0	0.05042639970337412
chr22	TMEM191A	20703467	20703524	0	58	0	2582	0	2524	0.0	0.0
chr22	TMEM191A	20702843	20702893	0	51	0	2582	0	2531	0.0	0.0
chr22	TMEM191A	20703818	20703883	0	66	0	2582	0	2516	0.0	0.0
chr22	TMEM191A	20702829	20702893	0	65	0	2582	0	2517	0.0	0.0
chr22	AIFM3	20973757	20973867	0	111	51	4168	51	4057	0.0	0.01257086517130885
chr22	AIFM3	20977699	20977776	0	78	51	4168	51	4090	0.0	0.012469437652811735
chr22	AIFM3	20980746	20980767	0	22	51	4168	51	4146	0.0	0.012301013024602027
chr22	AIFM3	20966505	20966546	0	42	51	4168	51	4126	0.0	0.012360639844886088
chr22	LZTR1	20985840	20985897	0	58	51	6931	51	6873	0.0	0.007420340462680052
chr22	LZTR1	20987503	20987583	0	81	51	6931	51	6850	0.0	0.007445255474452555
chr22	LZTR1	20988788	20988872	0	85	51	6931	51	6846	0.0	0.007449605609114811
chr22	LZTR1	20995367	20995484	0	118	51	6931	51	6813	0.0	0.007485689123734038
chr22	P2RX6	21022675	21022751	0	77	0	4616	0	4539	0.0	0.0
chr22	P2RX6	21017920	21018060	0	141	0	4616	0	4475	0.0	0.0
chr22	FAM230B	21183270	21185587	1428	2318	10805	6180	9377	3862	0.6160483175150993	2.4280165717244953
chr22	FAM230B	21171080	21171208	0	129	10805	6180	10805	6051	0.0	1.7856552635927945
chr22	TMEM191C	21469129	21469194	0	66	357	4210	357	4144	0.0	0.08614864864864864
chr22	TMEM191C	21468151	21468202	0	52	357	4210	357	4158	0.0	0.08585858585858586
chr22	UBE2L3	21592860	21592956	0	97	26562	3843	26562	3746	0.0	7.09076348104645
chr22	PPIL2	21669333	21669426	0	94	173	6288	173	6194	0.0	0.027930255085566676
chr22	PPIL2	21670298	21670360	0	63	173	6288	173	6225	0.0	0.02779116465863454
chr22	PPIL2	21685637	21685726	0	90	173	6288	173	6198	0.0	0.027912229751532753
chr22	GGTLC2	22646982	22647038	31	57	2882	1402	2851	1345	0.543859649122807	2.1197026022304835
chr22	IGLL5	22893696	22893818	0	123	0	1342	0	1219	0.0	0.0
chr22	IGLL5	22893699	22893818	0	120	0	1342	0	1222	0.0	0.0
chr22	RAB36	23152460	23152526	0	67	0	4118	0	4051	0.0	0.0
chr22	BCR	23268407	23268515	0	109	530	11548	530	11439	0.0	0.046332721391730045
chr22	BCR	23290338	23290413	0	76	530	11548	530	11472	0.0	0.046199442119944215
chr22	BCR	23313967	23314073	0	107	530	11548	530	11441	0.0	0.04632462197360371
chr22	BCR	23295023	23295155	0	133	530	11548	530	11415	0.0	0.04643013578624617
chr22	RGL4	23696327	23696494	0	168	90	4727	90	4559	0.0	0.019741171309497697
chr22	RGL4	23698414	23698548	0	135	90	4727	90	4592	0.0	0.0195993031358885
chr22	RGL4	23698554	23698645	0	92	90	4727	90	4635	0.0	0.019417475728155338
chr22	MMP11	23771117	23771299	0	183	148	4173	148	3990	0.0	0.037092731829573934
chr22	MMP11	23771186	23771307	0	122	148	4173	148	4051	0.0	0.0365341890891138
chr22	SMARCB1	23800943	23801081	0	139	1377	12335	1377	12196	0.0	0.11290587077730403
chr22	SMARCB1	23800943	23801135	0	193	1377	12335	1377	12142	0.0	0.1134080052709603
chr22	SMARCB1	23800943	23801964	0	1022	1377	12335	1377	11313	0.0	0.12171837708830549
chr22	SMARCB1	23800943	23800970	0	28	1377	12335	1377	12307	0.0	0.11188754367433168
chr22	SLC2A11	23877720	23877869	0	150	6841	8383	6841	8233	0.0	0.8309243289201992
chr22	SLC2A11	23883771	23883873	0	103	6841	8383	6841	8280	0.0	0.826207729468599
chr22	SLC2A11	23857420	23857531	0	112	6841	8383	6841	8271	0.0	0.8271067585539837
chr22	SLC2A11	23867734	23867899	0	166	6841	8383	6841	8217	0.0	0.8325422903736157
chr22	SLC2A11	23877384	23877869	0	486	6841	8383	6841	7897	0.0	0.866278333544384
chr22	CABIN1	24050824	24050974	0	151	136011	9431	136011	9280	0.0	14.65635775862069
chr22	CABIN1	24041138	24041273	0	136	136011	9431	136011	9295	0.0	14.632705755782679
chr22	CABIN1	24176110	24176275	612	166	136011	9431	135399	9265	3.6867469879518073	14.614031300593632
chr22	POM121L9P	24257996	24258059	6	64	46722	4967	46716	4903	0.09375	9.528044054660413
chr22	SPECC1L	24411587	24411704	0	118	26541	7480	26541	7362	0.0	3.6051344743276283
chr22	SPECC1L	24276699	24276803	0	105	26541	7480	26541	7375	0.0	3.598779661016949
chr22	SPECC1L	24311993	24312131	3498	139	26541	7480	23043	7341	25.165467625899282	3.1389456477319166
chr22	SPECC1L	24321404	24322918	13838	1515	26541	7480	12703	5965	9.133993399339934	2.1295892707460182
chr22	ADORA2A	24432620	24432726	884	107	935	4202	51	4095	8.261682242990654	0.012454212454212455
chr22	UPB1	24521985	24522028	0	44	46927	6805	46927	6761	0.0	6.94083715426712
chr22	UPB1	24500106	24500278	1189	173	46927	6805	45738	6632	6.872832369942197	6.896562123039807
chr22	GGT1	24609961	24610033	0	73	511	4343	511	4270	0.0	0.11967213114754098
chr22	GGT1	24614775	24614906	0	132	511	4343	511	4211	0.0	0.12134884825457136
chr22	GGT1	24620912	24621070	51	159	511	4343	460	4184	0.32075471698113206	0.10994263862332695
chr22	GGT1	24607953	24608023	0	71	511	4343	511	4272	0.0	0.11961610486891386
chr22	GGT1	24609964	24610033	0	70	511	4343	511	4273	0.0	0.11958811139714487
chr22	GGT1	24608989	24609231	0	243	511	4343	511	4100	0.0	0.12463414634146341
chr22	GGT1	24628080	24628136	0	57	511	4343	511	4286	0.0	0.11922538497433505
chr22	AP000356.3	24649277	24649383	0	107	366	1611	366	1504	0.0	0.24335106382978725
chr22	SGSM1	24874414	24874579	0	166	319	8635	319	8469	0.0	0.03766678474436179
chr22	SGSM1	24893430	24893613	0	184	319	8635	319	8451	0.0	0.037747012187906756
chr22	CRYBB3	25205219	25205362	0	144	0	861	0	717	0.0	0.0
chr22	GRK3	25644591	25644665	0	75	600	9263	600	9188	0.0	0.06530256856769699
chr22	GRK3	25702841	25702991	25	151	600	9263	575	9112	0.16556291390728478	0.06310359964881475
chr22	MYO18B	25797952	25798097	0	146	24339	9758	24339	9612	0.0	2.532147315855181
chr22	MYO18B	26003264	26003309	0	46	24339	9758	24339	9712	0.0	2.5060749588138385
chr22	MYO18B	26028340	26028595	0	256	24339	9758	24339	9502	0.0	2.5614607451062934
chr22	SEZ6L	26351051	26351243	0	193	51	7179	51	6986	0.0	0.007300314915545376
chr22	SEZ6L	26373450	26373483	0	34	51	7179	51	7145	0.0	0.007137858642407278
chr22	SEZ6L	26365371	26365566	0	196	51	7179	51	6983	0.0	0.007303451238722612
chr22	CRYBA4	26623233	26623352	0	120	0	815	0	695	0.0	0.0
chr22	MIAT	26660698	26660816	0	119	0	13610	0	13491	0.0	0.0
chr22	MIAT	26647173	26647311	0	139	0	13610	0	13471	0.0	0.0
chr22	MIAT	26667184	26667310	0	127	0	13610	0	13483	0.0	0.0
chr22	MIAT	26656031	26656154	0	124	0	13610	0	13486	0.0	0.0
chr22	MIAT	26663315	26663398	0	84	0	13610	0	13526	0.0	0.0
chr22	MIAT	26657481	26657654	0	174	0	13610	0	13436	0.0	0.0
chr22	MIAT	26663315	26663509	0	195	0	13610	0	13415	0.0	0.0
chr22	MIAT	26658182	26658339	0	158	0	13610	0	13452	0.0	0.0
chr22	MIATNB	26693680	26693836	0	157	0	5101	0	4944	0.0	0.0
chr22	MIATNB	26711829	26712008	0	180	0	5101	0	4921	0.0	0.0
chr22	MIATNB	26718139	26718231	0	93	0	5101	0	5008	0.0	0.0
chr22	LINC01422	26877328	26877413	0	86	272095	9911	272095	9825	0.0	27.6941475826972
chr22	AL020994.2	27337135	27337657	0	523	26	1407	26	884	0.0	0.029411764705882353
chr22	TTC28-AS1	27989881	27990026	0	146	510	11188	510	11042	0.0	0.0461872849121536
chr22	TTC28-AS1	27935150	27935230	0	81	510	11188	510	11107	0.0	0.04591698928603583
chr22	TTC28-AS1	27993123	27993535	0	413	510	11188	510	10775	0.0	0.047331786542923436
chr22	TTC28-AS1	27994472	27994653	0	182	510	11188	510	11006	0.0	0.04633836089405779
chr22	TTC28-AS1	27997985	27998152	0	168	510	11188	510	11020	0.0	0.04627949183303085
chr22	TTC28-AS1	27922017	27922178	0	162	510	11188	510	11026	0.0	0.04625430799927444
chr22	TTC28-AS1	27940019	27940171	0	153	510	11188	510	11035	0.0	0.046216583597643864
chr22	TTC28-AS1	27919722	27919966	0	245	510	11188	510	10943	0.0	0.046605135703189256
chr22	TTC28-AS1	27998603	27998838	0	236	510	11188	510	10952	0.0	0.04656683710737765
chr22	TTC28-AS1	27922017	27922227	0	211	510	11188	510	10977	0.0	0.04646078163432632
chr22	TTC28-AS1	27997985	27998838	0	854	510	11188	510	10334	0.0	0.04935165473195278
chr22	TTC28-AS1	27998071	27998152	0	82	510	11188	510	11106	0.0	0.045921123716909776
chr22	HSCB	28745863	28746008	0	146	0	1462	0	1316	0.0	0.0
chr22	CCDC117	28773724	28773778	0	55	545	4332	545	4277	0.0	0.12742576572363806
chr22	CCDC117	28780947	28781172	0	226	545	4332	545	4106	0.0	0.13273258645884073
chr22	EMID1	29225132	29225216	0	85	21	3322	21	3237	0.0	0.006487488415199258
chr22	EMID1	29234136	29234199	0	64	21	3322	21	3258	0.0	0.006445672191528545
chr22	EMID1	29231457	29231508	0	52	21	3322	21	3270	0.0	0.006422018348623854
chr22	EMID1	29254202	29254287	0	86	21	3322	21	3236	0.0	0.0064894932014833125
chr22	EWSR1	29282389	29282557	0	169	1634	6389	1634	6220	0.0	0.2627009646302251
chr22	EWSR1	29274264	29274282	0	19	1634	6389	1634	6370	0.0	0.2565149136577708
chr22	EWSR1	29274267	29274282	0	16	1634	6389	1634	6373	0.0	0.25639416287462735
chr22	GAS2L1	29306994	29307153	0	160	918	4005	918	3845	0.0	0.2387516254876463
chr22	NF2	29636750	29636876	0	127	212315	5395	212315	5268	0.0	40.30277145026576
chr22	NF2	29639089	29639212	0	124	212315	5395	212315	5271	0.0	40.279833048757354
chr22	NF2	29628657	29628773	0	117	212315	5395	212315	5278	0.0	40.22641151951497
chr22	NF2	29661204	29661339	11015	136	212315	5395	201300	5259	80.99264705882354	38.27723901882487
chr22	NF2	29681438	29681601	90	164	212315	5395	212225	5231	0.5487804878048781	40.57063658956223
chr22	NF2	29683019	29683064	27548	46	212315	5395	184767	5349	598.8695652173913	34.54234436343242
chr22	NF2	29683019	29683079	38276	61	212315	5395	174039	5334	627.4754098360655	32.628233970753655
chr22	NF2	29654974	29655080	0	107	212315	5395	212315	5288	0.0	40.15034039334342
chr22	MTMR3	29957035	29957088	0	54	10008	9913	10008	9859	0.0	1.0151130946343443
chr22	MTMR3	29970975	29971062	4341	88	10008	9913	5667	9825	49.32954545454545	0.576793893129771
chr22	MTMR3	29988479	29988562	0	84	10008	9913	10008	9829	0.0	1.0182114151999186
chr22	MTMR3	30023456	30023483	0	28	10008	9913	10008	9885	0.0	1.012443095599393
chr22	MTMR3	30022028	30022139	0	112	10008	9913	10008	9801	0.0	1.0211202938475665
chr22	HORMAD2	30104400	30104437	0	38	49969	2297	49969	2259	0.0	22.119964586100043
chr22	CCDC157	30361960	30362114	462	155	15217	6596	14755	6441	2.9806451612903224	2.2907933550690887
chr22	CCDC157	30365943	30366248	0	306	15217	6596	15217	6290	0.0	2.4192368839427663
chr22	CCDC157	30375478	30375663	0	186	15217	6596	15217	6410	0.0	2.373946957878315
chr22	CCDC157	30365989	30366248	0	260	15217	6596	15217	6336	0.0	2.4016729797979797
chr22	CCDC157	30375485	30375663	0	179	15217	6596	15217	6417	0.0	2.371357332086645
chr22	SEC14L2	30407094	30407154	0	61	223756	5735	223756	5674	0.0	39.43531899894254
chr22	SEC14L2	30407414	30407603	153	190	223756	5735	223603	5545	0.8052631578947368	40.32515779981966
chr22	SEC14L2	30415758	30415865	3555	108	223756	5735	220201	5627	32.916666666666664	39.13293051359516
chr22	SEC14L2	30399642	30399718	0	77	223756	5735	223756	5658	0.0	39.546836337928596
chr22	SEC14L2	30397748	30397870	1612	123	223756	5735	222144	5612	13.105691056910569	39.58374910905203
chr22	SEC14L2	30415947	30416087	12489	141	223756	5735	211267	5594	88.57446808510639	37.76671433678942
chr22	SEC14L2	30416233	30416403	12559	171	223756	5735	211197	5564	73.44444444444444	37.9577641984184
chr22	MTFP1	30427170	30427403	51	234	9395	1331	9344	1097	0.21794871794871795	8.517775752051048
chr22	MTFP1	30427121	30427403	51	283	9395	1331	9344	1048	0.18021201413427562	8.916030534351146
chr22	MTFP1	30427239	30427403	51	165	9395	1331	9344	1166	0.3090909090909091	8.013722126929673
chr22	AC004832.1	30491423	30491592	0	170	0	2426	0	2256	0.0	0.0
chr22	TCN2	30610234	30610335	0	102	2091	2960	2091	2858	0.0	0.731630510846746
chr22	OSBP2	30893121	30893242	34	122	39885	6541	39851	6419	0.2786885245901639	6.2082878953107965
chr22	OSBP2	30893816	30894001	0	186	39885	6541	39885	6355	0.0	6.2761605035405195
chr22	OSBP2	30770582	30770681	0	100	39885	6541	39885	6441	0.0	6.192361434559851
chr22	MORC2-AS1	30923245	30923422	0	178	0	2729	0	2551	0.0	0.0
chr22	MORC2-AS1	30923245	30923451	0	207	0	2729	0	2522	0.0	0.0
chr22	SMTN	31082909	31083002	0	94	7935	7949	7935	7855	0.0	1.0101845957988542
chr22	SMTN	31082915	31083002	0	88	7935	7949	7935	7861	0.0	1.0094135606156978
chr22	SMTN	31100884	31101049	0	166	7935	7949	7935	7783	0.0	1.0195297443145317
chr22	SMTN	31100884	31100953	0	70	7935	7949	7935	7879	0.0	1.0071075009518975
chr22	SMTN	31093783	31093876	0	94	7935	7949	7935	7855	0.0	1.0101845957988542
chr22	SMTN	31087082	31087200	38	119	7935	7949	7897	7830	0.31932773109243695	1.0085568326947638
chr22	INPP5J	31124141	31124263	51	123	688	4440	637	4317	0.4146341463414634	0.14755617326847348
chr22	INPP5J	31133405	31133483	0	79	688	4440	688	4361	0.0	0.15776198119697318
chr22	INPP5J	31124844	31126010	0	1167	688	4440	688	3273	0.0	0.2102047051634586
chr22	INPP5J	31125832	31126010	0	179	688	4440	688	4261	0.0	0.16146444496597043
chr22	INPP5J	31124844	31124906	0	63	688	4440	688	4377	0.0	0.15718528672606807
chr22	RNF185	31187046	31187270	0	225	1047	3456	1047	3231	0.0	0.32404828226555243
chr22	RNF185	31195468	31195581	0	114	1047	3456	1047	3342	0.0	0.3132854578096948
chr22	RNF185	31196935	31197157	0	223	1047	3456	1047	3233	0.0	0.3238478193628209
chr22	LIMK2	31225719	31225819	0	101	765	6188	765	6087	0.0	0.1256776737309019
chr22	DRG1	31400619	31400743	0	125	134	2211	134	2086	0.0	0.06423777564717162
chr22	DRG1	31403028	31403204	0	177	134	2211	134	2034	0.0	0.06588003933136677
chr22	DRG1	31421307	31421399	0	93	134	2211	134	2118	0.0	0.06326723323890462
chr22	SFI1	31528689	31528863	32	175	39711	12126	39679	11951	0.18285714285714286	3.320140574010543
chr22	SFI1	31603743	31603819	0	77	39711	12126	39711	12049	0.0	3.295792181923811
chr22	SFI1	31604308	31604404	0	97	39711	12126	39711	12029	0.0	3.3012719261784023
chr22	SFI1	31531057	31531129	0	73	39711	12126	39711	12053	0.0	3.2946984153322822
chr22	SFI1	31546860	31546971	0	112	39711	12126	39711	12014	0.0	3.305393707341435
chr22	SFI1	31580271	31580364	0	94	39711	12126	39711	12032	0.0	3.300448803191489
chr22	SFI1	31530591	31530784	0	194	39711	12126	39711	11932	0.0	3.328109285953738
chr22	SFI1	31497247	31497348	2320	102	39711	12126	37391	12024	22.745098039215687	3.1096972721224216
chr22	DEPDC5	31766584	31766668	0	85	194832	17819	194832	17734	0.0	10.986353896470057
chr22	DEPDC5	31778098	31778168	80	71	194832	17819	194752	17748	1.1267605633802817	10.973180076628353
chr22	DEPDC5	31806121	31806191	0	71	194832	17819	194832	17748	0.0	10.977687626774848
chr22	DEPDC5	31876156	31876265	0	110	194832	17819	194832	17709	0.0	11.001863459258004
chr22	DEPDC5	31901741	31901802	0	62	194832	17819	194832	17757	0.0	10.972123669538773
chr22	DEPDC5	31833914	31833980	253	67	194832	17819	194579	17752	3.7761194029850746	10.96096214511041
chr22	DEPDC5	31861367	31861433	0	67	194832	17819	194832	17752	0.0	10.975214060387563
chr22	DEPDC5	31895358	31895954	408	597	194832	17819	194424	17222	0.6834170854271356	11.289281152014865
chr22	DEPDC5	31831063	31831225	3124	163	194832	17819	191708	17656	19.165644171779142	10.85795197100136
chr22	DEPDC5	31766603	31766668	0	66	194832	17819	194832	17753	0.0	10.97459584295612
chr22	DEPDC5	31876086	31876265	0	180	194832	17819	194832	17639	0.0	11.045524122682691
chr22	YWHAH	31945499	31945678	357	180	14834	2398	14477	2218	1.9833333333333334	6.527051397655545
chr22	YWHAH	31950307	31950422	1275	116	14834	2398	13559	2282	10.991379310344827	5.941717791411043
chr22	YWHAH	31945556	31945678	357	123	14834	2398	14477	2275	2.902439024390244	6.3635164835164835
chr22	LINC02558	31976623	31976737	0	115	6571	1635	6571	1520	0.0	4.323026315789473
chr22	LINC02558	31972575	31972732	381	158	6571	1635	6190	1477	2.411392405063291	4.190927555856466
chr22	SLC5A4-AS1	32229089	32229372	510	284	10407	6812	9897	6528	1.795774647887324	1.5160845588235294
chr22	FBXO7	32479132	32479275	0	144	51	5275	51	5131	0.0	0.00993958292730462
chr22	FBXO7	32478980	32479275	0	296	51	5275	51	4979	0.0	0.010243020686884917
chr22	LINC01640	33134592	33134702	0	111	0	2020	0	1909	0.0	0.0
chr22	LARGE-AS1	33732255	33732649	0	395	294	2871	294	2476	0.0	0.11873990306946688
chr22	LARGE-AS1	33744128	33744328	0	201	294	2871	294	2670	0.0	0.1101123595505618
chr22	LARGE-AS1	33746414	33746457	0	44	294	2871	294	2827	0.0	0.10399717014503007
chr22	LARGE-AS1	33747669	33747824	0	156	294	2871	294	2715	0.0	0.10828729281767956
chr22	LARGE-AS1	33725611	33725756	0	146	294	2871	294	2725	0.0	0.10788990825688073
chr22	LARGE-AS1	33726115	33726197	0	83	294	2871	294	2788	0.0	0.1054519368723099
chr22	LARGE-AS1	33747625	33747824	0	200	294	2871	294	2671	0.0	0.11007113440658929
chr22	LARGE-AS1	33732255	33733685	294	1431	294	2871	0	1440	0.20545073375262055	0.0
chr22	LARGE-AS1	33725611	33725655	0	45	294	2871	294	2826	0.0	0.1040339702760085
chr22	LARGE-AS1	33743134	33743198	0	65	294	2871	294	2806	0.0	0.10477548111190306
chr22	LINC01643	34083968	34084027	0	60	612	3786	612	3726	0.0	0.1642512077294686
chr22	LINC01643	34109325	34109434	561	110	612	3786	51	3676	5.1	0.013873775843307944
chr22	LINC01643	34161595	34161791	0	197	612	3786	612	3589	0.0	0.17052103650041794
chr22	LINC01643	34107938	34107989	0	52	612	3786	612	3734	0.0	0.1638993036957686
chr22	LINC01643	34206081	34206194	0	114	612	3786	612	3672	0.0	0.16666666666666666
chr22	LINC01643	34147995	34148132	0	138	612	3786	612	3648	0.0	0.16776315789473684
chr22	LINC01643	34213811	34213970	0	160	612	3786	612	3626	0.0	0.16878102592388305
chr22	LINC01643	34107938	34107993	0	56	612	3786	612	3730	0.0	0.1640750670241287
chr22	LINC01643	34188184	34188425	0	242	612	3786	612	3544	0.0	0.172686230248307
chr22	LINC01643	34100357	34100441	0	85	612	3786	612	3701	0.0	0.16536071332072413
chr22	LINC01643	34175389	34175440	0	52	612	3786	612	3734	0.0	0.1638993036957686
chr22	LINC01643	34205472	34205558	0	87	612	3786	612	3699	0.0	0.1654501216545012
chr22	LINC01643	34149923	34150019	0	97	612	3786	612	3689	0.0	0.16589861751152074
chr22	LINC01643	34206081	34206163	0	83	612	3786	612	3703	0.0	0.1652714015662976
chr22	LINC01643	34213811	34213919	0	109	612	3786	612	3677	0.0	0.16644003263530052
chr22	LINC01643	34061274	34061500	0	227	612	3786	612	3559	0.0	0.17195841528519246
chr22	LINC01643	34102622	34102816	0	195	612	3786	612	3591	0.0	0.17042606516290726
chr22	LINC01643	34151864	34151927	0	64	612	3786	612	3722	0.0	0.16442772702847933
chr22	HMGXB4	35262322	35262421	0	100	0	6019	0	5919	0.0	0.0
chr22	HMGXB4	35263981	35264096	0	116	0	6019	0	5903	0.0	0.0
chr22	TOM1	35323495	35323630	0	136	0	5019	0	4883	0.0	0.0
chr22	TOM1	35317876	35317961	0	86	0	5019	0	4933	0.0	0.0
chr22	TOM1	35321741	35321847	0	107	0	5019	0	4912	0.0	0.0
chr22	TOM1	35331295	35331495	0	201	0	5019	0	4818	0.0	0.0
chr22	TOM1	35321958	35322037	0	80	0	5019	0	4939	0.0	0.0
chr22	TOM1	35323518	35323630	0	113	0	5019	0	4906	0.0	0.0
chr22	HMOX1	35386684	35387176	0	493	0	2254	0	1761	0.0	0.0
chr22	HMOX1	35389863	35389963	0	101	0	2254	0	2153	0.0	0.0
chr22	MCM5	35401665	35401814	0	150	612	5194	612	5044	0.0	0.12133227597145123
chr22	MCM5	35403413	35403542	0	130	612	5194	612	5064	0.0	0.12085308056872038
chr22	MCM5	35401370	35401466	0	97	612	5194	612	5097	0.0	0.12007062978222484
chr22	APOL1	36257082	36257136	0	55	228	2686	228	2631	0.0	0.08665906499429875
chr22	APOL1	36253837	36253991	0	155	228	2686	228	2531	0.0	0.0900829711576452
chr22	APOL1	36259668	36259856	0	189	228	2686	228	2497	0.0	0.09130957148578293
chr22	APOL1	36259668	36259918	0	251	228	2686	228	2435	0.0	0.09363449691991786
chr22	NCF4	36864044	36864129	279	86	51301	2252	51022	2166	3.244186046511628	23.555863342566944
chr22	MPST	37023751	37023927	0	177	0	2486	0	2309	0.0	0.0
chr22	MPST	37025001	37025127	0	127	0	2486	0	2359	0.0	0.0
chr22	KCTD17	37060822	37060922	0	101	0	2580	0	2479	0.0	0.0
chr22	KCTD17	37061103	37061175	0	73	0	2580	0	2507	0.0	0.0
chr22	KCTD17	37061538	37061629	0	92	0	2580	0	2488	0.0	0.0
chr22	CDC42EP1	37565599	37565722	0	124	0	2546	0	2422	0.0	0.0
chr22	GGA1	37613023	37613191	51	169	939	9038	888	8869	0.30177514792899407	0.1001240275115571
chr22	GGA1	37613118	37613191	21	74	939	9038	918	8964	0.28378378378378377	0.10240963855421686
chr22	GGA1	37613032	37613191	51	160	939	9038	888	8878	0.31875	0.10002252759630548
chr22	SH3BP1	37641125	37641168	0	44	28	4670	28	4626	0.0	0.0060527453523562475
chr22	SH3BP1	37655271	37655315	0	45	28	4670	28	4625	0.0	0.006054054054054054
chr22	LGALS1	37678375	37678392	0	18	0	1073	0	1055	0.0	0.0
chr22	TRIOBP	37713209	37713411	0	203	7739	12205	7739	12002	0.0	0.6448091984669222
chr22	TRIOBP	37754876	37754984	0	109	7739	12205	7739	12096	0.0	0.6397982804232805
chr22	TRIOBP	37750641	37750730	0	90	7739	12205	7739	12115	0.0	0.6387948823772184
chr22	GCAT	37809948	37810157	0	210	2412	2112	2412	1902	0.0	1.2681388012618298
chr22	GCAT	37810026	37810157	0	132	2412	2112	2412	1980	0.0	1.2181818181818183
chr22	EIF3L	37850014	37850063	0	50	37222	4164	37222	4114	0.0	9.047642197374818
chr22	EIF3L	37855564	37855644	0	81	37222	4164	37222	4083	0.0	9.11633602743081
chr22	EIF3L	37850523	37850574	0	52	37222	4164	37222	4112	0.0	9.05204280155642
chr22	EIF3L	37886949	37887071	9209	123	37222	4164	28013	4041	74.869918699187	6.932195001237318
chr22	POLR2F	37959345	37959476	306	132	62990	6258	62684	6126	2.3181818181818183	10.2324518445968
chr22	POLR2F	37958373	37958471	138	99	62990	6258	62852	6159	1.393939393939394	10.20490339340802
chr22	PICK1	38059233	38059345	0	113	1790933	4356	1790933	4243	0.0	422.09120905020035
chr22	PICK1	38067703	38067770	0	68	1790933	4356	1790933	4288	0.0	417.66161380597015
chr22	MAFF	38213822	38213889	0	68	1735677	3894	1735677	3826	0.0	453.65316257187663
chr22	CBY1	38665545	38665685	0	141	363	2355	363	2214	0.0	0.16395663956639567
chr22	CBY1	38656955	38657143	108	189	363	2355	255	2166	0.5714285714285714	0.11772853185595568
chr22	GTPBP1	38708844	38708956	99	113	2735	8041	2636	7928	0.8761061946902655	0.33249243188698285
chr22	GTPBP1	38736028	38736256	0	229	2735	8041	2735	7812	0.0	0.3501024065540195
chr22	GTPBP1	38735173	38735310	287	138	2735	8041	2448	7903	2.079710144927536	0.3097557889409085
chr22	APOBEC3B	38989456	38989610	0	155	7942	1623	7942	1468	0.0	5.41008174386921
chr22	APOBEC3C	39015594	39015751	765	158	3162	2648	2397	2490	4.841772151898734	0.9626506024096385
chr22	APOBEC3G	39078931	39079085	95158	155	708627	4135	613469	3980	613.9225806451612	154.13793969849246
chr22	APOBEC3H	39101917	39102042	1096	126	1699	1257	603	1131	8.698412698412698	0.53315649867374
chr22	APOBEC3H	39102511	39102605	0	95	1699	1257	1699	1162	0.0	1.4621342512908777
chr22	MIEF1	39509421	39509571	0	151	102	6464	102	6313	0.0	0.016157136068430222
chr22	MIEF1	39509337	39509571	0	235	102	6464	102	6229	0.0	0.016375020067426554
chr22	CACNA1I	39647821	39647926	0	106	1173	10828	1173	10722	0.0	0.10940123111359822
chr22	GRAP2	39947092	39947184	0	93	1503	6197	1503	6104	0.0	0.24623197903014415
chr22	TNRC6B	40264687	40267036	0	2350	306	20027	306	17677	0.0	0.01731062963172484
chr22	TNRC6B	40270121	40270280	0	160	306	20027	306	19867	0.0	0.015402426133789702
chr22	TNRC6B	40281118	40281289	0	172	306	20027	306	19855	0.0	0.015411735079325107
chr22	ADSL	40354247	40354327	0	81	724	7463	724	7382	0.0	0.09807640205906258
chr22	ADSL	40353072	40353117	0	46	724	7463	724	7417	0.0	0.09761359040043144
chr22	ADSL	40364879	40365056	0	178	724	7463	724	7285	0.0	0.09938229238160604
chr22	ADSL	40373345	40373535	0	191	724	7463	724	7272	0.0	0.09955995599559957
chr22	ADSL	40353332	40353419	0	88	724	7463	724	7375	0.0	0.09816949152542373
chr22	SGSM3	40401592	40401675	0	84	51	3960	51	3876	0.0	0.013157894736842105
chr22	ADSL	40366435	40366498	0	64	724	7463	724	7399	0.0	0.097851060954183
chr22	XPNPEP3	40870047	40870139	0	93	17895	8939	17895	8846	0.0	2.022948225186525
chr22	EP300	41137652	41137790	2	139	22467	11539	22465	11400	0.014388489208633094	1.9706140350877193
chr22	EP300	41146738	41146816	0	79	22467	11539	22467	11460	0.0	1.9604712041884818
chr22	L3MBTL2	41219418	41219536	65	119	118342	6141	118277	6022	0.5462184873949579	19.6408170043175
chr22	L3MBTL2	41213892	41214026	476	135	118342	6141	117866	6006	3.525925925925926	19.624708624708624
chr22	L3MBTL2	41208314	41208457	773	144	118342	6141	117569	5997	5.368055555555555	19.60463565115891
chr22	L3MBTL2	41227574	41227679	384	106	118342	6141	117958	6035	3.6226415094339623	19.545650372825186
chr22	ACO2	41518480	41518572	408	93	42848	9940	42440	9847	4.387096774193548	4.309942114349548
chr22	ACO2	41522829	41522987	0	159	42848	9940	42848	9781	0.0	4.380738165831715
chr22	ACO2	41526261	41526453	102	193	42848	9940	42746	9747	0.5284974093264249	4.385554529598851
chr22	ACO2	41527138	41527202	0	65	42848	9940	42848	9875	0.0	4.339037974683544
chr22	ACO2	41502629	41502771	876	143	42848	9940	41972	9797	6.125874125874126	4.284168623047872
chr22	ACO2	41507445	41507606	0	162	42848	9940	42848	9778	0.0	4.382082225403968
chr22	ACO2	41517942	41518408	8	467	42848	9940	42840	9473	0.017130620985010708	4.522326612477568
chr22	ACO2	41518495	41518572	288	78	42848	9940	42560	9862	3.6923076923076925	4.315554654228351
chr22	ACO2	41477912	41478127	0	216	42848	9940	42848	9724	0.0	4.406417112299465
chr22	ACO2	41504910	41505035	88	126	42848	9940	42760	9814	0.6984126984126984	4.357040961891176
chr22	ACO2	41511030	41511147	0	118	42848	9940	42848	9822	0.0	4.362451639177357
chr22	XRCC6	41628117	41628230	19	114	148208	3146	148189	3032	0.16666666666666666	48.875
chr22	MEI1	41753948	41754046	10863	99	52128	6712	41265	6613	109.72727272727273	6.239981853924089
chr22	MEI1	41784607	41784783	51	177	52128	6712	52077	6535	0.288135593220339	7.96893649579189
chr22	MEI1	41795410	41795542	0	133	52128	6712	52128	6579	0.0	7.9233926128590975
chr22	MEI1	41784338	41784420	30	83	52128	6712	52098	6629	0.3614457831325301	7.859103937245437
chr22	SREBF2	41878658	41878758	52	101	36163	7580	36111	7479	0.5148514851485149	4.828319294023265
chr22	SREBF2	41904534	41904732	0	199	36163	7580	36163	7381	0.0	4.8994716163121526
chr22	SEPTIN3	41981644	41981836	0	193	133774	4980	133774	4787	0.0	27.945268435345728
chr22	WBP2NL	42032392	42032487	0	96	193668	4482	193668	4386	0.0	44.155950752393984
chr22	WBP2NL	42022248	42022356	0	109	193668	4482	193668	4373	0.0	44.28721701349188
chr22	NDUFA6-DT	42092118	42092232	2690	115	26586	5096	23896	4981	23.391304347826086	4.797430234892592
chr22	NDUFA6-DT	42112305	42112390	0	86	26586	5096	26586	5010	0.0	5.3065868263473055
chr22	NDUFA6-DT	42123765	42123804	0	40	26586	5096	26586	5056	0.0	5.2583069620253164
chr22	NDUFA6-DT	42120035	42120128	0	94	26586	5096	26586	5002	0.0	5.315073970411835
chr22	NDUFA6-DT	42123525	42123591	0	67	26586	5096	26586	5029	0.0	5.286538079140982
chr22	NDUFA6-DT	42133329	42133410	0	82	26586	5096	26586	5014	0.0	5.3023534104507375
chr22	OGFRP1	42273893	42273974	18425	82	205792	3801	187367	3719	224.6951219512195	50.38101640225867
chr22	OGFRP1	42274655	42274821	4377	167	205792	3801	201415	3634	26.209580838323355	55.425151348376446
chr22	SERHL	42511815	42511927	0	113	740	2853	740	2740	0.0	0.27007299270072993
chr22	SERHL2	42555663	42555705	0	43	8137	2806	8137	2763	0.0	2.9449873326094824
chr22	SERHL2	42554937	42555087	0	151	8137	2806	8137	2655	0.0	3.064783427495292
chr22	SERHL2	42560185	42560265	0	81	8137	2806	8137	2725	0.0	2.98605504587156
chr22	SERHL2	42566303	42566338	0	36	8137	2806	8137	2770	0.0	2.9375451263537906
chr22	TSPO	43159209	43159420	0	212	0	1395	0	1183	0.0	0.0
chr22	PARVB	44151482	44151551	0	70	2300	7393	2300	7323	0.0	0.3140789294005189
chr22	PARVG	44181741	44181917	0	177	5004	7893	5004	7716	0.0	0.6485225505443235
chr22	PARVG	44196346	44196415	0	70	5004	7893	5004	7823	0.0	0.6396523072989901
chr22	LINC00207	44570499	44570588	0	90	0	1410	0	1320	0.0	0.0
chr22	LINC00207	44570499	44570624	0	126	0	1410	0	1284	0.0	0.0
chr22	LINC00207	44569596	44569663	0	68	0	1410	0	1342	0.0	0.0
chr22	PRR5	44702491	44702608	0	118	0	5239	0	5121	0.0	0.0
chr22	PRR5	44725243	44725292	0	50	0	5239	0	5189	0.0	0.0
chr22	PRR5	44735026	44735162	0	137	0	5239	0	5102	0.0	0.0
chr22	PRR5	44679346	44679885	0	540	0	5239	0	4699	0.0	0.0
chr22	ARHGAP8	44802076	44802164	0	89	1546	4776	1546	4687	0.0	0.32984851717516533
chr22	ARHGAP8	44808306	44808438	0	133	1546	4776	1546	4643	0.0	0.332974370019384
chr22	ARHGAP8	44859730	44859834	0	105	1546	4776	1546	4671	0.0	0.3309783772211518
chr22	ARHGAP8	44809005	44809098	0	94	1546	4776	1546	4682	0.0	0.33020076890217853
chr22	ARHGAP8	44777161	44777229	0	69	1546	4776	1546	4707	0.0	0.32844699383896325
chr22	ARHGAP8	44808671	44808732	0	62	1546	4776	1546	4714	0.0	0.32795927025880356
chr22	ARHGAP8	44786041	44786101	0	61	1546	4776	1546	4715	0.0	0.3278897136797455
chr22	NUP50	45175893	45176080	0	188	102	6581	102	6393	0.0	0.015954950727358048
chr22	NUP50	45178237	45178900	0	664	102	6581	102	5917	0.0	0.01723846543856684
chr22	NUP50	45170987	45171143	0	157	102	6581	102	6424	0.0	0.015877957658779578
chr22	NUP50	45166308	45166430	0	123	102	6581	102	6458	0.0	0.015794363580055745
chr22	NUP50	45170987	45171152	0	166	102	6581	102	6415	0.0	0.015900233826968042
chr22	NUP50	45170987	45171177	0	191	102	6581	102	6390	0.0	0.01596244131455399
chr22	NUP50	45165864	45166116	51	253	102	6581	51	6328	0.2015810276679842	0.008059418457648546
chr22	FBLN1	45523090	45523204	51	115	38569	7040	38518	6925	0.4434782608695652	5.562166064981949
chr22	FBLN1	45531264	45531324	0	61	38569	7040	38569	6979	0.0	5.526436452213784
chr22	FBLN1	45548612	45548744	1576	133	38569	7040	36993	6907	11.849624060150376	5.355870855653684
chr22	ATXN10	45689711	45689903	0	193	1756	5148	1756	4955	0.0	0.3543895055499495
chr22	PRR34-AS1	46055598	46055733	0	136	0	1098	0	962	0.0	0.0
chr22	MIRLET7BHG	46103191	46103249	0	59	2295	5737	2295	5678	0.0	0.4041916167664671
chr22	PPARA	46176752	46176836	0	85	318191	13233	318191	13148	0.0	24.2007149376331
chr22	PPARA	46188722	46188822	0	101	318191	13233	318191	13132	0.0	24.230201035638135
chr22	TTC38	46269141	46269289	0	149	3886	3596	3886	3447	0.0	1.1273571221351901
chr22	TTC38	46281970	46282151	0	182	3886	3596	3886	3414	0.0	1.1382542472173403
chr22	TTC38	46292202	46292328	0	127	3886	3596	3886	3469	0.0	1.1202075526088209
chr22	TRMU	46337778	46337944	0	167	504	7870	504	7703	0.0	0.06542905361547449
chr22	TRMU	46355989	46356072	0	84	504	7870	504	7786	0.0	0.06473156948368868
chr22	TRMU	46343261	46343368	0	108	504	7870	504	7762	0.0	0.06493171862921927
chr22	TRMU	46347372	46347495	0	124	504	7870	504	7746	0.0	0.06506584043377227
chr22	TBC1D22A	46792667	46792804	0	138	5965	5336	5965	5198	0.0	1.1475567525971528
chr22	TBC1D22A	46797443	46797620	0	178	5965	5336	5965	5158	0.0	1.1564559906940675
chr22	TBC1D22A	46878652	46878723	0	72	5965	5336	5965	5264	0.0	1.1331686930091185
chr22	TBC1D22A	46792519	46792576	1303	58	5965	5336	4662	5278	22.46551724137931	0.883289124668435
chr22	TBC1D22A	46789311	46789471	0	161	5965	5336	5965	5175	0.0	1.152657004830918
chr22	TBC1D22A	46792667	46792762	0	96	5965	5336	5965	5240	0.0	1.1383587786259541
chr22	AL117329.1	47635179	47635353	0	175	51	31762	51	31587	0.0	0.001614588279988603
chr22	AL117329.1	47635179	47635355	0	177	51	31762	51	31585	0.0	0.0016146905176507836
chr22	AL117329.1	47687140	47687206	0	67	51	31762	51	31695	0.0	0.001609086606720303
chr22	AL117329.1	47704588	47704747	0	160	51	31762	51	31602	0.0	0.0016138219100056959
chr22	AL117329.1	47738433	47738576	0	144	51	31762	51	31618	0.0	0.0016130052501739515
chr22	AL117329.1	47728828	47728995	0	168	51	31762	51	31594	0.0	0.0016142305501044502
chr22	AL117329.1	47641984	47642173	0	190	51	31762	51	31572	0.0	0.0016153553781832002
chr22	AL117329.1	47637509	47637604	0	96	51	31762	51	31666	0.0	0.00161056022232047
chr22	AL117329.1	47688595	47688719	0	125	51	31762	51	31637	0.0	0.0016120365394948952
chr22	AL117329.1	47724273	47724325	0	53	51	31762	51	31709	0.0	0.001608376170803242
chr22	AL117329.1	47793397	47793517	0	121	51	31762	51	31641	0.0	0.001611832748648905
chr22	AL117329.1	47685316	47685477	0	162	51	31762	51	31600	0.0	0.0016139240506329114
chr22	AL117329.1	47760418	47760492	0	75	51	31762	51	31687	0.0	0.0016094928519582163
chr22	AL117329.1	47634446	47634636	0	191	51	31762	51	31571	0.0	0.001615406543980235
chr22	AL117329.1	47637502	47637604	0	103	51	31762	51	31659	0.0	0.0016109163271107742
chr22	AL117329.1	47861991	47862122	0	132	51	31762	51	31630	0.0	0.0016123932975023712
chr22	AL117329.1	47710698	47710747	0	50	51	31762	51	31712	0.0	0.0016082240161453079
chr22	TAFA5	48646596	48646746	0	151	47	3087	47	2936	0.0	0.01600817438692098
chr22	CRELD2	49923233	49923317	0	85	0	3667	0	3582	0.0	0.0
chr22	CRELD2	49924359	49924455	0	97	0	3667	0	3570	0.0	0.0
chr22	CRELD2	49922296	49922443	0	148	0	3667	0	3519	0.0	0.0
chr22	MOV10L1	50120501	50120616	0	116	520	6832	520	6716	0.0	0.07742703990470517
chr22	MOV10L1	50150734	50150899	0	166	520	6832	520	6666	0.0	0.078007800780078
chr22	MOV10L1	50160687	50160825	0	139	520	6832	520	6693	0.0	0.07769311220678321
chr22	MOV10L1	50160963	50161055	0	93	520	6832	520	6739	0.0	0.0771627837958154
chr22	PANX2	50175431	50175482	283	52	36280	3023	35997	2971	5.4423076923076925	12.116122517670817
chr22	PPP6R2	50436987	50437068	0	82	102	5374	102	5292	0.0	0.01927437641723356
chr22	NCAPH2	50516446	50516548	0	103	19	4166	19	4063	0.0	0.004676347526458282
chr22	NCAPH2	50515719	50515774	0	56	19	4166	19	4110	0.0	0.004622871046228711
chr22	SHANK3	50724126	50724153	0	28	432526	9119	432526	9091	0.0	47.57738422615774
chr22	SHANK3	50698143	50698342	663	200	432526	9119	431863	8919	3.315	48.42056284336809
chrX	PLCXD1	281481	281684	3496	204	91280	6077	87784	5873	17.137254901960784	14.947045802826494
chrX	CSF2RA	1274754	1274842	0	89	0	3562	0	3473	0.0	0.0
chrX	CSF2RA	1285777	1285920	0	144	0	3562	0	3418	0.0	0.0
chrX	CSF2RA	1303260	1303362	0	103	0	3562	0	3459	0.0	0.0
chrX	CSF2RA	1300490	1300626	0	137	0	3562	0	3425	0.0	0.0
chrX	CSF2RA	1303922	1304019	0	98	0	3562	0	3464	0.0	0.0
chrX	CSF2RA	1274754	1274818	0	65	0	3562	0	3497	0.0	0.0
chrX	CSF2RA	1282408	1282560	0	153	0	3562	0	3409	0.0	0.0
chrX	CSF2RA	1305445	1305527	0	83	0	3562	0	3479	0.0	0.0
chrX	AKAP17A	1600137	1600207	0	71	153	3371	153	3300	0.0	0.046363636363636364
chrX	ASMT	1632703	1632787	0	85	0	1797	0	1712	0.0	0.0
chrX	ASMT	1633149	1633290	0	142	0	1797	0	1655	0.0	0.0
chrX	CD99P1	2622689	2622734	0	46	284673	5932	284673	5886	0.0	48.364424057084605
chrX	CD99	2717604	2717652	0	49	51	4873	51	4824	0.0	0.010572139303482588
chrX	CD99	2733356	2733374	0	19	51	4873	51	4854	0.0	0.010506798516687269
chrX	CD99	2727292	2727343	0	52	51	4873	51	4821	0.0	0.010578718108276292
chrX	XG	2806700	2806745	0	46	392	3368	392	3322	0.0	0.11800120409391933
chrX	GYG2	2842997	2843090	0	94	4223	3634	4223	3540	0.0	1.1929378531073447
chrX	GYG2	2853979	2854154	0	176	4223	3634	4223	3458	0.0	1.2212261422787738
chrX	GYG2	2877199	2877307	0	109	4223	3634	4223	3525	0.0	1.1980141843971632
chrX	GYG2	2843212	2843354	0	143	4223	3634	4223	3491	0.0	1.2096820395302206
chrX	GYG2	2875809	2875914	0	106	4223	3634	4223	3528	0.0	1.1969954648526078
chrX	LINC01546	3276985	3277517	0	533	51	4425	51	3892	0.0	0.013103802672147996
chrX	STS	7305045	7305183	0	139	102	12361	102	12222	0.0	0.008345606283750613
chrX	TBL1X	9653544	9653689	0	146	5090	9022	5090	8876	0.0	0.5734565119423164
chrX	TBL1X	9534899	9535034	0	136	5090	9022	5090	8886	0.0	0.5728111636281792
chrX	TBL1X	9636281	9637918	3162	1638	5090	9022	1928	7384	1.9304029304029304	0.2611050920910076
chrX	CLCN4	10195702	10195726	0	25	561	7579	561	7554	0.0	0.07426528991262907
chrX	CLCN4	10228345	10228595	0	251	561	7579	561	7328	0.0	0.07655567685589519
chrX	CLCN4	10191889	10191975	0	87	561	7579	561	7492	0.0	0.07487987186332087
chrX	AMELX	11298102	11298144	0	43	0	842	0	799	0.0	0.0
chrX	AMELX	11296778	11296826	0	49	0	842	0	793	0.0	0.0
chrX	MSL3	11759792	11759875	0	84	3468	7299	3468	7215	0.0	0.4806652806652807
chrX	MSL3	11760402	11760498	0	97	3468	7299	3468	7202	0.0	0.4815329075256873
chrX	MSL3	11768572	11768682	0	111	3468	7299	3468	7188	0.0	0.48247078464106846
chrX	MSL3	11772620	11772705	0	86	3468	7299	3468	7213	0.0	0.4807985581588798
chrX	MSL3	11761499	11761582	0	84	3468	7299	3468	7215	0.0	0.4806652806652807
chrX	MSL3	11768574	11768682	0	109	3468	7299	3468	7190	0.0	0.48233657858136303
chrX	MSL3	11766960	11767052	0	93	3468	7299	3468	7206	0.0	0.48126561199000834
chrX	MSL3	11766960	11767169	1326	210	3468	7299	2142	7089	6.314285714285714	0.302158273381295
chrX	MSL3	11766960	11767046	0	87	3468	7299	3468	7212	0.0	0.480865224625624
chrX	MSL3	11767818	11767862	0	45	3468	7299	3468	7254	0.0	0.47808105872622003
chrX	PRPS2	12819506	12819680	0	175	670	2703	670	2528	0.0	0.2650316455696203
chrX	TLR8	12910305	12910442	0	138	102	4356	102	4218	0.0	0.02418207681365576
chrX	LINC01203	13379597	13379798	0	202	2	6494	2	6292	0.0	0.0003178639542275906
chrX	LINC01203	13395261	13395392	0	132	2	6494	2	6362	0.0	0.00031436655139893113
chrX	LINC01203	13335211	13335312	0	102	2	6494	2	6392	0.0	0.00031289111389236547
chrX	LINC01203	13373061	13373234	0	174	2	6494	2	6320	0.0	0.00031645569620253165
chrX	LINC01203	13335658	13335697	0	40	2	6494	2	6454	0.0	0.0003098853424233034
chrX	RAB9A	13703813	13703902	0	90	204	2116	204	2026	0.0	0.10069101678183613
chrX	RAB9A	13703734	13703902	0	169	204	2116	204	1947	0.0	0.10477657935285054
chrX	OFD1	13740088	13740213	0	126	18139	5201	18139	5075	0.0	3.5741871921182264
chrX	OFD1	13751248	13751368	0	121	18139	5201	18139	5080	0.0	3.5706692913385827
chrX	OFD1	13758336	13758448	0	113	18139	5201	18139	5088	0.0	3.565055031446541
chrX	OFD1	13763744	13763855	12	112	18139	5201	18127	5089	0.10714285714285714	3.561996462959324
chrX	GLRA2	14530971	14531178	0	208	0	3717	0	3509	0.0	0.0
chrX	BMX	15534211	15534339	0	129	5372	2849	5372	2720	0.0	1.975
chrX	CA5B	15745630	15745710	0	81	32719	7863	32719	7782	0.0	4.204446157800051
chrX	MAGEB17	16168731	16168908	3502	178	50035	1614	46533	1436	19.674157303370787	32.40459610027855
chrX	NHS	17719343	17719406	0	64	0	10626	0	10562	0.0	0.0
chrX	SCML1	17744070	17744219	360	150	1635	4066	1275	3916	2.4	0.3255873340143003
chrX	SCML1	17745455	17745539	0	85	1635	4066	1635	3981	0.0	0.4107008289374529
chrX	CDKL5	18623878	18624001	0	124	7690	18806	7690	18682	0.0	0.411626164222246
chrX	CDKL5	18443818	18443959	0	142	7690	18806	7690	18664	0.0	0.4120231461637377
chrX	CDKL5	18457482	18457534	0	53	7690	18806	7690	18753	0.0	0.4100677224977337
chrX	PPEF1	18730180	18730308	0	129	288	3534	288	3405	0.0	0.08458149779735682
chrX	PPEF1	18803891	18804077	0	187	288	3534	288	3347	0.0	0.08604720645354048
chrX	PPEF1	18823922	18824086	0	165	288	3534	288	3369	0.0	0.0854853072128228
chrX	AL732509.1	19051703	19052145	0	443	102	5265	102	4822	0.0	0.021153048527581916
chrX	PDHA1	19346509	19346623	0	115	2703	4235	2703	4120	0.0	0.6560679611650485
chrX	PDHA1	19354490	19354583	0	94	2703	4235	2703	4141	0.0	0.652740883844482
chrX	PDHA1	19345735	19345819	0	85	2703	4235	2703	4150	0.0	0.6513253012048192
chrX	CNKSR2	21526866	21527000	0	135	9804	24430	9804	24295	0.0	0.40353982300884955
chrX	CNKSR2	21594973	21595047	0	75	9804	24430	9804	24355	0.0	0.4025456785054404
chrX	CNKSR2	21516484	21516631	0	148	9804	24430	9804	24282	0.0	0.40375586854460094
chrX	CNKSR2	21561470	21561560	0	91	9804	24430	9804	24339	0.0	0.4028103044496487
chrX	CNKSR2	21607994	21608131	0	138	9804	24430	9804	24292	0.0	0.4035896591470443
chrX	CNKSR2	21590714	21590786	0	73	9804	24430	9804	24357	0.0	0.4025126247074763
chrX	CNKSR2	21468594	21468674	72	81	9804	24430	9732	24349	0.8888888888888888	0.39968787219187646
chrX	CNKSR2	21637273	21637414	0	142	9804	24430	9804	24288	0.0	0.40365612648221344
chrX	SMS	21971896	21971990	510	95	5184	2038	4674	1943	5.368421052631579	2.4055584148224396
chrX	SMS	21972506	21972571	21	66	5184	2038	5163	1972	0.3181818181818182	2.61815415821501
chrX	PTCHD1	23379590	23380251	260	662	5591	12886	5331	12224	0.39274924471299094	0.4361092931937173
chrX	PRDX4	23686001	23686047	0	47	14	1865	14	1818	0.0	0.007700770077007701
chrX	SAT1	23783799	23783883	1119	85	8069	2184	6950	2099	13.16470588235294	3.311100524059076
chrX	SAT1	23784293	23784403	233	111	8069	2184	7836	2073	2.099099099099099	3.780028943560058
chrX	CXORF58	23923084	23923207	0	124	133	1855	133	1731	0.0	0.07683419988445984
chrX	ZFX	24208217	24208370	0	154	17988	9055	17988	8901	0.0	2.020896528479946
chrX	ZFX	24173606	24173723	1675	118	17988	9055	16313	8937	14.194915254237289	1.8253328857558464
chrX	ZFX	24207325	24207475	0	151	17988	9055	17988	8904	0.0	2.0202156334231804
chrX	ZFX	24152719	24152830	0	112	17988	9055	17988	8943	0.0	2.0114055686011407
chrX	ZFX	24151690	24151800	51	111	17988	9055	17937	8944	0.4594594594594595	2.005478533094812
chrX	ZFX	24161714	24161842	0	129	17988	9055	17988	8926	0.0	2.015236388079767
chrX	POLA1	24703250	24703347	0	98	10526	14745	10526	14647	0.0	0.7186454564074555
chrX	POLA1	24744599	24744893	0	295	10526	14745	10526	14450	0.0	0.7284429065743945
chrX	POLA1	24733754	24733816	0	63	10526	14745	10526	14682	0.0	0.7169322980520365
chrX	POLA1	24739374	24739550	0	177	10526	14745	10526	14568	0.0	0.7225425590334981
chrX	POLA1	24742001	24742121	0	121	10526	14745	10526	14624	0.0	0.7197757111597374
chrX	DCAF8L2	27712557	27712649	0	93	102	4428	102	4335	0.0	0.023529411764705882
chrX	MAGEB1	30247389	30247472	0	84	0	1976	0	1892	0.0	0.0
chrX	GK	30668011	30668118	0	108	1545	5391	1545	5283	0.0	0.2924474730266894
chrX	GK	30691122	30691199	0	78	1545	5391	1545	5313	0.0	0.29079616036137773
chrX	GK	30727465	30727552	0	88	1545	5391	1545	5303	0.0	0.291344521968697
chrX	GK	30697731	30697749	0	19	1545	5391	1545	5372	0.0	0.287602382725242
chrX	GK	30674301	30674466	68	166	1545	5391	1477	5225	0.40963855421686746	0.2826794258373206
chrX	GK	30665510	30665584	0	75	1545	5391	1545	5316	0.0	0.29063205417607224
chrX	GK	30695082	30695132	0	51	1545	5391	1545	5340	0.0	0.2893258426966292
chrX	AL591501.1	33917911	33917960	0	50	151	14454	151	14404	0.0	0.010483199111357956
chrX	AL591501.1	34295941	34296002	0	62	151	14454	151	14392	0.0	0.010491939966648137
chrX	AL591501.1	33853614	33853715	0	102	151	14454	151	14352	0.0	0.01052118171683389
chrX	AL591501.1	34270089	34270260	0	172	151	14454	151	14282	0.0	0.010572748914717827
chrX	MAGEB16	35801320	35801374	0	55	0	1991	0	1936	0.0	0.0
chrX	MAGEB16	35800516	35800568	0	53	0	1991	0	1938	0.0	0.0
chrX	CFAP47	36366965	36367127	0	163	163	11508	163	11345	0.0	0.014367562802996914
chrX	PRRG1	37425839	37426000	0	162	445	6149	445	5987	0.0	0.07432771003841657
chrX	PRRG1	37386598	37386689	0	92	445	6149	445	6057	0.0	0.07346871388476144
chrX	LANCL3	37668367	37668450	0	84	102	10304	102	10220	0.0	0.009980430528375734
chrX	SYTL5	38103025	38103091	0	67	13537	4838	13537	4771	0.0	2.837350660238944
chrX	OTC	38373595	38373738	0	144	51	1694	51	1550	0.0	0.032903225806451615
chrX	TSPAN7	38655995	38656155	1122	161	1122	2953	0	2792	6.968944099378882	0.0
chrX	TSPAN7	38622902	38623033	0	132	1122	2953	1122	2821	0.0	0.3977313009571074
chrX	TSPAN7	38646261	38646312	0	52	1122	2953	1122	2901	0.0	0.38676318510858326
chrX	MID1IP1	38802534	38804413	0	1880	0	4839	0	2959	0.0	0.0
chrX	MID1IP1	38804309	38804413	0	105	0	4839	0	4734	0.0	0.0
chrX	ATP6AP2	40597248	40597344	0	97	11430	6093	11430	5996	0.0	1.9062708472314878
chrX	ATP6AP2	40588985	40589116	0	132	11430	6093	11430	5961	0.0	1.9174635128334172
chrX	ATP6AP2	40597526	40597664	3073	139	11430	6093	8357	5954	22.107913669064747	1.403594222371515
chrX	ATP6AP2	40600761	40600881	0	121	11430	6093	11430	5972	0.0	1.9139316811788345
chrX	ATP6AP2	40598935	40599018	0	84	11430	6093	11430	6009	0.0	1.9021467798302547
chrX	ATP6AP2	40600768	40600881	0	114	11430	6093	11430	5979	0.0	1.911690918213748
chrX	ATP6AP2	40597252	40597344	0	93	11430	6093	11430	6000	0.0	1.905
chrX	ATP6AP2	40598680	40598734	0	55	11430	6093	11430	6038	0.0	1.8930109307717788
chrX	ATP6AP2	40600781	40600881	0	101	11430	6093	11430	5992	0.0	1.907543391188251
chrX	ATP6AP2	40603336	40603439	0	104	11430	6093	11430	5989	0.0	1.9084989146769076
chrX	DDX3X	41339035	41339083	0	49	2617	11657	2617	11608	0.0	0.22544796691936594
chrX	DDX3X	41334125	41334297	0	173	2617	11657	2617	11484	0.0	0.22788227098571925
chrX	DDX3X	41343215	41343351	0	137	2617	11657	2617	11520	0.0	0.2271701388888889
chrX	DDX3X	41343736	41343822	70	87	2617	11657	2547	11570	0.8045977011494253	0.2201382886776145
chrX	DDX3X	41344029	41344128	0	100	2617	11657	2617	11557	0.0	0.22644284849009258
chrX	DDX3X	41347859	41347915	0	57	2617	11657	2617	11600	0.0	0.22560344827586207
chrX	DDX3X	41357832	41358000	38	169	2617	11657	2579	11488	0.22485207100591717	0.2244951253481894
chrX	DDX3X	41347639	41347915	0	277	2617	11657	2617	11380	0.0	0.22996485061511424
chrX	DDX3X	41357832	41357939	38	108	2617	11657	2579	11549	0.35185185185185186	0.2233093774352758
chrX	DDX3X	41357832	41357990	38	159	2617	11657	2579	11498	0.2389937106918239	0.22429987823969386
chrX	DDX3X	41337407	41337465	0	59	2617	11657	2617	11598	0.0	0.22564235212967754
chrX	DDX3X	41341948	41342046	0	99	2617	11657	2617	11558	0.0	0.22642325661879217
chrX	DDX3X	41339038	41339083	0	46	2617	11657	2617	11611	0.0	0.2253897166480062
chrX	DDX3X	41337690	41339083	51	1394	2617	11657	2566	10263	0.036585365853658534	0.2500243593491182
chrX	DDX3X	41343220	41343351	0	132	2617	11657	2617	11525	0.0	0.22707158351409978
chrX	DDX3X	41340635	41340814	0	180	2617	11657	2617	11477	0.0	0.2280212599111266
chrX	DDX3X	41337690	41338912	51	1223	2617	11657	2566	10434	0.041700735895339326	0.24592677784167147
chrX	DDX3X	41336082	41336159	0	78	2617	11657	2617	11579	0.0	0.2260126090335953
chrX	DDX3X	41343288	41343351	0	64	2617	11657	2617	11593	0.0	0.22573967049081342
chrX	MAOA	43657861	43657969	0	109	9	5544	9	5435	0.0	0.001655933762649494
chrX	NDP-AS1	43967842	43968686	0	845	0	2172	0	1327	0.0	0.0
chrX	KDM6A	44974665	44974715	0	51	0	19804	0	19753	0.0	0.0
chrX	KDM6A	45020609	45020730	0	122	0	19804	0	19682	0.0	0.0
chrX	KDM6A	45051708	45051802	0	95	0	19804	0	19709	0.0	0.0
chrX	KDM6A	45060608	45060764	0	157	0	19804	0	19647	0.0	0.0
chrX	KDM6A	45062646	45062748	0	103	0	19804	0	19701	0.0	0.0
chrX	KDM6A	45079145	45079351	0	207	0	19804	0	19597	0.0	0.0
chrX	KDM6A	45106541	45106713	0	173	0	19804	0	19631	0.0	0.0
chrX	KDM6A	44976651	44976708	0	58	0	19804	0	19746	0.0	0.0
chrX	KDM6A	45090722	45090864	0	143	0	19804	0	19661	0.0	0.0
chrX	KDM6A	45060021	45060156	0	136	0	19804	0	19668	0.0	0.0
chrX	KDM6A	44961283	44961392	0	110	0	19804	0	19694	0.0	0.0
chrX	KDM6A	45068580	45069043	0	464	0	19804	0	19340	0.0	0.0
chrX	KDM6A	45090722	45090832	0	111	0	19804	0	19693	0.0	0.0
chrX	KDM6A	45106541	45106649	0	109	0	19804	0	19695	0.0	0.0
chrX	RGN	47080316	47080936	21842	621	106761	2818	84919	2197	35.17230273752013	38.652253072371415
chrX	RGN	47091677	47091809	0	133	106761	2818	106761	2685	0.0	39.762011173184355
chrX	RGN	47089775	47089991	0	217	106761	2818	106761	2601	0.0	41.04613610149942
chrX	RBM10	47171027	47171258	0	232	0	3562	0	3330	0.0	0.0
chrX	UBA1	47198308	47198355	0	48	850	6442	850	6394	0.0	0.13293712855802314
chrX	UBA1	47198166	47198355	0	190	850	6442	850	6252	0.0	0.13595649392194498
chrX	CDK16	47222272	47222342	0	71	0	5750	0	5679	0.0	0.0
chrX	CDK16	47222260	47222380	0	121	0	5750	0	5629	0.0	0.0
chrX	CDK16	47222260	47222342	0	83	0	5750	0	5667	0.0	0.0
chrX	TIMP1	47583407	47583536	0	130	51	1443	51	1313	0.0	0.03884234577303884
chrX	UXT-AS1	47685315	47685461	0	147	0	5414	0	5267	0.0	0.0
chrX	ZNF81	47842649	47842768	3327	120	41999	11822	38672	11702	27.725	3.304734233464365
chrX	SSX4	48389345	48389481	0	137	19406	1240	19406	1103	0.0	17.59383499546691
chrX	FTSJ1	48476562	48476668	140	107	184	2878	44	2771	1.308411214953271	0.015878744135691087
chrX	FTSJ1	48481150	48481203	0	54	184	2878	184	2824	0.0	0.06515580736543909
chrX	PORCN	48511294	48511487	0	194	40	2636	40	2442	0.0	0.01638001638001638
chrX	PORCN	48514126	48514141	0	16	40	2636	40	2620	0.0	0.015267175572519083
chrX	PORCN	48512834	48512852	0	19	40	2636	40	2617	0.0	0.015284677111196026
chrX	PORCN	48511365	48511487	0	123	40	2636	40	2513	0.0	0.01591723040191007
chrX	PORCN	48509423	48509577	0	155	40	2636	40	2481	0.0	0.016122531237404272
chrX	EBP	48522144	48522252	0	109	0	1774	0	1665	0.0	0.0
chrX	EBP	48522192	48522252	0	61	0	1774	0	1713	0.0	0.0
chrX	TBC1D25	48544868	48545023	51	156	39475	3839	39424	3683	0.3269230769230769	10.704317132772196
chrX	TBC1D25	48541332	48541442	0	111	39475	3839	39475	3728	0.0	10.588787553648068
chrX	RBM3	48575560	48575630	0	71	4998	5201	4998	5130	0.0	0.9742690058479532
chrX	RBM3	48575560	48575667	0	108	4998	5201	4998	5093	0.0	0.9813469467897113
chrX	RBM3	48575921	48576083	408	163	4998	5201	4590	5038	2.503067484662577	0.9110758237395792
chrX	WAS	48686780	48686955	115	176	26528	2375	26413	2199	0.6534090909090909	12.011368804001819
chrX	GATA1	48791090	48791329	3656	240	172876	1498	169220	1258	15.233333333333333	134.51510333863274
chrX	HDAC6	48802662	48802785	80	124	157384	7947	157304	7823	0.6451612903225806	20.10788699987217
chrX	HDAC6	48808257	48808326	51	70	157384	7947	157333	7877	0.7285714285714285	19.973720959756253
chrX	HDAC6	48818219	48818412	1420	194	157384	7947	155964	7753	7.319587628865979	20.116600025796465
chrX	HDAC6	48820105	48820255	570	151	157384	7947	156814	7796	3.774834437086093	20.11467419189328
chrX	PQBP1	48902232	48902517	204	286	41260	1863	41056	1577	0.7132867132867133	26.03424223208624
chrX	PQBP1	48902232	48902384	204	153	41260	1863	41056	1710	1.3333333333333333	24.009356725146198
chrX	MAGIX	49164907	49165090	0	184	0	4936	0	4752	0.0	0.0
chrX	MAGIX	49164862	49165090	0	229	0	4936	0	4707	0.0	0.0
chrX	PPP1R3F	49270607	49270873	0	267	0	4334	0	4067	0.0	0.0
chrX	GAGE1	49604997	49605140	0	144	0	3135	0	2991	0.0	0.0
chrX	CLCN5	50085451	50085634	0	184	1173	11479	1173	11295	0.0	0.10385126162018592
chrX	CLCN5	50088412	50088484	0	73	1173	11479	1173	11406	0.0	0.10284061020515518
chrX	CCNB3	50308504	50311496	0	2993	51	5427	51	2434	0.0	0.0209531635168447
chrX	MAGED1	51894275	51894349	0	75	0	5346	0	5271	0.0	0.0
chrX	MAGED1	51894268	51894349	0	82	0	5346	0	5264	0.0	0.0
chrX	MAGED1	51894626	51894794	0	169	0	5346	0	5177	0.0	0.0
chrX	AC239585.2	52054056	52054190	0	135	0	765	0	630	0.0	0.0
chrX	MAGED4	52190344	52190392	0	49	102	4286	102	4237	0.0	0.024073637007316497
chrX	SSX8P	52628941	52629144	0	204	0	1783	0	1579	0.0	0.0
chrX	SSX8P	52625226	52625349	0	124	0	1783	0	1659	0.0	0.0
chrX	SSX2B	52759500	52759646	7	147	7	2265	0	2118	0.047619047619047616	0.0
chrX	XAGE5	52814188	52814344	0	157	0	1120	0	963	0.0	0.0
chrX	FAM156B	52900567	52900660	0	94	102	4461	102	4367	0.0	0.023356995649187084
chrX	FAM156B	52900570	52900660	0	91	102	4461	102	4370	0.0	0.02334096109839817
chrX	GPR173	53070987	53071110	0	124	0	4913	0	4789	0.0	0.0
chrX	RIBC1	53428282	53428627	5145	346	52895	2329	47750	1983	14.869942196531792	24.079677256681794
chrX	GNL3L	54541272	54541389	0	118	66397	11968	66397	11850	0.0	5.603122362869199
chrX	GNL3L	54550365	54550616	1632	252	66397	11968	64765	11716	6.476190476190476	5.527910549675657
chrX	TRO	54920965	54921059	0	95	0	4939	0	4844	0.0	0.0
chrX	TRO	54922202	54922291	0	90	0	4939	0	4849	0.0	0.0
chrX	TRO	54922577	54923768	0	1192	0	4939	0	3747	0.0	0.0
chrX	TRO	54922217	54922291	0	75	0	4939	0	4864	0.0	0.0
chrX	TRO	54930740	54931031	0	292	0	4939	0	4647	0.0	0.0
chrX	APEX2	55002250	55002431	0	182	4845	3245	4845	3063	0.0	1.5817825661116551
chrX	RRAGB	55727306	55727390	0	85	11717	2726	11717	2641	0.0	4.436577054146157
chrX	AL050309.1	56002824	56002983	0	160	204	12309	204	12149	0.0	0.016791505473701538
chrX	AL050309.1	55985998	55986224	0	227	204	12309	204	12082	0.0	0.016884621751365667
chrX	KLF8	56250230	56250304	0	75	51	9486	51	9411	0.0	0.005419190309212623
chrX	KLF8	56270181	56270321	0	141	51	9486	51	9345	0.0	0.005457463884430177
chrX	KLF8	56268912	56268991	0	80	51	9486	51	9406	0.0	0.005422071018498831
chrX	NBDY	56811019	56811179	294	161	294	2378	0	2217	1.826086956521739	0.0
chrX	NBDY	56732062	56732199	0	138	294	2378	294	2240	0.0	0.13125
chrX	MIR223HG	66017064	66017189	0	126	0	3451	0	3325	0.0	0.0
chrX	HEPH	66170557	66170737	0	181	0	7136	0	6955	0.0	0.0
chrX	HEPH	66171126	66171268	0	143	0	7136	0	6993	0.0	0.0
chrX	AR	67680719	67681003	12	285	7086	12830	7074	12545	0.042105263157894736	0.5638899960143483
chrX	AR	67568835	67569022	0	188	7086	12830	7086	12642	0.0	0.5605125771238728
chrX	YIPF6	68511848	68511977	0	130	0	8616	0	8486	0.0	0.0
chrX	STARD8	68715293	68715375	0	83	2	5575	2	5492	0.0	0.0003641660597232338
chrX	EDA	69670209	69670293	0	85	522	7019	522	6934	0.0	0.07528122295933083
chrX	EDA	69620895	69620946	0	52	522	7019	522	6967	0.0	0.07492464475383953
chrX	GDPD2	70424975	70425089	0	115	189	2654	189	2539	0.0	0.07443875541551792
chrX	GDPD2	70426647	70426741	20	95	189	2654	169	2559	0.21052631578947367	0.06604142243063697
chrX	GDPD2	70430973	70431126	0	154	189	2654	189	2500	0.0	0.0756
chrX	GDPD2	70425353	70425457	68	105	189	2654	121	2549	0.6476190476190476	0.04746959591996862
chrX	DLG3	70448579	70448633	0	55	170064	7893	170064	7838	0.0	21.697371778514928
chrX	DLG3	70497179	70497221	30	43	170064	7893	170034	7850	0.6976744186046512	21.660382165605096
chrX	DLG3	70493375	70493475	0	101	170064	7893	170064	7792	0.0	21.82546201232033
chrX	DLG3	70495407	70495453	0	47	170064	7893	170064	7846	0.0	21.675248534284986
chrX	NLGN3	71153476	71153536	0	61	0	4014	0	3953	0.0	0.0
chrX	NLGN3	71148845	71148905	0	61	0	4014	0	3953	0.0	0.0
chrX	GJB1	71217720	71217895	0	176	0	4661	0	4485	0.0	0.0
chrX	GJB1	71223186	71223335	0	150	0	4661	0	4511	0.0	0.0
chrX	GJB1	71223219	71223335	0	117	0	4661	0	4544	0.0	0.0
chrX	GJB1	71222583	71222766	0	184	0	4661	0	4477	0.0	0.0
chrX	NONO	71284396	71284453	0	58	0	9256	0	9198	0.0	0.0
chrX	NONO	71294226	71294528	0	303	0	9256	0	8953	0.0	0.0
chrX	NONO	71297835	71297938	0	104	0	9256	0	9152	0.0	0.0
chrX	NONO	71284983	71285097	0	115	0	9256	0	9141	0.0	0.0
chrX	NONO	71299660	71299758	0	99	0	9256	0	9157	0.0	0.0
chrX	NONO	71297839	71297938	0	100	0	9256	0	9156	0.0	0.0
chrX	NONO	71297587	71297677	0	91	0	9256	0	9165	0.0	0.0
chrX	NONO	71294226	71294348	0	123	0	9256	0	9133	0.0	0.0
chrX	NONO	71296564	71296660	0	97	0	9256	0	9159	0.0	0.0
chrX	NONO	71290628	71290791	0	164	0	9256	0	9092	0.0	0.0
chrX	NONO	71288426	71288534	0	109	0	9256	0	9147	0.0	0.0
chrX	NONO	71294397	71294528	0	132	0	9256	0	9124	0.0	0.0
chrX	TAF1	71455006	71455012	3	7	1237475	10823	1237472	10816	0.42857142857142855	114.41124260355029
chrX	TAF1	71459149	71459251	0	103	1237475	10823	1237475	10720	0.0	115.43610074626865
chrX	OGT	71555189	71555385	3653	197	10516	8012	6863	7815	18.543147208121827	0.8781829814459373
chrX	NHSL2	72137093	72137225	0	133	51	16667	51	16534	0.0	0.0030845530422160396
chrX	DMRTC1B	72846884	72846945	102	62	204	1921	102	1859	1.6451612903225807	0.054868208714362564
chrX	DMRTC1B	72845871	72846005	0	135	204	1921	204	1786	0.0	0.11422172452407615
chrX	CHIC1	73679653	73679713	0	61	2071	4763	2071	4702	0.0	0.4404508719693747
chrX	CHIC1	73578703	73578785	0	83	2071	4763	2071	4680	0.0	0.4425213675213675
chrX	JPX	73994839	73994961	0	123	255	19827	255	19704	0.0	0.012941534713763702
chrX	JPX	73998767	73998844	0	78	255	19827	255	19749	0.0	0.012912046179553395
chrX	JPX	73998953	74000496	0	1544	255	19827	255	18283	0.0	0.013947382814636547
chrX	JPX	73944583	73944662	0	80	255	19827	255	19747	0.0	0.012913353927178812
chrX	JPX	73999354	74000496	0	1143	255	19827	255	18684	0.0	0.013648041104688504
chrX	JPX	73946998	73947374	0	377	255	19827	255	19450	0.0	0.013110539845758355
chrX	JPX	73998767	74000496	0	1730	255	19827	255	18097	0.0	0.014090733270707851
chrX	JPX	73984443	73984541	0	99	255	19827	255	19728	0.0	0.012925790754257907
chrX	JPX	73962730	73962801	0	72	255	19827	255	19755	0.0	0.012908124525436599
chrX	JPX	73962734	73962801	0	68	255	19827	255	19759	0.0	0.012905511412520877
chrX	JPX	73997043	73997166	0	124	255	19827	255	19703	0.0	0.012942191544434857
chrX	JPX	73997040	73997166	0	127	255	19827	255	19700	0.0	0.012944162436548223
chrX	JPX	73994863	73994961	0	99	255	19827	255	19728	0.0	0.012925790754257907
chrX	JPX	73966510	73966654	0	145	255	19827	255	19682	0.0	0.012956000406462758
chrX	SLC16A2	74529212	74529441	96	230	10557	4299	10461	4069	0.41739130434782606	2.5709019415089704
chrX	SLC16A2	74476962	74477125	0	164	10557	4299	10557	4135	0.0	2.5530834340991535
chrX	UPRT	75291674	75291747	0	74	155	3706	155	3632	0.0	0.04267621145374449
chrX	UPRT	75294562	75294620	35	59	155	3706	120	3647	0.5932203389830508	0.03290375651220181
chrX	UPRT	75296341	75296411	0	71	155	3706	155	3635	0.0	0.04264099037138927
chrX	UPRT	75291392	75291560	120	169	155	3706	35	3537	0.7100591715976331	0.009895391574780888
chrX	PBDC1	76176880	76176992	0	113	0	1213	0	1100	0.0	0.0
chrX	COX7B	77901743	77901867	0	125	0	3029	0	2904	0.0	0.0
chrX	ATP7A	78012878	78013112	0	235	51	10947	51	10712	0.0	0.0047610156833457805
chrX	ATP7A	77922998	77923042	0	45	51	10947	51	10902	0.0	0.004678040726472207
chrX	ATP7A	77922998	77923052	0	55	51	10947	51	10892	0.0	0.004682335659199412
chrX	ATP7A	77974744	77974808	0	65	51	10947	51	10882	0.0	0.004686638485572505
chrX	LPAR4	78750729	78750792	0	64	110	3119	110	3055	0.0	0.03600654664484452
chrX	P2RY10	78947814	78947863	0	50	51	3580	51	3530	0.0	0.014447592067988669
chrX	P2RY10	78952192	78952335	0	144	51	3580	51	3436	0.0	0.014842840512223517
chrX	CYLC1	83872885	83874631	0	1747	0	2133	0	386	0.0	0.0
chrX	ZNF711	85246929	85247188	0	260	5189	5056	5189	4796	0.0	1.0819432860717264
chrX	ZNF711	85267277	85267415	0	139	5189	5056	5189	4917	0.0	1.055318283506203
chrX	ZNF711	85246929	85247183	0	255	5189	5056	5189	4801	0.0	1.080816496563216
chrX	DACH2	86376823	86376862	40	40	40	2770	0	2730	1.0	0.0
chrX	DACH2	86827765	86827812	0	48	40	2770	40	2722	0.0	0.014695077149155033
chrX	DACH2	86742642	86742726	0	85	40	2770	40	2685	0.0	0.0148975791433892
chrX	DACH2	86184232	86184350	0	119	40	2770	40	2651	0.0	0.015088645794039984
chrX	KLHL4	87666474	87666880	0	407	0	3722	0	3315	0.0	0.0
chrX	PCDH11X	92201374	92201455	0	82	0	11642	0	11560	0.0	0.0
chrX	PCDH11X	92468298	92468322	0	25	0	11642	0	11617	0.0	0.0
chrX	PCDH11X	92263113	92263143	0	31	0	11642	0	11611	0.0	0.0
chrX	FAM133A	93698396	93698485	0	90	0	3385	0	3295	0.0	0.0
chrX	DIAPH2	96763099	96763120	0	22	3454	9579	3454	9557	0.0	0.36141048446165114
chrX	AL157778.1	98578985	98579074	0	90	0	2649	0	2559	0.0	0.0
chrX	SRPX2	100646321	100646404	1521	84	66882	7526	65361	7442	18.107142857142858	8.782719699005643
chrX	SRPX2	100646192	100646404	3781	213	66882	7526	63101	7313	17.751173708920188	8.628606591002324
chrX	SRPX2	100669247	100669369	0	123	66882	7526	66882	7403	0.0	9.034445495069566
chrX	CSTF2	100830807	100830867	0	61	12	2791	12	2730	0.0	0.004395604395604396
chrX	ARL13A	100988377	100988384	8	8	36	1320	28	1312	1.0	0.021341463414634148
chrX	ARL13A	100988377	100988558	36	182	36	1320	0	1138	0.1978021978021978	0.0
chrX	DRP2	101231584	101231764	0	181	486	8211	486	8030	0.0	0.06052303860523039
chrX	DRP2	101224603	101224706	0	104	486	8211	486	8107	0.0	0.05994819291969902
chrX	RPL36A	101395334	101395457	0	124	2550	3343	2550	3219	0.0	0.7921714818266542
chrX	RPL36A	101392049	101392095	0	47	2550	3343	2550	3296	0.0	0.7736650485436893
chrX	ARMCX4	101488443	101489315	0	873	87	13064	87	12191	0.0	0.0071364121072922644
chrX	ARMCX4	101524203	101524432	0	230	87	13064	87	12834	0.0	0.006778868630201029
chrX	ARMCX3	101624157	101624218	0	62	0	4243	0	4181	0.0	0.0
chrX	NXF4	102566516	102566624	0	109	34	2849	34	2740	0.0	0.012408759124087591
chrX	ARMCX5-GPRASP2	102600919	102601032	0	114	51	8165	51	8051	0.0	0.0063346168177866105
chrX	ARMCX5-GPRASP2	102601879	102601977	0	99	51	8165	51	8066	0.0	0.006322836598065956
chrX	ARMCX5-GPRASP2	102601463	102601509	0	47	51	8165	51	8118	0.0	0.006282335550628234
chrX	ARMCX5-GPRASP2	102637995	102638045	0	51	51	8165	51	8114	0.0	0.006285432585654425
chrX	GPRASP1	102651686	102651908	0	223	51	6794	51	6571	0.0	0.00776137574189621
chrX	GPRASP1	102652830	102652898	0	69	51	6794	51	6725	0.0	0.00758364312267658
chrX	GPRASP1	102652174	102652265	0	92	51	6794	51	6702	0.0	0.007609668755595345
chrX	GPRASP1	102651686	102651733	0	48	51	6794	51	6746	0.0	0.007560035576638008
chrX	GPRASP2	102713129	102713217	0	89	51	3852	51	3763	0.0	0.01355301621047037
chrX	BHLHB9	102747816	102747911	0	96	0	5486	0	5390	0.0	0.0
chrX	BHLHB9	102747832	102747911	0	80	0	5486	0	5406	0.0	0.0
chrX	BHLHB9	102747584	102747696	0	113	0	5486	0	5373	0.0	0.0
chrX	LINC00630	102770351	102770420	0	70	335525	11012	335525	10942	0.0	30.663955401206362
chrX	LINC00630	102816991	102817082	0	92	335525	11012	335525	10920	0.0	30.725732600732602
chrX	LINC00630	102825992	102826169	0	178	335525	11012	335525	10834	0.0	30.96963263799151
chrX	LINC00630	102843328	102843407	156	80	335525	11012	335369	10932	1.95	30.67773508964508
chrX	Z68871.1	102901022	102901133	0	112	3098	1139	3098	1027	0.0	3.0165530671859786
chrX	BEX4	103215681	103215764	0	84	2146	1315	2146	1231	0.0	1.7432981316003249
chrX	TCEAL9	103357082	103357161	0	80	12281	1048	12281	968	0.0	12.686983471074381
chrX	BEX3	103377027	103377106	0	80	1833	1115	1833	1035	0.0	1.771014492753623
chrX	TCEAL4	103586218	103586291	0	74	0	2405	0	2331	0.0	0.0
chrX	TCEAL4	103585858	103586107	0	250	0	2405	0	2155	0.0	0.0
chrX	TMSB15B	103964227	103964294	0	68	0	8594	0	8526	0.0	0.0
chrX	H2BW2	104041087	104041106	0	20	0	1885	0	1865	0.0	0.0
chrX	PWWP3B	106177223	106177359	0	137	17526	4349	17526	4212	0.0	4.160968660968661
chrX	TBC1D8B	106854197	106854296	0	100	2907	9523	2907	9423	0.0	0.30850047755491883
chrX	DNAAF6	107207147	107207422	0	276	0	1964	0	1688	0.0	0.0
chrX	PRPS1	107639294	107639478	0	185	102	3405	102	3220	0.0	0.031677018633540374
chrX	PRPS1	107640901	107641000	0	100	102	3405	102	3305	0.0	0.03086232980332829
chrX	PRPS1	107642365	107642490	0	126	102	3405	102	3279	0.0	0.03110704483074108
chrX	PRPS1	107645176	107645350	0	175	102	3405	102	3230	0.0	0.031578947368421054
chrX	PRPS1	107636587	107636679	0	93	102	3405	102	3312	0.0	0.030797101449275364
chrX	PRPS1	107636993	107637095	102	103	102	3405	0	3302	0.9902912621359223	0.0
chrX	PRPS1	107640903	107641000	0	98	102	3405	102	3307	0.0	0.030843664953129724
chrX	PRPS1	107644360	107644428	0	69	102	3405	102	3336	0.0	0.030575539568345324
chrX	PRPS1	107643222	107643286	0	65	102	3405	102	3340	0.0	0.03053892215568862
chrX	PRPS1	107646123	107646245	0	123	102	3405	102	3282	0.0	0.031078610603290677
chrX	PRPS1	107646147	107646245	0	99	102	3405	102	3306	0.0	0.030852994555353903
chrX	PRPS1	107647961	107648048	0	88	102	3405	102	3317	0.0	0.030750678323786553
chrX	VSIG1	108061427	108061535	0	109	0	3778	0	3669	0.0	0.0
chrX	ATG4A	108128780	108128852	0	73	51	2821	51	2748	0.0	0.018558951965065504
chrX	ATG4A	108138112	108138191	0	80	51	2821	51	2741	0.0	0.018606348048157608
chrX	ATG4A	108126792	108127094	0	303	51	2821	51	2518	0.0	0.020254169976171566
chrX	COL4A5	108695266	108695439	0	174	50	9386	50	9212	0.0	0.005427702996092054
chrX	TMEM164	110003882	110004164	0	283	204	6593	204	6310	0.0	0.03232963549920761
chrX	PAK3	111013827	111013900	0	74	2856	10441	2856	10367	0.0	0.275489534098582
chrX	PAK3	111146520	111146565	0	46	2856	10441	2856	10395	0.0	0.27474747474747474
chrX	PAK3	111144859	111144922	0	64	2856	10441	2856	10377	0.0	0.2752240531945649
chrX	ALG13	111689086	111689197	0	112	51	8141	51	8029	0.0	0.006351974093909578
chrX	ALG13	111722792	111722857	0	66	51	8141	51	8075	0.0	0.00631578947368421
chrX	ALG13	111730524	111730580	0	57	51	8141	51	8084	0.0	0.006308758040573973
chrX	ALG13	111744667	111744904	0	238	51	8141	51	7903	0.0	0.0064532456029355945
chrX	ALG13	111716952	111717004	0	53	51	8141	51	8088	0.0	0.006305637982195846
chrX	ALG13	111686136	111686174	0	39	51	8141	51	8102	0.0	0.006294742039002715
chrX	ALG13	111708026	111708393	0	368	51	8141	51	7773	0.0	0.006561173292165187
chrX	ALG13	111723797	111723898	0	102	51	8141	51	8039	0.0	0.006344072645851474
chrX	ALG13	111721602	111721711	0	110	51	8141	51	8031	0.0	0.00635039223010833
chrX	HTR2C	114717585	114717676	0	92	204	4849	204	4757	0.0	0.04288417069581669
chrX	LUZP4	115303299	115303418	0	120	0	1750	0	1630	0.0	0.0
chrX	PLS3	115614152	115614534	0	383	422	4122	422	3739	0.0	0.11286440224659
chrX	PLS3	115610802	115610921	0	120	422	4122	422	4002	0.0	0.1054472763618191
chrX	PLS3	115640109	115640136	0	28	422	4122	422	4094	0.0	0.10307767464582315
chrX	DANT1	115842643	115842763	0	121	0	449	0	328	0.0	0.0
chrX	SLC6A14	116457608	116457776	0	169	51	4550	51	4381	0.0	0.011641177813284638
chrX	WDR44	118378418	118378452	4823	35	4874	4223	51	4188	137.8	0.012177650429799427
chrX	WDR44	118387339	118387414	0	76	4874	4223	4874	4147	0.0	1.17530745116952
chrX	WDR44	118441367	118441559	0	193	4874	4223	4874	4030	0.0	1.2094292803970224
chrX	WDR44	118447059	118447114	0	56	4874	4223	4874	4167	0.0	1.1696664266858652
chrX	DOCK11	118616201	118616240	0	40	383259	6776	383259	6736	0.0	56.89711995249406
chrX	DOCK11	118685519	118685537	0	19	383259	6776	383259	6757	0.0	56.72029006955749
chrX	LINC01285	118841814	118841865	0	52	9996	5759	9996	5707	0.0	1.751533204836166
chrX	LINC01285	118845240	118845285	0	46	9996	5759	9996	5713	0.0	1.7496936810782426
chrX	LINC01285	118841814	118841871	0	58	9996	5759	9996	5701	0.0	1.7533766005963867
chrX	LINC01285	118881777	118881876	0	100	9996	5759	9996	5659	0.0	1.7663898215232374
chrX	LONRF3	118982820	118982943	597	124	38666	4054	38069	3930	4.814516129032258	9.68676844783715
chrX	LONRF3	118986924	118987080	432	157	38666	4054	38234	3897	2.751592356687898	9.811136771875802
chrX	PGRMC1	119240308	119240464	0	157	0	1922	0	1765	0.0	0.0
chrX	SLC25A43	119406459	119406701	25	243	25	2845	0	2602	0.102880658436214	0.0
chrX	SLC25A43	119410189	119410362	0	174	25	2845	25	2671	0.0	0.009359790340696368
chrX	UBE2A	119581506	119581596	504	91	1107477	4993	1106973	4902	5.538461538461538	225.82068543451652
chrX	UBE2A	119576944	119577066	2346	123	1107477	4993	1105131	4870	19.073170731707318	226.92628336755647
chrX	AKAP14	119914698	119914878	0	181	51	1177	51	996	0.0	0.05120481927710843
chrX	ZBTB33	120252668	120252770	0	103	51	5316	51	5213	0.0	0.009783234222136965
chrX	ATP1B4	120370714	120370843	21	130	26	4781	5	4651	0.16153846153846155	0.0010750376263169211
chrX	GRIA3	123465673	123465788	16	116	2264	6507	2248	6391	0.13793103448275862	0.3517446409012674
chrX	GRIA3	123480062	123480177	0	116	2264	6507	2264	6391	0.0	0.35424816147707716
chrX	XIAP	123860166	123860293	0	128	51	3270	51	3142	0.0	0.016231699554423933
chrX	XIAP	123891237	123891316	0	80	51	3270	51	3190	0.0	0.01598746081504702
chrX	XIAP	123885630	123886539	51	910	51	3270	0	2360	0.056043956043956046	0.0
chrX	XIAP	123891237	123891309	0	73	51	3270	51	3197	0.0	0.01595245542696278
chrX	STAG2	124021366	124021431	0	66	0	8243	0	8177	0.0	0.0
chrX	STAG2	124090853	124090964	0	112	0	8243	0	8131	0.0	0.0
chrX	STAG2	124026564	124026687	0	124	0	8243	0	8119	0.0	0.0
chrX	STAG2	123962078	123962106	0	29	0	8243	0	8214	0.0	0.0
chrX	SH2D1A	124367589	124367661	0	73	0	2825	0	2752	0.0	0.0
chrX	SH2D1A	124365760	124365824	0	65	0	2825	0	2760	0.0	0.0
chrX	OCRL	129584343	129584367	0	25	4690	6110	4690	6085	0.0	0.770747740345111
chrX	OCRL	129575653	129575719	0	67	4690	6110	4690	6043	0.0	0.7761045838159855
chrX	OCRL	129575896	129576062	0	167	4690	6110	4690	5943	0.0	0.7891637220259128
chrX	OCRL	129589236	129589364	0	129	4690	6110	4690	5981	0.0	0.7841498077244607
chrX	UTP14A	129911765	129911921	0	157	162	4103	162	3946	0.0	0.041054232133806386
chrX	BCORL1	130010507	130010663	0	157	1173	8013	1173	7856	0.0	0.14931262729124237
chrX	BCORL1	130024989	130025379	0	391	1173	8013	1173	7622	0.0	0.1538966150616636
chrX	BCORL1	130034454	130034676	306	223	1173	8013	867	7790	1.3721973094170403	0.11129653401797177
chrX	SLC25A14	130346543	130346691	0	149	0	2668	0	2519	0.0	0.0
chrX	SLC25A14	130350645	130350731	0	87	0	2668	0	2581	0.0	0.0
chrX	SLC25A14	130340106	130340344	0	239	0	2668	0	2429	0.0	0.0
chrX	SLC25A14	130359046	130359139	0	94	0	2668	0	2574	0.0	0.0
chrX	SLC25A14	130340106	130340353	0	248	0	2668	0	2420	0.0	0.0
chrX	STK26	132055455	132055521	0	67	0	3330	0	3263	0.0	0.0
chrX	STK26	132069477	132069663	0	187	0	3330	0	3143	0.0	0.0
chrX	STK26	132054630	132054861	0	232	0	3330	0	3098	0.0	0.0
chrX	CCDC160	134238778	134238840	0	63	0	1793	0	1730	0.0	0.0
chrX	LINC00629	134558379	134558497	0	119	714	2775	714	2656	0.0	0.2688253012048193
chrX	FAM122C	134847882	134847971	0	90	0	7535	0	7445	0.0	0.0
chrX	FAM122C	134852799	134852896	0	98	0	7535	0	7437	0.0	0.0
chrX	FAM122C	134849166	134849228	0	63	0	7535	0	7472	0.0	0.0
chrX	FAM122C	134847382	134847475	0	94	0	7535	0	7441	0.0	0.0
chrX	FAM122C	134844109	134844193	0	85	0	7535	0	7450	0.0	0.0
chrX	FAM122C	134847885	134847971	0	87	0	7535	0	7448	0.0	0.0
chrX	INTS6L	135556167	135556300	0	134	101548	5582	101548	5448	0.0	18.63950073421439
chrX	INTS6L	135570435	135570546	0	112	101548	5582	101548	5470	0.0	18.56453382084095
chrX	SLC9A6	136028885	136028975	0	91	41289	9929	41289	9838	0.0	4.196889611709697
chrX	SLC9A6	136000577	136000651	822	75	41289	9929	40467	9854	10.96	4.106657195047696
chrX	FHL1	136208454	136208641	0	188	335	5097	335	4909	0.0	0.06824200448156448
chrX	FHL1	136169906	136169980	0	75	335	5097	335	5022	0.0	0.06670649143767424
chrX	FHL1	136160473	136160569	0	97	335	5097	335	5000	0.0	0.067
chrX	FHL1	136209339	136209442	0	104	335	5097	335	4993	0.0	0.06709393150410575
chrX	FHL1	136209242	136209442	0	201	335	5097	335	4896	0.0	0.06842320261437909
chrX	FHL1	136182723	136182865	0	143	335	5097	335	4954	0.0	0.06762212353653613
chrX	FHL1	136168129	136168288	0	160	335	5097	335	4937	0.0	0.06785497265545878
chrX	FHL1	136167844	136168035	0	192	335	5097	335	4905	0.0	0.06829765545361875
chrX	FHL1	136167903	136168035	0	133	335	5097	335	4964	0.0	0.06748589846897664
chrX	ADGRG4	136322777	136323392	0	616	51	10103	51	9487	0.0	0.005375777379572046
chrX	VGLL1	136548588	136549008	0	421	0	1483	0	1062	0.0	0.0
chrX	VGLL1	136548588	136548867	0	280	0	1483	0	1203	0.0	0.0
chrX	CD40LG	136656355	136656418	0	64	0	1857	0	1793	0.0	0.0
chrX	AL390879.1	136921243	136922776	0	1534	0	3942	0	2408	0.0	0.0
chrX	AL390879.1	136925246	136925379	0	134	0	3942	0	3808	0.0	0.0
chrX	Z96074.1	137915531	137915607	0	77	0	2109	0	2032	0.0	0.0
chrX	F9	139541075	139541189	0	115	51	2835	51	2720	0.0	0.01875
chrX	LINC00632	140713516	140716289	0	2774	1417	14900	1417	12126	0.0	0.11685634174501072
chrX	LINC00632	140733877	140733964	0	88	1417	14900	1417	14812	0.0	0.09566567647853091
chrX	LINC00632	140768339	140768406	39	68	1417	14900	1378	14832	0.5735294117647058	0.09290722761596548
chrX	LINC00632	140711991	140712074	0	84	1417	14900	1417	14816	0.0	0.09563984881209503
chrX	LINC00632	140730922	140731044	0	123	1417	14900	1417	14777	0.0	0.0958922650064289
chrX	LINC00632	140713428	140713489	0	62	1417	14900	1417	14838	0.0	0.09549804555870063
chrX	LINC00632	140772077	140772358	0	282	1417	14900	1417	14618	0.0	0.0969352852647421
chrX	LINC00632	140772077	140772251	0	175	1417	14900	1417	14725	0.0	0.0962308998302207
chrX	LINC00632	140768344	140768406	39	63	1417	14900	1378	14837	0.6190476190476191	0.09287591831232729
chrX	SPANXA2-OT1	141187766	141187837	0	72	248	3893	248	3821	0.0	0.06490447526825438
chrX	SPANXA2-OT1	141183151	141183229	0	79	248	3893	248	3814	0.0	0.06502359727320399
chrX	MAGEC3	141896430	141896507	0	78	153	2774	153	2696	0.0	0.056750741839762614
chrX	FMR1	147928321	147928393	0	73	102	8809	102	8736	0.0	0.011675824175824176
chrX	FMR1	147938098	147938161	0	64	102	8809	102	8745	0.0	0.011663807890222984
chrX	FMR1	147937465	147937600	0	136	102	8809	102	8673	0.0	0.01176063645797302
chrX	FMR1	147943130	147943326	0	197	102	8809	102	8612	0.0	0.011843938690199722
chrX	FMR1	147924918	147925055	0	138	102	8809	102	8671	0.0	0.011763349094683427
chrX	FMR1	147933400	147933540	0	141	102	8809	102	8668	0.0	0.011767420396862021
chrX	FMR1NB	148025910	148026038	0	129	0	1146	0	1017	0.0	0.0
chrX	AFF2	148837646	148837733	0	88	450	14265	450	14177	0.0	0.03174155322000423
chrX	MAGEA8	149883070	149883349	0	280	6884	2367	6884	2087	0.0	3.298514614278869
chrX	LINC00894	149941056	149941239	372	184	21846	6782	21474	6598	2.0217391304347827	3.254622612913004
chrX	LINC00894	149943650	149943762	1224	113	21846	6782	20622	6669	10.831858407079647	3.0922177237966713
chrX	LINC00894	149948077	149948175	0	99	21846	6782	21846	6683	0.0	3.268891216519527
chrX	LINC00894	149942183	149942329	2066	147	21846	6782	19780	6635	14.054421768707483	2.981160512434062
chrX	LINC00894	149944290	149944570	588	281	21846	6782	21258	6501	2.092526690391459	3.269958467928011
chrX	LINC00894	149941789	149941847	640	59	21846	6782	21206	6723	10.847457627118644	3.1542466160940057
chrX	LINC00894	149945347	149945677	603	331	21846	6782	21243	6451	1.8217522658610272	3.292977832894125
chrX	LINC00894	149962582	149962716	0	135	21846	6782	21846	6647	0.0	3.286595456596961
chrX	MAMLD1	150462771	150462846	0	76	0	5969	0	5893	0.0	0.0
chrX	MTM1	150598591	150598686	0	96	249	3847	249	3751	0.0	0.0663822980538523
chrX	MTMR1	150712341	150712365	0	25	0	4511	0	4486	0.0	0.0
chrX	MTMR1	150714478	150714529	0	52	0	4511	0	4459	0.0	0.0
chrX	MTMR1	150714478	150714532	0	55	0	4511	0	4456	0.0	0.0
chrX	MTMR1	150712729	150712753	0	25	0	4511	0	4486	0.0	0.0
chrX	MTMR1	150736594	150736780	0	187	0	4511	0	4324	0.0	0.0
chrX	MTMR1	150751029	150751240	0	212	0	4511	0	4299	0.0	0.0
chrX	MTMR1	150762564	150762737	0	174	0	4511	0	4337	0.0	0.0
chrX	MTMR1	150712943	150712970	0	28	0	4511	0	4483	0.0	0.0
chrX	VMA21	151396798	151397057	0	260	560	5114	560	4854	0.0	0.11536876802637
chrX	FATE1	151721394	151721501	0	108	85	1077	85	969	0.0	0.08771929824561403
chrX	MAGEA2B	152716647	152716745	54	99	3566	2427	3512	2328	0.5454545454545454	1.5085910652920962
chrX	MAGEA2B	152715956	152716076	77	121	3566	2427	3489	2306	0.6363636363636364	1.5130095403295751
chrX	MAGEA2B	152715078	152715157	168	80	3566	2427	3398	2347	2.1	1.4478057094162762
chrX	MAGEA2B	152714846	152714928	0	83	3566	2427	3566	2344	0.0	1.5213310580204777
chrX	MAGEA12	152735147	152735253	0	107	0	1969	0	1862	0.0	0.0
chrX	NSDHL	152831633	152831700	0	68	1954	2005	1954	1937	0.0	1.008776458440888
chrX	ZNF185	152932872	152932971	24	100	315311	4837	315287	4737	0.24	66.55837027654634
chrX	ZNF185	152945266	152945464	24	199	315311	4837	315287	4638	0.12060301507537688	67.97908581285037
chrX	ZNF185	152920327	152920411	0	85	315311	4837	315311	4752	0.0	66.35332491582491
chrX	ZNF185	152922719	152922809	0	91	315311	4837	315311	4746	0.0	66.43721028234303
chrX	ZNF185	152928574	152928661	0	88	315311	4837	315311	4749	0.0	66.39524110339019
chrX	ZNF185	152936417	152936513	608	97	315311	4837	314703	4740	6.268041237113402	66.39303797468355
chrX	ZNF275	153336633	153336710	261	78	27442	7519	27181	7441	3.3461538461538463	3.6528692380056444
chrX	ATP2B3	153546087	153546129	0	43	17384844	7513	17384844	7470	0.0	2327.2883534136545
chrX	ATP2B3	153569602	153569756	475	155	17384844	7513	17384369	7358	3.064516129032258	2362.6486817069854
chrX	PLXNB3	153766158	153766324	15	167	141921	7027	141906	6860	0.08982035928143713	20.68600583090379
chrX	SSR4	153797457	153797532	122	76	11507	2164	11385	2088	1.605263157894737	5.452586206896552
chrX	OPN1LW	154154573	154154739	0	167	77	1248	77	1081	0.0	0.07123034227567067
chrX	OPN1MW	154191687	154191853	0	167	2142	2004	2142	1837	0.0	1.166031573217202
chrX	OPN1MW2	154228827	154228993	0	167	0	1267	0	1100	0.0	0.0
chrX	EMD	154379689	154379794	0	106	51	1860	51	1754	0.0	0.029076396807297605
chrX	RPL10	154400463	154400626	0	164	142	4328	142	4164	0.0	0.034101825168107586
chrX	TAZ	154412085	154412214	0	130	16	3645	16	3515	0.0	0.004551920341394026
chrX	TAZ	154419704	154419746	0	43	16	3645	16	3602	0.0	0.004441976679622432
chrX	TAZ	154414100	154414190	0	91	16	3645	16	3554	0.0	0.004501969611705121
chrX	TAZ	154419542	154419623	0	82	16	3645	16	3563	0.0	0.004490597810833568
chrX	TAZ	154418545	154418602	0	58	16	3645	16	3587	0.0	0.004460551993309172
chrX	TAZ	154419542	154419746	0	205	16	3645	16	3440	0.0	0.004651162790697674
chrX	ATP6AP1	154434830	154435050	0	221	459	5136	459	4915	0.0	0.09338758901322482
chrX	ATP6AP1	154431519	154431657	4	139	459	5136	455	4997	0.02877697841726619	0.0910546327796678
chrX	ATP6AP1	154435138	154435186	0	49	459	5136	459	5087	0.0	0.09022999803420484
chrX	ATP6AP1	154434985	154435050	0	66	459	5136	459	5070	0.0	0.09053254437869822
chrX	GDI1	154439709	154439797	0	89	0	4782	0	4693	0.0	0.0
chrX	GDI1	154438215	154438386	0	172	0	4782	0	4610	0.0	0.0
chrX	PLXNA3	154460156	154460777	294	622	779894	11650	779600	11028	0.47266881028938906	70.69278200943054
chrX	IKBKG	154560406	154560559	0	154	2745	3473	2745	3319	0.0	0.8270563422717686
chrX	IKBKG	154542281	154542452	0	172	2745	3473	2745	3301	0.0	0.8315661920630112
chrX	IKBKG	154562809	154562953	0	145	2745	3473	2745	3328	0.0	0.8248197115384616
chrX	DKC1	154766996	154767061	0	66	45295	3861	45295	3795	0.0	11.935441370223979
chrX	DKC1	154774785	154774844	24864	60	45295	3861	20431	3801	414.4	5.375164430413049
chrX	FUNDC2	155046508	155046584	0	77	4488	7527	4488	7450	0.0	0.6024161073825504
chrX	FUNDC2	155047368	155047391	0	24	4488	7527	4488	7503	0.0	0.5981607357057177
chrX	BRCC3	155116056	155116188	0	133	129	3197	129	3064	0.0	0.04210182767624021
chrX	BRCC3	155099314	155099389	0	76	129	3197	129	3121	0.0	0.04133290611983339
chrX	VAMP7	155895622	155895680	0	59	0	2623	0	2564	0.0	0.0
chrX	VAMP7	155919812	155919880	0	69	0	2623	0	2554	0.0	0.0
chrX	IL9R	156007522	156007607	0	86	0	2491	0	2405	0.0	0.0
chrX	WASH6P	156022698	156022834	0	137	0	2698	0	2561	0.0	0.0
chrX	CRLF2	1208805	1208908	0	104	0	1993	0	1889	0.0	0.0
chrX	CRLF2	1208805	1208905	0	101	0	1993	0	1892	0.0	0.0
chrX	ASMTL	1439096	1439144	0	49	410	3520	410	3471	0.0	0.11812157879573609
chrX	DHRSX	2408744	2408813	9418	70	11365	3640	1947	3570	134.54285714285714	0.5453781512605042
chrX	DHRSX	2392353	2392474	0	122	11365	3640	11365	3518	0.0	3.2305287094940307
chrX	ARSD	2915555	2915692	0	138	152	6092	152	5954	0.0	0.025529056096741685
chrX	ARSD	2923167	2923306	0	140	152	6092	152	5952	0.0	0.025537634408602152
chrX	ARSL	2958273	2958435	0	163	24	2937	24	2774	0.0	0.008651766402307137
chrX	ARSL	2964223	2964340	0	118	24	2937	24	2819	0.0	0.008513657325292657
chrX	ARSL	2959602	2959888	0	287	24	2937	24	2650	0.0	0.009056603773584906
chrX	BX890604.1	3822373	3822580	1631	208	47606	13199	45975	12991	7.841346153846154	3.53898853052113
chrX	BX890604.1	3818656	3818703	0	48	47606	13199	47606	13151	0.0	3.6199528552961753
chrX	BX890604.1	3822072	3822285	1785	214	47606	13199	45821	12985	8.341121495327103	3.528763958413554
chrX	BX890604.1	3818441	3818500	1109	60	47606	13199	46497	13139	18.483333333333334	3.5388537940482534
chrX	BX890604.1	3860789	3860996	0	208	47606	13199	47606	12991	0.0	3.6645369871449467
chrX	AC110995.1	5671083	5671199	0	117	0	1930	0	1813	0.0	0.0
chrX	AC110995.1	5724065	5724287	0	223	0	1930	0	1707	0.0	0.0
chrX	NLGN4X	6032690	6032750	0	61	399	7453	399	7392	0.0	0.05397727272727273
chrX	NLGN4X	6187482	6187789	0	308	399	7453	399	7145	0.0	0.05584324702589223
chrX	PUDP	7116965	7117034	0	70	306	3833	306	3763	0.0	0.08131809726282221
chrX	PNPLA4	7925939	7926132	0	194	0	3419	0	3225	0.0	0.0
chrX	MID1	10620289	10620419	0	131	120	6672	120	6541	0.0	0.01834581868215869
chrX	MID1	10501406	10501559	51	154	120	6672	69	6518	0.33116883116883117	0.010586069346425284
chrX	MID1	10553122	10553244	0	123	120	6672	120	6549	0.0	0.01832340815391663
chrX	ARHGAP6	11148629	11148719	0	91	22703	8912	22703	8821	0.0	2.5737444734157124
chrX	ARHGAP6	11290382	11290478	0	97	22703	8912	22703	8815	0.0	2.575496313102666
chrX	LINC02154	13287428	13287564	0	137	0	1560	0	1423	0.0	0.0
chrX	TRAPPC2	13734043	13734185	3406	143	62223	5668	58817	5525	23.818181818181817	10.645610859728507
chrX	TRAPPC2	13734049	13734185	3398	137	62223	5668	58825	5531	24.802919708029197	10.635508949557043
chrX	TRAPPC2	13720427	13720497	0	71	62223	5668	62223	5597	0.0	11.117205645881722
chrX	GPM6B	13807649	13807769	0	121	23928	5721	23928	5600	0.0	4.272857142857143
chrX	GPM6B	13812870	13812908	0	39	23928	5721	23928	5682	0.0	4.211193241816262
chrX	GEMIN8	14026051	14026221	162	171	14627	2432	14465	2261	0.9473684210526315	6.397611676249447
chrX	FANCB	14862251	14862332	0	82	57032	3605	57032	3523	0.0	16.188475730911154
chrX	FANCB	14868922	14869043	12	122	57032	3605	57020	3483	0.09836065573770492	16.370944587998853
chrX	ASB11	15291909	15292027	0	119	51	3133	51	3014	0.0	0.01692103516921035
chrX	PIGA	15324664	15324871	0	208	39	5184	39	4976	0.0	0.007837620578778135
chrX	PIGA	15331215	15331992	52	778	39	5184	-13	4406	0.06683804627249357	-0.0029505220154334997
chrX	PIGA	15325913	15326046	0	134	39	5184	39	5050	0.0	0.007722772277227723
chrX	PIGA	15331589	15331992	0	404	39	5184	39	4780	0.0	0.008158995815899581
chrX	PIGA	15326949	15327255	0	307	39	5184	39	4877	0.0	0.00799671929464835
chrX	PIGA	15331819	15331992	0	174	39	5184	39	5010	0.0	0.007784431137724551
chrX	PIGA	15331215	15331299	0	85	39	5184	39	5099	0.0	0.00764855854089037
chrX	PIGA	15331873	15331992	0	120	39	5184	39	5064	0.0	0.007701421800947867
chrX	PIGA	15328343	15328537	0	195	39	5184	39	4989	0.0	0.007817197835237523
chrX	ACE2	15500497	15500585	0	89	0	5741	0	5652	0.0	0.0
chrX	AP1S2	15828191	15828200	0	10	61686	5359	61686	5349	0.0	11.532249018508132
chrX	AP1S2	15840496	15840591	1820	96	61686	5359	59866	5263	18.958333333333332	11.374881246437393
chrX	AP1S2	15831451	15831568	261	118	61686	5359	61425	5241	2.211864406779661	11.720091585575272
chrX	AP1S2	15833443	15833524	135	82	61686	5359	61551	5277	1.646341463414634	11.664013644115975
chrX	AC078993.1	16159652	16159695	0	44	13117	1531	13117	1487	0.0	8.821116341627437
chrX	RAI2	17837536	17837730	0	195	306	2626	306	2431	0.0	0.1258741258741259
chrX	RAI2	17837536	17837733	0	198	306	2626	306	2428	0.0	0.12602965403624383
chrX	SCML2	18242438	18242590	0	153	10671	3305	10671	3152	0.0	3.385469543147208
chrX	ADGRG2	18994895	18995048	0	154	36	5324	36	5170	0.0	0.006963249516441006
chrX	ADGRG2	19033612	19033654	14	43	36	5324	22	5281	0.32558139534883723	0.004165877674682825
chrX	ADGRG2	19037466	19037490	0	25	36	5324	36	5299	0.0	0.006793734666918286
chrX	ADGRG2	19037588	19037636	0	49	36	5324	36	5275	0.0	0.006824644549763033
chrX	ADGRG2	19037597	19037636	0	40	36	5324	36	5284	0.0	0.006813020439061317
chrX	MAP3K15	19414259	19414332	0	74	267075	5606	267075	5532	0.0	48.278199566160524
chrX	BCLAF3	19923157	19923407	0	251	3628	5764	3628	5513	0.0	0.658080899691638
chrX	MAP7D2	20050823	20050946	0	124	49936	4385	49936	4261	0.0	11.719314714855667
chrX	MAP7D2	20052877	20052988	0	112	49936	4385	49936	4273	0.0	11.686402995553475
chrX	EIF1AX	20138538	20138622	0	85	1123	4421	1123	4336	0.0	0.25899446494464945
chrX	RPS6KA3	20187827	20187970	0	144	147683	9830	147683	9686	0.0	15.247057608920091
chrX	RPS6KA3	20209287	20209404	159	118	147683	9830	147524	9712	1.347457627118644	15.18986820428336
chrX	RPS6KA3	20240568	20240605	0	38	147683	9830	147683	9792	0.0	15.082005718954248
chrX	RPS6KA3	20235492	20235513	0	22	147683	9830	147683	9808	0.0	15.057402120717782
chrX	RPS6KA3	20240568	20240669	0	102	147683	9830	147683	9728	0.0	15.181229440789474
chrX	RPS6KA3	20241592	20241686	0	95	147683	9830	147683	9735	0.0	15.170313302516693
chrX	AL807742.1	21061972	21062120	0	149	0	5068	0	4919	0.0	0.0
chrX	AL807742.1	21029768	21029835	0	68	0	5068	0	5000	0.0	0.0
chrX	SMPX	21733655	21733757	0	103	0	1331	0	1228	0.0	0.0
chrX	ACOT9	23713134	23713208	255	75	89978	6263	89723	6188	3.4	14.49951519069166
chrX	ACOT9	23722669	23722753	8	85	89978	6263	89970	6178	0.09411764705882353	14.56296536095824
chrX	ACOT9	23734340	23734367	0	28	89978	6263	89978	6235	0.0	14.43111467522053
chrX	ACOT9	23735918	23736016	0	99	89978	6263	89978	6164	0.0	14.59733939000649
chrX	APOO	23856301	23856382	0	82	4906	2364	4906	2282	0.0	2.1498685363716037
chrX	APOO	23874402	23874457	4855	56	4906	2364	51	2308	86.69642857142857	0.022097053726169845
chrX	APOO	23833606	23833612	0	7	4906	2364	4906	2357	0.0	2.0814594823928725
chrX	PCYT1B	24587240	24587319	0	80	7134	1920	7134	1840	0.0	3.877173913043478
chrX	AC107419.1	27265747	27265811	0	65	663	6825	663	6760	0.0	0.09807692307692308
chrX	AC107419.1	27375860	27376091	0	232	663	6825	663	6593	0.0	0.10056120127407857
chrX	TAB3	30842965	30843049	0	85	29195	9842	29195	9757	0.0	2.992210720508353
chrX	TAB3	30845932	30846071	4108	140	29195	9842	25087	9702	29.34285714285714	2.585755514326943
chrX	DMD	31172347	31172413	0	67	301	18920	301	18853	0.0	0.015965628812390602
chrX	DMD	31177931	31177970	0	40	301	18920	301	18880	0.0	0.01594279661016949
chrX	DMD	31819974	31820083	0	110	301	18920	301	18810	0.0	0.01600212652844232
chrX	DMD	31126641	31126673	0	33	301	18920	301	18887	0.0	0.015936887806427703
chrX	DMD	32365019	32365199	0	181	301	18920	301	18739	0.0	0.016062756817332834
chrX	SRPX	38154461	38154583	0	123	2421	1998	2421	1875	0.0	1.2912
chrX	SRPX	38178284	38178344	0	61	2421	1998	2421	1937	0.0	1.2498709344346928
chrX	SRPX	38171880	38172057	0	178	2421	1998	2421	1820	0.0	1.3302197802197802
chrX	RPGR	38287860	38288041	0	182	0	8385	0	8203	0.0	0.0
chrX	RPGR	38291392	38291484	0	93	0	8385	0	8292	0.0	0.0
chrX	RPGR	38298955	38299141	0	187	0	8385	0	8198	0.0	0.0
chrX	RPGR	38304634	38304790	0	157	0	8385	0	8228	0.0	0.0
chrX	RPGR	38322852	38322945	0	94	0	8385	0	8291	0.0	0.0
chrX	RPGR	38287093	38288041	0	949	0	8385	0	7436	0.0	0.0
chrX	RPGR	38279166	38279205	0	40	0	8385	0	8345	0.0	0.0
chrX	RPGR	38272310	38272589	0	280	0	8385	0	8105	0.0	0.0
chrX	RPGR	38287093	38287245	0	153	0	8385	0	8232	0.0	0.0
chrX	RPGR	38287864	38288041	0	178	0	8385	0	8207	0.0	0.0
chrX	RPGR	38295984	38296144	0	161	0	8385	0	8224	0.0	0.0
chrX	RPGR	38302612	38302672	0	61	0	8385	0	8324	0.0	0.0
chrX	RPGR	38317810	38317893	0	84	0	8385	0	8301	0.0	0.0
chrX	LINC01282	39371791	39371850	0	60	0	1432	0	1372	0.0	0.0
chrX	BCOR	40071636	40071690	0	55	266	9975	266	9920	0.0	0.026814516129032257
chrX	MED14	40679863	40680133	51	271	5409	8462	5358	8191	0.1881918819188192	0.6541325845440117
chrX	CASK	41555599	41555635	0	37	13925	19740	13925	19703	0.0	0.7067451657108055
chrX	CASK	41787177	41787283	0	107	13925	19740	13925	19633	0.0	0.709265012988336
chrX	CASK	41557031	41557100	33	70	13925	19740	13892	19670	0.4714285714285714	0.7062531774275547
chrX	CASK	41622616	41622634	0	19	13925	19740	13925	19721	0.0	0.7061000963439987
chrX	CASK	41529528	41529648	0	121	13925	19740	13925	19619	0.0	0.7097711402212141
chrX	CASK	41522998	41523025	0	28	13925	19740	13925	19712	0.0	0.7064224837662337
chrX	CASK	41635685	41635769	0	85	13925	19740	13925	19655	0.0	0.70847112693971
chrX	NDP	43966507	43966602	0	96	0	1823	0	1727	0.0	0.0
chrX	LINC01186	46326374	46326454	4047	81	50220	2534	46173	2453	49.96296296296296	18.82307378719935
chrX	SYN1	47574001	47574590	0	590	20	3747	20	3157	0.0	0.0063351282863477985
chrX	ELK1	47649920	47650026	0	107	98	3406	98	3299	0.0	0.029705971506517128
chrX	UXT	47657571	47657639	0	69	0	1123	0	1054	0.0	0.0
chrX	ZNF182	47988523	47988617	0	95	1581	3605	1581	3510	0.0	0.45042735042735044
chrX	ZNF630	48060818	48060945	0	128	1288	3458	1288	3330	0.0	0.3867867867867868
chrX	ZNF630	48060818	48060903	0	86	1288	3458	1288	3372	0.0	0.3819691577698695
chrX	SSX5	48195006	48195129	0	124	0	1493	0	1369	0.0	0.0
chrX	SSX4B	48405943	48406079	219	137	23122	1240	22903	1103	1.5985401459854014	20.764279238440615
chrX	TIMM17B	48895351	48895501	1011	151	314668	2570	313657	2419	6.695364238410596	129.6639107069037
chrX	TIMM17B	48895351	48895972	187700	622	314668	2570	126968	1948	301.76848874598073	65.17864476386038
chrX	TIMM17B	48895351	48895454	619	104	314668	2570	314049	2466	5.951923076923077	127.35158150851582
chrX	SLC35A2	48904163	48905482	153	1320	3851	2960	3698	1640	0.1159090909090909	2.254878048780488
chrX	SLC35A2	48909813	48909996	0	184	3851	2960	3851	2776	0.0	1.3872478386167146
chrX	SLC35A2	48904745	48905482	51	738	3851	2960	3800	2222	0.06910569105691057	1.7101710171017102
chrX	SLC35A2	48904745	48904892	0	148	3851	2960	3851	2812	0.0	1.3694879089615932
chrX	SLC35A2	48910233	48910317	0	85	3851	2960	3851	2875	0.0	1.3394782608695652
chrX	SLC35A2	48909852	48909996	0	145	3851	2960	3851	2815	0.0	1.3680284191829486
chrX	GRIPAP1	48981794	48981872	0	79	91088	6161	91088	6082	0.0	14.976652416968102
chrX	GRIPAP1	48993427	48993578	0	152	91088	6161	91088	6009	0.0	15.158595440173073
chrX	GRIPAP1	48987784	48987877	0	94	91088	6161	91088	6067	0.0	15.013680567001813
chrX	GRIPAP1	49000860	49000959	46	100	91088	6161	91042	6061	0.46	15.020953638013529
chrX	GRIPAP1	49000565	49000689	129	125	91088	6161	90959	6036	1.032	15.069416832339298
chrX	PRAF2	49072432	49072650	0	219	0	1665	0	1446	0.0	0.0
chrX	WDR45	49075135	49075281	0	147	1938	3931	1938	3784	0.0	0.5121564482029598
chrX	WDR45	49075363	49075465	0	103	1938	3931	1938	3828	0.0	0.5062695924764891
chrX	WDR45	49076644	49076750	0	107	1938	3931	1938	3824	0.0	0.5067991631799164
chrX	WDR45	49077642	49077747	0	106	1938	3931	1938	3825	0.0	0.5066666666666667
chrX	WDR45	49078040	49078112	0	73	1938	3931	1938	3858	0.0	0.5023328149300156
chrX	WDR45	49076644	49076753	0	110	1938	3931	1938	3821	0.0	0.5071970688301491
chrX	WDR45	49076429	49076524	0	96	1938	3931	1938	3835	0.0	0.5053455019556714
chrX	WDR45	49076644	49076825	0	182	1938	3931	1938	3749	0.0	0.5169378500933582
chrX	WDR45	49076644	49076804	0	161	1938	3931	1938	3770	0.0	0.5140583554376658
chrX	WDR45	49079938	49080095	0	158	1938	3931	1938	3773	0.0	0.513649615690432
chrX	SYP	49197714	49197839	0	126	0	4790	0	4664	0.0	0.0
chrX	SYP	49194165	49194361	0	197	0	4790	0	4593	0.0	0.0
chrX	SYP	49197538	49197839	0	302	0	4790	0	4488	0.0	0.0
chrX	SYP	49197486	49197839	0	354	0	4790	0	4436	0.0	0.0
chrX	FOXP3	49253125	49253202	0	78	0	3100	0	3022	0.0	0.0
chrX	FOXP3	49255428	49255509	0	82	0	3100	0	3018	0.0	0.0
chrX	FOXP3	49257663	49257768	0	106	0	3100	0	2994	0.0	0.0
chrX	LINC01284	51101053	51101148	0	96	0	5668	0	5572	0.0	0.0
chrX	LINC01284	51101053	51101144	0	92	0	5668	0	5576	0.0	0.0
chrX	LINC01284	51099800	51099874	0	75	0	5668	0	5593	0.0	0.0
chrX	MAGED4B	52063702	52063750	0	49	255	4000	255	3951	0.0	0.06454062262718299
chrX	SSX2	52698785	52698931	0	147	0	1545	0	1398	0.0	0.0
chrX	FAM156A	52955153	52955246	0	94	229722	5892	229722	5798	0.0	39.62090375991721
chrX	FAM156A	52956272	52956755	0	484	229722	5892	229722	5408	0.0	42.47818047337278
chrX	FAM156A	52957087	52957238	0	152	229722	5892	229722	5740	0.0	40.0212543554007
chrX	FAM156A	52955153	52955243	0	91	229722	5892	229722	5801	0.0	39.60041372177211
chrX	FAM156A	52964083	52964235	102	153	229722	5892	229620	5739	0.6666666666666666	40.01045478306325
chrX	FAM156A	52957087	52957123	0	37	229722	5892	229722	5855	0.0	39.23518360375747
chrX	KDM5C	53218275	53218398	112	124	131862	8589	131750	8465	0.9032258064516129	15.564087418783226
chrX	KDM5C	53220838	53220916	4280	79	131862	8589	127582	8510	54.177215189873415	14.992009400705053
chrX	KDM5C	53221687	53221730	7141	44	131862	8589	124721	8545	162.29545454545453	14.595787009947337
chrX	KDM5C	53218563	53218712	1428	150	131862	8589	130434	8439	9.52	15.456096693921081
chrX	IQSEC2	53235782	53235832	1102	51	361160	13953	360058	13902	21.607843137254903	25.899726658034815
chrX	IQSEC2	53291894	53291924	20	31	361160	13953	361140	13922	0.6451612903225806	25.940238471483983
chrX	IQSEC2	53279563	53279659	6184	97	361160	13953	354976	13856	63.75257731958763	25.618937644341802
chrX	IQSEC2	53237420	53237516	0	97	361160	13953	361160	13856	0.0	26.06524249422633
chrX	IQSEC2	53279563	53279776	10477	214	361160	13953	350683	13739	48.95794392523364	25.52463789213189
chrX	SMC1A	53381017	53381087	0	71	228181	10856	228181	10785	0.0	21.15725544738062
chrX	SMC1A	53421894	53422040	0	147	228181	10856	228181	10709	0.0	21.307404986459986
chrX	HSD17B10	53431824	53431906	204	83	24435	1118	24231	1035	2.4578313253012047	23.411594202898552
chrX	HSD17B10	53431797	53431906	204	110	24435	1118	24231	1008	1.8545454545454545	24.038690476190474
chrX	HUWE1	53544559	53544762	0	204	128059	17357	128059	17153	0.0	7.465691132746458
chrX	HUWE1	53625785	53626034	0	250	128059	17357	128059	17107	0.0	7.485766060676916
chrX	HUWE1	53680558	53680694	51	137	128059	17357	128008	17220	0.3722627737226277	7.433681765389083
chrX	PHF8	53993600	53993903	0	304	9521	9217	9521	8913	0.0	1.0682149669022776
chrX	PHF8	53995130	53995205	0	76	9521	9217	9521	9141	0.0	1.0415709440980199
chrX	WNK3	54228713	54228743	0	31	2742	11498	2742	11467	0.0	0.23912095578616901
chrX	PFKFB1	54960823	54960917	0	95	84368	2183	84368	2088	0.0	40.406130268199234
chrX	PFKFB1	54960823	54960851	0	29	84368	2183	84368	2154	0.0	39.168059424326835
chrX	ALAS2	55013485	55013648	0	164	5710	2059	5710	1895	0.0	3.0131926121372032
chrX	ALAS2	55021051	55021274	0	224	5710	2059	5710	1835	0.0	3.111716621253406
chrX	ALAS2	55027750	55027857	4457	108	5710	2059	1253	1951	41.26851851851852	0.6422347514095336
chrX	ALAS2	55023756	55023867	0	112	5710	2059	5710	1947	0.0	2.9327170005136107
chrX	ALAS2	55025819	55026015	204	197	5710	2059	5506	1862	1.0355329949238579	2.95703544575725
chrX	SPIN3	56978291	56978421	0	131	4998	13521	4998	13390	0.0	0.3732636295743092
chrX	SPIN3	56978291	56978498	0	208	4998	13521	4998	13313	0.0	0.37542251934199655
chrX	SPIN3	56979297	56979422	153	126	4998	13521	4845	13395	1.2142857142857142	0.3617021276595745
chrX	SPIN3	56978291	56978417	0	127	4998	13521	4998	13394	0.0	0.37315215768254445
chrX	SPIN3	56993786	56993888	0	103	4998	13521	4998	13418	0.0	0.37248472201520344
chrX	LINC01278	63516909	63517082	45	174	1956	13947	1911	13773	0.25862068965517243	0.1387497277281638
chrX	LINC01278	63343205	63343289	0	85	1956	13947	1956	13862	0.0	0.14110517962775934
chrX	LINC01278	63509943	63510079	0	137	1956	13947	1956	13810	0.0	0.14163649529326575
chrX	LINC01278	63238992	63239059	2	68	1956	13947	1954	13879	0.029411764705882353	0.14078824122775416
chrX	LINC01278	63432363	63432491	0	129	1956	13947	1956	13818	0.0	0.14155449413808077
chrX	LINC01278	63259667	63259817	0	151	1956	13947	1956	13796	0.0	0.14178022615250796
chrX	LINC01278	63314996	63315107	0	112	1956	13947	1956	13835	0.0	0.14138055655945067
chrX	LINC01278	63253448	63253539	0	92	1956	13947	1956	13855	0.0	0.1411764705882353
chrX	LINC01278	63425947	63426052	24	106	1956	13947	1932	13841	0.22641509433962265	0.13958529008019652
chrX	LINC01278	63516909	63517100	45	192	1956	13947	1911	13755	0.234375	0.13893129770992366
chrX	ARHGEF9	63655493	63655737	11832	245	11987	12238	155	11993	48.29387755102041	0.012924205786708913
chrX	ARHGEF9	63665885	63666017	51	133	11987	12238	11936	12105	0.38345864661654133	0.9860388269310202
chrX	ARHGEF9	63724531	63724711	0	181	11987	12238	11987	12057	0.0	0.9941942440076305
chrX	ARHGEF9	63754303	63754676	0	374	11987	12238	11987	11864	0.0	1.010367498314228
chrX	ARHGEF9	63726645	63726693	0	49	11987	12238	11987	12189	0.0	0.9834276806957093
chrX	ARHGEF9	63719673	63719856	53	184	11987	12238	11934	12054	0.28804347826086957	0.9900447984071677
chrX	ARHGEF9	63715987	63716119	0	133	11987	12238	11987	12105	0.0	0.9902519619991739
chrX	ARHGEF9	63736989	63737118	0	130	11987	12238	11987	12108	0.0	0.99000660720185
chrX	ARHGEF9	63743368	63743446	0	79	11987	12238	11987	12159	0.0	0.9858540998437372
chrX	ARHGEF9	63638552	63638662	0	111	11987	12238	11987	12127	0.0	0.9884555124927847
chrX	ARHGEF9	63725682	63725735	0	54	11987	12238	11987	12184	0.0	0.9838312541037426
chrX	ARHGEF9	63724795	63724846	0	52	11987	12238	11987	12186	0.0	0.9836697849991793
chrX	ARHGEF9	63732005	63732310	0	306	11987	12238	11987	11932	0.0	1.0046094535702312
chrX	ARHGEF9	63722761	63722897	0	137	11987	12238	11987	12101	0.0	0.9905792909676886
chrX	ARHGEF9	63656509	63658064	0	1556	11987	12238	11987	10682	0.0	1.1221681333083693
chrX	ARHGEF9	63755833	63755910	0	78	11987	12238	11987	12160	0.0	0.9857730263157894
chrX	MTMR8	64336078	64336128	0	51	0	2817	0	2766	0.0	0.0
chrX	MTMR8	64343610	64343720	0	111	0	2817	0	2706	0.0	0.0
chrX	MTMR8	64345044	64345177	0	134	0	2817	0	2683	0.0	0.0
chrX	ZC4H2	64919041	64919204	0	164	4233	3190	4233	3026	0.0	1.398876404494382
chrX	LAS1L	65529211	65529258	0	48	188	7818	188	7770	0.0	0.024195624195624196
chrX	LAS1L	65528259	65528369	0	111	188	7818	188	7707	0.0	0.024393408589593876
chrX	LAS1L	65532560	65532630	0	71	188	7818	188	7747	0.0	0.024267458370982316
chrX	LAS1L	65533609	65533735	0	127	188	7818	188	7691	0.0	0.024444155506436093
chrX	LAS1L	65524563	65524614	0	52	188	7818	188	7766	0.0	0.024208086531032708
chrX	LAS1L	65520701	65520817	0	117	188	7818	188	7701	0.0	0.024412413972211403
chrX	LAS1L	65522745	65522849	0	105	188	7818	188	7713	0.0	0.02437443277583301
chrX	LAS1L	65527275	65527368	0	94	188	7818	188	7724	0.0	0.024339720352149145
chrX	VSIG4	66032467	66032749	0	283	0	2341	0	2058	0.0	0.0
chrX	VSIG4	66025477	66025618	0	142	0	2341	0	2199	0.0	0.0
chrX	PDZD11	70289521	70289593	0	73	30032	1367	30032	1294	0.0	23.208655332302936
chrX	TEX11	70897464	70897586	0	123	2053	3383	2053	3260	0.0	0.6297546012269939
chrX	SNX12	71061842	71061967	0	126	204	2360	204	2234	0.0	0.09131602506714413
chrX	AL590764.2	71107852	71107921	0	70	0	2383	0	2313	0.0	0.0
chrX	AL590764.2	71108598	71108695	0	98	0	2383	0	2285	0.0	0.0
chrX	AL590764.2	71110155	71110295	0	141	0	2383	0	2242	0.0	0.0
chrX	ZMYM3	71242169	71242424	0	256	51	6928	51	6672	0.0	0.007643884892086331
chrX	ZMYM3	71250431	71250726	0	296	51	6928	51	6632	0.0	0.007689987937273824
chrX	ERCC6L	72237830	72237948	0	119	102	4347	102	4228	0.0	0.024124881740775782
chrX	CITED1	72305301	72305422	0	122	0	1756	0	1634	0.0	0.0
chrX	HDAC8	72488932	72489041	0	110	89	18208	89	18098	0.0	0.0049176704608244
chrX	HDAC8	72567888	72568030	0	143	89	18208	89	18065	0.0	0.0049266537503459724
chrX	HDAC8	72490928	72491006	0	79	89	18208	89	18129	0.0	0.004909261404379723
chrX	HDAC8	72495155	72495268	0	114	89	18208	89	18094	0.0	0.004918757599204156
chrX	HDAC8	72568753	72568884	0	132	89	18208	89	18076	0.0	0.004923655676034521
chrX	HDAC8	72349691	72349926	0	236	89	18208	89	17972	0.0	0.004952147785444024
chrX	HDAC8	72330657	72330768	38	112	89	18208	51	18096	0.3392857142857143	0.0028183023872679043
chrX	HDAC8	72330690	72330876	5	187	89	18208	84	18021	0.026737967914438502	0.004661228566672216
chrX	HDAC8	72330690	72330768	5	79	89	18208	84	18129	0.06329113924050633	0.0046334602018864805
chrX	HDAC8	72490928	72491000	0	73	89	18208	89	18135	0.0	0.004907637165701682
chrX	HDAC8	72330815	72330876	0	62	89	18208	89	18146	0.0	0.004904662184503472
chrX	HDAC8	72494195	72494381	0	187	89	18208	89	18021	0.0	0.004938682648021752
chrX	HDAC8	72393958	72394098	0	141	89	18208	89	18067	0.0	0.0049261083743842365
chrX	HDAC8	72462361	72462442	0	82	89	18208	89	18126	0.0	0.004910073926955754
chrX	HDAC8	72562635	72562669	0	35	89	18208	89	18173	0.0	0.004897375226985088
chrX	HDAC8	72495155	72495266	0	112	89	18208	89	18096	0.0	0.0049182139699381075
chrX	PHKA1	72601990	72602029	29	40	203	6383	174	6343	0.725	0.0274318145987703
chrX	PHKA1	72620724	72620901	0	178	203	6383	203	6205	0.0	0.032715551974214344
chrX	PHKA1	72599815	72599866	0	52	203	6383	203	6331	0.0	0.03206444479545095
chrX	XIST	73831065	73831274	612	210	6270	13551	5658	13341	2.914285714285714	0.4241061389700922
chrX	XIST	73833237	73833374	0	138	6270	13551	6270	13413	0.0	0.46745694475508837
chrX	XIST	73822070	73822216	55	147	6270	13551	6215	13404	0.3741496598639456	0.4636675619218144
chrX	XIST	73822070	73822233	72	164	6270	13551	6198	13387	0.43902439024390244	0.46298647942033316
chrX	XIST	73826114	73826347	0	234	6270	13551	6270	13317	0.0	0.4708267627844109
chrX	XIST	73822066	73822216	55	151	6270	13551	6215	13400	0.36423841059602646	0.46380597014925373
chrX	XIST	73831065	73831206	612	142	6270	13551	5658	13409	4.309859154929577	0.4219554030874786
chrX	XIST	73830622	73830790	0	169	6270	13551	6270	13382	0.0	0.4685398296218801
chrX	FTX	74274341	74274410	0	70	14521	26391	14521	26321	0.0	0.5516887656244064
chrX	FTX	74008874	74009010	0	137	14521	26391	14521	26254	0.0	0.5530966709834692
chrX	FTX	74290394	74290430	0	37	14521	26391	14521	26354	0.0	0.550997950975184
chrX	FTX	74284742	74284944	6315	203	14521	26391	8206	26188	31.108374384236452	0.3133496257828013
chrX	FTX	74247331	74247424	0	94	14521	26391	14521	26297	0.0	0.5521922652774081
chrX	FTX	74261911	74262030	0	120	14521	26391	14521	26271	0.0	0.5527387613718548
chrX	FTX	74215396	74215536	0	141	14521	26391	14521	26250	0.0	0.5531809523809523
chrX	FTX	74247331	74247422	0	92	14521	26391	14521	26299	0.0	0.5521502718734552
chrX	FTX	74274341	74274457	0	117	14521	26391	14521	26274	0.0	0.5526756489305016
chrX	FTX	74284742	74284948	6843	207	14521	26391	7678	26184	33.05797101449275	0.2932325084020776
chrX	FTX	74285914	74286170	663	257	14521	26391	13858	26134	2.5797665369649807	0.5302670850233412
chrX	RLIM	74612581	74612643	0	63	59895	10632	59895	10569	0.0	5.667045131989782
chrX	ABCB7	75098941	75099061	0	121	51	5384	51	5263	0.0	0.009690290708721261
chrX	ABCB7	75114753	75114834	0	82	51	5384	51	5302	0.0	0.00961901169370049
chrX	ABCB7	75114753	75114831	0	79	51	5384	51	5305	0.0	0.009613572101790764
chrX	ABCB7	75114620	75114632	0	13	51	5384	51	5371	0.0	0.00949543846583504
chrX	ABCB7	75112885	75112972	0	88	51	5384	51	5296	0.0	0.009629909365558912
chrX	ABCB7	75097455	75097538	0	84	51	5384	51	5300	0.0	0.009622641509433962
chrX	ZDHHC15	75505820	75505847	0	28	1479	6833	1479	6805	0.0	0.21734019103600294
chrX	MIR325HG	76658501	76658668	0	168	0	4180	0	4012	0.0	0.0
chrX	MIR325HG	77007275	77007380	0	106	0	4180	0	4074	0.0	0.0
chrX	MIR325HG	76692966	76693087	0	122	0	4180	0	4058	0.0	0.0
chrX	MIR325HG	76837809	76837892	0	84	0	4180	0	4096	0.0	0.0
chrX	ATRX	77693823	77693937	0	115	255	17249	255	17134	0.0	0.014882689389517917
chrX	ATRX	77717130	77717243	0	114	255	17249	255	17135	0.0	0.014881820834549168
chrX	ATRX	77690802	77690925	0	124	255	17249	255	17125	0.0	0.01489051094890511
chrX	ATRX	77595711	77595785	0	75	255	17249	255	17174	0.0	0.014848026085943869
chrX	ATRX	77691224	77691291	0	68	255	17249	255	17181	0.0	0.014841976602060415
chrX	CYSLTR1	78283453	78283540	0	88	0	5571	0	5483	0.0	0.0
chrX	ITM2A	79363422	79363554	0	133	0	2058	0	1925	0.0	0.0
chrX	CHMP1B2P	80289838	80289905	0	68	102	7056	102	6988	0.0	0.014596451058958215
chrX	HMGN5	81119787	81119817	0	31	0	2398	0	2367	0.0	0.0
chrX	HMGN5	81118729	81118759	0	31	0	2398	0	2367	0.0	0.0
chrX	HMGN5	81197705	81197778	0	74	0	2398	0	2324	0.0	0.0
chrX	HMGN5	81195117	81195297	0	181	0	2398	0	2217	0.0	0.0
chrX	HDX	84475250	84475397	0	148	4026	7271	4026	7123	0.0	0.5652112873789134
chrX	HDX	84488023	84488132	0	110	4026	7271	4026	7161	0.0	0.5622119815668203
chrX	SATL1	85093184	85093225	0	42	23145	6989	23145	6947	0.0	3.331653951345905
chrX	SATL1	85117283	85117404	8068	122	23145	6989	15077	6867	66.1311475409836	2.195573030435416
chrX	AL022151.1	96371481	96371525	0	45	138	6265	138	6220	0.0	0.022186495176848873
chrX	PCDH19	100403523	100403664	1288	142	58900	5435	57612	5293	9.070422535211268	10.884564519176271
chrX	TSPAN6	100632484	100632568	0	85	102	4546	102	4461	0.0	0.022864828513786146
chrX	NOX1	100849279	100849426	0	148	27724	2213	27724	2065	0.0	13.425665859564164
chrX	NOX1	100863484	100863595	0	112	27724	2213	27724	2101	0.0	13.195621132793908
chrX	XKRX	100922792	100923061	0	270	81221	3375	81221	3105	0.0	26.158132045088568
chrX	TRMT2B	101037916	101038051	0	136	8	4036	8	3900	0.0	0.0020512820512820513
chrX	TRMT2B	101051250	101051366	0	117	8	4036	8	3919	0.0	0.002041337075784639
chrX	TAF7L	101276306	101276528	0	223	51	2726	51	2503	0.0	0.02037554934079105
chrX	TIMM8A	101348060	101348401	0	342	0	3083	0	2741	0.0	0.0
chrX	BTK	101377858	101378023	0	166	0	4323	0	4157	0.0	0.0
chrX	GLA	101400665	101400757	0	93	0	2857	0	2764	0.0	0.0
chrX	GLA	101398369	101398567	0	199	0	2857	0	2658	0.0	0.0
chrX	GLA	101399743	101399800	0	58	0	2857	0	2799	0.0	0.0
chrX	GLA	101405110	101405233	0	124	0	2857	0	2733	0.0	0.0
chrX	GLA	101401232	101401347	0	116	0	2857	0	2741	0.0	0.0
chrX	ARMCX6	101617502	101617584	0	83	0	2071	0	1988	0.0	0.0
chrX	ARMCX6	101617282	101617370	0	89	0	2071	0	1982	0.0	0.0
chrX	ARMCX6	101617291	101617370	0	80	0	2071	0	1991	0.0	0.0
chrX	ARMCX2	101658460	101658569	0	110	0	3553	0	3443	0.0	0.0
chrX	ARMCX2	101658460	101658525	0	66	0	3553	0	3487	0.0	0.0
chrX	ARMCX2	101659418	101659501	0	84	0	3553	0	3469	0.0	0.0
chrX	ARMCX2	101659407	101659501	0	95	0	3553	0	3458	0.0	0.0
chrX	ZMAT1	101918512	101918633	0	122	29935	7107	29935	6985	0.0	4.285612025769506
chrX	AC235565.2	102372950	102373156	0	207	1094	4954	1094	4747	0.0	0.2304613440067411
chrX	AC235565.2	102438552	102438674	0	123	1094	4954	1094	4831	0.0	0.22645415027944524
chrX	AC235565.2	102456806	102456914	0	109	1094	4954	1094	4845	0.0	0.2257997936016512
chrX	TCEAL8	103254604	103254677	0	74	0	551	0	477	0.0	0.0
chrX	MORF4L2	103678498	103678600	0	103	0	2654	0	2551	0.0	0.0
chrX	MORF4L2	103678498	103678651	0	154	0	2654	0	2500	0.0	0.0
chrX	MORF4L2	103684680	103684729	0	50	0	2654	0	2604	0.0	0.0
chrX	GLRA4	103719056	103719271	0	216	51	7972	51	7756	0.0	0.0065755544094894276
chrX	AC234782.2	103708469	103708567	0	99	35	7805	35	7706	0.0	0.004541915390604724
chrX	AC234782.2	103728132	103728261	0	130	35	7805	35	7675	0.0	0.004560260586319218
chrX	AC234782.2	103827004	103827078	0	75	35	7805	35	7730	0.0	0.004527813712807244
chrX	AC234782.2	103813121	103813233	0	113	35	7805	35	7692	0.0	0.004550182007280291
chrX	AC234782.2	103788409	103788505	0	97	35	7805	35	7708	0.0	0.00454073689673067
chrX	AC234782.2	103791253	103791400	0	148	35	7805	35	7657	0.0	0.004570980801880632
chrX	TMSB15B-AS1	103914736	103914794	0	59	51	2837	51	2778	0.0	0.0183585313174946
chrX	RBM41	107113396	107113468	0	73	765	4714	765	4641	0.0	0.16483516483516483
chrX	NUP62CL	107154095	107154246	0	152	1098	1877	1098	1725	0.0	0.6365217391304347
chrX	NUP62CL	107193028	107193072	0	45	1098	1877	1098	1832	0.0	0.5993449781659389
chrX	NUP62CL	107150855	107150967	0	113	1098	1877	1098	1764	0.0	0.6224489795918368
chrX	TSC22D3	107777019	107777184	0	166	315	4689	315	4523	0.0	0.06964404156533274
chrX	AL109946.1	107934634	107934680	3	47	70650	3953	70647	3906	0.06382978723404255	18.08678955453149
chrX	AL109946.1	107934316	107934364	15	49	70650	3953	70635	3904	0.30612244897959184	18.092981557377048
chrX	PSMD10	108087952	108088099	0	148	0	2395	0	2247	0.0	0.0
chrX	PSMD10	108088751	108088850	0	100	0	2395	0	2295	0.0	0.0
chrX	COL4A6	108164599	108164698	0	100	0	9330	0	9230	0.0	0.0
chrX	COL4A6	108169944	108170016	0	73	0	9330	0	9257	0.0	0.0
chrX	COL4A6	108183721	108183772	0	52	0	9330	0	9278	0.0	0.0
chrX	ACSL4	109696143	109696196	0	54	0	6568	0	6514	0.0	0.0
chrX	ACSL4	109685426	109685444	0	19	0	6568	0	6549	0.0	0.0
chrX	ACSL4	109691002	109691131	0	130	0	6568	0	6438	0.0	0.0
chrX	AMMECR1	110264488	110264599	0	112	0	6372	0	6260	0.0	0.0
chrX	DCX	111411969	111411997	0	29	0	10073	0	10044	0.0	0.0
chrX	XACT	114042367	114042484	153	118	969	26548	816	26430	1.2966101694915255	0.030874006810442677
chrX	LRCH2	115126842	115126893	0	52	24	4974	24	4922	0.0	0.004876066639577408
chrX	DANT2	115951294	115951383	0	90	0	4390	0	4300	0.0	0.0
chrX	KLHL13	118028423	118028497	0	75	20595	6416	20595	6341	0.0	3.2479104242233086
chrX	KLHL13	117983479	117983545	0	67	20595	6416	20595	6349	0.0	3.2438179240825327
chrX	CXORF56	119545462	119545504	0	43	288142	2588	288142	2545	0.0	113.2188605108055
chrX	NKRF	119603461	119603559	0	99	1521997	4550	1521997	4451	0.0	341.9449561896203
chrX	SEPTIN6	119625334	119625379	0	46	6173	5563	6173	5517	0.0	1.118905202102592
chrX	SEPTIN6	119618712	119618786	0	75	6173	5563	6173	5488	0.0	1.1248177842565599
chrX	UPF3B	119840645	119840684	0	40	51	3097	51	3057	0.0	0.016683022571148183
chrX	TMEM255A	120285624	120285696	0	73	153	3870	153	3797	0.0	0.04029496971293126
chrX	LAMP2	120439075	120439293	0	219	51	7735	51	7516	0.0	0.006785524215007983
chrX	CUL4B	120532421	120532594	0	174	0	8106	0	7932	0.0	0.0
chrX	CUL4B	120558248	120558292	0	45	0	8106	0	8061	0.0	0.0
chrX	C1GALT1C1	120627255	120627427	0	173	0	1811	0	1638	0.0	0.0
chrX	THOC2	123623643	123623709	0	67	102	10063	102	9996	0.0	0.01020408163265306
chrX	TENM1	124487208	124487229	0	22	283	12928	283	12906	0.0	0.021927785526111885
chrX	AL008633.1	129121150	129121238	200	89	8206	7238	8006	7149	2.247191011235955	1.1198769058609597
chrX	SMARCA1	129516330	129516497	0	168	10087	4382	10087	4214	0.0	2.393687707641196
chrX	SMARCA1	129493039	129493075	86	37	10087	4382	10001	4345	2.324324324324324	2.3017261219792866
chrX	ZDHHC9	129814657	129814795	0	139	4457	5255	4457	5116	0.0	0.8711884284597342
chrX	AIFM1	130136044	130136185	0	142	408	10093	408	9951	0.0	0.041000904431715404
chrX	AIFM1	130140532	130140617	0	86	408	10093	408	10007	0.0	0.04077145997801539
chrX	AIFM1	130155155	130155286	0	132	408	10093	408	9961	0.0	0.04095974299769099
chrX	AIFM1	130136044	130136181	0	138	408	10093	408	9955	0.0	0.040984429934706176
chrX	AIFM1	130156460	130156603	0	144	408	10093	408	9949	0.0	0.04100914664790431
chrX	AIFM1	130137322	130137525	0	204	408	10093	408	9889	0.0	0.04125796339366974
chrX	AIFM1	130136047	130136185	0	139	408	10093	408	9954	0.0	0.040988547317661245
chrX	AIFM1	130155155	130155187	0	33	408	10093	408	10060	0.0	0.04055666003976143
chrX	ZNF280C	130226758	130226905	0	148	37	4657	37	4509	0.0	0.008205810601020182
chrX	ENOX2	130709242	130709331	0	90	30	4295	30	4205	0.0	0.007134363852556481
chrX	ENOX2	130783546	130783690	0	145	30	4295	30	4150	0.0	0.007228915662650603
chrX	IGSF1	131275477	131275765	0	289	0	7445	0	7156	0.0	0.0
chrX	IGSF1	131286436	131286463	0	28	0	7445	0	7417	0.0	0.0
chrX	FIRRE	131777622	131777744	0	123	0	9139	0	9016	0.0	0.0
chrX	FIRRE	131695843	131695913	0	71	0	9139	0	9068	0.0	0.0
chrX	FIRRE	131709497	131709556	0	60	0	9139	0	9079	0.0	0.0
chrX	FIRRE	131743095	131743248	0	154	0	9139	0	8985	0.0	0.0
chrX	FIRRE	131711650	131711720	0	71	0	9139	0	9068	0.0	0.0
chrX	FIRRE	131711650	131711744	0	95	0	9139	0	9044	0.0	0.0
chrX	FIRRE	131695466	131695620	0	155	0	9139	0	8984	0.0	0.0
chrX	FIRRE	131703416	131703518	0	103	0	9139	0	9036	0.0	0.0
chrX	FIRRE	131795808	131796331	0	524	0	9139	0	8615	0.0	0.0
chrX	FIRRE	131804971	131805037	0	67	0	9139	0	9072	0.0	0.0
chrX	MBNL3	132384662	132384698	0	37	57	12213	57	12176	0.0	0.004681340341655716
chrX	MBNL3	132381358	132381432	0	75	57	12213	57	12138	0.0	0.0046959960454770145
chrX	MBNL3	132439434	132439572	0	139	57	12213	57	12074	0.0	0.004720887858207719
chrX	GPC3	133953049	133953211	0	163	6276	2883	6276	2720	0.0	2.3073529411764704
chrX	GPC3	133704204	133704273	0	70	6276	2883	6276	2813	0.0	2.231070031994312
chrX	MIR503HG	134545951	134546156	0	206	0	2887	0	2681	0.0	0.0
chrX	PLAC1	134733434	134733519	0	86	918	1909	918	1823	0.0	0.503565551289084
chrX	FAM122B	134789579	134789636	0	58	0	4413	0	4355	0.0	0.0
chrX	FAM122B	134772142	134772283	0	142	0	4413	0	4271	0.0	0.0
chrX	MOSPD1	134891478	134891640	0	163	51	2593	51	2430	0.0	0.020987654320987655
chrX	MOSPD1	134899089	134899165	0	77	51	2593	51	2516	0.0	0.02027027027027027
chrX	MAP7D3	136240381	136240486	0	106	51	6907	51	6801	0.0	0.007498897220996913
chrX	RBMX	136876502	136876655	0	154	0	4833	0	4679	0.0	0.0
chrX	RBMX	136877914	136878086	0	173	0	4833	0	4660	0.0	0.0
chrX	RBMX	136877914	136877964	0	51	0	4833	0	4782	0.0	0.0
chrX	FGF13	138990507	138990617	0	111	153	20751	153	20640	0.0	0.007412790697674419
chrX	FGF13	138857511	138857679	0	169	153	20751	153	20582	0.0	0.007433679914488388
chrX	FGF13	138985017	138985091	0	75	153	20751	153	20676	0.0	0.007399883923389437
chrX	MCF2	139631394	139631511	0	118	1261	5089	1261	4971	0.0	0.25367129350231343
chrX	MCF2	139613215	139613263	0	49	1261	5089	1261	5040	0.0	0.2501984126984127
chrX	ATP11C	139787172	139787244	0	73	367	7441	367	7368	0.0	0.0498099891422367
chrX	ATP11C	139731650	139731755	0	106	367	7441	367	7335	0.0	0.05003408316291752
chrX	ATP11C	139737730	139737796	0	67	367	7441	367	7374	0.0	0.04976946026579875
chrX	FMR1-AS1	147911280	147911384	0	105	0	2104	0	1999	0.0	0.0
chrX	AC244197.3	149526935	149527068	0	134	102	9717	102	9583	0.0	0.01064384848168632
chrX	LINC00893	149536173	149536213	0	41	126	2916	126	2875	0.0	0.04382608695652174
chrX	LINC00893	149538723	149538906	0	184	126	2916	126	2732	0.0	0.046120058565153735
chrX	IDS	149491537	149491667	0	131	102	8659	102	8528	0.0	0.011960600375234522
chrX	IDS	149502074	149502177	0	104	102	8659	102	8555	0.0	0.011922852133255406
chrX	LINC00893	149537632	149537778	0	147	126	2916	126	2769	0.0	0.04550379198266522
chrX	LINC00893	149536173	149536255	0	83	126	2916	126	2833	0.0	0.04447582068478644
chrX	LINC00893	149535946	149535982	0	37	126	2916	126	2879	0.0	0.043765196248697465
chrX	LINC00893	149537632	149537742	0	111	126	2916	126	2805	0.0	0.044919786096256686
chrX	MAGEA9B	149583546	149583633	0	88	941	1926	941	1838	0.0	0.5119695321001088
chrX	TMEM185A	149603986	149604070	0	85	0	4993	0	4908	0.0	0.0
chrX	TMEM185A	149608626	149608834	0	209	0	4993	0	4784	0.0	0.0
chrX	TMEM185A	149611286	149611463	0	178	0	4993	0	4815	0.0	0.0
chrX	EOLA2	149934376	149934573	0	198	217964	2354	217964	2156	0.0	101.09647495361781
chrX	EOLA2	149934376	149934568	0	193	217964	2354	217964	2161	0.0	100.86256362795002
chrX	CD99L2	150828305	150829604	0	1300	867	5777	867	4477	0.0	0.19365646638373912
chrX	CD99L2	150771804	150771822	0	19	867	5777	867	5758	0.0	0.15057311566516152
chrX	CD99L2	150795417	150795486	0	70	867	5777	867	5707	0.0	0.15191869633783073
chrX	MAGEA4-AS1	151907341	151907399	0	59	183	1596	183	1537	0.0	0.11906310995445674
chrX	GABRE	151955367	151955567	0	201	0	7557	0	7356	0.0	0.0
chrX	GABRE	151961282	151961365	0	84	0	7557	0	7473	0.0	0.0
chrX	GABRE	151971139	151971317	0	179	0	7557	0	7378	0.0	0.0
chrX	MAGEA10-MAGEA5	152129488	152129613	0	126	3268	1319	3268	1193	0.0	2.7393126571668063
chrX	MAGEA10	152135989	152136080	140	92	6115	2903	5975	2811	1.5217391304347827	2.1255780860903593
chrX	MAGEA10	152136061	152136080	140	20	6115	2903	5975	2883	7.0	2.0724939299340965
chrX	CSAG1	152733024	152733236	0	213	31273	1096	31273	883	0.0	35.4167610419026
chrX	CSAG1	152733020	152733236	0	217	31273	1096	31273	879	0.0	35.57792946530148
chrX	MAGEA2	152751724	152751822	0	99	0	2115	0	2016	0.0	0.0
chrX	MAGEA2	152751508	152751574	0	67	0	2115	0	2048	0.0	0.0
chrX	MAGEA2	152753541	152753623	0	83	0	2115	0	2032	0.0	0.0
chrX	MAGEA2	152753312	152753391	0	80	0	2115	0	2035	0.0	0.0
chrX	MAGEA2	152752393	152752513	0	121	0	2115	0	1994	0.0	0.0
chrX	MAGEA6	152769218	152769277	0	60	0	1867	0	1807	0.0	0.0
chrX	TREX2	153445598	153445644	0	47	0	2729	0	2682	0.0	0.0
chrX	TREX2	153446008	153446111	0	104	0	2729	0	2625	0.0	0.0
chrX	HAUS7	153454876	153455053	0	178	0	2885	0	2707	0.0	0.0
chrX	HAUS7	153464987	153465055	0	69	0	2885	0	2816	0.0	0.0
chrX	CCNQ	153592505	153592733	1213950	229	3601489	1673	2387539	1444	5301.091703056769	1653.4203601108034
chrX	CCNQ	153594546	153594679	313244	134	3601489	1673	3288245	1539	2337.6417910447763	2136.611435997401
chrX	CCNQ	153597421	153597706	1333	286	3601489	1673	3600156	1387	4.660839160839161	2595.6423936553715
chrX	PNCK	153672565	153672697	256770	133	3082117	4218	2825347	4085	1930.6015037593984	691.6394124847001
chrX	PNCK	153672565	153672666	195523	102	3082117	4218	2886594	4116	1916.8921568627452	701.3104956268221
chrX	PNCK	153686500	153686683	3	184	3082117	4218	3082114	4034	0.016304347826086956	764.0342092216163
chrX	BCAP31	153723507	153723612	0	106	46135	2972	46135	2866	0.0	16.0973482205164
chrX	IDH3G	153789113	153789200	0	88	68516	2656	68516	2568	0.0	26.680685358255452
chrX	PDZD4	153807896	153808139	190	244	2078	4353	1888	4109	0.7786885245901639	0.4594791920175225
chrX	L1CAM	153863882	153864017	408	136	176102	7299	175694	7163	3.0	24.527991065196147
chrX	L1CAM	153867799	153867910	12355	112	176102	7299	163747	7187	110.3125	22.783776262696534
chrX	L1CAM	153863367	153863379	0	13	176102	7299	176102	7286	0.0	24.16991490529783
chrX	L1CAM	153873227	153873242	272	16	176102	7299	175830	7283	17.0	24.14252368529452
chrX	L1CAM	153875760	153875944	3854	185	176102	7299	172248	7114	20.832432432432434	24.21253865617093
chrX	L1CAM	153880281	153880363	0	83	176102	7299	176102	7216	0.0	24.40437915742794
chrX	ARHGAP4	153910170	153910404	0	235	106	5199	106	4964	0.0	0.02135374697824335
chrX	ARHGAP4	153910921	153910999	0	79	106	5199	106	5120	0.0	0.020703125
chrX	ARHGAP4	153921096	153921159	0	64	106	5199	106	5135	0.0	0.020642648490749756
chrX	ARHGAP4	153919566	153919686	49	121	106	5199	57	5078	0.4049586776859504	0.011224891689641591
chrX	ARHGAP4	153918831	153919053	51	223	106	5199	55	4976	0.22869955156950672	0.011053054662379422
chrX	ARHGAP4	153910505	153910611	0	107	106	5199	106	5092	0.0	0.020816967792615867
chrX	NAA10	153932070	153932115	0	46	0	4351	0	4305	0.0	0.0
chrX	RENBP	153941949	153942031	0	83	0	2045	0	1962	0.0	0.0
chrX	RENBP	153944079	153944155	0	77	0	2045	0	1968	0.0	0.0
chrX	RENBP	153937091	153937188	0	98	0	2045	0	1947	0.0	0.0
chrX	RENBP	153944121	153944155	0	35	0	2045	0	2010	0.0	0.0
chrX	RENBP	153936003	153936105	0	103	0	2045	0	1942	0.0	0.0
chrX	HCFC1	153961541	153961648	0	108	102	9037	102	8929	0.0	0.011423451674319633
chrX	IRAK1	154012528	154012678	1261	151	86164	3637	84903	3486	8.350993377483444	24.35542168674699
chrX	IRAK1	154018005	154018120	0	116	86164	3637	86164	3521	0.0	24.47145697245101
chrX	IRAK1	154013042	154013433	27668	392	86164	3637	58496	3245	70.58163265306122	18.026502311248073
chrX	IRAK1	154014041	154014278	0	238	86164	3637	86164	3399	0.0	25.349808767284497
chrX	IRAK1	154016031	154016097	0	67	86164	3637	86164	3570	0.0	24.135574229691876
chrX	IRAK1	154013042	154013343	8442	302	86164	3637	77722	3335	27.95364238410596	23.30494752623688
chrX	MECP2	154092183	154092307	0	125	7798	6999	7798	6874	0.0	1.1344195519348268
chrX	MECP2	154058398	154058566	0	169	7798	6999	7798	6830	0.0	1.141727672035139
chrX	MECP2	154058398	154058548	0	151	7798	6999	7798	6848	0.0	1.1387266355140186
chrX	MECP2	154072990	154073106	0	117	7798	6999	7798	6882	0.0	1.133100842778262
chrX	FLNA	154352552	154352675	0	124	83220	9862	83220	9738	0.0	8.545902649414664
chrX	FLNA	154353553	154353727	1836	175	83220	9862	81384	9687	10.491428571428571	8.401362650975534
chrX	FLNA	154357250	154357274	0	25	83220	9862	83220	9837	0.0	8.459896309850564
chrX	FLNA	154365744	154365801	0	58	83220	9862	83220	9804	0.0	8.488372093023257
chrX	DNASE1L1	154409417	154409675	0	259	204	3587	204	3328	0.0	0.06129807692307692
chrX	DNASE1L1	154409111	154409196	0	86	204	3587	204	3501	0.0	0.05826906598114824
chrX	DNASE1L1	154409417	154409813	0	397	204	3587	204	3190	0.0	0.06394984326018809
chrX	UBL4A	154486227	154486333	0	107	2244	1102	2244	995	0.0	2.255276381909548
chrX	FAM3A	154507810	154507861	0	52	5044	4886	5044	4834	0.0	1.043442283822921
chrX	FAM3A	154508473	154508597	1392	125	5044	4886	3652	4761	11.136	0.7670657424910733
chrX	FAM3A	154512822	154512936	0	115	5044	4886	5044	4771	0.0	1.0572207084468666
chrX	FAM3A	154512313	154512411	0	99	5044	4886	5044	4787	0.0	1.0536870691456026
chrX	FAM3A	154507810	154507882	0	73	5044	4886	5044	4813	0.0	1.0479950135050904
chrX	FAM3A	154508473	154508811	1920	339	5044	4886	3124	4547	5.663716814159292	0.6870464042225644
chrX	FAM3A	154508473	154508652	1920	180	5044	4886	3124	4706	10.666666666666666	0.6638334041648959
chrX	FAM3A	154512313	154512431	0	119	5044	4886	5044	4767	0.0	1.0581078246276485
chrX	GAB3	154680131	154680248	0	118	6853	5284	6853	5166	0.0	1.3265582655826558
chrX	GAB3	154712228	154712701	1924	474	6853	5284	4929	4810	4.059071729957806	1.0247401247401247
chrX	MPP1	154799744	154799893	0	150	2091	5410	2091	5260	0.0	0.39752851711026616
chrX	MPP1	154804696	154804827	0	132	2091	5410	2091	5278	0.0	0.3961727927245169
chrX	MPP1	154789953	154790022	0	70	2091	5410	2091	5340	0.0	0.39157303370786517
chrX	F8	154947697	154947907	0	211	663	10987	663	10776	0.0	0.06152561247216036
chrX	F8	154977351	154977441	0	91	663	10987	663	10896	0.0	0.060848017621145375
chrX	F8	155022409	155022496	0	88	663	10987	663	10899	0.0	0.06083126892375447
chrX	MTCP1	155065905	155066057	0	153	0	2468	0	2315	0.0	0.0
chrX	CLIC2	155298784	155298910	0	127	0	2848	0	2721	0.0	0.0
chrY	PLCXD1	281481	281684	0	204	2324	6077	2324	5873	0.0	0.3957091775923719
chrY	CSF2RA	1274754	1274842	33	89	666	3562	633	3473	0.3707865168539326	0.18226317304923698
chrY	CSF2RA	1285777	1285920	0	144	666	3562	666	3418	0.0	0.19485078993563487
chrY	CSF2RA	1303260	1303362	0	103	666	3562	666	3459	0.0	0.19254119687771032
chrY	CSF2RA	1300490	1300626	7	137	666	3562	659	3425	0.051094890510948905	0.19240875912408759
chrY	CSF2RA	1303922	1304019	0	98	666	3562	666	3464	0.0	0.1922632794457275
chrY	CSF2RA	1274754	1274818	33	65	666	3562	633	3497	0.5076923076923077	0.18101229625393195
chrY	CSF2RA	1282408	1282560	0	153	666	3562	666	3409	0.0	0.19536520973892638
chrY	CSF2RA	1305445	1305527	89	83	666	3562	577	3479	1.072289156626506	0.16585225639551596
chrY	AKAP17A	1600137	1600207	0	71	102	3371	102	3300	0.0	0.03090909090909091
chrY	ASMT	1632703	1632787	0	85	51	1797	51	1712	0.0	0.029789719626168224
chrY	ASMT	1633149	1633290	0	142	51	1797	51	1655	0.0	0.03081570996978852
chrY	CD99P1	2622689	2622734	0	46	1715	5932	1715	5886	0.0	0.29136935100237854
chrY	CD99	2717604	2717652	0	49	0	4873	0	4824	0.0	0.0
chrY	CD99	2733356	2733374	0	19	0	4873	0	4854	0.0	0.0
chrY	CD99	2727292	2727343	0	52	0	4873	0	4821	0.0	0.0
chrY	ZFY	2961073	2961646	0	574	0	5444	0	4870	0.0	0.0
chrY	ZFY	2976669	2976822	0	154	0	5444	0	5290	0.0	0.0
chrY	ZFY	2953908	2953997	0	90	0	5444	0	5354	0.0	0.0
chrY	LINC00278	3102084	3102194	0	111	35	4194	35	4083	0.0	0.008572128337007103
chrY	LINC00278	3058656	3058784	0	129	35	4194	35	4065	0.0	0.008610086100861008
chrY	LINC00278	3079283	3079341	35	59	35	4194	0	4135	0.5932203389830508	0.0
chrY	PCDH11Y	5030898	5031067	0	170	0	10882	0	10712	0.0	0.0
chrY	PCDH11Y	5002687	5002758	0	72	0	10882	0	10810	0.0	0.0
chrY	TTTY7	6457158	6457414	0	257	0	1473	0	1216	0.0	0.0
chrY	TBL1Y	6978212	6978243	0	32	51	2646	51	2614	0.0	0.019510328997704666
chrY	TBL1Y	6995803	6995898	0	96	51	2646	51	2550	0.0	0.02
chrY	TTTY12	7805543	7805625	0	83	0	1178	0	1095	0.0	0.0
chrY	USP9Y	12847238	12847327	0	90	0	15112	0	15022	0.0	0.0
chrY	USP9Y	12708633	12708693	0	61	0	15112	0	15051	0.0	0.0
chrY	ANOS2P	13854443	13854577	0	135	0	4421	0	4286	0.0	0.0
chrY	ANOS2P	13790918	13790966	0	49	0	4421	0	4372	0.0	0.0
chrY	NLGN4Y	14622008	14622591	0	584	102	8602	102	8018	0.0	0.012721376901970565
chrY	NLGN4Y	14719458	14719518	0	61	102	8602	102	8541	0.0	0.01194239550403934
chrY	NLGN4Y	14748618	14748729	0	112	102	8602	102	8490	0.0	0.012014134275618375
chrY	OFD1P6Y	18732158	18732272	0	115	0	4111	0	3996	0.0	0.0
chrY	TXLNGY	19591779	19591959	0	181	51	8366	51	8185	0.0	0.006230910201588271
chrY	TXLNGY	19569384	19569459	0	76	51	8366	51	8290	0.0	0.006151990349819059
chrY	TXLNGY	19591919	19591959	0	41	51	8366	51	8325	0.0	0.006126126126126126
chrY	TXLNGY	19598551	19598639	0	89	51	8366	51	8277	0.0	0.0061616527727437476
chrY	EIF1AY	20584473	20584524	0	52	0	2900	0	2848	0.0	0.0
chrY	RBMY1B	21517056	21517234	0	179	0	2279	0	2100	0.0	0.0
chrY	RBMY1B	21524511	21524622	0	112	0	2279	0	2167	0.0	0.0
chrY	RBMY1A1	21548052	21548163	0	112	0	2267	0	2155	0.0	0.0
chrY	RBMY1A1	21540597	21540775	0	179	0	2267	0	2088	0.0	0.0
chrY	RBMY1J	22409151	22409329	0	179	0	1907	0	1728	0.0	0.0
chrY	PRY	22512637	22512752	0	116	0	1359	0	1243	0.0	0.0
chrY	BPY2	22994480	22994598	0	119	0	1447	0	1328	0.0	0.0
chrY	DAZ2	23236827	23236899	0	73	5	4192	5	4119	0.0	0.0012138868657441126
chrY	DAZ2	23246385	23246457	0	73	5	4192	5	4119	0.0	0.0012138868657441126
chrY	DAZ2	23253540	23253612	0	73	5	4192	5	4119	0.0	0.0012138868657441126
chrY	DAZ2	23239209	23239281	0	73	5	4192	5	4119	0.0	0.0012138868657441126
chrY	DAZ2	23255917	23255989	0	73	5	4192	5	4119	0.0	0.0012138868657441126
chrY	DAZ2	23243989	23244061	0	73	5	4192	5	4119	0.0	0.0012138868657441126
chrY	DAZ2	23251144	23251216	0	73	5	4192	5	4119	0.0	0.0012138868657441126
chrY	BPY2B	24628221	24628339	0	119	0	1447	0	1328	0.0	0.0
chrY	DAZ4	24888533	24888605	0	73	0	4377	0	4304	0.0	0.0
chrY	DAZ4	24893302	24893374	0	73	0	4377	0	4304	0.0	0.0
chrY	VAMP7	57082142	57082200	0	59	0	2623	0	2564	0.0	0.0
chrY	VAMP7	57106332	57106400	0	69	0	2623	0	2554	0.0	0.0
chrY	IL9R	57194042	57194127	0	86	0	2491	0	2405	0.0	0.0
chrY	WASH6P	57209218	57209354	0	137	0	2698	0	2561	0.0	0.0
chrY	CRLF2	1208805	1208908	0	104	91	1993	91	1889	0.0	0.048173636844891475
chrY	CRLF2	1208805	1208905	0	101	91	1993	91	1892	0.0	0.04809725158562368
chrY	ASMTL	1439096	1439144	40	49	1979	3520	1939	3471	0.8163265306122449	0.5586286372803226
chrY	DHRSX	2408744	2408813	0	70	3735	3640	3735	3570	0.0	1.046218487394958
chrY	DHRSX	2392353	2392474	0	122	3735	3640	3735	3518	0.0	1.0616827743035815
chrY	TTTY2B	6419764	6419851	0	88	0	5866	0	5778	0.0	0.0
chrY	AMELY	6868867	6868909	0	43	0	998	0	955	0.0	0.0
chrY	RFTN1P1	7805494	7805604	0	111	765	3939	765	3828	0.0	0.19984326018808776
chrY	TTTY7B	9707315	9707571	0	257	0	1473	0	1216	0.0	0.0
chrY	RBMY2QP	10024356	10024471	0	116	0	1635	0	1519	0.0	0.0
chrY	GYG2P1	12407192	12407309	0	118	0	5162	0	5044	0.0	0.0
chrY	UTY	13251016	13251187	0	172	3078	9223	3078	9051	0.0	0.34007292011932383
chrY	UTY	13306037	13306112	0	76	3078	9223	3078	9147	0.0	0.33650377172843554
chrY	UTY	13359087	13359222	182	136	3078	9223	2896	9087	1.338235294117647	0.31869703972708263
chrY	UTY	13360429	13360528	0	100	3078	9223	3078	9123	0.0	0.3373890167707991
chrY	UTY	13393858	13393893	0	36	3078	9223	3078	9187	0.0	0.33503864155872426
chrY	UTY	13354785	13354833	0	49	3078	9223	3078	9174	0.0	0.3355134074558535
chrY	UTY	13358463	13358553	0	91	3078	9223	3078	9132	0.0	0.33705650459921155
chrY	UTY	13358463	13358619	0	157	3078	9223	3078	9066	0.0	0.33951025810721375
chrY	UTY	13396917	13396972	0	56	3078	9223	3078	9167	0.0	0.33576960837787717
chrY	TTTY9B	18588130	18588244	0	115	51	1648	51	1533	0.0	0.033268101761252444
chrY	TTTY14	18789810	18789919	0	110	255	17451	255	17341	0.0	0.014705034311746728
chrY	TTTY14	18813615	18813743	0	129	255	17451	255	17322	0.0	0.014721163837894008
chrY	TTTY14	18927075	18928373	0	1299	255	17451	255	16152	0.0	0.015787518573551262
chrY	TTTY14	19068723	19068798	0	76	255	17451	255	17375	0.0	0.014676258992805755
chrY	TTTY14	18877067	18877205	0	139	255	17451	255	17312	0.0	0.014729667282809613
chrY	TTTY14	18932742	18932841	0	100	255	17451	255	17351	0.0	0.014696559276122415
chrY	TTTY14	19073498	19073561	0	64	255	17451	255	17387	0.0	0.014666129867142118
chrY	TTTY14	18932650	18932841	0	192	255	17451	255	17259	0.0	0.014774900052146706
chrY	TTTY14	19045241	19045291	0	51	255	17451	255	17400	0.0	0.014655172413793103
chrY	BCORP1	19457056	19457117	0	62	153	10235	153	10173	0.0	0.015039811265113535
chrY	BCORP1	19459958	19460104	0	147	153	10235	153	10088	0.0	0.015166534496431404
chrY	KDM5D	19739527	19739662	0	136	122	9273	122	9137	0.0	0.013352303819634453
chrY	KDM5D	19741317	19741488	0	172	122	9273	122	9101	0.0	0.013405120316448742
chrY	KDM5D	19741734	19741857	0	124	122	9273	122	9149	0.0	0.013334790687506832
chrY	KDM5D	19723340	19723433	0	94	122	9273	122	9179	0.0	0.013291208192613575
chrY	TTTY10	20469871	20469981	0	111	0	8026	0	7915	0.0	0.0
chrY	TTTY10	20518270	20518329	0	60	0	8026	0	7966	0.0	0.0
chrY	TTTY10	20524267	20524440	0	174	0	8026	0	7852	0.0	0.0
chrY	TTTY10	20565067	20565191	0	125	0	8026	0	7901	0.0	0.0
chrY	TTTY10	20519035	20519233	0	199	0	8026	0	7827	0.0	0.0
chrY	RBMY1D	21881239	21881350	0	112	10	1933	10	1821	0.0	0.0054914881933003845
chrY	RBMY1D	21888627	21888805	0	179	10	1933	10	1754	0.0	0.005701254275940707
chrY	RBMY1E	21904780	21904891	0	112	0	1933	0	1821	0.0	0.0
chrY	RBMY1E	21912168	21912346	0	179	0	1933	0	1754	0.0	0.0
chrY	PRY2	22073643	22073758	0	116	0	1359	0	1243	0.0	0.0
chrY	RBMY1F	22169704	22169815	0	112	0	1933	0	1821	0.0	0.0
chrY	RBMY1F	22177093	22177271	0	179	0	1933	0	1754	0.0	0.0
chrY	DAZ1	23143010	23143082	0	73	51	4311	51	4238	0.0	0.012033978291647004
chrY	DAZ1	23155173	23155245	0	73	51	4311	51	4238	0.0	0.012033978291647004
chrY	DAZ1	23159952	23160024	0	73	51	4311	51	4238	0.0	0.012033978291647004
chrY	DAZ1	23138209	23138281	0	73	51	4311	51	4238	0.0	0.012033978291647004
chrY	DAZ1	23139846	23139881	0	36	51	4311	51	4275	0.0	0.011929824561403509
chrY	DAZ3	24784136	24784208	0	73	0	3535	0	3462	0.0	0.0
chrY	DAZ3	24786513	24786585	0	73	0	3535	0	3462	0.0	0.0
chrY	DAZ3	24791270	24791342	0	73	0	3535	0	3462	0.0	0.0
chrY	DAZ3	24796026	24796098	0	73	0	3535	0	3462	0.0	0.0
chrY	BPY2C	25041768	25041886	0	119	0	1447	0	1328	0.0	0.0
